@saaaaa_o	human
@k_kwanchanok	org
@DentelleFleurs	human
@cosmosdiner	org
@cucina_amore	human
@ArtOfTheSpa	human
@purplepoli	human
@MissSassyStyle	human
@EricInce_	human
@nike_fame	org
@MissY_Vegan	human
@S2xxbaby	human
@HealthyFusions	human
@jacksonlmarcal	human
@yess0307	human
@meetic_hunter	human
@magic_eye	human
@EatFirstUK	human
@VirgoGigi	human
@UngieNY	human
@drtgoesvegan	org
@EngrAhmedAli	human
@GingerVixenXoXo	human
@cooksmarts	org
@LaticiaD	human
@vispotosh	human
@DesireeBailey5	human
@AntuaneYoline	human
@chiostrodelbram	human
@DOLESalads	unknown
@ToveHenckel	human
@BordeauxPink	org
@GetCrocked	org
@sssourabh	human
@MODEnetworks	unknown
@Unreal_Deals	org
@TampaE4LDeals	org
@GAyanian	human
@VerradoGolfClub	org
@AmazingRouge	unknown
@WisdomOrganic	human
@IonPhoto	human
@imel_1085	human
@BGLW_LLC	human
@SaundersYeardl	human
@BridgitsLunchXO	org
@torandkinpira	org
@WangCharmy	human
@AbbagailAerica	human
@homerestobar	human
@JesusAndreu_FC	human
@yannwong	human
@ShreddybrekGYM	human
@HealthSwellness	human
@silverspoonorg	human
@hundredacresnyc	org
@mgreen318	human
@3Songbird	human
@JenniferKiara3	human
@flightinfo32	unknown
@Serendipitycork	org
@Foodie_Fatale	human
@CZARaliver	human
@MulberryStPizza	org
@ZaviaDavonna	human
@HanBaxter	human
@Athens4Lunch	org
@bottleandcan	human
@anatomidelgusto	human
@Adesdsljoe0108	unknown
@Phentermineme	human
@WynchellVontell	human
@fashion_time77	org
@d3_plus	human
@pamelasalzman	org
@chenxiangjustin	human
@amieleac	human
@simonseow	human
@CarmellaNYC	org
@goodwillwa	human
@MissLena_21	org
@myflashtrash	org
@klausrulowski	org
@DafneGonz12	unknown
@Imscouser	human
@Debs1	org
@shaza_noor	org
@raymund9099	human
@rebeccacoleman	human
@colowolman	org
@Yazable	human
@ErickCUEVAS_	human
@VeluetaDaniel_	human
@RobertEduard01	human
@CafeVue	human
@aisurumayuge	unknown
@TheGiffnockIvy	org
@Belgium_I_Love	org
@DandDLondon	org
@Gillocolonna	human
@Hupiom	human
@AdkenJeralyn	human
@Charlottes1984	human
@thesomerdawn	human
@ArmyTalkRadio	human
@AroundMainLine	human
@ameliavirgo	unknown
@gourmanda_me	org
@makrestaurant	org
@CheriSyFy	human
@84Robster	human
@urbanviti	human
@IsFavourite	human
@ReynoldsWrap	org
@trucnnyc	human
@CheeseRecipe	human
@UncleRuru411	org
@sofritonyc	org
@VisitVinings	unknown
@EsseryTucker	human
@colintan79	unknown
@maximumhealthan	org
@ohsushi_bot	org
@MidgetMomma1200	human
@Soberana_MID	org
@AleaMilham	org
@balancedblogger	human
@grouponhk	human
@JosFitspiration	unknown
@ForzaT5couk	human
@YrreMikaela	human
@RaquelMend5	unknown
@wawel1364	human
@shirleyahampton	human
@EWABEACHMANA	human
@FoodiePatutie	human
@natashabevins	human
@djsirvere	human
@ellenorsworld	human
@UkStartUpHelp	org
@InstaYevpatoria	human
@goLadleToronto	human
@djantlo	org
@TruongXuanTong	human
@samantha_leeys	human
@razorw	human
@LOCOLIFE_ALEX	human
@LucySTravers	human
@TheCrownE3	org
@FarinaLievito	human
@chibishiro_bebe	human
@Silver_Palate	human
@JenGetMo	human
@HipFoodieMom1	human
@MorninThunderCA	org
@ItsOnMe	org
@AudrianCooksley	org
@SirPizza	org
@DealDaysOnline	human
@CleanEatsFast	human
@Ms_Giggs	human
@JuanPnte	unknown
@miyakago11	org
@DatBoyDupe	org
@abbeyfloorcare	org
@Peckhamist	human
@hyemania	human
@iamweiping	human
@meursgerken	human
@MunicipalChi	human
@nadhasile	human
@CaribCookSchool	org
@_811008	org
@AliciaJasmine9	human
@karenfanfan	human
@joncates	human
@ZakariMaidel	human
@Mallard_Cottage	org
@BrckYrdGrnds	org
@BossTawat	human
@rachaelimm	human
@Komeeda	human
@pmworkchan	human
@Valentweety	human
@backhausgermany	human
@angie_lcc	human
@LunchBoxabc	unknown
@sofiyabahipuhy	org
@ZeppelinZain	human
@SariStrawberry	unknown
@sammysue13642	human
@zimkey	human
@cubist12	human
@CarreeYardley	human
@kunchan46	human
@tomomochan624	human
@SBCre8tive	human
@Bhum_	human
@AfilSyazwan	human
@kinofitall8490	unknown
@LorettasTweetin	org
@ZagatDC	org
@WylingfordCorne	human
@mrbdaniel	human
@701chloe	human
@PaigePayton1	human
@theatre_breaks	human
@QuantumVegan	org
@hgoodrichRD	human
@SunDialATL	org
@The_Good_Cooker	human
@BlueMoonAve	human
@TheBlackburne	org
@ScotchEDbonnet	org
@DinnerDiva1	unknown
@jenscloset	human
@chefvikkik	org
@riskinfo	human
@ZetaBrewing	human
@marco_ht	human
@crixtwist	human
@beazellscajun	org
@Blanco_sahara	human
@ChantalMunoz	human
@SarahRDtv	org
@sakiike	human
@WLShafor	human
@chasetheRG	human
@TheLunchBelle	human
@WannaBHealthNut	human
@RockYourMeal	org
@YGFarmersMarket	human
@TheLifeGoddess	human
@DaveBustersPHL	org
@AzurLuxury	org
@MarcosVlle_	human
@UrSecretIngred	org
@TheFemaleBlue	human
@_SuperGossip	human
@annacolegate	human
@Pervyi_Modnyj	human
@panopticlove	human
@muffingoddess1	human
@SophieRalls	human
@like_roxane	human
@MaxsGrille	human
@RoxyLunaCruz	human
@abd828	unknown
@kitchenrebel	org
@fidelgastros	human
@larabeeuk	human
@howbabbyformed	org
@EasyOnTheCook	org
@saltlicksmoke	org
@AberthaAglaeca	human
@rymbz	human
@charisseethomas	human
@JamieBrittany1	human
@fitness_curious	unknown
@ihnfsa	human
@robinsky830	human
@thereallife_RD	org
@pinkethai	human
@Odettes_rest	org
@ocanak	human
@akitchenaddict	human
@emogen_indie	unknown
@deadsezar	human
@InstAustinTX	org
@ysilver	human
@AeqmalHuat	human
@AlexisButters	org
@Faye_Lotso	human
@atlanticgrill	org
@BellsofShandon	human
@ChefJoseGamez	org
@bitchybabie	human
@Karlagollanes	human
@ChloeMeghan1	human
@anizam75	human
@EmilyStox	human
@ViriSol0	unknown
@rye1984	human
@Hedonies	human
@NycciNellis	human
@princeyuanito	human
@SimplyRealMoms	org
@KoKoaMagazine	org
@PegCasidy	unknown
@kita927	human
@mycraziefoodie	unknown
@rossanavanoni	human
@racheshire	org
@dazzidaz	unknown
@sabebe22	human
@doclocs	human
@bubbletushable	unknown
@aocla	org
@MicerAndreu	human
@RashellKay	human
@BlogButterflies	human
@eatsalem	human
@andityoemo	human
@3geventcatering	human
@knakaneezee	human
@MiaBethany1	human
@icalynn	human
@jihealee2011	human
@sewsimmershare	human
@pearl_essence	human
@AskAConciergeLA	unknown
@cafePROPER	human
@Parentingtweete	human
@vlatkoristevski	human
@delinorr	human
@EatBERLINS	human
@ZerenityLacie	unknown
@YolineVonn	human
@mmscooks	human
@raipon1971	unknown
@ShanellLuster	human
@MollyMalonesDC	human
@Bcn_SSTG	human
@dadthebaker	human
@huangfuhan	human
@wearesimplyfish	human
@ClamScavenger	human
@dalebanaag	human
@Inspiredjae	unknown
@CandiesKartel	human
@HuxlyChapel	human
@dickyfabriando	unknown
@BiancaPicaPica	unknown
@iamkarenfaner	human
@RobertA1Herrera	human
@be_healthful	human
@afuie27	unknown
@DiannesKingston	human
@DaniaTrr	human
@airn_airn	human
@artcafe1	human
@hiyokobio	human
@anadimana	human
@AnaRevealed	human
@CrownIslington	org
@carlosmelia	human
@LAXHashtag	human
@klostermanbread	org
@VictoriaEss2	human
@RobinWono	human
@teklalneguib	human
@technicianmedia	unknown
@real7a	human
@niferschmitz	human
@angeliajthn	human
@anglesey42	org
@elsaloveshoe	unknown
@MyDiaryofUs	human
@Tae_Kantana	human
@sya0ran	human
@AntonelloKaos	human
@fourpointsdubai	org
@shifuku_id	human
@RoddZackery	human
@Ama_yrani	org
@PumpRestaurant	org
@allsgstuff	human
@carine4evershow	human
@boostbastille	human
@RonnBeldad	human
@feddy389	human
@JohnLan12	human
@FinanzAltFin	unknown
@mjkMi	human
@dukethedrummer	human
@GFTBestBuy	org
@Patygarraus	org
@MustardHove	org
@SpiritTalkRad	org
@x_SoulBeat_x	human
@francesfrugal	org
@ohiofoodnetwork	human
@ParentTalkRadio	human
@Le__binh	unknown
@AegelweardAttew	human
@bigdelicious	org
@ptythelper	org
@DYsbail	human
@NatrlHairVegan	human
@CatalystCam	org
@SrbijaPutovanja	human
@dfwbiztv	org
@NDTVFood	org
@LobsterHouseNJ	org
@detron81	human
@friends_ofours	org
@bellahunnebo	human
@voulezvousdiner	org
@Jally_Tatsumi	human
@GoaConnect	human
@ryankubotumblr	human
@JavierEQuirosV	unknown
@TheHavenCafe	org
@IshitaUnblogged	human
@LeahMichaela2	human
@QueenettaYesti	human
@NaduvanSvemirac	human
@toyamaisikawahu	org
@evabin	human
@jeploksify	org
@MsKellyAmber	org
@RaisedSouthern1	human
@SmileInBristol	human
@hudsonkitchen	human
@kaffeetweetie	unknown
@MemeGuy1	human
@Aiiyah	human
@AriannaAmanda	human
@makaylavalerie1	human
@Whaelse	human
@BBs_Cafe	org
@hotsmartusa	org
@JodieFitz	human
@hillyshadow	org
@scoochmaroo	unknown
@DayanaMont13	unknown
@MelissaLlado	human
@vincelsie	human
@FruitNFitness	unknown
@JoanieYeardleig	human
@BoulestinLondon	org
@FunFoodRecipes	org
@sugarcanerawbar	org
@aiai_lalala	human
@delvytio	human
@fashionjuice	unknown
@foodiliciouskit	human
@GoldiesNaples	org
@lealou	human
@DeniLie	human
@Panama21E	human
@slowcarbfoodie	org
@phitnphat	human
@ChelitaBi2	human
@zlwebber18	human
@tabbyspantry	human
@ProspectPtCafe	org
@MariselSalazar	org
@fuseBOX_W_Oak	human
@DiZuccheropr	org
@AriekaChen	human
@MyloHwitloc	human
@saki840717	human
@Ashley_APL	human
@cephascjs	human
@charlesbuntoro	human
@WalbyModesty	human
@MorganJillian2	human
@gymracom	unknown
@leanbeanfitness	human
@DrKukur	unknown
@Mlle_Pamela	human
@anishariah	human
@zbe81017	org
@BloorStDiner	org
@TravelHostFTL	human
@RealFoodFolks	human
@traazil	human
@ThearlAbbigale	human
@natashaahelen	human
@DC_Brunchers	org
@JuliaCabr2	unknown
@LegitBostonFan	unknown
@Chezbobbelsize	org
@nnguyen04	human
@BoringSunday	human
@Boardwalkmarb	org
@JInferido	human
@pizonabriti	human
@vc1016	human
@jitladaLA	human
@ZakaryPhayth	human
@antipatikath	org
@OlgaGuardia_	human
@chefcoteque	human
@CocineroFraile	human
@MandysRecipeBox	human
@LorenDespradel	human
@AlexanderRmos	human
@portfondakc	unknown
@jax_florida	org
@BychkovDavid	human
@Baking_Bigfoot	human
@BirdhilOrford	human
@Angelic05090288	human
@Jannetrego	unknown
@Silvias_closet	human
@debbiecat	org
@captamericafans	unknown
@jodiediefenbach	human
@AnneLynn90	human
@ardo81	human
@PaisleyCafe	human
@pinkiss_queen	org
@AngusClub	org
@cescasj	human
@brunchaholicnyc	human
@annasblumenblog	org
@yuri0328boo	unknown
@facesbyyessi	org
@WyligbyLind	human
@iamboredhelpme	human
@Ms_Chaparra73	unknown
@mandimellen	human
@Otherbots	human
@jamaicastores	human
@BakerandcoNY	human
@RavenFoods	org
@AndiShadam	human
@burniesclovelly	org
@widya16111992	org
@Cure_UR_Cancers	human
@GourmetMealPlan	org
@ChasitaBedford	human
@BierLoda	human
@InstaLiepaja	human
@SellyBurns	human
@OffTrackCooking	org
@NataliaQuez	unknown
@JWBarger	human
@hotelcoz	human
@ashabutterflys	human
@OscarOMGLIST	human
@RajivsKitchen	human
@budatai	human
@copocafediner	org
@TheSenatorTO	org
@PhillyE4LDeals	org
@KylieYip	human
@glance_magazine	human
@Bakchic	human
@janeywoo	human
@ulive	org
@SaboresbCJ	org
@CarnabyLondon	org
@LilyoLiving	human
@cleanandlean30	human
@lynnlynn69	human
@byzuzanna	human
@KathrynKuby	human
@butchermiami	org
@KimnYamilet	human
@RomanticInns	human
@OneGreenPlanet	human
@MzSavvyPREvents	human
@lemontree7lt	org
@songphol	human
@Elephant_Food	org
@jdfarmsturkey	human
@ChefsDisplay	org
@EggandI_Waco	org
@EatBeMerryCrew	org
@FoodEmbassy_	org
@DotHustla	human
@dukeofa	human
@PPsoul511	human
@HalukKU	human
@lemonicafe	org
@bakesinslippers	human
@Afandi_ahmet	human
@WyattShorter	human
@WURSTCalgary	human
@AnnikaUrm	human
@ExpertOnHorses	human
@trentscafe	org
@KennysCookery	unknown
@booksfortweens	human
@Mademoisellesno	human
@highslowsmiira	human
@BetweentheBread	org
@501Donderslag	human
@avirtualvegan	human
@innomanews	org
@JNaymin	human
@christacollie	human
@caramelwings	unknown
@MWModernMomma	human
@Ladybridgefood	human
@dietcokehead85	unknown
@HartfordSq	human
@EKB_life	human
@GKuffuor	human
@brocktonvilla	org
@BurhleagAcennan	human
@Kwiiishy	human
@SusanaKawai	unknown
@laurasmessperth	human
@culinaryginger	human
@crewmusic	org
@cerati9	human
@AutumnBrenda	human
@reiderger	unknown
@ClassyChicShel	unknown
@Kyleedrian	human
@LychaXue	human
@GreatBeerNow	human
@GoDrJo	human
@Robzi_girl	human
@et8071	human
@XandraColin	human
@waccamica	human
@MinnieBesT	human
@gracemakesalady	human
@thelearnerchefs	org
@Sassyitalian41	human
@JacquelynneS	human
@simplecafe	org
@dolphinluvrGail	human
@MONTEGO_VABEACH	org
@La_Douce_Vie	human
@AbadineKynedyr	human
@ZumbaNaazi	human
@WeatherMarkTav	org
@FratellosApp	human
@AdelaidoLacherr	human
@iamedwarde	human
@TheSteadyCafe	org
@FishHooking	human
@Vintage_Voltage	unknown
@Its_Bryetta	human
@periscat	human
@greenbarkitch	org
@LifeWErikaBlog	org
@crazzzytam	human
@yangzi_	human
@priti2	org
@team37bb	unknown
@JAMRehoboth	org
@RumbaCafeDC	org
@MissHijabi_MK	human
@TignesHub	org
@ShapiroDe	human
@racinginit	human
@mikhalt	human
@MPowerNutrition	org
@MuscleFoodUK	human
@SavingUGreenMom	unknown
@DiniKiddis	human
@HariGhotra	human
@chicca_secco	human
@AnnePeppy	human
@fitnessmotiv8n	unknown
@rosereisman	human
@GheirTweets	human
@TaliaMariani	human
@tjyusun	human
@nofx2345	human
@MissingCatsRT	human
@FLTripGuides	org
@John1827Joyce	human
@uqapamreiq	unknown
@melsrentoy	human
@peachesfoodtrl	unknown
@larapanget	human
@DavidHarris707	org
@plateaulondon	org
@MealsWithME	human
@DamianVzqz	human
@MeilissaT	org
@RinaMohamad	human
@KissAfteRunning	org
@GirlMeetsFood	org
@hellogr8health	human
@dylla_adeq	unknown
@melishialove	human
@AdenyddSeeley	human
@JonValdezX	human
@yakuks1	org
@lite_delights	org
@cookierookiebec	org
@fernandmunoz	human
@TheBocadillo	org
@JonV_Nutrition	human
@dinnu_m9	human
@spanishkitchene	human
@poandpo	human
@SugarFreeSheila	human
@SeptemberThird	human
@Jacki621	human
@katyryje	human
@elisazied	human
@Foodtrainers	human
@FatAl_Thoughts	human
@ajgswa	human
@ourpeaceplanet	human
@dinkyprincessa	org
@RamziAbed	human
@renegade528	unknown
@cupcakesasa	human
@HoosierRadio	human
@mohowajavuti	unknown
@PinkNinjaBlogg	org
@CulinaLA	org
@BobbyBurgerPL	human
@emster72	human
@nickscalgary	human
@yurix446	human
@Foodilicious_BE	org
@KatiArndt	human
@NancyNewcomer	human
@foodculturist	human
@das_fla	human
@casey05isaac	human
@science__cat	human
@Dofmhg	org
@OnlyFerrariPics	human
@MaxTheCutePom	org
@southbeachchefs	org
@AtheistEnigma	human
@calgarycaro	human
@TelmaBarragao	human
@elocin9696	unknown
@ValbyGarden	human
@crepelovetruck	org
@EAT_withus	org
@BIBAYourSide	human
@PerfectlyFitt	human
@kitschy_cat	human
@rl_TwoD	human
@jayvegaonline	human
@Sofiaa88	human
@gabbietatad	human
@inesssousa	human
@Backyard_PB	human
@rievy_ipy	human
@crcmarquezmd	org
@Beta_Fashionite	human
@ChiaraFormigoni	human
@Travelgroup3	org
@DaiseeGamble	human
@LaneFamily7	org
@thislilpiglet	human
@ValleybrinkRoad	human
@zaimaizzat	human
@vanillandlemon	human
@FullMusicGM	org
@yelpsandiego	human
@bikinimgfind	unknown
@bitememore	org
@Barcontessa	org
@mrQismyname	human
@BodfordVe	org
@quebec_rt	human
@daleleetw	human
@JillianMorgan16	human
@dunkndip	org
@CoachSueAnn	human
@andri0412	org
@EquivocalMusic	org
@vdilone	human
@jennhtweet	human
@foodpornmtl	human
@instaBikiniGram	org
@EveMireu093	unknown
@SalmaZais	human
@CstoneFitnWell	org
@Lily_Jan2nd	unknown
@Alexander_MacKi	human
@JoeysPizzeria	org
@yuixxx0214	human
@Don39294915	human
@MealTango	org
@thedeanslist_	org
@clownfishx	human
@AltaCaliforniaF	human
@luv2momy	human
@cafe_ichiren	human
@syafilfuad	human
@SophiaNOTLoren	human
@bot19813897	unknown
@KajsaAspJonson	org
@holyokehummus	org
@kevinandamanda	human
@JCCHuang1989	human
@KhunSher_Sherry	human
@RufosFamousTapa	org
@DaryleEldwin	human
@InstaMurmansk	human
@BeerAgentUKSean	human
@Micki_b30	human
@CrownePlazaBG	human
@Recipejunkie27	human
@marusso30	unknown
@GranvilleCafe	org
@sarahalizacooks	unknown
@YAlphonzo	human
@DowntownJasper	human
@soulmate_yjj	human
@ZackaryKirstan	human
@Smart_LiLCookie	human
@thatgirlchef	org
@RowanThiele	human
@sunnynblue	human
@spydamanunltd	human
@erangatennakoon	human
@marcelosendon	human
@kevincaban	human
@Sandra__Gin	human
@orsisoguy	human
@dindinmejong	human
@sophiesscran	human
@IsalieTyfiell	human
@TDiddyBoxing	human
@DiamondMgmt	org
@NorthForkd	human
@TheTempleBarNi	human
@RyanD1996	human
@Glaisnockcafe	org
@vaiishaliii	unknown
@ZachDanyale	human
@walkerlilly85	human
@AmayaMckenzie2	human
@MozzaBar	human
@CouponSherpa	org
@Stephan96366346	human
@hypnagogiamanda	human
@UrbanSwank	org
@DebboraDakeith	human
@TimmyNolans	unknown
@lindsaysss3	human
@kkalex1	human
@mieleton	human
@iloveSonia09	org
@rhevora	human
@charlainethorn	human
@lou_slimming	human
@cherry_mint31	unknown
@MyLadyChocolate	org
@Ms_Shany_BabY	human
@Diedrius	unknown
@IAmFloydsMom	human
@BeAtBeAtRiXs	human
@iamflirty4677	human
@Vintage_Pics	human
@365Guide	org
@AshleyHanstag	human
@Soppahanna	human
@chetnamakan	human
@marianatann	human
@sandrablaz	human
@PLovelace2	human
@Gastronomie_491	org
@Natadi23	unknown
@AndyWong0502	human
@IthelJae	human
@daguilar914	human
@jemdenis	human
@ickfactor_	unknown
@xicelia	human
@NOERU1	unknown
@Ciardale	human
@dz_amylynn1982	human
@msKD2u	org
@IreneLintong	human
@rachelcooksblog	human
@3decades3kids	human
@bungactiongirl	human
@RoadtoLessCake	human
@misssEykaFull	human
@yed_uy	human
@cafe_cowgirls	human
@SnoWrite124	human
@piccolocafenyc	org
@miss___nothing	human
@TucCraftKitchen	human
@EatCleanKL	org
@mrcoconutsacs	unknown
@MarliskaB	human
@podlondon	org
@nia_sharon	human
@AnniesDishList	human
@vegetable_slut	human
@Christina_Octa9	human
@lebarayoga	org
@EastsideCan	human
@AdkynRusty	human
@ernmander	org
@ashleighegoh	human
@leejooji125	human
@fotoclip	human
@smveganchefs	org
@BBCgmu	org
@TheShanahanPlan	human
@TheCecilHarlem	human
@1interiors1	human
@JohnReyesCalder	human
@EricPhuaym	human
@JannahHotels	human
@TamaraBenningto	human
@LowFatTips	org
@XzavierApRode	human
@TheAleiMuch	human
@Canadian88	human
@MissLunchParis	org
@FollowYrTrolley	human
@NorikoPak	human
@RakiReloaded	human
@RRR_NYC	human
@EmButlers	human
@joshuafighting	human
@herrygilly	human
@1momof5	human
@lovesAIYING	human
@LaCrostaceria	human
@BroadwayBrunch1	human
@No35Restaurant	org
@MichaelLieder	human
@WTGMilan	org
@BrooklynJacquel	human
@cute_ahaha	human
@abcvision	human
@teddyzelig	human
@JuicesAndCakes	human
@Malek0eid	human
@jkigay	human
@Nicolaa420	unknown
@JusWurk	human
@mbdbdesign1	human
@EorlAckerley	human
@EatGuideNapa	human
@AyseOrum	human
@NaaraiC	human
@AderynMikeya	human
@AnnaleahZina	human
@Crowsnestnash	org
@wiseciara	unknown
@VeganSJ	human
@BrianaHayley	human
@lazynetworker	human
@victors	human
@Kazueeee	human
@vanfoodster	human
@jess_kok	org
@brunch951	human
@DelfinosHymart	human
@Mitang11	human
@buccorory	unknown
@TresbienTay	human
@JOHNDUNNANHP	human
@slideinnpdx	org
@HQIFood	org
@Atika159	human
@queenieleong	human
@cha_maru	human
@AbbraAndrean	human
@AvParties4u	unknown
@Dakmannella	human
@FoodieEveryday	human
@Fortheloveto	human
@shuntaro_3	human
@AdelineOon	human
@YeddaCutler	human
@travelfreak1234	human
@dyamesvil	human
@RoderickValdez	human
@900Brickell	org
@withsaltandwit	human
@AsnLoveXXX	human
@cksrencontre	org
@eatupnewyork	org
@MaxVorontsevich	unknown
@iamraincrystal	human
@TheRealAdan	human
@LordCarreon	human
@MassageBucks	human
@AbertholAubra	human
@PhotosbyDafire	human
@officerocks	unknown
@Restomeson	org
@oceanmoonspirit	human
@EixSantAndreu	human
@Kimi_Pie	human
@therealtarao	human
@PersuAsianfood	human
@jahkob123	human
@rhyan_182	human
@PanPacificBali	org
@suezhoudoesfood	org
@FikriCRP	human
@Momo_Adachi	human
@SDE4LDeals	org
@PapillonOnFront	org
@FashionPgd	human
@RestoMatsui	org
@HoustonE4LDeals	org
@MelleBonPlan	org
@MayaMegan1	human
@VictoriaPntn	unknown
@DamonWarmack	human
@youthere1web	org
@blog_nsomayaji	human
@EmmaKel55626111	human
@mstephenc16	human
@DragonTruck	org
@Eatliveburpblog	org
@SanFranPicks	org
@Bento	org
@maudinettte	unknown
@KODistinction	human
@morningmode	human
@CherylStyle	unknown
@mido_sayed10	human
@Mwholesomelife	human
@BisonDublin	org
@nicolas75flyert	human
@LadySvetlana	human
@CatBinge	org
@divergentyes	unknown
@sweetcrazymlene	human
@TescoFood	org
@amejane1406	human
@aCountryTune	unknown
@lovekitche	human
@aa_stardust	human
@thepurpleeleph1	org
@MAgostinis	human
@VonOneil	unknown
@ActiveApryll	human
@EelbrookTweets	org
@AmysKitchenUK	human
@CoqdArgent1	org
@speki4eyes	human
@makNming	human
@PaleoPlusDiet	human
@tropitch	human
@Marsoutt	human
@RamburesYulee	human
@Lindsay11863436	human
@TribecaBelgrade	human
@cocoycalderonmd	human
@Tasha_T2	human
@CHARLIEWINES	human
@DomiPJ	human
@DowntownDogsChi	org
@bento_box_japan	org
@slehan	human
@DrSarahB	org
@rob82840557	human
@advera	human
@AckerDaysi	human
@brandonlwp	human
@BrockAdam	human
@ErikEdubb	human
@pub_queenshead	human
@AvivRestaurant	org
@KelseyLydia1	human
@monicazmuzik	human
@hardcandyM	human
@yenny_chai	human
@iLauracp	human
@Realmzmiss19	human
@aliantecasino	human
@cherishedbyme	human
@4NationsDine	org
@SensibleLessons	human
@VeryVoonHong	unknown
@ChloeTiffanyLee	human
@eatforendurance	human
@TeenFashion_123	human
@SmartTalkings	human
@Popconi	human
@CptNash	human
@BABEL_ROCK	human
@MyPastaBar	org
@Yamada_Ai_Lisa	human
@snoopy2013cr	human
@wobblyclark	human
@Mel00	unknown
@Patriarshiye	human
@RauldaChef	org
@foodyschmoody	human
@nao_nmr	human
@JNSantaniello	human
@wiolciaqx	human
@ShannonVanessa2	human
@realfoodbydad	org
@Destiny27176998	human
@JaelDesignsInc	unknown
@edelbro_	org
@lindatol001	human
@producerpassion	human
@Ferdinands1	org
@gourmetcasero	human
@GrabbMobile	human
@Meet_Singles_	org
@NelsEnriquez	org
@acowux03	unknown
@BELlEVEinDreams	human
@trendymomreview	human
@zeppy_muffins	human
@KimberSummerlyn	human
@Amaiia10	human
@IsabelleSpanu	human
@LindseyElizab14	human
@indealsNCL	org
@AnnmarieKostyk	human
@AdrinArth	human
@speckledpalate	human
@AbbegayleLymog	human
@bluesky_pandura	human
@aloha	human
@CuevRuiz	unknown
@BigRubeOnline	human
@SteffiiTeph	human
@NeuvooPTSea	unknown
@MidtownGrilleNC	org
@StowellLiz	human
@MONAPRARICH	human
@updatesbot	human
@agonzalezfl	human
@WoolseyChatwin	human
@antichifrutti	org
@Janell_Lim	human
@app4food	org
@WavPin	human
@Wealthy1Percent	human
@IAmRamPaige	human
@HollyAutumn2	human
@queenofswag4u	human
@buddhish	org
@jankynola	human
@aNitricionista	human
@EngrishTwit	org
@SpinaRestaurant	org
@CircleofDrink	human
@JarranYaris	human
@AJohnsonNutri	human
@ktchnprvsns	org
@Wordsof_eL	unknown
@sgnr	human
@ktkrystaltan	org
@BurnbraeFarms	human
@gretchylicious	human
@massimomele007	human
@LoCoEntertain	org
@hirukime	human
@Juneunicorn	human
@RenettoMario	human
@delaneylogcabin	org
@kathyvivas21	human
@KudosDelivered	org
@DJTANELF	unknown
@Phowsfundraiser	unknown
@Flareware	human
@XiaoTiff	human
@amanitaorganico	org
@yaoki_dokidoki	human
@CAUrestaurants	human
@kokocooks	human
@earthlngorgeous	human
@GreenCaerleon	org
@javierc34	org
@eFromDC	human
@abi8in	human
@supportthetrust	org
@vegancandigirl	human
@mimihyll	human
@tradeyourkidsc1	org
@BadExampleMan	human
@kirtfloydtrini	human
@BlackWalnutCafe	human
@timeismuscle	human
@soupaspud	org
@CodaBarBoston	org
@JohannahBryson	human
@4virtu	human
@thewebber2020	human
@scarsdaleselfi	human
@dax	human
@modelvanick	human
@so0oma1992	human
@RosedaleDiner	human
@TillamookCheese	human
@omgitzlinaa	human
@RiverCreeCasino	org
@Merenji	human
@MEIHsu0314	human
@EastSide_Deli	human
@kazenoeki	human
@nonyababe	human
@Ron2ThaPon	human
@pompocod	human
@LoudmouthLorrie	human
@CookinCovati	human
@PTAntNyman	human
@La_Varenne	org
@kamalmustafa78	human
@master2h	human
@iamBENZON	human
@IngridVazqz	unknown
@HookahRetweet	org
@LondonBrazil1	human
@gqindia	org
@ArianaSamantha6	human
@sortrachen_	unknown
@IsabellaKenne19	human
@DjDueL	human
@ronal_ys	org
@WINGIT_App	org
@F_Alexander_L	human
@MirDWoonie	unknown
@chiftf_willis	org
@ellegant_	human
@mfrider	human
@Micasayourcasa	human
@Collectif_ATK	org
@asajoelsson	human
@ohhollygosh	human
@suzilehrmanvzf	unknown
@bethanybeads	human
@PedramsPress	human
@rhg_anglust	org
@jasmine_nl	human
@auto_snack	org
@DVB88T7P9YaN95s	unknown
@kfmillican1	human
@RICKYJIROUX	human
@MayMunich	org
@aaha0524	unknown
@jenlschiffer	human
@MAntoniettaCrea	human
@WyohDeserae	human
@arpenck	human
@kleindesigner	human
@eric_lanlard	org
@nike_ninja	unknown
@syuksha	org
@obunochiuketa	org
@HotelFB	org
@MuthiKa	human
@IntolerantG	org
@feliciafroggy	human
@Syafeena	unknown
@snstreet	human
@BelmonteRaw	org
@raulcohen	human
@MeBonitaMaldita	human
@Savory_Cooking	org
@CosmoTriBeCa	human
@sarahbinsd	human
@commune_nico	human
@ryanlively2012	human
@AdalbrechtaMaci	human
@VictorBunD	unknown
@AefreKatherina	human
@mehmetaliyilmz	org
@SpereWoodward	human
@wellnessbyjenna	unknown
@deifsitas_nu	org
@diet365global	unknown
@0l1l2	human
@mayscorp	human
@cat7320000	human
@saglikli_yasama	human
@CHOY_911	unknown
@fula97	human
@NestFreshEggs	org
@RivieraEP	human
@wmigz	human
@Davidneoslayer	human
@StellaBarraChi	human
@StunningWoman84	human
@BaronsRB	human
@AlexandriaHanst	human
@Pierre_Producer	human
@EpicerieBoulud	org
@tokyoblack	human
@TheOverDraught	org
@ErickaSaves	unknown
@AngieLupusLife	human
@icelandcool	org
@DanicaLovenjak	human
@AbgailFarris	human
@riccicutie	human
@BagatelleLA	org
@ShemZina	human
@AmyLaur58897814	human
@AbigaleBuffi	human
@Sazonnyc	org
@AmandaArianna1	human
@OmarAlmidfa	human
@tonkoutentyou	human
@brownandbrownin	org
@VivaLVegan	human
@Pietrart	human
@norakobrenik	human
@grubmachine	org
@TerryZita1	human
@DebbieAnneRuns	human
@countercult_dub	org
@KevinZmra	unknown
@nikisavage	org
@napabramhall	org
@MyaVanessa1	human
@CerroSantaAna	human
@HarbourCityGril	org
@ROEyiyemi	human
@LOVERHIANNON39	human
@Chibimaru717	human
@victjunior	human
@chrisjason1778	human
@VinesonClark	org
@JayJayasuriya	human
@kianweng95	human
@sobadokoro510	human
@AngelaRunsAmuck	org
@Quezzz1	human
@GhaDaH00	human
@DancesWithRain	human
@RDHolland	human
@designboom3	human
@locappy	unknown
@fabveggievegan	org
@teukoapp	org
@seturepi	unknown
@frankiesfeast	org
@warmandtote	org
@alicejommakan	human
@wblounge	org
@CARYNyo	human
@herbthymemarket	org
@lackofcolorfash	human
@insup	human
@BrndMrttnz	unknown
@Genius_Knight	org
@AgentArmageddn	human
@ClyveMyers	unknown
@cacanito	human
@FionasCloset	human
@FoodsSafety	human
@TrayCafeKL	org
@ennielim	human
@WavyCA	org
@alma2004satea	org
@upstartup30	human
@enggirl	human
@Tidbitsofexperi	human
@DNM_Phi_Dining	org
@AbbegailCamyron	human
@educationyoga	org
@backpacker_16	human
@KentonAckerley	human
@greenzlife	org
@albertogarza	human
@BigFatDaddys	org
@ErikaHaley11	human
@BrixtonVillage	org
@tanagnes13	human
@imaRhubarbarian	human
@MStaufferRD	org
@FehmiBenSlama	unknown
@lil_junio	org
@MastermindBrom	org
@SherryInk	human
@G_Delights	human
@KingTruffleITA	org
@GGenosa	human
@beeswonderland	human
@djaki19	human
@khunpentor	org
@OriginalNFV	human
@KavidaRaveendra	human
@briagutierrez	human
@HarlemRestRow	org
@ErickaWP	human
@winendineapp	human
@ConocedLaVerdad	org
@iamJerepee	human
@mrHelmiMokhtar	human
@FC_Review	org
@serniver	org
@NaturesBasket	org
@Sandy_Cca	unknown
@plantbasedpixie	org
@manee_me_more	human
@ardipulaj	human
@2bbistro	org
@cathy257	human
@ChinTeddy	human
@gipsipink	org
@chrisfreytag	org
@henry33tan	unknown
@JOY0415	human
@theserialfoodie	org
@harryspizzeria	org
@davidbhagger	org
@haridas24887	human
@Nocturnalsaint	org
@intotheFworld	org
@norca17	human
@MrsHannah11	human
@MilkBar_CafeIsh	org
@hannah_tan	human
@ivanbrezakbrkan	human
@RUMI_Cocktail	unknown
@PerthAaliah	human
@hendrickerz	human
@jjryu125	human
@ReykjavikStyle	org
@IrisClmn	human
@DJ_Battlefield	org
@royalcowgirl	human
@buu_k	unknown
@FederalCafeBar	org
@yensytehani	human
@yanaisou	unknown
@ClassicTacos	human
@FoodMaster3	org
@CharactersYEG	org
@Telekorn	human
@PoonChanS	human
@ExpatsinParis	org
@murielskitchen	human
@CampbellsBakery	org
@nanyan12	human
@nghipham91	human
@AHungryPear	org
@shelikesde	human
@birgerbird	human
@NYMagDeals	human
@JihaneKhan	human
@Ms_Ishinomaki	human
@robpavo	human
@tonethskiie	unknown
@rzalmj	human
@Alessandra_LDN	human
@50eggsjk	org
@AnnikaDomek	human
@TommRbls	human
@shawsimpleswaps	human
@bacididama_gf	org
@OMyRahDance	unknown
@DesayunosconDia	org
@stealthhawk	human
@KnutsfrdReTweet	org
@FineDinerYYC	org
@IoannaLiouta	human
@peke_genemata	unknown
@EmmySpiers	human
@Gor4You	human
@Aureliemalau	human
@meghasarin	human
@gcrutgers	org
@AmarraAdyn	human
@Sirime	org
@runfastmama	human
@LGourmandises	org
@DJFUJIKO	human
@AldeLighthouse	org
@venadiumcava	human
@lgarland1	human
@KpopUnlimited	org
@LutchoChrist	human
@AckerleyCorde	human
@edouardedward	human
@AdrianaMartnz	human
@odeedee	org
@johnforbis	org
@_LordoftheForks	org
@opalcampbell11	org
@JaquelinePaz65	unknown
@GretasDay	human
@TrinityAlejand1	human
@matchyu	org
@FamilyFinest	org
@ColumbusNewzer	unknown
@Pillsbury	org
@elliemathews1	human
@WOLFPACK_tyG	unknown
@MoAwesomeSauce	human
@serenewen0202	org
@iam_ishii	org
@NoliZalia	human
@momfindsout	human
@jeyanea	human
@RealInto	unknown
@FrauLoermann	human
@JTsDiner	human
@Take5Eats	org
@JudithBleher	human
@chefwithwings	human
@grandmannermag	human
@SpiritBaltimore	org
@BebaPhotography	human
@therealmahrz	human
@chiehjmc	org
@flattailsurf	human
@GeniusKnight	human
@YatesAnjeanette	human
@ange_leung	human
@LarAbertha1	human
@ObliqueLondon	human
@imanahmed970	unknown
@CamrynShelby	human
@MsCindz	human
@BadBitch_Bugz	human
@ipendut_	org
@BikesbridgeBeer	org
@MobileFoodConf	human
@EarlyAmericanMA	org
@MartinDrive	org
@ingeniouscook	org
@CartimanduaWynw	human
@NeuvooCsrHou	unknown
@viavaiTO	org
@CurveLatte	human
@prettyByrd1	human
@noask0302	human
@ChilisKuwait	org
@kpspiderman1979	human
@JOKERSnTHIEVES	human
@TasteCharades	human
@strongadolfos	org
@jackypostgrad	human
@DanielValenciaT	human
@yetjuls	human
@MamaBsLosingIt	human
@DianaAlyssa3	human
@EsmeraldaSkylar	human
@sni_ct	human
@NoorTehini	human
@EatThisBurnThat	org
@NewcastleLive	org
@Meeeri_B	human
@ZenArchives	org
@vildesophie	human
@Belli860	org
@bagelnash	org
@beautifulthngs	human
@AndreaLnda	human
@berlinmittemom	human
@agusk2010	org
@thaonhile	human
@TheLocalVoice	human
@mightyfinetx	human
@MandeepSheera1	human
@dhemz	human
@Warrent9	org
@TheBreakfast_Co	org
@merrinmae	human
@swanabout	org
@brendamrodz	human
@MomSpotted	human
@BlondeArrow23	org
@Mr_Enjoy_Aja	human
@WhollyWholesome	org
@thedailysequin	human
@sincerelygage	human
@StylishByNature	human
@vraticeserode	unknown
@84thand3rd	human
@YsberinWacfeld	human
@I_heart_kale	human
@Mr_arm_	human
@perkupcafenj	org
@may840813	human
@ViralVideoTube	unknown
@JacquiBelieves	human
@FelicityGamelin	human
@TheHealthGod	human
@kimchi_mom	human
@AelfdaneChaise	human
@fleur_CestLaVie	human
@PaymonsHookah	org
@YaninaIT	unknown
@LaurenDariana	human
@EricTendian	human
@food_wanderer	org
@ElizabethL	human
@rayuelaec	human
@LacyIssaic	human
@LustinaLee	human
@LeMeridienDXB	org
@Urbanrayz	human
@KKComms	org
@KildaresYunk	human
@AllisonChelsea5	human
@fashionfiesta87	human
@Henningland	unknown
@xtinaluvspink	human
@PoesTipTapRoom	org
@chriiiis	human
@APPETITEology	unknown
@IsabelEvelyn2	human
@picniccornwall	org
@avenuedublin	org
@Kai_Ergo	human
@WorldsShop1	human
@BBMunny	unknown
@Shizue_Skobiak	unknown
@FitnessViking	org
@Aika_Minagawa	human
@MalikAbdul00	human
@steventeaster	human
@GenesisMariah1	human
@CourtneyLWells	human
@Estetica_Yaneth	unknown
@UScanwatercress	human
@mame72	human
@ethepmarvellous	human
@jenteesitup	human
@APresenda	human
@ZohraMuhammed_5	unknown
@AnnArborWFM	org
@KitYardley1	human
@KrisKrisGr	human
@CowboyGamesBot	human
@divastar_klao	human
@nycfoodtruck	org
@missnellebelle	human
@SC_Cicchetti	org
@JasmineAlicia3	human
@InspacePapa	human
@Haleartisanmkt	org
@HyperionPublic	org
@AdkinsIna1	human
@Mr_Friendlys	org
@YorathCyntheia	human
@emmelodie	unknown
@ZavannahJonni	human
@muggle_sharon	human
@AlwaysBeenMad	human
@GiorgosPel	human
@BIGGINAENT	human
@CCS24h	human
@mackie430	human
@PannaCooking	human
@JerrysUSA	org
@WOrtun	human
@AnAnnoyingTweep	human
@xiscamayol	human
@gewgew69	unknown
@MrMidgetMomma	human
@CrosleighAaric	human
@NickDeVolder	human
@juliasimson82	human
@BINGBING_CKTAIL	human
@La_only1_Monica	human
@cindyhyz	human
@kaloriku	org
@AdramGentry	human
@princesayaiza	human
@Fresh_Living	org
@kBrotherhead	human
@SandyCoughlinRE	org
@AdynaCater	human
@HealthyMuffinRe	org
@vickychan222	org
@FikriRx	org
@EEthnic	human
@domsdads	org
@MatannaKatz	org
@derektte	human
@hhzahid1	human
@staircasejapan	human
@BostonParents	org
@ZaatarWzeitUAE	human
@ZadieMilman	human
@YamilexCranley	human
@WetherlyXavior	human
@1971kanan	human
@weddingdaze_	human
@KaiKai_Eeyore	org
@AedreApryll	human
@dbupintheair	human
@rienazzahra	human
@itsAfeeling	human
@healthymania777	human
@zoegathi	human
@EnjoyYoso	org
@KildaresStateCo	human
@The_Swag_Shop	org
@JaneLovesStuff	human
@Fiery01Red	org
@mayakoba	org
@ChefLeenaTorres	human
@PinkRecipeBox	unknown
@RuneAbadine	human
@farrel_backer	unknown
@WyndellDyvyr	human
@Hapjesprincess	human
@DoctorGooFee	unknown
@DaveMagrogan	org
@MinneappleEats	human
@clairemu1	human
@purekomadoka	human
@Melbourne4Lunch	org
@BlackSeedHealth	org
@eggladybbf	human
@ChanelTanaka	org
@OrmondAelfdene	human
@OhDearPenguin	unknown
@MomMadeFoods	human
@crockettscamp	org
@EmilyFruitCrisp	human
@LadySoiledDove	unknown
@WebChefKimberly	human
@hannu_harjunmaa	human
@622North	human
@LeoandLilyWH	org
@Adrienne_Kane	human
@qwerpoiu0	org
@lahueca	human
@Soukiengabe	human
@vivifunk13	unknown
@myshellter	org
@BmoreMobileFood	human
@savemrespendles	unknown
@mikeyesTV	human
@HansonChan2020	human
@Brytwire	human
@PhilipRLeodoro	human
@EatWith	org
@christytyy	human
@suaDenisse	unknown
@coachtanisha	human
@D2WELLNESS	human
@caffe817	org
@CandBnyc	human
@MennoFellowship	unknown
@AkaciaShelly	human
@PiroskaMaga	human
@HUSHeducation	human
@LondonEastWOT	org
@LuciasFineFoods	org
@shaunmyrick	human
@KBreakt	org
@DebbieZackary	human
@ConswalaAbeoda	human
@almallanerard	human
@JRomrell91	human
@foodandfoodss	org
@MomNutrition	human
@JGGrillMexico	org
@AudreyRachel3	human
@realafifdimyati	unknown
@franklanguage	human
@ZaineDale	human
@RachelKaycee	human
@stevenshomler	human
@Nocreklamozdera	human
@Bibani_mx	human
@amandaho147	unknown
@naomicpk	human
@france_images	human
@Maracaiboguia	human
@blueincboston	org
@NYCgrubber	org
@ragupesto	org
@YeardleighColye	human
@AveryCaroline4	human
@XFitnessit	org
@DarloBiz	org
@RTGlos	org
@Gabby58	human
@PASTELMIAMI	org
@NicholasCLF	human
@BelcourPreserve	org
@GlasgowFoodie	human
@fashionpremier	org
@maneldeswart	unknown
@teddyelwood	org
@WyntonBeaman	human
@PriscilaMldnd	human
@Mari_Ayurveda	human
@hungrygirlatx	unknown
@YettaNorwel	human
@StrandDining	org
@StravinskyHngl	human
@ambde	org
@coneyislandcook	org
@Smalltowngrrl	human
@JLgoesVegan	human
@ArabunnaFiona	human
@shirleykarra	human
@WynnoveTheomund	human
@Berlinfoodtruck	unknown
@AntionoAbrielle	human
@ProspectSF	org
@JoliceNashawna	human
@CopperChandni	human
@QueenCtySpcls	human
@syphonsteve	human
@drinkinbtn	org
@taaaaaaaaaask	unknown
@doimakeyourandy	human
@SpeckHamUSA	org
@stillblondeaaty	org
@FannyBF	human
@BuGGy2DaB	human
@Food_For_Life	org
@BenFizoummen	human
@WoolcottYsberin	human
@rinadecola	human
@sdickison	org
@TomsKitchenDeli	org
@pinchofactory	org
@I_Am_Shortie	human
@HeavenlyAngel28	human
@ginger7727	human
@rikafiorentina	human
@iJelgava	human
@Trixiebellexx	human
@vicenteLibre_	unknown
@beautyhawaii	human
@KeremPolat	human
@pancake130530	org
@katespiehole	unknown
@SofiAjem	human
@Darylhochi	human
@cyolacan	human
@anita_0620	unknown
@2saucytomatoes	human
@oldmilldoodles	org
@WytheJonithan	human
@AcwellenAleishk	human
@pea	human
@JonsFeasts	org
@eellaaa	human
@BellevueKloof	org
@whatscookingmum	human
@WynwardCyntheia	human
@tamamihomma	unknown
@foodakigr	unknown
@billiehuberta	human
@kelgoodfoodlove	unknown
@IAdvertiseForU	human
@mykulcats	org
@TerrificFitness	human
@Yukoable	org
@The_BrassKens	human
@joyce_yam	human
@Vamos_alMontes	unknown
@TurnerMillen	org
@Elcongero	org
@PymesUnidasEs	human
@crystalwang	human
@HappyLionTweet	human
@AbagayleAjia	human
@TvAtlas	human
@satsuma_otome	org
@myfoodbookAU	org
@EduardoRl_	unknown
@BackForSeconds	org
@yadirasmont	human
@runningme1988	org
@frickinfrickstr	human
@TheDuckDive	org
@SaoCafeLagos	human
@FitMenCook	org
@Choc_Buddha	human
@notjustparantha	org
@Sexy_Kerry21	human
@LiveLearnEat	human
@Brooklyn_df	unknown
@TheChurchillLA	human
@biercraft	human
@ChiaraGiovanni4	org
@chritiques	human
@ZavanaDajuana	human
@rae_stickler	human
@raphaelbek	human
@nao0925k	human
@magby	human
@KuvanaNogica	human
@RiverCafePV	human
@Signed_TheMrs	org
@girllovescoffee	human
@TalkRadioBooks	human
@itskawdashians	human
@YMKDesigns	human
@MargredHouerv	human
@MozzoCentrale	org
@WynfrithPerkins	human
@true10fitness	human
@SuisGenerisNOLA	org
@bluefishbnb	org
@REGRHODES	human
@GerardoTrrn	unknown
@ChefJaume	human
@izafoodie	human
@EmersonGuy	human
@ixtapaeldestino	human
@abujatrends	org
@StephaneeYule	human
@OakesAbbeygail	human
@WylltunWeatherl	human
@Santiago_Magic	human
@snowluvnferret2	org
@AirrealFferyll	human
@truthseeker818	human
@tomaszbudasz	human
@WeeRascal	org
@LeslieK44745396	human
@nutritionisteat	unknown
@lovelybakeshop	human
@Paulienbrouwers	human
@BrytanieZain	human
@Chef_Pink_Lady	human
@Purple_Rose67	human
@MalynZack	human
@0044106838	unknown
@RecetasNaturale	unknown
@correa_Andy_	unknown
@DickeysYonkers	org
@SouthStreetNash	org
@FrankyGardenXan	human
@sherryshroff	org
@Arbel2025	org
@AbbigailCelnse	human
@AdiaDemarkus	human
@heidilynnds	human
@yt_twdhcd	unknown
@jessiabaylor	human
@rocrok	human
@crLvncnT	unknown
@YoghurtBarn	org
@ikakukung	human
@alexdiesta	human
@KiWi4eV3R	human
@TerilynnYorath	human
@WODWolff	human
@CarlyHeshmat	human
@SPIROSCATERERS	org
@McMuffinx33	human
@AFandBFortWorth	unknown
@PalomaHotelAcc	org
@eMeals	human
@TineisBrutal	human
@LisaFranceCNN	human
@angelgultom	human
@han_salleh	human
@krystasdishes	human
@GlenWithSingleN	unknown
@drcraigwax	org
@prc323	human
@kcwc_womensclub	org
@Nutrisystem	human
@FilipaSDias	unknown
@CubaLibreAC	org
@superflashapps	human
@KKAOS_VE	org
@MaharajaXpressM	human
@NettaNyman	human
@ArreonYule	human
@wanedi	unknown
@AnggerSchlyzer	human
@highdivesd	org
@HauteDogLady	org
@Parna89	human
@BABILONIAgroup	human
@AeccestaneWinth	human
@sleigh30286	human
@oiseaudeparis	human
@osharee	human
@FrideswideAbbot	human
@Valery_Sev	human
@n1videos	org
@glamrockgal	human
@ReadyPacTweets	human
@honeybunnyb	human
@koitsujin912	human
@YashmineBethney	human
@WeightLossDietG	unknown
@Murph200491	human
@poornimavardhan	org
@sundowndfw	org
@YoceyAlfornia	human
@katelynkarina	human
@raisinganchor	human
@angheluvsg	human
@LimaZino	human
@ByreleahZackery	human
@clubsushinaples	org
@charleneanes	human
@ZiniaFitz	human
@MayuGene	org
@Mahoneysrc	unknown
@ExpatWomanFood	org
@myym10	human
@GabrielleSummer	human
@gemico1360	human
@Fishify	human
@ShamPatchCrew	org
@AdreneRollie	human
@matchsticksstar	unknown
@Dmerry00	human
@GinoJRocco	human
@TheLittleOwlVI	org
@ZWattekinson	human
@Leundicilune	human
@dchanyyz	human
@QiJjO	human
@SWBCATERING	human
@menberof	human
@MojosCairo	org
@astonclinton_rt	human
@OneVanillaBean	human
@EvaHopstaken	human
@MaynardAbagale	human
@CaviarCookies	org
@AbbotKimball	human
@XWaefreleah	human
@happeninginDTLA	org
@PsycoGenie1	human
@bellagraziella	human
@JoePromoL	human
@DrJohnCook	human
@RedORestaurant	org
@KendallAna2	human
@SayersWorrell	human
@koey666	human
@AdrianVra_	unknown
@WillowbrookCRB	human
@MiyukiDonChan	human
@hosts_poweredup	unknown
@YUI_maaru49	human
@YolksBreakfast	org
@linc0lnpark	human
@Bham4Lunch	org
@Buddies4Brunch	org
@scofffood	org
@ZDemarian	human
@USAHumanist	human
@DarBrowen	human
@abg112070	human
@mypurplekitty	human
@WomInlandEmpire	org
@7ElevenID	org
@lemon_lime_yuzu	unknown
@pulledtogether	org
@AnnamariaColi	human
@Deliflavour	org
@WynthropArlean	human
@JeannielynXavio	human
@AmandaLorefice	human
@YsgawynBoston	human
@KARZdashian	human
@MattheoZvl	human
@MzAMLLC	human
@mondai__	human
@StringsKitchen	org
@theRoriTAI	human
@Jayangots	human
@BlackBerry_Mama	human
@IlariaIann	human
@Cocinavital	human
@LoHiSteakBar	org
@MOONWALKERAUBIN	human
@BroadwayYale	unknown
@Francyable	human
@Jennyjar22	human
@66sparcs	human
@NathanielDanes	human
@Spinningfields	org
@LeisureMartini	human
@WyneCloyd	human
@taranicmckenzie	human
@Rockandrosenews	human
@cecigpasteleria	unknown
@NOvelo_Lui	human
@FiresidePiesDFW	org
@EastEndTaste	human
@joancarroll	human
@theLudwigs	org
@NormanBuffong	human
@NotationQtrly	human
@JanetNoome	human
@Catherineqoau	human
@xinli29288	human
@pealdaya	human
@JPretoriusAU	human
@YusufYunus13	human
@annemichelle	human
@DontKnowAskJoe	human
@SmallBarDst	unknown
@Granada_Pedro	unknown
@ForYourRaffle	org
@Emely007123	human
@arp4098	human
@mon8211	human
@jocno85	human
@BabirusaSEA	org
@MarieSchindler	human
@ZandaCupid	human
@eng_pheng	human
@Jdore_Jd	unknown
@BrienzaDanielle	human
@YWHcom	human
@Muay_Sukjaijung	human
@PremsPune	org
@CountryMusic2ns	human
@beauteparis	human
@TravelGuru231	human
@wendygoPhoto	human
@jerlynwong	human
@Making_of_a_Mom	human
@FandysterJohn	org
@LavenderBromley	org
@akuyoukinshi_sh	unknown
@TacubaNYC	human
@comidayvinos	human
@kiri705	unknown
@natashaashdown	human
@caravan_hotel	human
@darlineydrew07	human
@rompersbee	human
@AiyahDotsy	human
@JillsPlaceSB	human
@weeklygreens	human
@EggAndCheeseYo	org
@missleeny	human
@OpenCityDC	human
@JoachimBrackx	org
@SlimmingDiaries	human
@kazan_life	human
@Empratado	human
@alljessicarose	human
@homemsemblogue	human
@shakiddo	human
@HadleysSK	org
@kalu_mk	unknown
@CrackinEggCo	org
@akosiaiken	human
@DFWStuff	org
@AdreaAbdullah	human
@_haeyeon	human
@UndrakhE	human
@XaviarFalcon	human
@HeartRome	human
@NYCSingleMom	org
@Vinoteca	org
@Sync_Radio	human
@foodenthusiasm	human
@Tanjzilla	human
@EatPalmBeachCom	org
@Confitasturias	human
@wjnphoto	human
@akiko_tk	human
@TehLATimez	human
@splasharama	org
@TasteofHoneyM20	org
@just_evie	human
@Greed_Goddess	human
@brieuc75	human
@NICHOLASONG	human
@NativePalate	org
@TheRecipeRebel	human
@ColanWyth	human
@ARMzilla06	human
@CharliexPalmer	human
@PuiBerry	human
@thainabox	org
@sarakay1105	org
@BBNyce	human
@PierogiStreet	org
@jubelmalang	human
@NitaLakeLodge	org
@Loudnomids	unknown
@dcvemma	org
@Pane_Fresco	org
@yowmommacom	org
@pilsenerhaus1	org
@YanaSamanta	human
@EatGuideSF	human
@JeffCutler	human
@AChocolateWoman	human
@CicekPacheco	unknown
@fareenjj	human
@giverecipe	human
@Vancouverscape	human
@reserveout	human
@instadonetsck	human
@rosecruden	org
@TheGoatBar1	org
@MyPlaceX	unknown
@MaryDaisy4	human
@beingrandomfood	human
@billfelty	human
@M4ttr1987	unknown
@simepresbitero	human
@delecticanyc	human
@londonwhistler	human
@SanaaCooks	org
@YWebbestre	human
@TBedsDotCom	org
@RelaxInSpain	org
@shellshaye	human
@JoHo555	human
@eatatgold	org
@francy_cava	human
@dexheimerj	human
@PastariaSTL	org
@ShinRamenMagic	org
@CaffeMonteBaldo	human
@granvacas	unknown
@ruudsmets	human
@TomoAKIZUKI	human
@aaronsowards	human
@BumblingBird	human
@murcafe	human
@BaristaOnDutY	human
@chazzofsheckys	human
@TrinaLomar	human
@LAdineNclub	org
@sarahgolezzz	human
@Jina_Sim	human
@EdsonAris_	unknown
@SophiaVeronica5	human
@Thebeautyass	org
@FODMAPjourney	human
@YatCuisine	org
@SaraPaz81	unknown
@mizubunnie	human
@rosequartz0518	human
@vivian28low	unknown
@cookiechRUNicle	human
@miavalentinaceo	unknown
@WarpedToys	human
@PJCaporaso	human
@aqem87	human
@jhens_heart	unknown
@brettbmartin	human
@valerievillamar	unknown
@oosmusic	unknown
@meriver	human
@AfterSexArt	human
@DonovanMarsh88	human
@GiusyLovesGreen	human
@mananyan7742	human
@LuxuryReport	org
@estesparkpix	human
@Beginspiration	human
@eastvillagevan	human
@Hennychenz	human
@duoreinesworld	org
@oliviaslacala	org
@SJH1400	human
@TinaRosen	human
@IanBezanson	human
@DJBenLuhrman	human
@ParkRat	human
@TheAnneIsabelle	human
@Rojas_Edmundo_	human
@theamormagno	human
@AcwelFraine	human
@notd14u	unknown
@PietyAbbagael	human
@twinkleyukari	human
@whyneLu	org
@FoodTubeNetwork	human
@DistinctWorlds	human
@cookclickndevou	human
@Mariaan77160127	human
@aileenrenner82	human
@jimmyauw	human
@Lira7F	human
@Hanstagputf	human
@OldCaliMiningCo	org
@dianaa_halimm	human
@BoadiceaMereri	human
@Sonya91984	human
@chickslovefood	human
@AdoreDominican	human
@EBOOK_BESTELLEN	human
@ShahScander	unknown
@chancesmommy	human
@NATTYNAPBO	org
@BuntaBBQ	human
@OlivierNassoy	human
@eunicaa	human
@SpitzLosFeliz	unknown
@kikozepol	human
@yapjingling	human
@thevegsters	unknown
@EatMyTwiix	unknown
@VianeySrda	human
@matireliredunet	unknown
@OutThereLincoln	human
@suiiiika	human
@heartdr1	human
@dodomesticdad	human
@eatwsk1	org
@nkandhari	human
@kilnrestaurant	human
@rockingrawchef	human
@ZumburaUK	org
@tonyromas	org
@denQers06	human
@RAWhats4Dinner	org
@Sanchos_Bar	org
@La_Societe	unknown
@linhieta	human
@HealthyPasta	org
@watanabe_yuko	human
@brixtonsf	human
@kml	org
@xdeathrune	org
@Sarah_888_Lizzy	human
@Emilyatnap_time	human
@BraxtinBrit	org
@VerdeMelaBio	org
@childa23	unknown
@Asianstar1016fm	human
@DjBiggRich910	human
@zennyelsie	human
@CLArK_HYP	human
@HotelRivalago	org
@PtboCanada	org
@svhennig	human
@keltonmorgan	human
@yisforyifen	human
@MCRWhatsOn	human
@cspearsdreamfit	unknown
@mrklein	human
@Mikaelakoskela	human
@ElifAltndl	human
@KennyCamposNYC	human
@eyeliner_dyes	unknown
@LoccoBerryT	human
@OweanHodge	unknown
@mmtakemiami	human
@foodiehk	org
@BadManMedia	org
@MrsLilySnape	human
@Wasabi_NYC	org
@kawaiishopping	org
@WillCobey	human
@TwistKitchen	org
@dannybeyond	human
@starfishtrix	human
@TheCookieWriter	org
@BrainBalanceATX	org
@lesterhallig	human
@ZackGehard	human
@MerciMarieResto	org
@CricketQuila	org
@TrxRandy	human
@BridgitKasper	org
@satoeco	human
@lynology	unknown
@Sunny4Chat	human
@marimel_x3	human
@CatherineDaisy3	human
@MariaAnthonia	human
@JadaBrittney	human
@X_Mas_Retweets	unknown
@TheSultansTent	org
@Bronc787	human
@themadjournal	human
@6SigmaProEngr	human
@tomosapp	unknown
@selsienna	unknown
@iamfujoshi	human
@LangStudio	human
@Elystik	human
@moriwei	human
@e7erlasting	unknown
@EricasRecipes	human
@Brettaandco	human
@PointEnt	org
@GrayceBeverly	human
@whitmanandbloom	org
@Kimberl36120684	human
@_Everyday_Life_	human
@NatalieHeather4	human
@JustUMNOThings	human
@ChaosNSilence	human
@iheart52514	human
@dlf_cyberhub	org
@crappymonjh	human
@jsismee	human
@supergolden88	org
@azizahsham	human
@Galle_Watch	human
@Sound_Shot	unknown
@lizbiro	org
@CathBrad	human
@Hogswarsh	human
@Silvestre_Mende	human
@Tuay55	human
@makeuppsycho	human
@Na_dou	human
@TLsDelkery	human
@a_southernfood	org
@HotelsAvailable	org
@CervetecaDTLA	org
@Appetiton	human
@Chelle_xx	human
@foodsetsthemood	org
@ROBSTER2828	human
@kd316	human
@JoeyLuluChen	human
@2foodwithlove	human
@paperwirestudio	human
@NIREZEITLER	human
@ImoBurgers	human
@darrelljava	human
@binnyjs	human
@stiforp_money	unknown
@anniesMCR	org
@meichachan	human
@EricaRankin4	human
@InfoRajan	human
@JaimesJanet	human
@BRGRCO	org
@Sasha_Maggio	human
@WillamenaNakyt	human
@doindubai	human
@Dominic_Ong	human
@TKOENT1	human
@kayelben	human
@Aish_Imran	human
@nicksonbroadway	org
@vanicyUSA	org
@HofbrauhausLV	org
@RubioJuan_	unknown
@PatisserieVB	human
@Meckon	human
@catchURBANGRILL	org
@HogtownCure	human
@NYCHashtags	human
@ValeriaAiroldi	human
@LuisTmyo	unknown
@Moma	org
@ailaling1017	org
@dundurnmarket	org
@HITOTSUMEEBA	human
@miimii0214	human
@khadijaturki	human
@en_091	human
@lily_k77	human
@BasketIsOysters	org
@kiri_992	human
@EloydKong	human
@Trelfa	unknown
@JPCasihan	human
@_HDZeliseo	unknown
@CensieJ	human
@GrumpysHoneyB	human
@chie_119	unknown
@KathyBear0103	human
@obanzaineki	human
@PlumSpiltMilk	org
@GreggMcBride	org
@shiro0909	human
@mister_sammy_v	human
@little_bouillon	org
@sylwina	human
@ErnestinoJanee	human
@haehcreivilo	human
@pinkymomo	human
@BreAnnaCamille	human
@ZEAL_Shturmovik	human
@StanShady8	human
@RycroftZakary	human
@mommyweek	human
@JonesLouiseisa	human
@BestDamnTrainer	human
@easybitesonline	org
@Purplegarter1	human
@InGoodTasteMag	org
@AshbyInnParis	org
@MohdShahRizan82	human
@CamBeachBermuda	org
@ANationOfMoms	human
@alacartebistro	org
@AJonace	human
@TheMagazineLDN	org
@dietwithfat	human
@momnbabyreviews	org
@JadoreToulouse	human
@lottarosiexx	unknown
@martiparks	human
@RTPHOTO69	human
@leonie_rachel	human
@hfxbreakfast	org
@CashionsEatPlce	org
@SuarezAntonio_	unknown
@vwlblog	human
@_martinsalgado	human
@stormSSD3	human
@HuskyHogBBQ	org
@floever87	human
@highfatlowcarbs	human
@Eilyn929	human
@kumameaw	org
@GabrielaSarah5	human
@iamkhymdiuyan	unknown
@TheJeffreyNYC	org
@MrsNewlynaV	human
@HuddCassialyn	human
@TatyanaB_	human
@realwoman1970	human
@IZZY0219	unknown
@ShapedBySherri	org
@junichi0321	human
@SaraWoznicki	human
@velasi	human
@steveswindells	human
@nelsonsabrina	unknown
@WynFreelyWheely	human
@potterscarniall	human
@azteca_CR01	human
@LIE4LDeals	org
@mowonder	org
@JohnnyAnnihilat	human
@DigestWordpress	org
@wxyzarch	human
@franky1712	human
@SlowCookerSarah	org
@AtlantaE4LDeals	org
@squared6	human
@ShanelleHokama	human
@staywoke64	human
@VL_Hamlin	human
@TheRealDD918	unknown
@Paulintrobiz	human
@emihill	human
@maderakitchen	human
@hijiri_matsuoka	human
@nubu515	human
@Tvtiein	human
@IQuitSugar	org
@DebbieBertrand	human
@KambrookAU	org
@Eduardo_Nero	human
@DurtyCash	human
@NevaLT	human
@MiamiNowTv	org
@AlManaraPharma	human
@SideTracks1	human
@_hurricanekat	human
@KristelPapagna	org
@_jyau	human
@DiabeticCookin	org
@SabrinaKaren18	human
@ValerieMCathell	human
@PippaD	human
@jody_tollison	unknown
@BrianKlymDDS	human
@LijfenLijn	org
@yeenalison	human
@littlenextdoor	org
@TheMustBar	org
@casillasOmarR	human
@kashi_katuryoku	unknown
@manumoda	human
@dollactitud	human
@GTaiWoo	human
@MelanieIArmy	human
@KA0	human
@BookThatTruck	org
@DaCozinha	org
@LifeOnMyPlate	org
@RaymundoSln	unknown
@Conc2Conc	unknown
@FlashFunArcade	human
@jyhuangsterrr	org
@akah103	human
@MARREYKJAVIK	org
@braziliacafe	org
@Air_JunIII	human
@SienaMiami	unknown
@haulani7	human
@WarriReTweet	org
@BlackOlive_Food	human
@GrandpaWilbur69	org
@tasteofcarolina	human
@DJpsycoRave	human
@TelfordQ	org
@delionmiles	org
@LibertyKitchen	human
@SpiceuptheRoad	human
@LagustaTorrell	human
@SabrinaSpiher	human
@MonicaKaylee1	human
@asprinkleoftat	human
@AzureEye	human
@Kampucheea	human
@cyrusaman	human
@206MAC	org
@hashtagafric	human
@WoernerWarehous	org
@madhavdwivedi	human
@GotchaCoahuila	human
@Harlem19therare	human
@Dlifestylist	human
@Onetomato_two	human
@adadnila	human
@Langolobistro	unknown
@FitMommaDuble	human
@6packfromfat	human
@BoBites	human
@ShoeNews4Girls	org
@JaimeChristie77	human
@jubeljatim	human
@Sexy_Luna_Bella	human
@Admiral_EliW	human
@NerdiDirtiCurvi	unknown
@Uriel_Ramirez_	unknown
@DennisDawg	human
@Camemberu	human
@CoffeeCrumpets	human
@YaleDannell	human
@UmmSugaRae	org
@BarbaraMcDWhitt	org
@GourmetRambler	human
@SeventyOfficial	human
@MelissaRingstaf	human
@KThijsebaard	org
@eudoraluvart	human
@ViewtheVibe	org
@hitomirin37hr	human
@StarlaWelborne	human
@Cherwell_Fire	human
@e52362070	human
@rediry	human
@fishborough	org
@thyme4cocktails	org
@tasteandtell	org
@RhozieMahrobey	unknown
@Diskedo	human
@Mhel63	human
@diclemre	org
@aftonfarnsworth	human
@manoramaonline	org
@essdubs2	human
@LianaMassiah	human
@vincesaint	org
@AminuJay	unknown
@EasyCookin2012	human
@EdiblesMag	unknown
@beatrizv520	unknown
@Bestbrekkie	org
@acoring1976	unknown
@KatieSophie2	human
@AbeodanSunshine	human
@saitama_dazo	org
@CouponersUnited	human
@NadaAlGhowainim	human
@chihirollipop	human
@Voorstadslaan4a	unknown
@SophieSarina	human
@CColosio_	unknown
@MichellePC	human
@SennaStylez	human
@chicprincess81	org
@Redbloodsnow	human
@stanleywu520	human
@Genos_FastBreak	org
@CaffeinaCompany	human
@sarahfox28	human
@cavo_911	unknown
@Nyxks	human
@milleystarr	human
@TJBethesda	org
@episimarmata	human
@bewellphilly	org
@AethelhardAutom	human
@CafeStrudel	org
@hectorakatico	human
@InTheFresh09	org
@fingknitcoolgal	human
@ohyeahhlean	human
@careymelnichuk	human
@MyWeddingLab	human
@AlyssaMusicYTF	human
@DiegoVlla	unknown
@alexandrakirsch	human
@windbreeze3	human
@liangsteph1689	human
@gp_cafe	org
@WilfridaEllis	human
@AsianSoundLive	human
@PotsandPans	org
@DNM_Bos_Dining	org
@AMALART_IT	human
@lotusclapham	human
@TheGrantLife	human
@SantiagoRmro	unknown
@BigHueysDiner	org
@alifestylechoic	unknown
@TyffanieAmmeter	org
@Talisa_	human
@PandaCloudCandy	human
@smithfielduk	org
@HalieToft	human
@alfayezlebanese	human
@glamgrind	org
@AejaWebbeleah	human
@GloriaOConnell	org
@liahadipranoto	human
@ingoodcompanyhg	org
@LasCasuelasNuev	org
@oreovamenta	human
@quartierdetweet	human
@PatKanyapat	human
@abloomnova	org
@Peterrification	human
@LaCuochina	human
@DNM_Bos_Bars	org
@edwardchoa	human
@KenGray	org
@LimitlessYYC	human
@FitzsimonAbbaga	human
@corinthiabud	org
@PhilosophieMama	human
@OlderMommyStill	human
@EatingWell	org
@NeuvooCharlotte	org
@MamaMiasFL	org
@sweetums82	human
@hrtv24	human
@SimpLiveLove	human
@ikokesifte	human
@morcondv	human
@TreaxyV	unknown
@greatwallscenes	unknown
@ValerieMakayla	human
@MelOgKush420	human
@alyzehrs	human
@RickGarley1	org
@Receptomaten	human
@AxelKoster	human
@anticsfitness	human
@YogurtNutrition	human
@NorthEastHour	human
@thetablecafe	org
@fletch2222dc	org
@wiradinata_eddy	human
@zexyLEZAH	human
@SmacznaPyza	human
@SheratonMiramar	org
@Lisa_DailyHiit	unknown
@JRocketsRD	human
@DietitianCindy	human
@WanderCity	org
@dineanddabble	org
@DistrictDonuts	human
@RustyIvey	human
@NightTherapy	org
@HappyMeBeerTeam	human
@MARI_SABEL	human
@thebauerkitchen	org
@healthydoses	human
@pullingcurls	org
@dennysdinerrd	org
@OsellePunla	human
@StephanieOQ	human
@FforFood	human
@weightlossfreek	human
@cGloaces	human
@RobertoAmaya09	unknown
@tookkatabarbie	human
@IfindUseek	human
@VonsSeattle	org
@cougarvintage	human
@DelAngel81	human
@JumeirahCH	org
@ThePonyEspresso	org
@whip_cream_love	human
@MakeTheMostOfUK	org
@HuntBeachlover	human
@PoweredbyPB	human
@ScottParisi	human
@Getting_2_115	unknown
@RebeccaSkylar1	human
@CaitsPlate	human
@CranberryCeC	human
@FlavorMosaic	human
@JCM	human
@TheFirestation1	org
@RealFoodsBart	human
@ASPlayboyVinny	unknown
@food_jazz	org
@DJNOPHRILLZ	human
@iklimaDogan	human
@MarcAngeloFoods	human
@akosijon	human
@Sal_Godfrey	org
@MamaAkeel	unknown
@ToastCoffeehous	org
@WorkGrindFly	org
@__Healthy_Life	human
@AngelMediaLou	unknown
@ViaggioTapas	org
@RedStripe_Prov	unknown
@NnwWSsaA	unknown
@WanakaYokoo	unknown
@tsai122	human
@esculentdreams	unknown
@PetitBuzz	org
@_FrancoSabino	unknown
@ottowillie0925	human
@phoodietweets	human
@imawardana	human
@raymondguerrer6	human
@NatsMadderMeals	human
@jess_galletly	human
@paddybear5001	human
@sosotha1	human
@JonathansTheRub	org
@dianehenderiks	human
@AtlantasBest	org
@KorkmazGulin	unknown
@melissa_stitch	human
@TheStandNYC	human
@robbieboi78	human
@MissHappeePants	human
@kittymayo7101	human
@SuccessTalkRad	human
@mutabento	unknown
@PublicCBD	org
@cjonescooks	human
@TwittSlogan	unknown
@totonator23	org
@cubanaPLK	human
@Cerissa_2	org
@Alex_LeFave	human
@websedia	human
@FriendOfAFarmer	org
@dealsoff	org
@LyllysyEchelon	human
@charshaff	human
@juanjosebao	human
@hungerpass	org
@PoppysKitchen	org
@Axdelwen	human
@Bitchy_Valerie	human
@yummiestNYC	human
@akira6969arika	human
@DOPEMUZIKWORLD	org
@goLadleDC	human
@Garage88_	human
@elfiedd	human
@Dr_DGrove	human
@HorizonInnAtl	org
@coupon_whore	human
@lamlam1314	human
@jess_magliulo	unknown
@everyday_dishes	human
@IAmAHero613	unknown
@OurMilkMoney	org
@notagoodfatty	human
@ROBERTA2004	human
@erinhayhow	human
@KiaraJennifer2	human
@livenyclife	human
@sleeprevolution	unknown
@Daysinbed	human
@theblackdogse11	human
@ZSpirov	human
@RockGlam_style	human
@GetPickEase	org
@FoodieFeline	human
@cupcup8	human
@_christmastrees	org
@federicacirilli	human
@juicerulesmx	org
@tiatanyell	human
@thelatherlounge	org
@Maria31PS	unknown
@carlamagno_	human
@CapitalArtworks	human
@blujeennyc	org
@MargaretOlivia4	human
@twit_nar	human
@vegandearest	unknown
@kitchencookshop	org
@jophie0511	org
@romaine_calm	human
@mirrormirrorxx	unknown
@SpurTreeSpices	org
@PopColorsXal	org
@RoxieKwongDimen	human
@FreeTimesCafe	org
@justinbieberzx2	unknown
@CaribeBlu	org
@CleanPlateCo	human
@urbantablekc	org
@anakhaswan	human
@LaTaqueriaYVR	org
@chikachi_mi	human
@FoodsmokingJo	org
@TaraEllina	human
@bibicjs	human
@dvittanathallia	human
@MoniqueYip	human
@AdammRickey	human
@CourtSportRD	human
@SavoytruffleK	human
@alvinadam	human
@publiventaperu	org
@LoganCheng	human
@alwie81	human
@ly5261	org
@ROD_D_SMG	org
@DLPetitto	human
@gizfarris	human
@eiswuerfelimsch	human
@frugalmomwife	human
@pinkrosepdx	org
@eshlicia	human
@DFHambrientas	human
@RedneckReality	human
@ZenjiRetweet	org
@chilloutnil	human
@JenShinrai	human
@JohnBogusDeVall	human
@nunesupicha	human
@mikitty_onlyone	human
@ananyah	human
@memeinge	org
@itisalovelylife	org
@lisariosva	human
@m3lisat3oh	human
@TheLuxuryRep	human
@jachavez	human
@McDonaldPRyan	human
@PollyPerryExp	human
@AndreaHayley1	human
@mymcrdiary	org
@fishgoat2015	human
@cooshhh	human
@Fonty_Madrid	org
@elenabarolo	human
@castilloSAUL_	unknown
@YumKenya	org
@officialPRgirl	org
@NeuvooHosMiami	org
@Blue3yexxRockin	human
@jenniferanhdo	human
@rocahouse	org
@Mtwils3	human
@JackieLede	human
@suriyono_sas	unknown
@valcanahui	human
@gigglesnlaundry	human
@happyichigo0127	human
@Piruuula	human
@loosefatforever	human
@CurvyGirlsRChic	human
@HinHARLEM	human
@FraLe1987	human
@YsbailBobbye	human
@naturlBRNfoodie	human
@indiansfsweden	human
@CAStrawberries	org
@00058051063	unknown
@chelzeeeee	human
@gochie808	human
@TFSundayMarket	org
@iampanjee	human
@M6a3mR	unknown
@CloudsBrewing	org
@kina_kinally	human
@KitKatLounge	org
@price_AH	human
@discussionsclub	org
@NocciolinaV	human
@brunswickcafe	org
@HellsBells_80	org
@JMarieSingh	human
@SerenellaBianch	human
@melissasoliver	human
@smokinalsny	org
@4CASTSteve	human
@TobeyWmffre	human
@KENandCOOK	human
@YanniVosloo	human
@KalElsBirth	human
@HIsBestKitchens	human
@Sooners0561	human
@BourbonJacksAzS	org
@CafeDufrain	org
@TheTable_Colaba	org
@Nutrition2L	org
@dreamtob	human
@Elliesworld	human
@BarbieDaBoss	human
@alohayangyang	human
@DreamStarrCEO	human
@ShareCapeTown	org
@chisae_a	human
@mlswelissa	human
@affair_heart	human
@CharismayoonYH	org
@SydneyFoodLover	human
@DorchMarket	human
@Ella_LaPetite	human
@MrMuscleTov	unknown
@LCB_restaurante	human
@chocolateclaim	unknown
@imfashioncomtr	human
@glassofrose	human
@tonysnb	org
@GeirholtVidar	human
@OnlyRollsRoyce	unknown
@GapperSteven	human
@AndreaZZevallos	human
@dontsithome	human
@OrchidaceaRes	human
@TerryLott	human
@Lio_N_ortH	human
@ScorpioIsDaName	human
@cafe1730pune	human
@WaziFood	org
@PHXretweet	org
@7pecadosresto	org
@SaltineOysters	org
@Artemissian	human
@Tanja4292	human
@WinLathan	human
@ancutseek	human
@misscandelita	human
@yu1129	org
@24honlinecasino	org
@StPaulE4LDeals	org
@vdub_mike	human
@Ilive4sweets	unknown
@SpidzasDiner	org
@FrankieFINCH	human
@ygiedamaso	human
@hayleehermann10	human
@zysenko	org
@shauntae89	unknown
@AethelwyneJoi	human
@monojitang	human
@AtraMartinez_	unknown
@katherinemaslen	human
@pritigurl10	human
@DataGroupAsia	human
@cheftavdmv	org
@GastroyPolitica	human
@samyflorendo	human
@tonyspats	human
@countrylivin567	human
@sliderdimension	human
@Lauramolinayuso	human
@RitzCarlton	human
@_ValeriaAngie_	human
@DigestMiami	org
@JaylynJeong	unknown
@ikuhirata	human
@KIZOKUNEKO516	human
@willies_cafe	org
@ck_insta	human
@PrimitivoBistro	org
@SSStyle1	human
@kyleuy	human
@nekohokkuri	unknown
@akn_man	human
@ShangriLaParis	org
@kapi_t	human
@ocallaghaan	unknown
@LilBudgetFoodie	human
@yukomama0912	human
@JodiBainum	human
@StonesCove	org
@price_scanner	human
@SaoriTg1214	human
@DJSmashKASH	human
@123Appleton	org
@joeannagan	human
@TheGuiseleyEye	org
@upgradereviews	unknown
@NicohdelValle	human
@RockLobsterFood	org
@Moomettes	org
@HarbourMBar	human
@Soos808	org
@soniaprincesss	human
@ValeriedeJong1	unknown
@ShannonGrella	human
@BakingWithMom	human
@takerestaurante	human
@tonia_cell	human
@ShepherdsMkts	org
@shootingstar_18	human
@BreakfstCourier	org
@putush	human
@kelz_belz1	human
@lindaevans042	human
@Preventionaus	human
@AgataPokutycka	human
@jaydedarcy	human
@TheKHotel	org
@Shiri_tan	human
@HTARestaurant	org
@puppychao	org
@lgreenberg	human
@alchemistcookbk	unknown
@donizettimilano	human
@Jordansclare	human
@ORL_Streetfood	org
@AizatSapphire	human
@Gobbytraveller	human
@_Officialken_	unknown
@northridgelive	human
@DinoMcevoy	org
@FunLolcat	org
@Kitchology	human
@mOhdiZwaN88	human
@ErinBethany4	human
@BarunkiAngel	human
@CherriaEmmet	human
@DragonGrille	org
@DupontDaughter	org
@WillyBurchard	human
@PancakesPeonies	human
@ArvieTahil	human
@LunionSuite	org
@allumsbutchers	org
@buckslouisville	org
@alissaloves	human
@bot_salty	human
@JunichiKajioka	human
@drjonfajardo21	human
@SignorSassi	org
@Clemsoup	human
@D_vienista	human
@BandAidAnimals	org
@TheHotelExpert1	human
@PennsylvaniaRT	human
@Kavey	human
@griska_purple	unknown
@IceCreamLady104	human
@BillyDec	human
@prissie68	unknown
@Nina_Phanita	human
@Onestaralone	human
@ClearOneco	human
@aaaMIYAaaa	human
@totony_tony_c	human
@dkyw	human
@SuperVideolux	human
@Lexi1021	unknown
@graceEjacob	human
@92_pomichael	human
@CallistaChuah	org
@AlexandraHansta	human
@ryckslopes	org
@HurricaneCafeJB	human
@zsuzsanna_kis	human
@coffee_in_a_cup	org
@marketbardublin	org
@PizzaDAngelo	unknown
@Cathalinas_	human
@tantalizemiami	human
@omgsohungry	human
@joaopbmr	human
@GauriChopra2	human
@PointBreakNY	org
@tamalespaceship	org
@IamPaulie016	human
@TheDarloSavoury	org
@besosdechocyfre	human
@bikkinibarista	org
@_swincatx	human
@s3lecia	human
@SproutSalad	org
@Utami2790	human
@BhamBarScene	human
@cintia_assis	human
@jaafar_ryzal	human
@coffeenvanilla	human
@PTMagazine	org
@NYMinuteMag	human
@Yebrij	human
@chandlergilbert	org
@GEVARAynnek_	unknown
@costolleumus84	unknown
@carolmaroun	human
@thelyonsshare	human
@ivanfiori	human
@BurhanAbe	human
@KimmieQ10	human
@urban_energie	human
@enjoy_iphone	human
@McD_CTWMA	org
@yumi31748	human
@DeWeekendRo	human
@Ivana_NY	human
@iice_toretto	human
@juliabyron751	human
@TIUcirre05	human
@nkwai	human
@YFMHalifax	org
@jpareyes	human
@transper2009	human
@misery2814	org
@sylviawonglewis	human
@TalkRadioMusic	org
@TGIFCary	org
@local_athens	org
@MILF_OF_3	human
@caramiakelly	org
@stephenschimpf	human
@Dr_Lina_	human
@priya_arun	human
@DailyJuiceTime	org
@RetTosupport	human
@DataGroupEurope	human
@EricSirote	human
@dqlHuiShi	human
@Saileene	human
@DidieNasir	org
@OpBeastmode	human
@AllyWythe	human
@Rooster95020	human
@LeighTiffany	human
@reever123	human
@SparkiesDiner	org
@Pompeii2	org
@ElexusAbOwen	human
@_hudasabry_	human
@ClairaCalderone	org
@CookThisAgain	human
@HealthyDiva	org
@WiltonKendria	human
@bila_asraf	human
@AlimentsEDFoods	org
@tceggingtons	org
@jaxecology	org
@WejdanWow	human
@FriscoSquare	org
@NikkiBlakk	human
@EzequielSls	unknown
@GiulioPaneeOjo	human
@b1uehawaiiangrl	human
@asktatia	human
@kosherprivate	org
@SaraVK	human
@greencathedral	human
@milaona	human
@leothedevil	human
@Ellin_yap	human
@CafeNRC	org
@416NOW	human
@OnePunkArmy	org
@SALTstation22	org
@annie79115	human
@mrsrmeldrum	human
@NicholasYeohWs	human
@AGirlWorthSavin	org
@RTPembs	org
@TalkRadioImpact	human
@pobitegary_pl	human
@anasky00	org
@ThriftyCpnDiva	human
@fickrj5	unknown
@spa_sensations	org
@Montys0711blog	human
@0325Gaga	human
@esthersalamanca	human
@LaurielLOFierce	human
@NottinghamIs	org
@RelaxInMalta	org
@ajsweetsoap	org
@AekerleyJenaya	human
@DanielleIsabel8	human
@CafeMarketplace	human
@habitat_grr	org
@HarisMamas	human
@ForemanLoreen	human
@kinjobrooklyn	org
@zdevents	org
@JonesWythe	human
@SpiritofNewYork	org
@Doitinparis	org
@hiromi_mr	human
@lovelymelx	org
@JimmyGsteaks	human
@LaurenShipleeey	unknown
@cutebun	org
@TorontoPicks	org
@chinlovesiowa	org
@DayspringClinic	human
@redsonia32	human
@sexywend	human
@taniastep92	human
@KSmobbin22	human
@Sunny_Side_Ups	human
@zhiyun85	human
@ZaneMaximillia	human
@PktChangGourmet	org
@jovenatheart	human
@SydPersonalChef	unknown
@ZeMonsta_	human
@hungryangeleno	org
@seestephrunmtl	human
@kanyanco_queen	human
@MrAEChan	human
@JenBad47	human
@mickpinna	human
@marederulucious	human
@LoliLo13	org
@AyaSBK	human
@ZeroCater	org
@brnngflwr	human
@BeckaBlake	human
@eat_landmarc	human
@keoreyes	human
@MomFoodie	human
@bot98695109	unknown
@lterveld	human
@B_Crazy_Fit	human
@BaezaLorenzo_	unknown
@mizzjuicibabi	human
@GabriellaGenna	human
@WildGastronomy	org
@petslookgood	unknown
@missusjoy	human
@jonesandjonests	org
@CrossKeysNottm	human
@letruck_se	org
@RolandsOnFourth	org
@livinmylife16	human
@sally06301	human
@JeremiahC	human
@nick_200058	human
@50daychallenge	unknown
@DoreenWinkler	human
@BuzzyNeil	human
@HerJunkMiles	human
@ericachiesi	human
@Cellar_Gascon	org
@Kitchen1454	human
@EdenMarketiers	org
@SpiceIndianEK	org
@MarquisReforma	human
@FATEVER	org
@RealJungleOats	human
@LolaRdguez1	unknown
@FoodDiaryDaily	org
@rAj_lala_23	human
@kiyah201313	human
@Yuninchu46	human
@BrunchGangNYC	human
@TheBakeClubLA	human
@dennislori1	human
@triptinerary	org
@PineTribe	org
@strawbeerries	unknown
@KTownStriders	org
@ClemmonsAedd	human
@AnnaJade10	human
@AhimSarmadi	human
@johnsoulesfoods	org
@SerafinaGroup	org
@AkikoCappadocia	human
@InBetweenRivers	human
@ladyandhershoes	human
@GeorgesOnSunset	human
@dodon_jerry	org
@DeiFratelli	org
@megumeguchoco	human
@DeveralWordswo	human
@TREVILV	org
@goLadleMiami	human
@albaadgeer	unknown
@trufflem	human
@DrLoraT	org
@drdancake	human
@JRazzos	org
@RobustWineBar	org
@fishssNet	human
@M_confused_	human
@janinfoster	human
@Msmoney215	human
@judithsomekh	human
@ThereSylvanny	human
@Guapaxl	human
@AtlFBS	org
@Arabic_content	unknown
@sergs_best	unknown
@NoCoastSushi	org
@salsaycarbon	org
@lipbalmaddict78	unknown
@cater_paul	org
@forbiddenlive	org
@LynRadioDeeside	human
@tircomaccet	human
@iLluSioNniK	unknown
@LowerMainlandBC	human
@sporedeal	org
@JamesArnettDunn	human
@jianbautista	human
@AkaylaWaylen	human
@Golf_kob	human
@jimmyteddy80	human
@JOAQUINvALLEJO_	unknown
@1974kai	human
@AceySyd	human
@MyUnfinishedlyf	human
@Simpsonsgarden	org
@OktarinaPW	org
@zataartheory	human
@Jdisebavitcz	human
@GiveAndGrub	org
@AnnsieSlimWorld	org
@za_to	human
@brunchkichijoji	human
@sherlonya	human
@CaptureYourNite	unknown
@Isaac_West	human
@jerrylim17	org
@Erica_Malloy	human
@SanitaSalim	human
@mytravels2	human
@duxemfgco	human
@Sidman	human
@Augusta4Lunch	org
@Gosia_Klima	human
@AymesthyDevonn	human
@Melzy_Melzerson	human
@MilkMustache	unknown
@HijaDeDios_	human
@timelesschef	human
@everytap	human
@MelsDriveIn	org
@Relauncher	human
@AilenRandolph	human
@DetroitE4LDeals	org
@diediekilanta	human
@mikeygreen68	org
@Chai_Lounge	org
@bbgradegourmet	org
@SofitelLuxEU	org
@Tan_taz	human
@OofTB	org
@BloggingWealth	org
@cherrytomatecom	human
@awmandy313	human
@RNasKitchen	human
@KeitochanSays	human
@Lugirlnextdoor	human
@songaboutmymom	unknown
@LabEspr	org
@Highheeledlady	human
@im_Lov3Ly	human
@PitaPitaKuwait	human
@BusyBeingJenn	human
@bernaburnz	human
@KongCloth	human
@msclaire76	human
@hieponumeko	unknown
@ClaireAlondra	human
@Tour_Tour_Thai	human
@BarocknRoll	human
@nottmonline	human
@Jesnypi	org
@alyaaboulhosn	human
@biteme_brighton	human
@OdysseyDC	org
@Blaastyle	human
@vanekatherina	human
@THEFLORISTbc	unknown
@PumpPaleo	human
@unixcox	human
@dinosahid	org
@JulieDaWaitress	human
@AndreaChrist_CH	human
@KMFoodService	human
@HoustonEatBeeps	org
@KaiBosco666	human
@Onthesideblog	human
@PillboxTavern	org
@FranchesskBarbi	human
@Bistro_BarBelow	unknown
@vampSaam	unknown
@_crimson96	org
@_AlexDizon	human
@LuxuryFred	human
@ShawDC	org
@robtimusprime	human
@AmyBeintner	human
@mykingcrab	org
@AngeloRug	human
@mizuno1231	human
@shokochaaaaan	human
@reverieforest23	human
@fefebibib	human
@Carolineoncrack	human
@Restaurant_tip	org
@KompasJakarta	human
@TribeHotelKenya	org
@WinthorpToddy	human
@lmaior2770	human
@ganapetitmonde	human
@KaitlynMadelyn1	human
@EveYewook	unknown
@Gayliciouz	human
@SaraleguiPedro	org
@giuliasplendida	human
@DenverE4LDeals	org
@MollyJamie2	human
@AinsleyEllena	human
@CVRrentals	human
@lovgreenmartini	unknown
@danderedere	human
@olibrecht	org
@JohnWales22	human
@helentsangaride	human
@fourdaysayear	unknown
@Anthonyfuda3	human
@LouiseQuan	human
@seatatmytable	human
@GogiOnTheBlock	human
@mikemikerob	unknown
@ClancyPub	org
@Taste_of_Mumbai	human
@kabegami_anime	unknown
@guynesher123	human
@sammymusa	human
@tastedefined	human
@wishesNdishes	human
@tripsNYC	org
@advicebeckmedia	unknown
@foodpornjournal	human
@hannesalome	human
@LePeepCafeVista	human
@fdgoodlife	org
@NobleSandwiches	unknown
@tiarastantrums	human
@noorshamuhd	human
@Kill_in_milk	human
@GbyMikeIsabella	human
@mypaninicafe	org
@OraleMK	org
@rie0723	human
@clifflouiemadar	human
@TheDiningFeed	human
@KaylaCassidy2	human
@TheGreasyWiener	org
@MaximusChua	human
@NasiLemak_M14	unknown
@KOLrestaurant	org
@oscarocmch	human
@TamarinaMiami	org
@Ro_blesPe_pe	human
@MeerkatReporter	unknown
@yoear	human
@VAL_RockingLife	human
@BuffalosQatar	org
@Miho12012	human
@AistonDemetris	human
@Vickdogga	human
@LisaBritney	human
@HwitlocZadie	human
@HAHdenver	org
@youkillmeso	human
@KORandKARMA	unknown
@WholeFoodNewBod	human
@KailuaNow	human
@mannajpt	org
@Ima_TV_Junkie	org
@lanejack84	human
@tuckerandbevvyj	human
@freshbitestogo	human
@HeistBrewery	human
@camillaolesen	human
@BriansWebWorks	human
@nevespugly	human
@mishuleo	human
@KimDenne	human
@GourmetGirlsmd	org
@lalalovelyblog	human
@alwaysneedher	human
@Pt626	human
@gerrykellymiami	human
@iFrybook	human
@PTchudo	org
@JohannesPong	human
@Paleo__life	human
@CorkTyler	human
@DineDestination	org
@kparkgevrekevi	human
@Aliciax7	human
@loxozen	human
@TravissoAustin	human
@BangBangCanteen	org
@Live__Paleo	human
@canacci_	unknown
@nilbarcodefood	human
@News24lHOT	unknown
@JamesJamesgart	human
@datahunter84	unknown
@wynnema	human
@sona31102011	org
@DemeyBemia	human
@paleo_terrific	human
@BluJamCafe	org
@Bean2ren	human
@BFinnMerrifield	org
@mandriano77	human
@DanielADraper	human
@KayleeMonica1	human
@LoriRaeDeVoti	org
@Dobbix23	human
@chef5fit	human
@nyc10016	human
@wohv	human
@LeBunUK	org
@Bitchinc1	human
@TessavdDolder	human
@cookpoint	human
@KuyaaRay	unknown
@BangItRadio	org
@FashSydney	human
@SadieGibbs	org
@Mo_Ti_Moris	unknown
@Kutchigingging	human
@MUNGUIA_GONZALO	unknown
@Seonkyoung	human
@EleInSearch	human
@LisaGNV	unknown
@Hierophant1985	org
@HonADawson	org
@SlimmingWorldUS	org
@FollowersF0ll0w	unknown
@comebackmomma	human
@DenbyDudley	human
@christine_pe	unknown
@musingincolor	org
@MeryES_Yukimi	human
@Barrel31KC	org
@menxus91	human
@La_Mode_Cafe	org
@_Decency_	human
@BlissfulMiller	human
@FIappyBirdFans	human
@BarlataATX	org
@AlexisHanstag	human
@MBaxerias	human
@SexbyBelle	human
@MarcGF87	human
@AndressaWren	human
@Brunchlesque	human
@Intake_Inc	org
@zomangee	human
@ODPortPortals	org
@PaleoPete1	human
@MarineJuy	org
@WoodwardKenton	human
@Biaa_Barbiee	human
@MezzanotteCafe	org
@mavkitchens	org
@BoMMeKuN	human
@Momsandthecity	org
@NevyKaminski	human
@foodpedaler	human
@yonca_yildirim	human
@daehyunori	human
@lifeofsimplejoy	human
@maximcatss	unknown
@Phuketvibe	org
@dishcrawlprov	org
@UmutEvirgen	human
@mmirnanda	human
@BreakfastJC	org
@make969	human
@smarksthespots	human
@RetweetJakarta	unknown
@JoieDeJackie	human
@AdysonGijs	human
@LindaMannsLinne	human
@missrafael	human
@Campanile_Manc	org
@emilymsq	human
@HaileyCrystal1	human
@TopgolfAtlanta	org
@SticksStoneCafe	org
@DollyCalifornia	org
@JoseResendez	human
@yoshimiru_SS	human
@MiaAnzola	human
@oggressiveBot	human
@Doughgasm	human
@RangoliGrill	org
@fannylee_ca	human
@YiReservation	human
@jjaeNYC125	human
@LasZarandajas	human
@xyz99612222	human
@xtinvillarosa	human
@Antiguanice	human
@CaveIndian	human
@GangstaRap23	human
@xoxoGossip_Boy	human
@DacCody1	human
@SadwmMordwywr	human
@PolicyDC	org
@yucha0614	human
@TotalGreek	org
@olivegloria	human
@plumdeluxe	org
@ShoutLouderHour	unknown
@Addictissima	human
@MajidiDandi	unknown
@sinfulbombs	org
@Adrian16MP	unknown
@ssilvestori	human
@TawannaPatrice	human
@BrantleyEddric	human
@Elly_Scorpionz	human
@BABEL_Co	human
@LavendeLemonade	human
@WellnessWarung	human
@DDDDay	human
@appetite4health	org
@Applebees	org
@royalsantrian	human
@awkwardLiny	human
@mynjayz	human
@anchan104	human
@DietsDaily	org
@ying_varalug	human
@joyoushealth	human
@GOYA_Fit	human
@DownAshleyLane	human
@leanhealthyyou	human
@gorgeousasever	human
@mbarloon	human
@Stcy022288	human
@EatsnSweets	human
@AdindaHayyuN	unknown
@maywibs	human
@K3chocolate	org
@LOVExAK	unknown
@WorrellEverhar	human
@Sam_Jayne90	human
@PrimrosesKit	human
@roberto_dr	human
@TheMarcSmith	human
@ChildsBloom	human
@dmdigital_tv	human
@realmiguelg	human
@Zhoulin_Cuiyang	human
@barrettanne	human
@armariodesilvia	human
@TheWilson77	human
@tokyowanderers	unknown
@CMopsa	human
@jinkuord	org
@TennesseeDavis	human
@Ate08Steph	human
@TopMusicPromote	human
@CassidyTurleyNY	unknown
@topgolfhouston	org
@Ryan_Jones88	human
@RicardoAFelix86	human
@wylena12	human
@DelmontAwesome	human
@zamoney28	human
@MandieD101	human
@LobelsSince1840	org
@silodc919	org
@verlenda	human
@KarolWojtylaRec	org
@CaveBenfr	human
@BrianBrownNet	human
@RadioTruckers	human
@celosia7	human
@obrigadocoffee	unknown
@StephanieSuni	human
@mic_happy	org
@carol38banks	human
@GlasgowBBlogger	human
@RiosBrazilian	unknown
@Eltuitdebeto	human
@Android_warrior	unknown
@ohenryhenri	human
@Dodi_SP	human
@mykuromiy	human
@NeuvooAdmCA	org
@AvelineAdalbre	human
@Zeffy34	human
@CtrlAltRockYSU	human
@KrisztinaMaria	human
@srrshah	human
@gngeek	human
@VeraSweeney	human
@finalkt3	human
@zoozooworld	human
@LPQUK	org
@giftgarate	human
@polala89	human
@SteepedTeaInc	org
@jessyonthewall	human
@Klocksnack	human
@LilFamAdventure	org
@Annespantry	human
@bigwigburger	human
@soleosoleosole	human
@eastdevonbc	org
@foodpr0n	human
@kvongsy	human
@Sonneblom	org
@FirstNightArt	human
@nutritionhapps	human
@Anson_Queen	human
@DarlingPresley	human
@Asuka_Sase	human
@shopmatrixuk	human
@bellybootcamp	org
@cooknindablubox	org
@3sonshavei	human
@Winachandra22	org
@kaputinocoffee	human
@MGFD_MIA	unknown
@raisingrosa	human
@LunchinParis1	human
@a17261573	unknown
@LORRAINECOLPEAN	human
@astroross	human
@ihshaniqbal	human
@junichiarahata	human
@GolfSuriya	human
@JerrilynMordre	human
@inSEMARANGcity	org
@DHayes_ERA	human
@GothyTopline580	human
@nordinroger	human
@LunchtimeUkr	human
@designersartist	human
@SusanAretz	org
@SMLanangPremier	org
@axelandring	human
@Its_a_Mister_B	human
@BenjaminSto_	unknown
@LABARHOU	unknown
@LadyBirdAtlanta	org
@ParissYocey	human
@VilladiGeggiano	human
@FreshAsHoney	human
@Bianca_Minnie5	human
@DTTSurveillance	org
@MLosToros	org
@cameraturkey	human
@HulaJuiceBar	org
@vky_tan	human
@LikeThsLoveThat	org
@teeSOreckless	human
@randomtelaviv	org
@mompy_027	unknown
@charleswanmushi	human
@todaylicioustw	unknown
@cmmama10	org
@eijaebarredo	org
@ellefashiongirl	org
@phoon_sheauchyi	human
@sandbar718	org
@julieg205	human
@cynthiaplazam	human
@MalinsJapan	org
@TitusMcTerry	human
@yellywelly	human
@afrinaqistina	human
@ginalimp	human
@jillianturtle	human
@themunnyshot	human
@WineTweeters	human
@sabrinagirl0125	human
@MartyValentin	human
@No11PimlicoRoad	org
@BuzzUrBroadcast	org
@JayAugustBaabby	human
@CynnieManes	human
@eminemsshadyz	unknown
@CloudDrew	human
@OpenTable_NY	org
@leenerz	human
@_chefmarques	human
@stylemajordomo	unknown
@AKhan353	human
@Tana_Ahkia	human
@BurnhamWinfield	human
@DianMelissa	human
@vandino43	human
@louieyabut	org
@AperolArgentina	org
@AiSakuraHaruka	human
@locogirl67	unknown
@FreyaZavala	human
@Chevauneleon	human
@Stefanie_Ross	human
@astolfialessio	human
@Marcela14092401	unknown
@r_vansteenberg	unknown
@LaurenceWoodro	human
@shappenstance2	org
@TheListRUOnIt	human
@PetitsChefsAcad	org
@TheHudsonLA	org
@Ouichefsf	unknown
@White_Spot	org
@seamusphan	org
@petitezampona	org
@GLWanderlust	unknown
@71Market	unknown
@adriatennor	org
@DayByDayPhilly	org
@PebblesVashon	human
@caratandroses	human
@aSavoryFeast	org
@Beatles__music	org
@DolcettoRisto	org
@AliMirza2k	human
@catherinegelera	human
@HINAGUJRAL	human
@i_MarcoTaguiam	human
@gavin7168	human
@babyemjay	human
@TheYearOfBarbie	human
@DorianaTucci	human
@rosalinette	human
@korilakkumaai	unknown
@katerickey	human
@geplilo	human
@AndrejReschini	unknown
@billygoatchips	org
@alisdamico	human
@mobielekok	org
@Maebellskitchen	org
@Aryme80	human
@whole88inside	human
@AndronicasUK	org
@Bizitalk	org
@WhatMikeEats	human
@criistianac	unknown
@WendyAw93	unknown
@inspirationfor	human
@solo_el_fin	human
@WilsonLey	human
@Angiexwright	human
@martinaseo	human
@CarmenVarner	human
@RochelleGMG13	human
@NewVitaUK	human
@1BiteAway	org
@DJ_Bean	human
@ShahnazT	human
@tengentoppa_roa	human
@JerseyDemure	human
@Rea_HWilliams	human
@mvenzon	human
@MNasir_Yan	human
@SaraBojarski	human
@LayneLipscomb1	human
@suburbiaU	human
@__RayChan	human
@cqzxo18	org
@Navarrarest	human
@ZZnoor	human
@kas827	human
@KeVitaDrinks	human
@snacket_app	human
@denisu81	human
@TradeTracker312	human
@cheffitness	human
@POCHO_CHOLO	org
@MarcMK	org
@Chloesesa	human
@Aaron_Dixon_	human
@mrfoodtastic	human
@UnbearablySoft	org
@HsiehRebecca	human
@JandLCatering	human
@achristiangirl	human
@apparelandstyle	unknown
@HamiltonBeachCA	org
@IbnBattutaGate	org
@cherineann	unknown
@briggettebaust	human
@yvonnejiann	human
@yngtxh	org
@Sabra	org
@ArevaloLexi	human
@27huku27	human
@minnacup	human
@WhitingtonSteve	human
@Canteen900	org
@jack_Demian98	unknown
@BoldskyTa	human
@nahualpang	human
@AhreddanGlorie	human
@RoseWiltshire	human
@LottielMurphy	human
@kiyoclearing	human
@DickieLue	human
@TJXenos	human
@tobyamidor	org
@JetSettersFlyIn	human
@debuggirl	human
@5oclockapron	human
@Ambicltd1	org
@WilhomenaHolmes	human
@OliSari	human
@Confiesoqcocino	human
@AyaOseurg	human
@SuperstoreNQ	org
@MahaSabek	human
@RielleParedes	human
@e_watie	human
@mel_p5	org
@WayneCollier	human
@Nicole_Ez	human
@prairiejoes	org
@evesphotostock	org
@FreyaDunst	human
@GICENTP	human
@kalihitea808	human
@mmalherbe	human
@anandph1	human
@CaramelKay86	human
@syarahh09	human
@StickyBeakBlog	human
@foodchants	human
@sabrinasg	human
@BrizzleHadley	human
@sheaindia	human
@AntMozzarella	human
@LeonoreRest	human
@juttan0308	human
@BreannaIsabell1	human
@Vii_VivianO	human
@iPeaze	unknown
@elzalauzne	unknown
@directorjewels	human
@DhwaniiShah	human
@swangsadiredja	org
@CortesRest	org
@andretyxxx45	org
@A_Melysa	human
@ParentingTRadio	human
@BritishBC	human
@challains	org
@boobledoodle31	org
@OscarsBarLux	human
@RHartleyRD	human
@i_kzs2	unknown
@ElectricBird7	human
@diaarturo	human
@RirmLwit	human
@bolongo2	human
@ArrreRaza	org
@TheEatery620	org
@GarboFood	org
@reftpt	human
@gtedios	human
@isadeluca3	human
@Hotelslive	human
@cocosdeli	human
@MzKShine	human
@shaza_radz	human
@giuliae89	human
@BuffaloBrunch	org
@Shayneperritt	human
@bocceristorante	org
@AanUtWater	org
@katiemorford	unknown
@robertamirata	human
@AddelineMaelgw	human
@dsa11183	human
@QueenHotelAlder	human
@ShawsBurgers	org
@Beingfatima_s	human
@CityCrabNYC	unknown
@ShopArdTheClock	org
@TopeDigiworks	org
@diana_verdin	human
@ProteinWorld	org
@mikanarl	human
@PCbackups	human
@HelloMyNameisCC	human
@JoshToTheUA	unknown
@Gr8Lin	org
@KingsOakLane	org
@PointBreakNYC	org
@RaniaKelesidou	human
@ZoeinStow	human
@chantallipp	org
@InTheKitchenKP	human
@ZotarSupergirl	human
@orchid_isle	human
@nua_arquero	unknown
@RozaKincaid	org
@Daneke12	unknown
@tamalyn1	human
@londonhoteltips	org
@UneGrandeFrite	org
@debittoinjapan	human
@ChopAndWokUK	org
@Gail_Karn	org
@MLebreRD	human
@aes529	human
@DukesNYC	org
@CuteasaFoxBlog	human
@epicuruscom	org
@Chatayodom	human
@cisvul	human
@travelair4	human
@TADAYABAII	human
@AdultProfileAt	unknown
@BeaucoupBAG	org
@hasfulbat	unknown
@Faith_Lietzke	unknown
@EmpressLyrixLee	org
@TaariniNB	human
@meals_bristol	org
@itsmetracky	human
@AmberKristen1	human
@LioneyeMedia	org
@Elena_Scala	unknown
@i_in79	human
@MySceneSpotter	human
@OsteriaMoriniDC	org
@djmaddod	human
@MadisonHanstag	human
@yasuokaayumippi	human
@davemerret	human
@CPantazis	human
@MissAlAbeer	human
@CookWithManali	org
@mikehalewood	human
@Cardifftweeter	org
@Zikhie	human
@sarabear73	human
@ChoccyWoccyPorn	human
@JeffreYoon	human
@Suite701	org
@Celts4Life88	org
@novsunflower	human
@MarieVarley_	human
@missaimeenek	human
@eastmanegg	org
@sitolandy	human
@parse906	human
@aomtofubear	human
@EatFitNOLA	human
@planktownbrew	org
@shecooksheeats	human
@mmmSandwich	org
@michaelamusto	human
@iamSillyMama	human
@jin_oscar	human
@Bistro_Q	human
@_LucieLou_	human
@chefpandita	human
@Mornintippa	human
@suyun524	human
@ozzcheep	human
@thymetoindulge	org
@Rebel_Recipes	org
@cheflaszlo	org
@WildEggsCO	unknown
@HeeroFanel	human
@LAXretweet	human
@aquilacafe1983	human
@bawdewyn	human
@SDragger	human
@AINA_ACE	human
@Redclogchef	human
@foodfriendsfri	org
@samlee561	human
@FreyaTanner123	human
@PrincesaliceLoL	human
@criochicago	org
@NewYerkPost	org
@TheBlackBlessed	human
@nigelcohere	human
@taldebrooklyn	org
@EibhearOrwel	human
@wholelivinglarg	human
@jordanfsaran	human
@AelfdeneFergus	human
@ChowBuzz	human
@JMF1007	org
@cozy_viral	unknown
@juicee_mama69	human
@RockyParcs	org
@dominomag	org
@PeterMakela	human
@midwaypizza	org
@ExtrablattCapeT	org
@WC17Burlington	org
@Duo_53	org
@Jburdick1	human
@bot49202475	unknown
@meanroel	human
@kotibeth	human
@CheyenneKaitli1	human
@mygiobro	human
@Oline_BMI	human
@KarenMessier	human
@Bu3mim	human
@beyoncesongspop	unknown
@amindfullmom	org
@Noelle_Edman	unknown
@ThaisLuy	human
@MelissaAlexia2	human
@N1COL3AL3K	unknown
@JacquelineKaitl	human
@ArielKaylee1	human
@MyCookingSpot	org
@TCBYSFL	unknown
@glamfitwraps	human
@brunchaddict	org
@petitmignondeux	unknown
@MemberCareTT	unknown
@fashioncook3892	unknown
@puertonuevola	org
@BookMissMoe	human
@joannehmyers	human
@OMGTastey	human
@DugganWeller	human
@LaCaveLV	org
@amitjethva	org
@brandonchenkl	human
@DCHarvest	org
@SlayerPanda1996	org
@CaroGarciaAbalo	human
@AnticaPosta	org
@YantyPardede	human
@YaraMekawei	human
@PeiFenHugs	human
@Jazztwk	human
@joyfulng	human
@TheKTGinaMeow	human
@HyperJanLi	human
@kimkmw	human
@socksrockd	unknown
@AleChsm	human
@torontopath	org
@jra011464	human
@ginascupcake	org
@figuremagician	human
@Soulsister13	unknown
@BestVideosToday	human
@toohenboku	unknown
@kungphoo1	org
@READYCHEFNEW	org
@KievaDern	human
@LisenbeMonica	human
@NioManzano	org
@heatherchristo	human
@reimi_official	human
@davidguettahere	unknown
@emina565157	human
@MzSummerDion	human
@FranAzcoitia	human
@nurulashikinlee	human
@brunchpass	org
@aothitis	human
@RS_delivery	human
@murakao73	unknown
@ellie_esx	unknown
@dmcfit	human
@Momhatescooking	human
@photosdarchi	org
@MakkarPonnu	human
@TomAndAnitaCook	human
@EarnDollarFast	human
@SpitzLitTokyo	unknown
@Charmsthefoodie	human
@Said_DarkRose	human
@AlexZaprudsky	human
@ja1gqw	human
@Otaku_Jimenes	unknown
@andriabintoro	org
@Vegetarianized	org
@Vinipediam	human
@TheBullLondon	org
@CHLukes	org
@HealthyLiving34	human
@TezRank	human
@TonyPatti_Lyca	human
@juliayylee	human
@hammonde2	human
@BluMoody	human
@raulroa	human
@SunsetGrillTX	org
@chiftf_cbot	org
@L_D_Rosen	human
@Ergenstussenin	human
@ubertune	human
@fufukitten	human
@dinnerwithjulie	human
@a10631023	unknown
@Joyeewcy	human
@TalkeeEntertain	org
@AlexandraSalasG	human
@MahaDassoum	human
@SussexMiles	org
@soulofwit2013	org
@oscaryagues	human
@fmgnutrition	human
@CrookedKnife_14	org
@MikePaineShow	human
@FlagshipChicago	org
@AtelierChefsUK	org
@irene8nunes	human
@wilchan0313	org
@TMZW_29	human
@emesslemont	human
@WhaleyJL	unknown
@WillCook4Smiles	org
@SKRecipes	human
@SmashATL	org
@WaltersMarie1	human
@dirtywatersf	org
@khun_apple	human
@Oliva_Salgado	unknown
@sophiexlinnett	human
@SmplKtchnSeason	human
@ClimpsonsArch	org
@SaschaOkamoto	human
@shannon_miller	human
@restuento	human
@Nutrition_UK	org
@bethanyoregan	human
@gracefulcity	human
@eborestaurant	human
@JCITYMUSIC	human
@ShamikJones	human
@domi_BTGfit	org
@thespoiledmummy	human
@carbonpapers	org
@WeightLossExpe	human
@MileyShakesItUp	human
@TheLifesWay	human
@CapeTownBot	org
@LeNajib	human
@evil_gnome	human
@50mmart	human
@Iam_Hungrrry	unknown
@DontayeAdrena	human
@hazarizal	human
@xtnafnatic	human
@BellasWhiskey89	human
@JacobSwedenLand	human
@darwinisdavid	human
@TheVintageYear	org
@NandoPrc	unknown
@AngelEnOsadia	unknown
@IrwanFeehily	human
@Glasgow4Lunch	org
@MissTaraToYou	human
@TheTurfTavern	human
@wineloversmag	org
@live2dance247	human
@CKYH	human
@CheffyMitchYu	human
@bottegadvinonyc	human
@allUneediscandy	human
@SocaNick	human
@SANTEcatering	human
@chukkutweets	human
@Wani_Hamzah	unknown
@pawsitiveliving	human
@WhitePeacockuk	org
@BeasleyK83	human
@CalderdaleHour	unknown
@Just_YauYau	human
@Adrigirl	human
@Wissam_Akl	human
@TheRebelChick	org
@CajunBaby86	human
@alicecevans	human
@nathankeith1	human
@FishMarketNS	org
@faezah_elai	human
@OryxRotana	org
@PolpettinaPizza	human
@BlogdeCecileNa	human
@KWJean_	unknown
@tatsuki_0314	unknown
@52weeks_annemi	human
@mahommie77	human
@wittier	human
@nachiketshetye	human
@UP2CHOICE_UK	org
@WhatIndigoAte	unknown
@ferpisan	human
@JenWebb7	human
@JewelBeMine	org
@bubblessky02	human
@AethestonKesha	human
@TLTourist	human
@cogemex	unknown
@delletglopet	unknown
@ayaa1977	human
@alexandro512	org
@annelie_rainbow	human
@QueenzyJover	human
@_aLoiY	human
@Waldelfentraum	human
@LiketoCookit	human
@TEOMomblog	org
@party_shibuya	human
@DoggstaXT	human
@GoCasinoGuide	human
@LaBelleAnnee	human
@earlermita	unknown
@BethannyL	human
@AxelEscuderoPR	human
@ZBLKHARTE	human
@_LA_GOLOSITA	human
@samara706	org
@ferrariis	human
@00Sebastiantroy	human
@henpickednet	org
@sarahbalivo	human
@ItsuOfficial	org
@DorflersMeats	org
@jancerato	human
@Thomas_dalesio	unknown
@GAILs_Kitchen	human
@sheidafashion	human
@LubiePodroze_EU	human
@ChrystianTeh	human
@KafeEbaki	human
@KingstonStar_A	org
@AvaQuiros	human
@staaryjhonaa	human
@wisenakagawa	human
@dottie1277	human
@kauaiuae	org
@VeerMulraj	human
@StelaChloe	human
@marie_chip	human
@WrEtcH_	human
@Clouds_Ads	unknown
@FazendaManc	org
@Decorismodotcom	human
@modalitademode	human
@AbbottPariss	human
@joyq74	human
@absolutezaA	human
@justin5015	human
@spicesnflavours	human
@mau_hawaii	human
@PH4NT0M_PH03N1X	human
@vmsonline	org
@AericQuella	human
@rhanenzo	human
@JuanaMBrickell	org
@RusticoSwindon	org
@TheRealYasmien	human
@howshehustles	human
@So_New_York	human
@CoventryUpdate	org
@guodda	human
@spiroscottrell	org
@RubysRestaurant	org
@snakebb3	human
@jjfrias1	human
@whatthekidate	human
@Harrisburgarts	human
@SavingCmnCents	human
@ChristinaBianc9	human
@nbfm69	unknown
@KauketDE	human
@SpiritofNorfolk	org
@AddaneyePerley	human
@__aarum	human
@OumarDammak	human
@chiii_ka	human
@GuerreroJoey	human
@tvxq_tk5s	unknown
@cnsmiles	human
@jojoCharlie_	unknown
@WexlerEvents	org
@FRIDAAmericana	human
@Club_10000	org
@FrTRX	org
@bren37barbera	human
@CommissaryDC	human
@bertufarrugia	human
@cinnabarcafe	org
@TheClassicDiner	org
@sherly_thamrin	human
@LIFES_cafe	human
@chiyinng	human
@Howbb	human
@MyMessyMiracles	human
@102BlogTips	human
@GabbardSlaughte	human
@PaoloLakin	human
@promderby2	org
@K3nny_11	human
@Rajibu	human
@lussoegusto	org
@CoralieSeright	human
@roselynaris	human
@VanessaShanno19	human
@BINGBINGSAM	human
@MR_74SP6	human
@WaterlooBarD4	org
@Bonjour_Darling	human
@SaegeBistro	unknown
@thehowardtravis	human
@cafekacao	org
@aay_ailada	org
@onlcookbook	org
@AlilaDiwaGoa	org
@BrewBrothersLtd	org
@Nonannna	human
@NgremixAe	unknown
@Violava86	unknown
@MelisaneYeardle	human
@LinaBacklund	human
@Rivkind	human
@danieljesusher1	human
@xsheervanilla	unknown
@pick1less	human
@instakrystal	org
@marmheadmama	human
@NiallFlorence	unknown
@ChrisantiaMeicy	unknown
@Nitewing27	human
@TheSimpsons65	human
@rashidrmr	human
@oscargasparbcn	human
@lunasdiner_dk	human
@CourtneyKaren3	human
@tauchengel	human
@EadwiellaHoldy	human
@GulaTerapia	human
@psychokittyn	human
@PortlandVariety	human
@greenvideos	org
@signaturebagels	human
@MajoyoMaruruna	human
@flecja	human
@Leona_453	human
@MomResource	human
@kaygee	human
@TurleyLinton	human
@HeatherLouCee	human
@meiyann	human
@MercadoHalal	org
@Japan_Antique	unknown
@BrunchBot	org
@HoegerKurt	human
@2DegreesFund	org
@LorenzoZblt	unknown
@MezzogiornoNY	org
@minteapurpleCYN	unknown
@caffei_nate_d	human
@NewJerseyTweetz	unknown
@CouchPotatoRev	org
@helloDEUX	human
@EstamosdePlan	org
@Texas_Retweet	human
@rudreksh	human
@airgbrooty	unknown
@DrGeriOrders	human
@silvicaroline	human
@namaneko1920	human
@SomethingPorn	unknown
@slimk	human
@AraluenNeued	human
@enriched_farms	human
@daventori	org
@DingHowSA	org
@dandidaffyhill	human
@hayleylhayley	human
@trechicchere	human
@eatstatuskuo	human
@osseweyer	human
@naoumiyasssine	human
@TanzaniaRetweet	human
@PBoody	human
@LeadenhallMkt	human
@Rolling_Sobat	human
@r0salina_ay0b	human
@_BELLAxDONxQ	human
@cornerpubtn	org
@AJP_CT	human
@MissBrogan	human
@MabelMontes01	human
@MarielaSabino	human
@thesocialgroup_	org
@cobbiecollinge	human
@infoZine	human
@CookingWithAnne	human
@hipmomjulie	human
@Stephllewellyn	human
@AvosfromMexico	org
@FatGooseBK	org
@opart12	unknown
@sydneyflaneur	human
@CorissaAndswar	human
@DanielPandaBjj	human
@a27026199	unknown
@MadridBrunch	org
@Tuloulah	human
@luvoinc	human
@V1va_La_Vegan	human
@ValeEspr	unknown
@LettuceEats	org
@Manhattan_nites	human
@reashellexie	org
@SerlickHoward	org
@MODEmagazineS	org
@IBonStage	human
@cate_dwyer	org
@freshoneglinton	org
@CyberArbitrage	unknown
@sevencooks	human
@plussignal	human
@MeaganShamy	human
@ITALIANASENORA9	human
@CScityshopping	human
@Vida_Imp	human
@DiyaMarketing	human
@AethelredaNefyn	human
@FactoryGastrpub	human
@JosephBadaro	human
@161Kirk	org
@ichanlim	human
@betterwithveg	human
@FriedPecans	human
@ncytleon8	human
@tastefullygf	human
@SDLoRusso	org
@ERodenhaus	human
@kimny05	unknown
@Kinda_AlFaisal	human
@DYharrogate	org
@arttisbeauty	human
@murillosandro_	unknown
@mercaditoCHI	human
@ReelChow	human
@MarisCarey	human
@knoxfoodie	org
@yellobb	human
@HasletWulf	human
@AyoubSomebaty	human
@hotchefinred	org
@Jill_Firns	human
@RamiroLobo01	human
@Hannahfgale	human
@smartbodychange	human
@HipHoptima	human
@GreenbriarCafe	org
@fuelboxorders	unknown
@OzMomoChan	human
@FirstBlueShoes	human
@Kpugs	org
@peytonlovesfood	human
@PLAYthisLIFE	human
@jansuchadickfoo	human
@kittytatti	human
@barleymashSD	org
@S_a_m_a	human
@RaechellRitchy	human
@Guide2Uganda	org
@DanielPrdo	unknown
@MarketonMacleod	org
@XariLouden	human
@anhsfoodblog	human
@LeeAnn915	human
@LaMezcaleriaYVR	org
@alexlimcw	human
@VerreBois	human
@xfileslover99	human
@RiverOysterBar	org
@ProofKW	org
@AaronVlsc	unknown
@krysmacqueen	human
@djjonex	human
@CTLifestyles	org
@iMe_Angela	human
@sergiohowland	human
@FoodOozle	org
@80thandIvy	org
@Man_uelNaje_ra	human
@TheModernPantry	org
@DealOfTheDay41	human
@Denverocious	human
@JeanVrm	human
@NesNate	unknown
@Nancerelli2	human
@ShoshanahTIU	human
@ayachii98	human
@JeenaAndow	human
@SoHoBurgerBar1	org
@stefsbrownies	org
@Betselline	human
@NataliZale	human
@enjoyapple	unknown
@thatLoook	org
@armie_marie	human
@SakaraLife	human
@ThisLilParent	org
@PeanutPimpMama	human
@deva_devee	unknown
@shinya12ji	human
@carlabarzotti1	human
@GangstaFashun	human
@CookingWithKimE	org
@LuvSaga	human
@RedLanternViet	org
@MyNanasKitchen	human
@chitowneatery	unknown
@angcheese	human
@lookbench	human
@xepalito	org
@BJSimpson66	human
@nieldeepnarain	human
@Jesstours	human
@FitMomDiet	org
@AurelyaMorton	unknown
@SugarBrownie	org
@SamiPasci89	human
@ChasingBunnyB	human
@HalalDude	org
@wangtinh716	human
@forksake	org
@TenterdenTown	human
@shewy88	human
@CroslandAbbiga	human
@StephLouiseATB	human
@InyoRestaurant	org
@LoveLockwoods	org
@IMLVH	human
@Renulalwani1	org
@JuliaHanstag	human
@ShabrinaAreefs	human
@SassyEthnicBoho	human
@EclipseSTL	org
@JJEatPlay	human
@AvantiKenya	org
@Sofia_Santos	human
@fruitbatwalton	human
@ReSnapchat	unknown
@MysteryVlog	human
@Sekar_Ai	org
@TucFoodTrucks	org
@eatjxn	org
@touchofasian	human
@GangstaOfBoats	org
@_ItsGiorgia	org
@drunkenfish	org
@xiaoEats	human
@AlfredoTrrl	unknown
@factoryxii	human
@AiekinShae	human
@Summer_Crush	human
@ELopezCafe	org
@PadariaMercatto	human
@arriannariff	human
@OurFamilyWorld	human
@zass_xin	human
@Blessoboy	human
@abastraa	human
@GorasgwrnJeane	human
@WiggWalker	org
@WithTheGrains	org
@xxxmm	human
@HudsonsHouse	org
@rossella76	human
@lutecebistro	org
@ClementineDull	human
@LT38	human
@GristleNGossip	human
@brookewren	human
@WaterandWall	org
@PoPville	org
@SeaItClearBVI	human
@Xsorribas	human
@kei_jackandroll	human
@IamAuvinen	human
@tresorhotels	org
@OliviaCoxLondon	human
@ebay_FLBoutique	org
@booring_tomuco	human
@arzcubed	org
@KimberliZakary	human
@KildaresScr	human
@Being_Melody	human
@RealKitchenChi	org
@mariakhz	human
@TheDixieDish	human
@dishdishmc	org
@AbsolutLIBRA	human
@nutrisavercom	org
@katjabymyself	human
@DeeSeeBeaucoup	human
@Tak_z1028	human
@SarahCB1208	human
@Pyknic	org
@psswstyles	org
@ardanny87	human
@SunTempleFood	human
@chrtoybearis	org
@NewStreetGrill	org
@WythKathrine	human
@1BalancedBeauty	human
@EricTanTanto	human
@kittyBearZokoza	human
@Minassian86	human
@mrcupcakes2014	org
@FitMis5	human
@tinfishscs	org
@CityVisitorCle	org
@mao951030	human
@lloyddeee	human
@dannyosc	human
@OnleeAmore	unknown
@Okema_07	human
@RuizOlguin	human
@mushroomscanada	org
@surashni	org
@PandOChelsea	unknown
@blueberry411	org
@tetsukun0105	human
@One2Ad_com	org
@TopFineReviews	human
@ozzy4120	unknown
@Grace_Elease	human
@PulaGolf	human
@RCHPHOTO	human
@VeganStart	human
@WCILS	human
@DEEJTANTRUM	org
@franciscocamach	human
@helensarmstrong	human
@BordeauxKitchen	org
@Kimberlykokourt	org
@PeteyProtein	human
@AlmasedWellness	human
@Sofietvarno	human
@kianfit	human
@ChicagoFoodMag	org
@Megachrist	human
@TashaEdzard	human
@fashranfauzi	human
@CPR4THEBODY	human
@310na2mi0220	human
@wwwsimonlynl	unknown
@ENightray	unknown
@greigo_uk	human
@HelianaMansilla	human
@JackelynAbbagai	human
@MaryEllenrecipe	human
@BeInsprd	org
@Sheryll918	human
@FactsUpFront	org
@RiotOfFlavours	human
@VegaTeam	org
@laproman1	unknown
@ItalyHotline	human
@Generom4	human
@LiveInKitchen	human
@TheGoodEgg_	org
@ElimAma	human
@Chef_banana	human
@steakedinburgh	org
@sweettoothmarti	human
@nori_moonhill	human
@em0lie	human
@DanielHong61614	human
@reshipide_bot	unknown
@makobiscribe	human
@RamadaPlazaJBR	org
@CityNomads	org
@DerbyshireCCC	org
@OctavioRms	unknown
@hamadasaki	human
@TheTripelLA	human
@PeterDillonsNYC	human
@CaJaPopcorn	org
@Ototobi_NO2	human
@AdalsonDyllyn	human
@piedrahman	human
@Roebucknw3	org
@KSMITHMANAGES	human
@LilahWolf0	human
@siggisdairy	org
@myselfielikeins	human
@robinsnewswire	human
@SandraVenes	unknown
@mygraphichunt	human
@SmileyBeautys	human
@LorenaMata20	human
@zehporteiro	human
@PhuaXiong	human
@ArmedNYC	human
@AldyCallan	human
@johnpneedham	org
@achievehealthgo	org
@NataliaBenatti	human
@NautickaLea	human
@LeolineJarrel	human
@GuerreroEdisson	human
@WokingMarket	human
@AmelieZgigi	human
@Amy27688	human
@Cheesy_Grinner	human
@relleoMein	human
@FarmersgirlCook	org
@pickydiner	human
@AikenAudric	human
@najatoziar	unknown
@ReneSlva	unknown
@WorldsBars	org
@Heatheritis	human
@waishang90	human
@cheweychi	human
@jessievaz12	human
@Honey2378	human
@DealOfTheDay43	human
@OfficialMado	human
@PinkSapphire6	human
@LeiterElena	human
@CobornsDelivers	org
@IsitPrahran	org
@hserody	org
@SimpliBB	org
@QuintaMagazine	human
@nasalhazel	human
@DealOfTheDay49	human
@parkeryvr	unknown
@31CharityCases	unknown
@healthlovdesign	human
@pianolomo	human
@RushStreetCC	human
@Aize7	human
@vegasstyleguy	human
@qweboolifestyle	org
@mezetto	org
@fiorellabas	human
@ndrewmarin	human
@CynsationalGirl	org
@goodnesscafeott	org
@nyankoemi_Tiger	human
@uzki	human
@oharajohn	human
@Xaarikax	human
@bot07936595	unknown
@ahwen7	human
@shamahim	org
@kimtbraveheart	human
@bri_081129	human
@hurryHail	human
@eSAXnetworking	human
@daredevileak	human
@kazami_11	human
@paologriffa	org
@baronramlie	human
@BarbHoyer	human
@uranai_seiza_ke	unknown
@NoeBer7	unknown
@smallgreenkitch	human
@Janee0803	human
@MaxineCafe	org
@KitchenRebel	org
@LoudStellar	human
@macmalz	human
@Totaldietfood	org
@HungryForeverCo	org
@azeppelil	human
@adoboloco	human
@Platform61	org
@4_s4m	org
@plumpernickel	org
@InstaKirovograd	human
@Weightlosslivin	unknown
@FoodTruckBeeps	human
@ChefDavidLentz	human
@PrannaNYC	human
@CulturalGranada	human
@ZenyLV	human
@anglemoine	org
@cafe_kohaku	human
@lisaco61	human
@HannyInReverie	unknown
@WittahereKayley	human
@RidgewoodSocial	org
@RTDelhi	org
@brewwinefun	org
@West14th_UAE	org
@My_Mom_MadeThat	human
@TheMCCorner	org
@MOHICANZ_PUNX	human
@RTonetsy	org
@AngelinaFaith3	human
@brickyardnyc	human
@SaulPer9	unknown
@williejane	human
@SidneyCates5	human
@YoungMonop	human
@SloppyMamas	org
@agigi	human
@LeftOverJunk	human
@AngelaTague	human
@legalseafoods	human
@RaydiantlyRai	human
@djkazuyoshi	org
@Lovelylanvin	human
@LiveHealthyMeow	human
@bluefenix	human
@SaborSM	org
@lambxxxx	human
@JillianConley	human
@Ramadan_101	human
@jaenadams	unknown
@seek_satiation	org
@jojo_g2	human
@happeninginHLP	org
@1ToastTheCity	org
@tracy_kwind	unknown
@deskickbox	human
@yAkUs0kU	human
@geoffreview	human
@bensonwu0727	human
@SouthStPantry	org
@GodfreyHotel	org
@jacklynndrod	human
@Bintaro_ecenter	org
@MovatEhealth	org
@naze01	human
@ShielaRodriguez	human
@satie_san	org
@MarioxysC	human
@taylorhouseblog	human
@mommylikewhoa	human
@angelinevandani	human
@JamesWyer	human
@mulia	human
@kouichi212	human
@minspireproject	human
@eri921011	human
@luciano_Italian	org
@delmargirl99	human
@shoegalnycblog	org
@ZacharyDeysi	human
@ILuvCandyCane	unknown
@Agustin_Glez_A	human
@Aoifemcgee	human
@pajamasandjam	human
@VasoLoko	org
@aluloli	human
@Selwynbaptiste	human
@44_viant	human
@AddisDilania	human
@babypyo	human
@JohnPAtkinson	human
@_byull	human
@ColvilleMilana	human
@kitchendotnet	org
@christyckm	human
@bjjbot	human
@CrimsonEdgePR	org
@_weddingjourney	human
@DarthMigs	human
@IlanLouis	human
@hapunacafe	human
@sushisunday	human
@CabbageFirst	human
@KristinMcGee	human
@Zippys	human
@hendraN6	human
@EarlWhitchurch	org
@Jennifer_Teo	human
@shonamackie	human
@smstr66	human
@modmarket	human
@luvhammiepi	human
@StayGoldAustin	human
@Noo_AA	human
@tykittytyz	human
@myVenue10	org
@HuntleyAbagayle	human
@carlo_parducho	human
@_maaki_	human
@RollCoasterMom	org
@ArgoelMaredud	human
@yuuri905590	human
@rockamybb	human
@JacquesDelorme	org
@josuacwsianturi	human
@AintAlwaysNice	unknown
@snowdoniapub	org
@DealOfTheDay39	human
@nyatichiy	human
@hixterbankside	org
@CampagnoloATL	org
@me_giovani	human
@BetoHughes	human
@WuTang420Bl4z3r	human
@EatLondonInLove	human
@kneadtocook	human
@iamaliabdallah	unknown
@GenuinelyDope	human
@AuLapinAgile_To	org
@EatThisCafe	org
@WonderCafe1	org
@BeautySwot	org
@ParkdaleBIA	org
@GoRedChef	human
@TheDaffodil	org
@Dou02	unknown
@nycfitfoodfash	unknown
@pemandudunia	human
@Debwi96150570	org
@HealthWellnessQ	human
@Haniz1973	human
@mealplan4me	org
@prettyjopai	org
@AgyfenNerthus	human
@VerbotenNewYork	org
@BaguaRestaurant	human
@ElizaMolin1	unknown
@MoscowPushka	human
@Concentrics	human
@DEeMonei	human
@Forevamor	human
@handfulsunshine	human
@MathisOdell	unknown
@Tarla_Dalal	org
@MeSoHungrySF	org
@Ailene21998711	human
@sabu_aka_masato	human
@WholeIngredient	human
@2cfschool	human
@benitle	human
@dajanaroesch	human
@rin_chubbie	org
@Juniorny_	unknown
@ADAMideast	org
@sydneyreyesjr	human
@TOPOdistillery	human
@michiquita1222	org
@BlakeOBlair	human
@PRINCE_N4_SWAGG	unknown
@AdkinsStedman	human
@CheerAnonymous	human
@VanishiaYen	human
@lisasa320	human
@musicheart_1996	human
@CearasKitchen	human
@twizzlerific	human
@Catgoesnatural	human
@drewArellanes	human
@WesMegan	unknown
@carmelatantoo	unknown
@KathGarske	human
@jello2310	human
@Socialeatingit	human
@_Quutie	human
@JennaLov13	human
@terumi330	unknown
@nininabakery	org
@Cycliclapse	org
@MammaChia	org
@zemat84	org
@LeicesterStage	human
@StellaRossaPHL	unknown
@ryanwongso18	unknown
@saimatkong	human
@BinksGinShop	org
@Yowhanes	org
@sirronaldpope	human
@nadiafarehah	human
@piaiezzi	human
@drlisayoung	human
@CanopyHouston	org
@mirandabakery	unknown
@CHACAOBISTRO	org
@kitchenkarma	org
@TimmyJpn	human
@NiteTables	org
@beckysblogg	human
@MultiBeckMedia	human
@robsbistronj	unknown
@sophieq01	human
@GregZuff	org
@cgsession	human
@CarlaSiegel	human
@PaljamaicRest	org
@naka0419	unknown
@kyohirofuku	human
@elanaspantry	org
@GenieKitchen	human
@RestaurantsinSA	org
@SweetMasterson	human
@loveschard	human
@DSMPartTimeJobs	org
@yipinggggg	human
@TorontoCommon	org
@one_pi_	unknown
@janicelalxo	human
@shu_cho0124	human
@WillieJoely	human
@BeatrizSubtil	human
@szudypeter_com	human
@Eightablish	org
@rdelaparraNDV	org
@bodybuildingyes	unknown
@aimeeMARIEm	human
@TheHuntLife	human
@Deri_Rika	human
@altasociedadii	human
@7pip	human
@ElizabethM_J	human
@Witchy_5	human
@Dad_Journal	human
@VeggieFest	human
@onyangadaniel	human
@ImNasni	human
@milongapartner	human
@TriadtoWellness	org
@villandrybakery	unknown
@WholeFoodRealFa	human
@ricardolsw	human
@blondiegirl702	human
@pitufina_vivi	human
@birdiebee52	human
@Retajhotels	human
@mazenmoadam	human
@MrsSundaysSoups	org
@beefandpudding	org
@amityhallnyc	human
@StacyFawcett	human
@ManyTastyMiles	org
@SomersetBroad	org
@HungryHobby	human
@kimkallistar	unknown
@juananomuerdas	human
@PedraHall	human
@ThomasMooretave	org
@ModCloth	org
@danaboo1804	unknown
@ThatSkinnyChick	human
@MoonShine07041	org
@thebrentco	human
@AbbigaleCashey	human
@SeanAMurr	human
@InstaPenza	unknown
@hinasafi	human
@stellaelieka	human
@MarkEti31466948	human
@Grahamonger	unknown
@melaniesbistro	org
@matsz	human
@supastarjkwik	org
@joysyooky	human
@Renzze	human
@port654	human
@laurieallee	human
@FerFiloFer	org
@maverickdpapier	unknown
@FoodieJudie	org
@LadderLeaper	human
@labrosso	human
@10LangstonJ	human
@elossastyle	human
@MJ4Animals	unknown
@LayneM	org
@FLSunSugar	human
@yovent02	human
@thekidbearcat	human
@LuvSig	org
@akira_angler	unknown
@SlicedDeli	human
@LauraTortella	human
@TheScoutChi	org
@bellevalencia	human
@RadolfYamilet	human
@ciaomichaella	human
@CounterCafeATX	org
@KionzChan	human
@Ruescy	human
@RubenRmrz_	unknown
@buzylizzy1	human
@QSavagepromo	org
@UnexpectedTweep	org
@DelightfulEMade	human
@e_kano	human
@MattPShendell	org
@tsinoyfoodies	human
@ragdejum	human
@hulkchilli	human
@Ziloufs	human
@BrotherJan	human
@LaquishaTabure	human
@paulinegtc	human
@Nutrisavvy247	org
@sabrinaorlins	human
@khwan1605	human
@Gnomex666	human
@thevajra	human
@pandamned	org
@JorgeEQuiros	human
@kent3602	human
@CarolChenmilk	human
@omgbart	human
@pPRUDENCEe	human
@elfallie860911	human
@DameDistrict	org
@BoqueriaDC	org
@ScenicRunway	org
@Lionatan72	human
@marialeqp	human
@MoreThanAMomOf3	human
@WillaimFairy	human
@LuizHalan	human
@ayuayu630	human
@MOWLondon	org
@ShoesNSugar	org
@AnneliWillis	unknown
@365dayscrockpot	human
@AenescumbDraca	human
@EduardoPsda	unknown
@Chalkz	human
@MktHouseCoffee	org
@kazumaakahane	human
@Primal	org
@stargirl_77	org
@NataliaBojanic	human
@truevuu	human
@balieatplaces	org
@JazminRvr	human
@recipespantry	org
@JoannaSormunen1	human
@sarahroseturner	human
@kaitokid_thief	human
@info_utopiaspa	human
@heismypanda	human
@s3xyvanilla	human
@PrimeBeauty50	human
@yuuki_nakajima	human
@Table_DC	org
@Jijie4everJared	human
@samriddhi21	human
@VeloAlternative	human
@CMarieNico	human
@lhealthychoices	human
@jwashle	org
@waltercaesar	human
@WindsorSheryy	human
@ngshitingZ	human
@ekitzel	human
@TheAshBaGash	human
@JennaObeid	human
@ANRI_UMETANI	org
@nycfoodie_	human
@foodiezhub	org
@MoonieSays	human
@Celigueta	human
@quench_mag	org
@KCeverything	human
@TheFederalBar	org
@Suikerverslaafd	human
@dealwith_mark	unknown
@FlyingCouponer	org
@dylarrno	human
@MasiasJnny	unknown
@robbsoulcafe	human
@crabzilla40	human
@Ally_Henry	human
@Cheavor	human
@OfficialAdhi	human
@MomKnwsBstOnLn	human
@kannumanaktala	human
@BreakfastCzar	human
@MunchDC	human
@tmhr1023	org
@ANNArong	human
@KeithArrieta	human
@MY_CandidaPlan	unknown
@Bouche_Doux	human
@MorterJon	org
@gregoriony	human
@TheLList	unknown
@QuinetteAckerle	human
@monumentlane	org
@SaulBlv	unknown
@Brandonhan1976	human
@DealOfTheDay47	human
@Carmen_Solis56	unknown
@shamsiah7788	human
@chompiesaz	org
@what_about_food	human
@thdivewhisperer	human
@JaiAdnan	org
@cbfaninfo	human
@Mobile_babe	unknown
@dandynhabarbosa	human
@F4Tdotcom	human
@BuyBuyCasual	human
@ZabrinaColyer	human
@DealOfTheDay50	human
@lambra912	human
@onsen_tamago_0	unknown
@realxstboiboi	human
@arisacandy	human
@amechan921	human
@AntonioSerioni	unknown
@514eats	org
@CoolHandCafe	org
@pisakafe	org
@MichelleHope17	human
@chiloroo	human
@a_superstarr	human
@SuperSteel	human
@SpikerLinda	org
@JeysonGarcia	human
@annaesunica	human
@DarioVlln	unknown
@bigapplescenes	human
@zeppy_camping	human
@iamyhurs	human
@thenaturalmix	unknown
@DaneGriffiths	human
@Dferred_annuity	human
@Mglamable	human
@SmoothieKingRC	org
@FIGat7th	org
@gomommacoupons	human
@shallwesasa	human
@irenematys	human
@IndahIrhandy	human
@lebistroduparc	org
@wilkikm	human
@JatineFashion	human
@tiradtoss	org
@LoungeBistro	org
@MINNMINNTHU2014	human
@BordoDean	unknown
@Lavesq	human
@JazzFever	human
@BedfordPavilion	org
@yx920301	unknown
@grandchildh	unknown
@jazjazPIGlet	human
@mojito_grill	human
@BistroFranc	org
@Jason_Staats	human
@chienen93	human
@NikkisCupCakes1	unknown
@wine4all4wine	human
@JogasakiBurrito	org
@CartoonTaffy	unknown
@grenlake	human
@hollywood26hw	human
@lvfoodjunkie	org
@asadorvasco	human
@foodsfrenzyhk	human
@vietngohong	org
@BROULOM	human
@cassis_jason	human
@activity16	human
@bunatree	human
@cinncindy	unknown
@RTRestaurants	unknown
@SaraBinde	unknown
@MSimpson67	human
@ChefBarnes	human
@XhicoSayChico	human
@Justmemarie2	human
@karenhi28186538	human
@andyluvv	human
@LakersEvie	unknown
@DementevaPolina	human
@Andruchovici	human
@coorslightking	human
@wmtyemi	human
@WyndhamWaylon	human
@BoysEatScotland	org
@rissa2143	human
@CarolannWyciyf	human
@kingfishersnews	org
@TomurcukYemek	human
@ijanicephillips	human
@CafeTurnier	org
@JooohnxBuch	human
@HealthFactoryAE	org
@SecikNur	human
@masa1038	human
@IHeartCeceJean	human
@2DArtbot	human
@ornithoserge	human
@dontsayitJusto	human
@ChrissyNYC9	org
@PartyTimeJohnny	human
@_MARMOHDS	human
@BreakfastinBCN	human
@RadissonBLU_UWE	human
@Natalie42222	human
@YanaKawaii	org
@chrissy4281	org
@PetiteAbeilleNY	org
@xJORINx	human
@GadgetGoodies	human
@WhiskKid	human
@offerkingz	org
@carlopaguio_	unknown
@haobanh	human
@ms_elliehearts	human
@PineKitch	org
@claytonitalia	human
@ChrisXP27	org
@JoseAzcarate	human
@MoneyMediaCo	org
@ZeldaWiiUNews	org
@midtownchinese	org
@Coachmanhotel	org
@lars13831	human
@PaperDolls3	human
@vegan109	human
@Jennifer_Vuong	human
@Pittpossible	human
@eatlatenight	human
@une_caii	human
@bar_carmen	org
@AstridSillviena	human
@Yutchner	human
@OmoPongsuwan	human
@bowerytowilliam	org
@ohsweetbasil	human
@allaspinaphilly	org
@BloggersTbb	org
@PeachPearCrumb	human
@realmiatorres	unknown
@kyao_run	human
@Smiley881	human
@blendyz	human
@wendysito	human
@Mayu_tO	human
@tweet_a_pizza	org
@raregroove1968	human
@alwards	human
@PayneJaicee	human
@Angela_Mraz	human
@tarisu	human
@SPRestaurant	org
@Gyant	human
@cooperrebecca	human
@MalindaMarika	human
@WilliamGh	human
@Kitchenette_UK	unknown
@HilmiAdi	org
@craigp71	human
@FitMomTalkRadio	human
@MsUniverseCrown	human
@Galateofriends	human
@StoriesBar	org
@thanatosrelena	human
@BelleSia	human
@DrakesRest	org
@familyfoodie	org
@PaleoFondue	unknown
@BritneyCHAPSTIX	human
@WENXINNN	human
@ccreammm_	human
@MaraxxXO	human
@khtphotography	human
@KrisnaMPutra	human
@BetsyHuot	human
@EribeRami9	unknown
@STRAFHOTEL	human
@shopbvm	org
@listanahotel	org
@MrJocko	human
@Veromafalda7	human
@CafeHarlington	org
@_xoxobarbz	org
@epc	org
@Hilton_SFFD	org
@NoeliAmar5	unknown
@ElleBee206	human
@StefaniaMenz	human
@ThaiFusionWK	org
@cbellistweet	human
@OVOXOKilla93	human
@rowenberrys	human
@AbbottegaMilano	human
@side_tracks	human
@Christy41970	human
@frugalcouponmom	human
@Amalstable	human
@Lorekarus	human
@KarmaCoffee058	human
@NarsipKaur	human
@chelsea621	human
@wornwheeled	human
@_acube_	unknown
@MarxRobby	org
@WurstExpress	org
@COCOFASHIONBLOG	human
@pvazmusic	org
@brunolovesbrit	human
@REDLIONBarGrill	human
@JaslinJing	unknown
@j_trad	human
@Onsening	human
@aymn0905	human
@allie_page	human
@jessjeanmyers	human
@canteencants	org
@rynonavy	human
@xavier0720	org
@MissCocoCupcak1	unknown
@ABTBSRS1	human
@everythingyeg	human
@Zest_PR	org
@ODonnellsBread	org
@AgencyPS	human
@DealOfTheDay46	human
@rfuruse	human
@GiuseppeTavo	human
@BrandonBsAs	human
@LMJB	org
@ourthreepeas	human
@bluerosefeli	human
@WirtRacquelle	human
@land_arts	org
@amber8517	human
@FerranTomas	human
@danicalicooks	org
@iccyan777	human
@MGRbeckmedia	human
@diamond_smoke	unknown
@Whitehorse_RT	human
@noctivagus666	human
@superdjromeo	human
@LivingRemixed	human
@073517622	unknown
@RaeFedUp	unknown
@Jyael1	human
@NadushaDF	unknown
@ChristinaCucina	human
@InstaChita	human
@NeuvooAdmOtt	org
@EtagereAntiques	org
@Sesame_TSS	human
@eatsleepchic_ie	human
@Moscow_2life	human
@KimsCravings	human
@LisaM71	human
@STrebeccatan	human
@NewJersey_RT	human
@mikobhayangkara	unknown
@jomarise	human
@KashmiriBeesham	human
@WomenWhoBrunch	org
@KHanstag	human
@EmpoweredFood	org
@TheFashionReign	unknown
@Shefernando	org
@WulfgarKortney	human
@sofiahdz65	human
@ScottFordTVGuy	human
@TheGreekGods	org
@geinou_shiseika	unknown
@priorities	org
@johnleesandiego	human
@rocasenergy	unknown
@Brooklyn_Brand	org
@SarahKoszykRD	org
@FarmerMarketVeg	human
@felipeperez	human
@KadieWybert	human
@Lunka_Almeida	human
@napturaltravel	human
@kimmygurlo8	human
@VastOKC	org
@VerdePizza	human
@morgenrot3180	human
@Wildwestph	org
@NLwebinarexpert	human
@GilbertoKenneth	human
@nikkiannewells1	human
@AisleyWilburt	human
@romyraves	human
@WMayree	human
@chloelazarovits	human
@NourishRecipes	human
@sassygirlfit	human
@smilingbluedog	human
@snacksindia01	org
@_ToastMistress_	human
@PiggyBuff	human
@tasteLUVnourish	human
@imarlocarlo	human
@charliesbronx	org
@AmandaPerezFan	unknown
@OzeryBakery	org
@leeannewong	human
@msnubooti83	human
@PablodlaToCu	human
@Saxtys	org
@dcatdemon	human
@Laquet	org
@bea_90_D	human
@bot13482723	unknown
@XoXoAng3l	human
@jqsydney	human
@WriteOnRubee	org
@aprilharuspring	human
@msholistic	human
@MidwestDairy	human
@mahecdining	unknown
@thechurch_ie	org
@aliciasomma	human
@rosemesara	human
@gabsmlara	human
@SmartPhoneWay	unknown
@emerbreen1	human
@athegat_	org
@hazlianahazrah	human
@kennethkingong	human
@kasumindesu	human
@AnyanaWolf	human
@CodyCPruitt	human
@ryanventura604	human
@SunshineBfli	human
@DrKarlios	human
@reeve11	human
@sosidolcesalato	unknown
@Carolin31928036	human
@ChiaraCaru	human
@TheJosieWorld	human
@YukonEvents	human
@theclassictee	human
@ludelevedove	human
@mfharith	human
@kimmy_1113	human
@ntsToronto	human
@BKarnal	human
@PPettenuzzo	human
@jon0h	human
@TerrynMorgann	human
@jesslilya	human
@Tufairytale	unknown
@AkoPoSiGavin	human
@Toronto__Style	org
@SazonCuisine	org
@KaypriceMary	unknown
@SunYii0102	human
@NWILLEBRAND	org
@evelyn_sando	human
@MostlyHomemade	human
@sayid_ann_ima	human
@GBrydger	human
@rmyc	human
@AwaniLevant	human
@PierOneSydney	unknown
@tokyobronx	human
@scATmirchmasala	unknown
@Uni_Tunes	org
@HisTreeNut	org
@winedineC	human
@SmokeandSaltLDN	human
@mkw70	human
@Crema_Gourmet	org
@StKildaVenues	human
@ElenaLovesThis	human
@Foodtruckgirl7	human
@TersiguelsFCR	org
@BryleaAdrienna	human
@SweetPeasSaff	org
@SweetMizK	human
@brandonflatsoda	human
@MrsS07	human
@barnesemma56	human
@iLoveVB_	unknown
@MudHenTavern	human
@NeeaLin	human
@ChowDownUSA	human
@Virlova	human
@cecyjuarez83	human
@ItBakesMeHappy	org
@Magpie__Magpie	org
@hamid2d	human
@CapellaDC	human
@London_Network_	unknown
@rebeccakufla	human
@azzyla_sanchez	human
@JennPawelkoski	human
@the_bon_vivant	org
@alsurcafebcn	human
@AllAcquaResto	org
@FelixGROUPON	unknown
@SpellMaaadz	human
@revensamuel8	unknown
@Cleverlychangin	human
@donferia	human
@petidejeuner	org
@TheSpareKitchen	org
@AyaResurreccion	human
@Lotusflwerboom	human
@cafe_henri	org
@warai_kanndou	unknown
@noyvietlao	org
@MITCHUMM_1976	org
@stashica87	human
@CountryCleaver	human
@BoomTiny	org
@TheSurpriseSW3	org
@piaktw	human
@ClaraSoca	human
@SakanaMcr	org
@AttitudeFuckU	human
@KatiePizzaPasta	human
@LaGourmandina	org
@seanredfernan	human
@Natsunamasan	human
@lorieyeo	human
@coachsaudi	human
@JennGlamCo	human
@TheSpiceScribe	org
@RahRah6288	org
@JennyFaith	human
@AnIndianFoodie	human
@BOBMANPIFF	human
@BettyCrocker919	human
@cherryhatch	human
@missconfig	human
@marvelanne97	human
@TrixiWoodman	human
@melanie_c28	human
@sorarium	human
@asnatch	human
@ChefJayAllDay	human
@kukukichux	human
@BigCed0814	human
@Market_Organics	org
@ToddHui	human
@astroboyisgay	human
@SkinnyGrub	org
@bezproducts	org
@vannyall	human
@DaniEllaAnasTas	human
@CUIHUI_LOO	human
@SoDelhi	org
@lapetitejess	org
@FriehaAltaf	human
@The1LCheatwood	human
@BIAparis	org
@DawniesKitchen	human
@YulAlberteen	human
@WeBeatFat	human
@SIMPLYBEAUTY504	human
@momoko0402	human
@RebeccaMaslin1	human
@LifeLoversBcn	human
@midwestlady15	unknown
@foodieskitchen	org
@hirahira1130	human
@diabetichealing	org
@DealOfTheDay00	human
@LetsDishRecipes	human
@FredBex	org
@dawnchats	human
@rarieke	org
@keepercoll	human
@_alice_Magg	human
@NutritionRadio	org
@cbctom	human
@TheKennardK	org
@skabz_07	human
@rehseaside	org
@LuisSanchezjr1	org
@pghnewbie	org
@MaryeAudet	human
@WalterJennyfer	org
@colourfulradio	human
@littleyolkstall	org
@RAHBITW	unknown
@Ur_Little_TiTo	human
@JillHendry2	human
@Quigleywines	human
@BiodunAbudu	human
@BrookwoodDublin	org
@noelledistura	unknown
@JC2009USA	human
@SilkCityDiner	human
@DaBadddestOne	human
@UNO68	human
@darkspace76_msk	human
@EmmettsCastle	org
@cornchopsuey	human
@WHEREAREYOUJV	human
@TupTimThaiOR	human
@ellensyummylife	human
@OzGoofyPrincess	org
@theneeds_food	human
@iCinnabun	human
@MV_FoodDrink	human
@internautic2015	human
@cindyrhernandez	org
@hudsoncafeNJ	human
@gomichild	human
@Kelly_Ann157	unknown
@bostonbakery	human
@Rslcairns	unknown
@hilady2u	human
@JackieDeG	unknown
@LonnyWoodwards	human
@mumbalance	org
@Kennyshing	org
@WinstonCalbert	human
@HannahHanstag	human
@InspiredByDoll	org
@AdriennedeWolfe	human
@Fatcentric	unknown
@LuigiGiulianiJr	human
@WinfieldJacquii	human
@OldGreenBean	org
@BiggBoysToys	human
@ndajessica	human
@DealOfTheDay51	human
@SahraHussain	human
@asyikin_iRish	human
@azmilabuan	human
@HappyWineMiami	org
@VBeast265	human
@proyectoaescala	human
@uknewse	human
@vaa_ney	unknown
@Tanner_Co	org
@GlansdaleAbbaga	human
@TokeAid	human
@BB_Supporter	human
@alineMichaen91	human
@sean626	org
@sherrecipes	org
@anilcroqueteria	human
@busrabagbasi	human
@LeproBal	human
@rioedward_dr	human
@catseye107	org
@ItsBariNotBarry	unknown
@Home4Jobs	human
@AliveluAkondy	human
@JenKnoedl	human
@sallytherock	human
@ShopCoralGables	human
@IvanKMcCartney	human
@drhikaru	org
@LisaPierce__	human
@breakfastclubme	org
@LDietetics	org
@AverelCenhelm	human
@ThatAznChik	human
@ImNotPerfect86	human
@WiltEtheridge	unknown
@solselsilsalsol	human
@joanneeatswell	human
@DaisyMoos1	org
@mochan0128	human
@ParsonsAbraham1	unknown
@ManInTownWorld	org
@Chikibrainstorm	org
@AmyG13	human
@burntzilla	human
@iamjoannroda	human
@eisforericka	human
@MirrorofFashion	human
@WintanweorthLo	human
@ITALIANASENORA8	human
@hobbyberries	unknown
@Olisimus	human
@Rollie3333	human
@EstherYHM	unknown
@ConejoTron	org
@ppicchia	human
@niapriskilla	human
@ORANGE_BRUNCH	human
@IndreetLoire37	human
@JennBartoli	human
@RobTomasHawaii	unknown
@weightlossupusa	human
@ElissaCoxen	human
@momoca_nakamura	human
@theprovidores	org
@chrisj1914	human
@Ben_aserfeliz	unknown
@Aryanna__A	human
@OutForLunchBlog	org
@VankaStephanie	human
@mikah_lurima	unknown
@JuneRichards	human
@bambinoyoko	human
@ClaireTalbot59	human
@2520Tavern	org
@waypointgrill	human
@CapeGrace	human
@ChinaJacks	human
@erinsanders0311	org
@Triple_century	human
@olciaky	human
@beanienus	human
@Ginna05304190	human
@trailersMEDIA	org
@REXLondon	org
@StudioSunday	human
@sunprapach	human
@ImJrLyn	unknown
@GFTSportchalet	human
@DitzyDeeD	human
@nikhileshmurthy	human
@olgacerpita	human
@TigerPrincess86	human
@PuppyRetweet	human
@RealWeightLoss3	org
@FrugalCouponMum	human
@ElenaIstomina	human
@BringYourDate	org
@SugarAndPlumm	org
@crookedtreecafe	org
@BurksPerez	unknown
@_amazingfoods	org
@lovemefood	human
@HsienHsienZi	human
@KingRedd615	human
@HugoIngaCompany	human
@maxine_vienna	human
@DealOfTheDay40	human
@TheNest	org
@tathibarroco	human
@melissaandre	human
@iamjsondizon	org
@RougeJB	human
@pVKo9kJux9	unknown
@Bippu_Style	human
@thedudemom	human
@PanYipu936	human
@UrbanChefArnhem	human
@TASTEOFFAME	org
@thefoodliaison	org
@StefanieBrich	human
@BabyModeuse	human
@MyFoodRocks	human
@Truburger	org
@AbodeRestaurant	org
@hapooms	org
@8790240	human
@JspaceFood	org
@DMC1982Nice	human
@tatzgrrly	human
@Franciska84	human
@fragiledolly	unknown
@TheBotanistAE	human
@Cecamp83	human
@dimora	org
@lacasitatacos	org
@WilloughbyGaze	human
@hellosoulmat	unknown
@vaiedadan	human
@deamezaga	human
@CedarPointPHL	org
@BrandingBritain	org
@Inspiralized	human
@JamesonJuwily	human
@Cefasb7	org
@SPNfit	human
@mitchteryosa	human
@travelseason198	human
@yukacharin	human
@healthychels	unknown
@simyuk	human
@AesoburneDossie	human
@CandyBrenn	human
@gmoscoso23	org
@panelaandco	org
@_Food_Story	human
@AKB__meigen_gaz	unknown
@credd	human
@Sheema_Ahmad	org
@scenesfromusc	human
@Pussia_Galore	human
@Ming_Ai	human
@alyssabaldovino	human
@SofiaMrqz_	unknown
@fspecial1004	org
@WilhelmeniGran	human
@BlackpoolBiz	human
@LizziStead	human
@BribedwithFood	human
@pmiki68	human
@_WinAHouse	org
@nolitsa	human
@BONGLETBAUL	human
@buenaparrilla	org
@RENA_INDIA	org
@yummylummyblog	org
@ftasterblog	human
@CrossroadsMrkt	org
@Casa_D_Angelo	org
@SPOCOM	human
@AlbionSE1	unknown
@AmazonDirect2U	human
@SEVEREWAR	human
@BotchMeshiBot	human
@notesbyastylist	human
@jairocalixtos	human
@BrunchBro	human
@wilfandadas	human
@BrandonNail	human
@debbiej0ey	human
@iykaa_ozawa	human
@Kitchen_Pride	org
@U_Gotta_Have_It	human
@Cadillaclounge2	org
@AdelynDerrold	human
@yopatrizzle	human
@4600_close	unknown
@Blessed_Element	human
@frankdeckbar	human
@AbrecanEawart	human
@hoaxliverpool	unknown
@pornstar_happy	human
@kellyfoxy303	human
@Ikhsan_wahyono	human
@LaPromotecaRD	human
@CafeMedina	org
@PowerPee	human
@MelissaTippie	human
@TerravinaHotel	human
@FAUCHONistanbul	human
@JasMc_	human
@WilmerCammie	human
@tanjyoubi_urana	unknown
@modareforma	human
@araijain	human
@mariasgoodtaste	human
@BrookeAlondra	human
@ultravioletraez	human
@ijaimz	unknown
@Sabrosasf	org
@TimWelch84	human
@drNatt	unknown
@aedy_RMAF	human
@GildaSays	human
@HandleDistrict	org
@janetanddenis	human
@Tagrushi	human
@abbytoks	org
@urockgirl	org
@rhetoricchick	unknown
@golffyeiei_1	human
@Felt1_am	human
@rjay4rm619	human
@CharlieCoppola	unknown
@GreatDayFarms	org
@zombietalkradio	org
@BearLawStudent	human
@meridianstcafe	human
@sekai_ga_neko	unknown
@THESMALLMILANO	human
@chefsthattweet	org
@gieneeinc	human
@Golafulham	org
@gothammag	org
@galapagosscenes	unknown
@DaniJz_	unknown
@NorthStarCdf	human
@lukesginrickeys	org
@melanisemuel	human
@AenedleahAiron	human
@WillieDeesland	human
@AekerBeale	human
@BeatonHandi	human
@ChefLianaMK	unknown
@jauipop	human
@RicasAmateurs	human
@goodlotz	human
@fabrecipes	unknown
@carrotoh	human
@annesramblings	human
@ake_0926	human
@MarconaLA	org
@lalasgrill	human
@CCSBurgers	human
@foodnfocus	human
@Danz_divo	human
@mrs_hawkins	human
@cadeguzman25	human
@got_2_have_it	org
@tyecorcuera	human
@jesvinjavier	org
@skallday29	unknown
@janersm	human
@PriorTruth	human
@MyVegWhole30	unknown
@BockmanPeter	human
@Mista_GQ	human
@Corrinadreams	unknown
@SmittysSleuths	org
@TableBabel	human
@bluedogbeertav	org
@mommalewsblog	human
@MARKinthemaking	human
@P_lins	human
@Supperphilly	org
@feelgoodbarber	org
@iamdebss	human
@IamNaZza	human
@nu_asia	org
@TheMonksYard	org
@amoihayat	unknown
@JessNelson9	human
@HapChapMusic	human
@LoveIsLove247	human
@GermanOlvr	unknown
@Nutrition_Share	human
@milanierica	human
@PoetSera	human
@AdunRumate	human
@yanarchy_s_d	human
@iamsikora	human
@dionnebaldwin	human
@Tiberiasnyc	org
@com_asami	human
@hyperfunk_mike	org
@soju4two	org
@CantoCorvinoE1	org
@JasAkhtar	human
@blomo_chiemi	human
@bonsoljosephine	human
@SnoopConnieCon	human
@JesusReveals	unknown
@kaloyalameda	human
@jeffgelpa818	human
@tomwiener	human
@nadmaf	human
@ErmitaMiravalle	human
@ShingoKido	human
@LingyOh	unknown
@Steph_is_Shiny	human
@veganricha	human
@ESSoutheastWI	human
@TazWube	org
@cocochipink	human
@RossanaWyatt	org
@badhopper	human
@OME_ENT_Promo	org
@TheWestinMumbai	human
@RobDellaPietra	human
@MeridienCairo	org
@Taste_Spain	org
@DakDakCafe	org
@CoolSussex	org
@hillel_zavala	human
@mwaura388	unknown
@NadiasRecipes	org
@WoodrowTinaa	human
@GioHaritonidis	human
@msscheesemonger	org
@SCluvkpop	human
@ThienLaura	human
@LaFontanaDoral	human
@bobocinta	unknown
@_SoFashion_	org
@JulianaMack11	unknown
@sceneMCR	org
@hippie_mom	human
@tarekhotelier	human
@pandaking_s	human
@princenickstone	human
@AldinoVineyard	org
@MerchRiverHouse	org
@CraziiMonique	human
@ijustwanttoeat	human
@SooZarr	human
@gabyneves	human
@SaharaFoley	human
@TatwsTrading	human
@lovesomedimsum	org
@timetravelplans	unknown
@patisuro_10	unknown
@CasaundraWorde	human
@peacemanor	org
@ciaopiadaUS	human
@jrepoza	human
@TrentonImzzen	human
@MadItalianTO	human
@CharlesAWinters	human
@un1tytv	human
@poppyandrosela	org
@jmtaninon	human
@MarkLakshmanan	human
@thechester_	human
@reneedobbs	human
@SincerelyKayJ	human
@mikethemovieguy	human
@donnavells	human
@MrCoolLooking75	human
@babyplannr	human
@mppaillettes	human
@theKidGerald	human
@lucylean	human
@AshBG	human
@ItsDanielKyle	org
@siewlee1812	human
@MyMansBelly	human
@aDFWTaxiCab	org
@KupfertKim	org
@RB_Jimenez	human
@RomanCyruz	human
@dans_inthedark	human
@MahaGadde	human
@Portuguese_chef	human
@AhebbanKimberl	human
@myvalentine_421	human
@jerminix	human
@RocknHott1	org
@Andy_Kho	human
@linolivia	human
@GemmaRoper1983	human
@fitnessversum	human
@emmisneverland	human
@BluEyedLu	human
@OwenKelso	unknown
@ESchardt	human
@fcreolo	unknown
@DealOfTheDay45	human
@manturabistro	human
@NellGwynneDubai	human
@EleanoraBrayden	unknown
@ketchlazo	org
@deliciousmag	org
@PSLilyBoutique	human
@CubanaFourways	human
@theonli1luv	human
@TamratyKSA	human
@cestzanne	human
@urMHADJesty	human
@couturesandwich	org
@Massielhn	human
@huzyo112	unknown
@MomKnwsShopping	human
@ontlr	human
@DuchessOfDorks	human
@DirectFlix	human
@NelyCab	human
@CheshuntNetwork	human
@KatieShuck	human
@WaldoWell	org
@HealthyCSteph	org
@GreatBodySkin	human
@SingleDatingDiv	human
@cinetonala	human
@gaedepa	human
@08_aditi	human
@ArlaCafe	human
@vegevege13	human
@extraLio	human
@AdiaSebert	human
@lulucoghlan	human
@sugarandsoulco	human
@nickdan2726	human
@with_team_	org
@PulangParuparo	human
@ElementsSV	org
@rowansmom1127	human
@sswifttgamingg	human
@MagicCityBlog	human
@dineatvictorias	org
@lulupho	human
@KinzieHotel	org
@grillemidtown	human
@lauraagarwilson	human
@stylishplate	org
@KaNooMKaNiM	human
@Chowffeur	org
@hunhankids	org
@bblabellaverona	human
@mahs12	unknown
@alabanjo	unknown
@YloncaAgterhof	human
@jeonjugram	human
@designerdigress	human
@hbhowto	human
@CROOKED_FORK	human
@instahachiman	org
@fit_survivor	human
@Sax_O_PhoneGirl	human
@BenedictBcn	human
@Forgeandco	org
@kristofsteiner	human
@zenkinz	human
@k24hollywood	org
@adrianbeats	human
@msedlock9292	human
@captinsteph26	org
@RadioSuccess	org
@dunnbroslasalle	org
@lolita__11	unknown
@TeresaPLMegias	human
@PatandCarla	human
@DaiquiriDicks	org
@3rdsupply	human
@LilyMaesCafe	org
@arnomayorga	org
@Paleorecipe24	org
@onfoodandwine	human
@Zeph_Zion4ever	human
@LeMilleRicette	human
@TheEmeraldHotel	org
@MANANMANA12	org
@FRESHUMAN	human
@ki_kuruma	unknown
@3in1Eliminator	org
@nasobema	human
@1girl2boys	human
@KillerCafe	org
@OrganicsDeliver	human
@KimberlyCorwin	human
@BreakfastLearn	org
@BellaCrusta	human
@KristinePThomas	org
@Junehikaru96	human
@michaelleza	human
@naokichi0531	human
@LombardosPizza	human
@RWJUH	org
@JohannTing	human
@halaliaasma	unknown
@byclaquinta	org
@GodfreyJeffers	unknown
@shotmasterpat	human
@androidjen	org
@annekyognaleb	human
@Hubbell_Hudson	org
@Abelko89	unknown
@monsieurearl	unknown
@faBiCheung	human
@StShotsLA	human
@gprishker	human
@cheyzie03	human
@RadiusDowntown	org
@WTCAD	org
@Shyvillezion	org
@Noonygirly	org
@ActonJerry	human
@GREAT_EETS	org
@gimme36	human
@Mr_Ulloa01	human
@peterkross1	human
@DurhamLazarus	unknown
@heyddym	human
@WaalaaStore	org
@mila069	human
@koalaswife	unknown
@AnitaMIsaac	human
@7babystep	human
@vbaileyactor	human
@alohapaola	org
@JesicaLeaRD	human
@Encore_Catering	human
@oogam	human
@Micika013	human
@DealOfTheDay52	human
@SafeHomes1	human
@cyndusen	human
@smiling_liberty	human
@military_kid_2	org
@acapulchra	human
@BrandiChiara	org
@herbalife_leads	unknown
@t3il33n	human
@SP12XX	human
@BarriosDaly	unknown
@thheyworth	human
@FourCafe	org
@NextBadman	human
@lualtmann	human
@Pub_SlyeFox	org
@BuckySandine	human
@Kcbaby54	human
@GerardoMun65	unknown
@milo051	human
@nowyvr	org
@rodricksu	human
@5thTavern	human
@VegaVanTeese	unknown
@mrsteeh	human
@ShenalG	human
@gellapunkrock	human
@healthyfamily4	human
@nsarkhel	human
@blondebunnybo	unknown
@Divine_Kaiser	unknown
@CafeSNS	human
@FreshCanteen	unknown
@mvncnt	human
@espaciofit	human
@104BlogTips	org
@bradchais	human
@naughtydred	human
@TheYahdSale	human
@yourbadkitty	human
@dd_foodnstyle	human
@SKGFoodBlog	org
@mhmilo24	human
@kimmanw	human
@PorkodiSengodan	human
@RaithConstantia	human
@BeckCoachMedia	unknown
@yegretweet	human
@SRQlivin	human
@MarcosRomn_	unknown
@DailyGawk	org
@Jthatshot83	human
@robtuazon	human
@quantisize	human
@JorgeDz_	unknown
@AKANE301TaK	unknown
@BeatrizJimy	unknown
@WinfredMaecena	unknown
@fennylavenia	org
@hauntedplacesca	unknown
@The1HeLetGetAwy	human
@izzat6888	human
@JacopoGrazzi	human
@MassimoSongs	human
@vsetzorange	human
@BoomJuiceDallas	human
@FrankyFaze	human
@WalesNo1BizShow	human
@erecca13	human
@LordoftheWings_	human
@kecosaboath	human
@LowWenQiang	human
@winegal57	human
@DealOfTheDay53	human
@sugunl	org
@dandelionmoms	human
@GrantStockton	human
@maemukisuit	human
@shelovesmengons	human
@scrummynmunchy	org
@IAmLayLaTerrace	human
@nancy3511	human
@saori6vv6	human
@sjcdg	human
@Bosyelbakly	human
@RadioSiani	human
@rm7726	human
@cutielesley8	human
@ninjaTHEPOET	unknown
@TheCricklewood	org
@bine_binedoro	human
@M2KJ	human
@LemongrassRest	human
@realchefjamie	org
@FitFamTweets	org
@bismillahsalawa	unknown
@GoMunch	human
@decorationartlo	human
@HyraBanks	unknown
@DenverBeerGuy	human
@IamPattyCatalan	unknown
@localrootscranf	org
@chrisnumber8	human
@FarmGirlWorld	org
@LowerBricktown	org
@AdamCBanks	human
@another_4	human
@GentleRedHead	org
@GreenGourmetCA	human
@ChickNik	human
@tatsdeli	human
@MartinRanfft	human
@jeroxie	human
@TrueNorthTavern	org
@manifested1	human
@Rofizah79	human
@IreneMoney1	unknown
@Dedsh8	human
@arjeskitchen	human
@cocoveranda	org
@erikapaula03	human
@WillRunFoodWine	unknown
@HaleandHeartyNY	unknown
@MYBALANCEDPLATE	human
@L2KFITNESS	human
@Solestio	human
@ComeYummers	human
@iamlablita28	human
@AlarkoLeroy	unknown
@atoquainoo	human
@NarvaezMaud	unknown
@Zusteras	human
@TheBloggerPearl	human
@yamextian	human
@bluesky0508	human
@ricettinegiunti	human
@RFSeafoods	org
@BaltE4LDeals	org
@anjanadkumar	human
@SergiosPizzaa	human
@AlexOreglia	human
@FronteraFresh	org
@ClintonStDubai	human
@FaraShamshir	human
@AlkalineFood4u	org
@365DaysofBaking	human
@mammariccia	human
@cornmomma	human
@PurdyKhloe	unknown
@RinnsKitchen	human
@MysticMarketCT	org
@ayaya_jpn	human
@nancelynn24	human
@brew_cafe	org
@TarponBend_CG	org
@SabrassRest	unknown
@ShawnaRobey	unknown
@Life_n_Food	human
@video_gopro	human
@Russllarena	org
@michaelsmikael	human
@ellincycling	org
@CougarMeatJones	human
@BistroVue	org
@CA_Avocados	org
@BGuzmen	human
@machtwatch	human
@toshiko_s	unknown
@warawara_wa	unknown
@CageFreeKID5	human
@PhilanthropicHR	org
@Yenny_2501	human
@Lancmike	human
@CacyXaviar	human
@johnnyrocketsca	org
@amomhavingfun	human
@MariferDuran	human
@Meetgourmet	org
@graceywalsh	unknown
@judoclubmestre	human
@TurbineUSA	org
@brofitnessteam	human
@French_Kissxx	human
@TravelVoyaz	human
@DealOfTheDay42	human
@Cosmedicals	human
@TellMeDelmy	human
@CupcakeDiaries1	human
@Wyled_C	org
@TeamRachael	org
@EverydayMaven	human
@Pirate_News_	org
@foodheavenfl	human
@HarvesterUK	org
@RedMangoQ8	org
@jacvil5237	human
@BBCoachMollie	human
@WilliamJenice	human
@onlyyouuuuuuuuu	human
@sfazly	human
@newsinvideos	org
@chiyo045	human
@ELEAITAMAE	human
@Den_DenDenny	org
@NMXFitness	human
@N8Shea	human
@AnnekeOele	human
@andrewfwkelly	human
@TheLansdowne	human
@OralandCummings	human
@terrywalters	org
@ANONyMiSsLyMEEh	unknown
@Tamara_ExOh	human
@JPercorsi	unknown
@EmbraceWNY	org
@djhane16	human
@JeffyChua	human
@Fast_Blogging	human
@adam_orth	human
@FlagshipSD	org
@takedashizuka	human
@SpicyCandyDC	human
@tammybangkok	human
@MrCheffito	human
@Social_Yakama	human
@meidsmoe2004	org
@maki_namusan	human
@aNgeLpAoh	org
@_KateG7	human
@couleurblanche	unknown
@OliveBranchFood	org
@jenursa	human
@zainsaraswati	human
@AethelstunClark	human
@InstaAdler	human
@jigga02	human
@Chamartin_Mad	human
@BookingCatch	org
@kiik_kuruma	unknown
@StevenLin8g	human
@s_nameera	org
@KimMillerStyle	human
@mister_Grolsch	human
@AlannaFeeney	human
@Healthy_Lisa1	human
@AnnaLenaxox	human
@greenteashan	human
@AragornAcca	human
@BollywoodZing	org
@Looney92027	human
@AHizz	human
@EatBelfast	human
@WIC_LAW	human
@FrugalNovice	human
@Texican_Cafe	org
@CeLvi_ChaN	human
@LeahAndMark	unknown
@mycustardpie	human
@kathleenkl	human
@Tatami_Kuwait	org
@FoodNOLA	org
@healthynibs	human
@Stanfords_SCtr	org
@thesilverarcade	human
@hellocupcake4u	human
@king_brah	human
@oldhatessex	human
@PoochAndCo	org
@teysko	human
@NudeCR	human
@SunflowerBabeTX	human
@Samads_Wife	human
@joinupdot	human
@AislyDudly	human
@macaron_kahve	unknown
@DunnBrosEdina	org
@BBlogger25	human
@thewdish	org
@exmouthlondon	org
@WittaGiselbert	human
@VaishnaviPandya	human
@FinerThingsLA	org
@rendramondong	unknown
@eatthisto	human
@emilia_mel	human
@fashionstarlite	human
@TeenBrainGuy	human
@SaveThisBuyThat	org
@Taannas	human
@helenL4444	human
@ChefAaronN	human
@daphnedebauchee	human
@AccidentlyDlish	human
@MohamedHarmoudi	human
@LKISStyle	human
@BzM_Jezyce	human
@bubbys	org
@BivinsWampler	unknown
@Cindo	human
@CuziFreshCafe	org
@irie_sachi	human
@Iam_BHITZ	human
@KraftAppliances	human
@Sagitter_One	human
@absonfitness	human
@FoodgameDublin	human
@ticucinocosi	human
@SnapinIndia	human
@IAmChefBrian	human
@MsElizebeth_	human
@itsme_ake	human
@HectorZpata	human
@geraldtuckersr	unknown
@BossBabezEnt	human
@EthanFOwen	unknown
@P_Kitchen	human
@angelinawong	human
@WorldClassWorcs	human
@BridgeDetroit	org
@vnorrland	human
@kitschn	human
@Jakes_Mood	org
@BemepPartyboy	human
@KiddoAlan	human
@Vorarlberg1	human
@Gaggyl	org
@AeldraCoy	human
@VeggieVisa	human
@AshleyKCMiller	unknown
@nancy_Fitness	human
@DAmbrosioRd	human
@Lovesmytwoboys	human
@FabiolaRoasr	unknown
@gang_56	human
@refrigeration	org
@cafeoncampus	org
@supper	org
@ayalanimsay	human
@HuppieMama	human
@APT78	org
@SammysGVP	org
@RossoRestaurant	org
@Kaplankag	human
@Psych_of_Eating	org
@cjzgetnfit	human
@KJLR84	human
@datdudetoe87	human
@EmmanPader	human
@preventionRD	human
@Lenasblackbook	human
@BestHairEver1	human
@OvertimeHustlin	org
@reducecalories	org
@VillaKehl	human
@TheWetFishCafe	org
@sports_know	human
@HuttoRandolph	unknown
@Tyroneyoung_	org
@pigandegg	org
@TheQuarterLivpl	org
@JIkkySS	human
@DealsFromMSDo	human
@bloordalenotice	human
@GPirret	human
@8cafebar	human
@dylanccrain	human
@VoluptuousMami	unknown
@LongLeggedUncle	human
@AngelinaEveline	human
@sweetie_tweeter	human
@Nourish_Kitchen	human
@larsvansusteren	human
@CharisKuri	human
@DollarBoatwrigh	unknown
@cafemetro	org
@s_dove	human
@homemadebklyn	human
@BeggarsBushD4	human
@ayagourmet	human
@nuttiz_com	org
@djwizzz	human
@michelesgranola	org
@zaegirs	human
@HaberdasheryLdn	org
@suelee1998	human
@anlamarama	human
@ToniPatton	human
@briggsmichaile	unknown
@racheldaneman	human
@SidnieZhane	human
@vikkiekaye	human
@czarra326	human
@aclaramonica	human
@sofmuzio	human
@joinupdotsdaily	human
@IkTheStylist	human
@Cleaneatschar	human
@Olliesbebe	human
@DCamposfitness	org
@Chef_Zam	org
@JocyMall	org
@david_l991	human
@ButchersBunches	org
@janvercie	human
@BINGBING_LUXURY	human
@abbytizer	human
@HarbourClubCHS	org
@One7PR	org
@DJFPrepublic	org
@Lift_Nesters	org
@welike_things	unknown
@jaymasterchef	org
@patralak	org
@anouchka_23	unknown
@lottadigital	org
@2WheelTonio	unknown
@comidachocera	human
@Milieunet	human
@YourAllBarOne	unknown
@JoeMusters	human
@Tukibomp	human
@rainyesplease	human
@Halyards_ssi	org
@ColleensCookies	human
@Skinny_Kimmy	human
@TheLjama	unknown
@lookladymode	human
@lisaking0881	human
@gre3ntee	unknown
@debyes	org
@HoeLiong	human
@datingdad	human
@SchniBot	unknown
@HeartCosmicCat	human
@TheBlogGuideRT	org
@mzekigunay	human
@SerFer1577	human
@reyssongs	human
@tie_ya	human
@smilton3rd	human
@JessRighthouse	unknown
@grallegretti	human
@AlcalaCharlson	unknown
@pixelbistro	human
@bennysoo	human
@JanggarUlam	human
@PerfectoPizzas	org
@riynie	human
@BeerlyLegalGrp	org
@yasmine1775	human
@heatherwaxman	human
@MommyTalkShow	human
@tashaamorrish	human
@PrincessRoyalSt	org
@DaRealRastaBwoi	human
@THIS_AM_	org
@BoldskyHi	human
@ChaChasBrea	org
@Andreka55201755	human
@HelloHealthyYou	human
@ng4_online	org
@Hitomimyhomie14	human
@mariaverele	unknown
@HudsonOlive1	unknown
@Cater2me	org
@letseatyum	human
@SweetieChica	human
@RockRunBrewery	org
@ThatSOBKenji	human
@trendthursday	human
@ElindaLie	unknown
@MtnMoxieGirl	human
@RoxysEZeats	org
@CoffeeBaconBks	unknown
@JKanyomoziFans	human
@manhattanbeer	org
@marashomemade	org
@BolthouseFarms	org
@TastefullyPaleo	human
@ahungryrunner	unknown
@m_kozuka	human
@Flamin_Redhead	human
@CharmaineKEY	human
@miotwitt	org
@BestDayBlogger	human
@CrossfitatFR	human
@Henrietta683A	human
@veronicawrlta	human
@HauteCuisineMx	org
@ThatcherMcGhees	org
@RoanesDogs	human
@Gooru2015	human
@YVRBCbro	human
@CameraniCabrera	org
@HEisNOTaxel	human
@LuisaTledo	unknown
@Yenlingttt	human
@HealthLoverz	human
@ChaptersCafeNI	org
@nikerwannawre	human
@CassialynAeker	human
@Chryss28	human
@thelandofkush	org
@dailylifeIM	org
@MarionQuintin1	unknown
@ShafinaPatel	human
@farhadtantra	human
@jennac2012	human
@Robuchon1	human
@TheHowff	org
@mirellaclark	unknown
@OKOldKinderhook	human
@GeminiMiityan	human
@beautyjunkie_hu	human
@dailyRx	org
@sigantengkalem	org
@monica_morgan	human
@ali_bidabadi	human
@sarra_atti	unknown
@27Terrence	human
@robb281	human
@Auragasum	unknown
@excalibur123456	human
@pochdpt	human
@sharon_inez	human
@aaronrthomasinc	human
@OKKinderhook	human
@rosemariemcg	human
@WayTHEGENTLE	human
@uk_dfz	unknown
@ontakara	human
@ntmsntm	unknown
@LasVegasChicas	org
@jmeteo	org
@xxde_illestxx	unknown
@LS_kashi	unknown
@ANDREWCHOW9	human
@flydrob	human
@zaatarwzeit	org
@_MyChers_	org
@CapellynMercer	human
@WyclyfAlbertina	human
@DreamSearchGo	org
@senseneast	human
@portercentral	org
@chewoutloud	human
@NaiNiWho	org
@tastemade	human
@jeff_mccallion	human
@StRegisBarGrill	org
@PepposSubs	org
@Lilmissmeatfree	human
@RickDoley	human
@emmachambers82	human
@BenejamenWself	human
@OpalDivines	org
@BrunnerCoulter	unknown
@AdriannAmorica	human
@shinji0516	human
@Hotellook	org
@BusyInBrooklyn	org
@porpoyz	human
@TableForTwoNYC	human
@Hook_n_Ladder	org
@mau_miyu	human
@DwiSyafiarti	human
@VeggieGalaxy	org
@RomilRatra	human
@sfs52002	human
@isamerose	unknown
@YokeChawalee	unknown
@truemadlove	org
@FeedingBig	human
@daleyandrew007	human
@Humble_Bella	human
@InThisRage	human
@CentralBakeryMx	human
@DHQLounge	human
@logogram_	org
@arvinklark	human
@argone69	human
@glutenfreegigi	org
@allforjury	human
@angiehoggett	human
@simmworksfamily	human
@AlannaNorkham	human
@barriejdavies	human
@krissariana	human
@RachelsBites	unknown
@JuliaSweetie2	human
@wenhua2015	human
@byctemecula	human
@MunderaMedia	human
@MargosEntries	human
@Bazinsonchurch	human
@Anthony_Assaker	human
@LayNaKim	unknown
@Pugliafashion	org
@XGDesignsNYC	org
@macacobleu	human
@NorinaWynnifred	human
@VisitBrkhaven	org
@yukki76	human
@COMOHotels	org
@M0rningNight	unknown
@Gastrologer	unknown
@kuku222	human
@EmMaria87	human
@WiloneKayley	human
@MyTOFD	human
@centralkitchen	org
@KishwerM	human
@quickstrike78	human
@kyukirin91	unknown
@myeasylunch	unknown
@TateMediaUk	org
@EnjoybyPaula	human
@BeanyGreen	org
@UrbanCowbeauTG	unknown
@DealOfTheDay48	human
@HawksNationYes	human
@anyonita	human
@Demon_BoaT	human
@Senso2010	org
@KrystenJai	human
@ParisienneNDog	human
@SoomFoods	org
@CoastPenticton	org
@goLadleVAN	human
@xeraphimz	human
@3KPMARKETING	human
@ofie23	org
@stma_a	unknown
@VanzKoh	human
@Deborahjoan56	human
@Amunayco32	human
@monicashaw	human
@WinteRReginO	org
@coriecam	human
@CameronDodd1	unknown
@RVASource	human
@pooo_11	human
@DECAdiaries	org
@JanniferAdamae	human
@CATHYMCGANN	human
@Nasty4Dawg	human
@VermouthTsao	org
@SupplementJ	human
@momorepublic	human
@SupremeSees	human
@JenellBStewart	human
@cendril2	human
@BeltranKnoll	unknown
@RelaxInOrlando	org
@AprilDesimone1	unknown
@italianlandaner	human
@Carl9sMonta	unknown
@DavidStanstead	unknown
@theminty	human
@Lia_OH	unknown
@UrprincessV	human
@KellysChoiceLLC	human
@katmalicsi	human
@betsyboo410	org
@Hecisdope	human
@nanZook	human
@OolaSF	org
@MangumLori1	unknown
@_ClassyChoco	human
@mserdemg	human
@BlendAbout	org
@ALovingMe	human
@TheArmyKernel	human
@Awesomeon20	human
@chinay_russel	human
@RetroFinn	human
@PiolaRosslyn	human
@ChefBCFromDC	human
@Mrs_OC	unknown
@jojoyuki	org
@bignoodlesfan	human
@AcademyRoadBIZ	human
@HeadOvr6inHeels	org
@RedChris74	human
@CuisineEnLocale	org
@JayChetawat	human
@TwoSeatTango	human
@BadBoii_W	org
@curlsnchard	human
@lavee_6	human
@MakikoEats	human
@ShinbashiRenn	human
@co__ri	org
@ohmyveggies	org
@ADailyDoseOfFit	human
@SherrillCoulter	unknown
@MissDissentEats	human
@orangecountygal	org
@1600BierHaus	org
@Alassiosv	human
@ggusstaaz	human
@BannerChandter	unknown
@artingraphics	human
@BestofSingapore	org
@bake_and_take	org
@anyanaele	unknown
@_sugarmountain	unknown
@gucci1017	unknown
@olocomesolodeja	human
@PiyapongPO	human
@ArArAvera	human
@DiannaBenez	human
@LaFromagerieUK	org
@pyrodamsel	human
@TheBigDinner	unknown
@BlissRelaxation	human
@suermoore	human
@yeoldekitchen	human
@jacky_with_a_Y	human
@dyschick	human
@ira_1123	human
@SheerLuxe	org
@HOLESANDHEARTS	human
@jdecurtins	human
@Ladybugfly	human
@notaleaf	human
@JeanettesHealth	human
@JohnPj	human
@9mahalle	human
@aashpazi	org
@dyanita95	unknown
@Jontsan	human
@babyvee11	human
@AvalonImg	org
@ejamsayang	human
@GreatEccPub	org
@istigazali	human
@ThePureKitchen1	human
@moneorange	org
@teaspionage	org
@SKEGAZObot	unknown
@farahsharihan	human
@bhcplive	human
@AzwanAzmiTweet	human
@micmic105	human
@WelshBiz	org
@ChilisIndia	org
@mccallsmandf	org
@jchaang	human
@BostonMA_USA	org
@glory_Betty	human
@definingdad	human
@tomkuu	human
@MelvinJohnLacia	human
@ExeterHampton	org
@GrainStoreKX	org
@IJust_LoveThis	human
@SartikaSMEunHae	human
@silverknight03	human
@HotelSK	org
@mekizo	human
@chengchen_k	human
@MarianeHardwick	human
@ChefDadisi	human
@AKBBOT2BOT	unknown
@DowntownLeth	human
@flatrockchris	org
@thequirkycarrot	human
@WaltherKrickl	human
@krystalnewbury	org
@SeleraKuliner	org
@portfonda	org
@wincent916	human
@shadeheights	org
@Auntmaryscookie	unknown
@VCHOSTRUCK	org
@banapplekitchen	org
@SurfHut_Destin	org
@NutritionCheck	human
@SHISHIMAI0113	human
@ChichaVancouver	org
@GAME_GOOROO	human
@IAteMontreal	human
@raygullon	human
@RachelKCarter	human
@wan_botak89	human
@TinyLovesMusic	human
@LauraBougourd	human
@HearDawn	org
@seapieparcel	human
@ChrisGODProject	human
@missgarko96	unknown
@harlemfoodlocal	org
@Zabardastwraps	org
@MissChocl8	human
@kleungsf	human
@cabinetrooms	org
@riemu5	human
@BarStLouisMo	human
@MelodiesMenus	unknown
@thenerd1134	human
@kittiemui	human
@AubrieDover	human
@AndraosBrian	human
@sbots	human
@MullinShorter	unknown
@phillygrub	human
@Amici205	org
@TheNewYorkBlvd	human
@OriginalPhilips	org
@sadieraeandco	org
@GerardoHz	human
@branchofmine	human
@joannatan76	human
@tGo2g0	human
@theadamsamuel	human
@lisalewiscomps	human
@danieljoes	human
@MichelleCFW	org
@RstaurantMrktng	human
@DanielRGuardia	unknown
@marniwasserman	org
@autospare_	human
@loolapchiit	unknown
@Angieebasta	human
@PersianKitchen	human
@iiTSMUNCHKiiN	human
@TheKitchenPrep	human
@Tracy198911	human
@harahetty3	human
@valentinswp	human
@Nicken_Chen	unknown
@JeSqueezeME	human
@momwhoneedswine	human
@Major_Woody_76	human
@BadDGoddess	human
@MisslovingGod	human
@adonmagazine	org
@chefitjesa	org
@stephysim	human
@hamm4	human
@Altraider	human
@AbigailNg	human
@kitty6462	unknown
@BisenietseMs	unknown
@wwforever	human
@purplelilpixie	human
@kissmybroccoli	human
@blogA	org
@AKBpicBOT	unknown
@DowntownBistroM	org
@healthboxldn	unknown
@CubataVSMojito	human
@samanthalauzon	human
@VegasE4LDeals	org
@AdyAdyva	human
@DeboSweetParis	human
@Le_Salone_Megu	human
@DNM_Sea_Dining	org
@s_kor	human
@kahhwaiii	org
@joyolsson	human
@StreetEatsEDM	org
@LouEllenAcker	human
@misiogatto	human
@irelandarthouse	human
@alaidrooos	human
@MaurosCafe	org
@CANCreationCafe	unknown
@tamitokyo	human
@Dinnerumacht	human
@JorgeSia_	human
@kusanagikeisuke	human
@HKTbot2	unknown
@Sunrisecafevb	org
@OsteriaLondon	human
@florkanal	human
@kerstin_ix	unknown
@motimotimotthin	human
@kilbrannan14	org
@itsmetonkaw	human
@aztekafrontera	human
@ChennaiTwEater	human
@Cylly_Twatz	human
@Sheelakilala	human
@yusrihm	human
@ChattDirectory	org
@hipsterfashion6	human
@adamdavidbirch	human
@CurvyHealthkick	human
@1810Restaurant	human
@MStreetKitchen	org
@Andreabellag	human
@DelimarketAA	human
@OhhFalafel	org
@Best_Reciipes	org
@megacevik	unknown
@WillowLindly	human
@SBloxham	human
@DailyEatsTampa	unknown
@prettymindy0121	human
@xAnnCherryx	org
@LagosFoodie	human
@PaulGHCL	human
@anttiiezgolffie	human
@HuxefordAcenna	human
@CenFina	human
@bluebluetopaz	unknown
@coolandsmart101	human
@EazyMoneyGMDS	human
@TheDailyOut	org
@megzzz	human
@JeniferOscar	unknown
@consueloblocker	human
@wyattandjones	org
@DearIgnazio	human
@styleandpaper	human
@foodieflower	org
@topofthemarc	human
@CampagneHillel	human
@NFoodielicious	human
@noot010	human
@IrisproCO	human
@siljoevsan	human
@GageEleanora	unknown
@BeyuCaffe	org
@MGirl83	human
@leeagasguang	human
@martinawardrobe	human
@OlivePaintsAlot	human
@CaramelKissATL	unknown
@DealOfTheDay44	human
@AMPopplewell	org
@yaoxizi	human
@kazbey	human
@kevinsoewondo	human
@DarkAngelTeresa	human
@jojobeanss	human
@HarrisRanchCA	org
@EstanCabigas	human
@MyDisorgnzdLife	human
@RonAsraff	unknown
@Nancy_White	org
@SharonPalmerRD	human
@DandyWellington	org
@pmichelleann	human
@Rawismyreligion	human
@ZambranoAlmeida	unknown
@konul_i	human
@pinqkub	human
@adriano25prata	human
@Charleys_health	human
@FragolaLimone	org
@LearyTraveler	org
@YogiJoshKenobi	human
@AngelwealthInc	org
@AngelaMahon	human
@FashionEcstasyT	org
@aya1spc5k10ve2	human
@MyLaundryStinks	human
@_sfab	human
@MariluLamenza	human
@FleurSeule	org
@icandicre8iv	unknown
@thistlehilltav	org
@Cri_OCa	org
@tcthesaxman	org
@coffee_affair	human
@IyanSommerset	human
@GustavoTrj	human
@LongNooyen	human
@DuncanBatchelor	human
@RadiusPizza	org
@GFyyc	human
@LISAxYS	human
@EVOscottsdale	org
@cheezinwie	human
@CarlisleFSP	org
@kiksVeganUK	human
@miami2vegas	unknown
@DEBIJOT	human
@1angelamoore	human
@Popcorn_Indiana	human
@armie1876	human
@anm__bot	unknown
@louiblake	human
@DeliceDeliCafe	org
@littleprettymes	human
@P0tat0head	human
@dellanjani_	human
@5riracha	human
@BBsATTheRiver	human
@StalkingDaBeat	org
@Tony_Gallo03	human
@Dragos_UBF	org
@AbbotAdam	human
@saorinrin421	human
@pahnun	human
@hobbysport_	human
@fitnessyaletown	human
@LittleBearLA	org
@NITECAPCOFFEE	org
@darylvickers	human
@unnaturalapp	org
@BghamRetweet	org
@ChellesBlog	human
@thekenshen	human
@JodelDeauna	org
@JennyDeLaPole	org
@Aliciapcooking	human
@chopsticks03	human
@SinfulNutrition	human
@MichaelDeane61	human
@vhezhang	human
@lostthenumbers	human
@bluecircleny	human
@IndraPr	org
@COCOLOCAFE	human
@brothajoseph	human
@rainie_backbone	org
@MO_LONDON	human
@itsanidealworld	human
@cxMm	human
@Vanity080Glam	unknown
@CandiceFoster20	human
@tchilders	human
@Kantarellrecept	org
@garx_bot	unknown
@sybaritewino	human
@karen_incognito	human
@perlengkapan_	human
@BoweryBay	org
@LovenRamos	human
@gooseberrypatch	org
@desuki90	human
@BrandonLeong97	org
@clairelung	org
@chupcaipng	human
@SolsDeliBham	org
@YellowDoorYYC	org
@IlCieloBH	org
@samuelchan32sc	human
@CrockinMoms	human
@ILoveBramhall	human
@BostoniaPublic	org
@Cristiastic	human
@picklesandsilk	human
@VaughanVarner	unknown
@CooksCounty	unknown
@AlainaBullock	human
@Deltalondon	org
@TheRisingSpoon	human
@mizumushikun	human
@ArianJersey	human
@3PTWKPeterFan	human
@jtmetal777	human
@healthifiedpath	human
@infini_dee247	human
@Notsofastfood	human
@candicemclean	human
@itzMzLORi	human
@notsotiny23	human
@Lacyann9	human
@VossGabriella1	unknown
@SammyGsTavern	human
@ETSTFoodTour	org
@MystieJ	human
@porterentps	human
@jun_jun_r	human
@lfongyee	human
@CoachAnaServin	human
@JenniferHarty	human
@NovelTeasBDS	org
@provinzkindchen	human
@BikersCafe	org
@Moxie_Moment	human
@SweetBrina	human
@beautyfoodtips	human
@CureSimple	org
@VideojugFood	unknown
@TheMeghanJones	human
@FineFoodCuisine	human
@kerisabe	human
@botchan1234	human
@rexck17	unknown
@nikki38mendez	human
@Bonnfoods	human
@bmerrymerry	human
@PiaWismar	human
@DelphiGreek	org
@piccoloistrione	human
@ZoomOnParis	org
@vinnadelapaz	human
@GamlinWH	human
@TheShipMalaysia	human
@kids_allergy	org
@zeppy_manchuni	human
@forkandflower	human
@LaCasita101	org
@robinvzq97	unknown
@NumeroUnity	human
@dinersdelightt	org
@picassocafe	org
@fatchick411	human
@1OfficialTip	human
@suomi0930	human
@WesleyPrichard	unknown
@kathychiu82	unknown
@PontSt01	unknown
@thomashaddock	human
@Testerfly	unknown
@suomafmai	human
@Eat_and_Think	org
@jepe51	unknown
@Tesszz	human
@androidloverabl	human
@RachellesJB	human
@rpdahlke	human
@TommiesMommy14	human
@sayoko1024	human
@FratellosSN1	org
@kwakamole21	human
@DeltaFRE	org
@carminesacco	org
@MaronyV	human
@MartasKitchen	human
@LouisChefworks	human
@iamgunti	human
@GetFruityBar	org
@kira_SN1235	human
@Bossiibiitch	human
@christinaorlova	human
@ArturoTll	human
@bot_busu_	unknown
@onchan51	human
@Sandwichman8	org
@DCRepatriate	unknown
@auliaahmad92	human
@AssadoWaterloo	org
@AMairwen	human
@aMMPh	human
@Sofia_Lundberg	human
@drinksfeedAR	human
@jeeyuh	human
@DefensiveFW	human
@edras_dy	human
@NicanorAmor	human
@HelpUsFind	human
@jo_stevi	human
@foodiemtfitness	human
@AKBQuizBot	unknown
@KangooClubDXB	org
@magenta_3	human
@Darcelita	human
@NpsEarn	human
@saikyoorest	unknown
@MattCaldi	human
@brianwong_	human
@perbankan_	human
@BestHomeRecipes	org
@RomeoVModel	human
@micheeleem	human
@InstaGosDuma	unknown
@cjunco	org
@ompsyram	human
@AjiaRicky	human
@lilbacitaverna	org
@KatieGlaysher	unknown
@LilyLippy	human
@Bring_theBeef	org
@KristianaBartho	human
@KikisdelaCreme	org
@mari_tokkari	human
@gabesurvives	human
@giuliatumi	human
@alexisrakovac	human
@RedStarYeast	org
@wkm_aya	human
@ExceptionalSD	human
@AskBartenders	human
@BlogsRelease	human
@paulineLBAZ	human
@taverner86	human
@leinadgnaw	human
@melissas_za	org
@WalulasLap	human
@KerrinGrosvenor	human
@MangiamoTruck	org
@PlugraButter	org
@MikielGatt	human
@ufania	human
@hayusugestia	human
@1MEDICAL2NEWS	human
@Alosrarestbh	org
@Piratemumsie	human
@aqua8co	org
@FGLemkova	human
@OpheVee	human
@JAYTHEBODY	human
@MKerr15	human
@fen_rrpp	human
@TheWorktop	human
@tinnedtoms	org
@JazzyJ_89	human
@iampinch	human
@AeriannaAethele	human
@Osinskys	org
@mini109_	human
@cecilia_304room	human
@sxs05	human
@azfaromarzZZ	human
@majchy46	human
@Kumigar	org
@YTV83	human
@DressCodeApp	org
@SonnyLamore	human
@themikeshap	org
@LeBlogDeChanty	human
@ThisWink	org
@LittleShadow91	human
@koiCafe_bot	org
@maineiacmakeup	org
@DCFoodScene	org
@leonography	human
@elijpn	human
@ChicoCrowd	org
@NinjaMommers	human
@hamletgarcia17	org
@ilpaninotondo	org
@Rent360	human
@marcuswareing	human
@averosh	human
@Semajjy	human
@My12Weeks	human
@JossimarJ	org
@osteriamamma	org
@Heinens	org
@MarialvaVR	human
@micheleficara	human
@anice44	unknown
@aaaholic777	unknown
@designica_	human
@adonisdajewel	human
@movipositivo	human
@MayraADiaz1	human
@Goodwriting2013	human
@rLBaEVCL7GtLfCV	unknown
@SazBarzani	human
@ulis_darama	unknown
@pascalinicheryl	human
@zombieBAM	human
@SecretsToReveal	human
@jeninesangel	human
@RebeccaTurnerRD	human
@WilmarieLynde	human
@ViVaBarKitchen	human
@gabiwatson86	human
@Mumun_ShinHaKyo	unknown
@ronak	org
@djbriancua	human
@lotusblossomnyc	human
@keopu	human
@brianlinca	human
@TableCrowd	org
@vejpn	human
@SeithWolsey	human
@HishamYahaya	human
@joelleriga	org
@isigzz	human
@bali_kuliner	human
@zhuningxin	human
@LG__fitness	org
@cecilialu	org
@ccm1997	human
@55Draught55nyc	org
@OrderInSA	org
@dreamsbeckmedia	unknown
@djhak	human
@lobstershack33	unknown
@imcelineabacan	unknown
@djprez1	human
@ZegelsAlkmaar	human
@wingyi1128	org
@lilkitchenyum	human
@TeachMeHwToIrry	org
@TheMarinaRest	org
@rubadapaula	human
@BettyCrocker	org
@TheHarpBoston	org
@PackHorsePub	org
@yousan12	human
@MCKitchenmiami	human
@SommInTheCity	human
@WhatTheForkBlog	human
@ShanaeThe1Jones	human
@LadyInRedBlog	human
@sparkzutamodel1	org
@melya_agustine	human
@RenukaNadkarni	unknown
@xsentertainment	human
@MSBO69	human
@redsomcom	human
@maha512	unknown
@rakhipatel	org
@ElMiradorMexRes	org
@yutoman531	org
@LetDatGirlCook	unknown
@jkong2quarts	human
@AudreyMarianne	human
@KarenDanczuk	human
@sparkstiles24	human
@Adhefernandez	human
@leomarmlejo	human
@kyon2robin	human
@Equinox10sr	org
@HaqeemNonsah	human
@RobFarrellNJ	human
@BarraRossaPHL	human
@10fresh_salads	human
@CanvasFoodsLA	org
@kev_setia	human
@pghpoboy	human
@GladstoneHotel	org
@lightliterature	unknown
@kimcheesal	human
@MarciaGouse	human
@FarmersMktCafe	human
@MandiCupCakes	human
@Joanna_soon	unknown
@DuquesneDining	org
@AddisJeorge	human
@Kiran_	human
@phtreats	org
@g8c2ctabogmailc	org
@davevidcab	human
@mausamnyc	org
@AllasYummyFood	human
@KakaAzraff	human
@Columbia4Lunch	org
@memyselfandDENN	unknown
@pandadococopan	human
@830amShanghai	human
@AlbertsTable	org
@viktorrocco	human
@ScottStauber	org
@wherejessate	org
@PureWaterSecre1	human
@skybarmanhattan	human
@HubertSZW	human
@enutn	human
@ValAtkinson	human
@THE_HIIT_COACH	unknown
@magsdeguzman	human
@MarylandGirl85	human
@valeryapple1406	human
@Chewee365	human
@hashtageat206	human
@lewisbryan	human
@Leekz_So_Swavey	org
@HarrietBabbage	human
@Adacadarebra	unknown
@Chef_JMonfaredi	human
@BigDaddysNYC	org
@Jerlyn	human
@TheMFShadow	human
@oldxtown	human
@A7D	org
@mitch758	human
@Barken2015	human
@stephsia	human
@_indianrecipe	org
@nutri4well	human
@bowtuckphoto	org
@nayuta110	human
@CastevenLimKHJB	human
@fakhrimumin	unknown
@glamobserver	org
@ericbingzhongli	unknown
@LuvBBV	human
@annyeonghaseyo0	human
@ExSloth	human
@suciona	human
@FitArmadillo	org
@KirlySueKitchen	human
@GardenPornUk	human
@rinoldi1	human
@IACJDMedia	human
@davidsbrasserie	human
@pamela_ybc	human
@LawStudentsWife	human
@culinarycalendr	human
@MuratoreManuela	human
@antjustcoolin	human
@kulinisbipolar	human
@joyflashlight	human
@susyQ_0307	org
@busabaeathai	human
@FieldIrishPub	human
@PIOLAMerida	human
@FernRhee	human
@AiraSantiago	human
@NehomarGil	human
@yukakohu	human
@NeelysBBQParlor	org
@ForneriaCantina	human
@TerryBloxham	human
@misstonic813	human
@alob_emman	human
@SuperSafeway	human
@the_tasty_bite	human
@TashaP4	human
@UnbornDesign	human
@CicciosCali	org
@janinebucks	human
@1KitchenStories	org
@Nonoka61	human
@soupconcochon	org
@tiffnarb	human
@WinchellHelea	human
@knumarti	human
@realjessnichols	human
@blackberrycooks	human
@DinahLombardi2	unknown
@tinktastic	human
@zoepi310	human
@Mayhematicness	unknown
@xfsddnh	human
@kimbuibui	human
@jjvirgin	org
@sarahh008	human
@malaaDONis	human
@eatdeliverdshef	unknown
@southsidepgh	human
@ZilliMedia	org
@takakozhao	human
@diningdishes	org
@familyfocusblog	org
@UrbanMktChicago	org
@Borage_cpt	unknown
@chanwise	human
@VildanYahni	org
@CMDPcomm	human
@nammura_project	human
@baris_demirel	org
@The_Gold_Rush	org
@DiBrunoBros	human
@IsaRaja_Loebis	human
@rstrawn	human
@DongwoonsBride	human
@lazydreamerpras	human
@DistancePlease	human
@HoneyChiles	human
@mihyon	human
@wellshire	org
@Mayeaux	human
@girlwithapuck	human
@DeadmanCheffing	human
@1sliceoflemon	human
@msdjaxn	human
@reinaaaa1328	unknown
@boizter	human
@DonatasFitness	unknown
@WatupButtercup1	org
@marinelRcruz	human
@onlyatfullers	org
@ragincajunhou	org
@modebezirkblog	human
@mayuko0808	human
@zhangyuan2014	unknown
@TCooperHullPics	human
@bcomingarealgrl	human
@boyenlng	human
@Man_freed	human
@PaillerAurore	human
@streetartselfie	unknown
@blascatering	human
@DADDYONYC	org
@richardsilver	human
@popeynpelec	human
@Thato_SGi	human
@billyhamlan	human
@GirasolLA	org
@clarabell_29	human
@hyun_liu	human
@Gourmet_For	human
@CASAYOGA	human
@nutrition_sol	org
@AbegailHarkus	human
@divathatateny	human
@360Magazine	human
@WDWRLD	human
@Tomssyka	org
@Miami_FoodPorn	human
@TajMahalHotel	human
@JohnnyNewnes	human
@CaptionThisFood	unknown
@PaoCaruso	human
@jubelnesia	human
@JessiCalamita	human
@MusicHackFest	human
@AlbiterBrian	human
@JuliaChou	human
@l2eiven	human
@Timanani	human
@bambooware	org
@CarlaJeffery93	human
@iLoVemoGGy	human
@elyseboonen	human
@N0r4J0	human
@MaRiAeXaL	human
@CaptainVie	human
@ldguru	org
@_michelleOnline	human
@Homemaderecept	human
@hungrybirdsdoha	human
@KC23Lapinid	human
@thomas_munk	human
@JumeiraRotana	human
@alexisangelus	human
@shavedheadmedia	human
@TravelnBeyond	human
@kleinewereldcur	org
@bkmontgomery	human
@blaueberg	unknown
@creatingsubstnc	human
@MigsMina	unknown
@VGestri	human
@LOVELY_MSJONES	org
@free2bfit360	human
@PimpYourGarden	human
@CitywalkDubai	human
@LolaBunnyWeeny	human
@nichiwisdom	human
@Soto_Lebanon	org
@5Magic_Words	human
@TheNutritionMom	org
@Fat2FitTwins	org
@ShashaAyob	human
@LKOysterette	human
@Rosiediscovers	org
@jesscorbinBKS	human
@chars_xxx	org
@McnabbWinfield	unknown
@TheCowWestfield	org
@7995st	unknown
@MisterSCollins	human
@rosemary629	human
@rafidahghani	human
@dlmiddleton	human
@kitchenchick123	org
@MixMyOwn	org
@Dr_Reginia	unknown
@MoylansBrewery	human
@STLTastingMenu	org
@HeatherLMcCurdy	human
@NationTowers	org
@MyLinhLu	human
@Ds_Tacos	org
@PutriEhara	human
@SunderlandGC	org
@eatliftfamily	human
@minitim	human
@StellaRossaDWN	unknown
@antonioeffe	human
@HRXblog	human
@salaonenine	org
@northernspyfood	org
@nicholasyeoh81	human
@tartrestaurant	human
@herzstuecke	unknown
@yungflyychick	unknown
@MariEleptic	human
@tofestivalcity	human
@lettysanchezv	unknown
@LynnKawa	human
@MarteHveem	human
@Lovetocookhlthy	human
@LeiffelBistrot	human
@MorinDolores1	unknown
@foodsisterhood	org
@SyanaCandy	human
@bonnieTastic	human
@AlsoKnownAsPhil	human
@akuulanputri	org
@pnclounge	human
@Divalicious_THM	human
@MadHungryWoman	org
@MelissaRapoport	human
@KnutsfordX	human
@SpiceDropsUK	org
@QueverenMadrid	human
@domkingston	human
@MuchoBurritoHQ	org
@eskitchen	org
@thehungrymouse	org
@Brasserie27	org
@gtunny2	human
@wild_coconut	human
@Mary_B_Happy	human
@nk_tsushin	unknown
@KrisLaurin	human
@m0529xxx	human
@StreetEatsLDN	org
@foodeur	org
@ScottBigman1	org
@RavenNewcastle	org
@kingside_ny	org
@HoangNguyen24	human
@victorsflosc	org
@adayinthebite	human
@amsterdambeer	org
@StevesEsteves	human
@OACltd	org
@oxwall	human
@xiqittina	human
@BenSulston	org
@saulangulo	human
@guruhnurcahyono	human
@AlvaroMorenoFue	human
@williamwwongso	human
@Chrisvilla9	human
@BertPadilla	human
@BBCincinnatiOH	org
@StMarkBurger	org
@susanlwp	unknown
@pferrell3	human
@Startisans	human
@kigigi13	human
@PeachValleyFL	org
@EtFashionFund	unknown
@CoupaCafe	org
@DFGrilleTampa	org
@da_loca_pina	human
@OmahaSteaks	org
@BudgetEpicurean	human
@mynajemima	human
@zepha66	org
@YotikaFitness	human
@Matrixity	org
@judithetadams	human
@Bennigans_LGV	org
@ShangriLaHotels	org
@EL_MUCARO	human
@EllenChiuTweets	human
@WelliDesserts	human
@WulfricLeonine	human
@BTooDC	org
@AutoAlleyOKC	org
@nekoneko5542	unknown
@holly_vanessa	unknown
@chicofruit	org
@crynlee	human
@McDonaldsLeb	org
@denywidjaja_17	human
@purple_snowdrop	unknown
@warriorlight	org
@RRC_CulEx	org
@TheRealChada	human
@natasha_allen	human
@PeachMyeonCandy	unknown
@tkofitatx	human
@satefan	org
@wicketsbargrill	org
@dsin	human
@crazykrist	human
@martinsaidthat	human
@lourdesdumes	human
@RadioIndeMexico	human
@darrenO_O	org
@eatdelicafe	org
@ChefShivGhosh	human
@sweetpaul	human
@AfifSalibi	human
@dadpreneurs	org
@Rick_OntheRocks	human
@zaticoy	human
@deklippelv	human
@bernbernny	human
@ai_pp_pe	human
@avekitchen	org
@UncleTomsBBQ	org
@KitchenCouture1	org
@SanowarFITNESS	org
@fitnewgirl	org
@MrDanielNguyen	human
@SallysMiddleNam	human
@thymeandagain	org
@LaCooquette	org
@Kenga22	human
@cinziasanna89	human
@Getleanlife	human
@HulaBayClub	org
@likemattieross	human
@puputnovrentia	org
@RileyLandPantry	org
@Omniyat_net	human
@LischenSpeaks	org
@Paul_A_Newman	unknown
@iBraiianTRB	human
@rising81	org
@Cookthelook	org
@ChanMcCarrick	human
@yuyufashionbook	human
@WisdomNorwyn	human
@bobchasf	org
@MBCOUAE	org
@pnjr11	human
@icefc88	unknown
@HotelArtsYYC	org
@angeliquejeni	unknown
@mealwhip	org
@novy_montemayor	human
@oonicc	org
@RickCarterRadio	org
@StandardBurger	org
@NDTVCooks	unknown
@Fancie	unknown
@GRK_Kitchen	human
@DanielleEvents	human
@Dion_Live	human
@rllong4o1	human
@cutedevilmeg	human
@kaylacheatwood	human
@katigwapa	human
@Sal_Lobos	human
@BeUtifulLaura	human
@springoohlala	human
@toffeelick	human
@abrabbit0125	human
@PaulaRAngeles	human
@AllInGoodThyme	human
@djkandy6	unknown
@kuekj	human
@seraphimrudy	org
@LutzValentine	unknown
@kitty1014	human
@AsiaMiard	org
@joyloveian	human
@reshipi_hyakka	unknown
@EastlondonIT	human
@amber_lee_rose	human
@hannahalehandra	human
@nael2000	human
@ludypaat	human
@IAmPrinceStefan	human
@ShahreenRahim	human
@BookedinChico	human
@ArabellaPrada	human
@Hopie_Avery	human
@joshua57ng	human
@PhoenixxMD	human
@pengperrylin	human
@kimmyalfaro	human
@Lina_Bunny_1002	human
@totallydublin	org
@karinnachsicht	unknown
@GenosGrille	org
@tonythetiger323	human
@xinyuan13	unknown
@noellesnotebook	human
@NYK_Events	org
@mancfoodie	human
@Valpakcoupons	human
@FoodWineThyme	org
@HappyappUS	human
@Bchic02	human
@JamesPotterEggs	human
@adlymn	human
@AtlasVTitan	unknown
@neko_ga_iinda	unknown
@DJExeQtive	human
@AtolAedd	human
@TIFFINRASOI	org
@jellyjosie	human
@cdpc23	human
@kchanelle	org
@MarconyNYC	org
@lunchdabbha	human
@FitKristinH	human
@VictoriaRodens	human
@I_am_Mikako	unknown
@healthylifenl	human
@Vintage_Rare	unknown
@CelinesCuisine	human
@SynthiaGreen	human
@CraeZy8	org
@CottonsHotel	org
@foodbodfood	org
@theblueshrimp	org
@WhiteHareJewel	human
@Banker_4_life	human
@nerjamap	human
@Juanalop86	human
@Joint_RedM	org
@nicoletanska	human
@FellowsDeborah	unknown
@Michelle_BLD	human
@PRESIDENTGAVINW	unknown
@HarlemTrends	org
@AiamJan	human
@emmalynnperry	human
@_Karen	human
@RelaxInAntigua	org
@AmandaSoper89	human
@liz_rogero	human
@JustCavalliClub	human
@muffinmyth	human
@marquesalinne	human
@yhamberger	unknown
@katooniverse	org
@ChaosRunning	human
@BheHae	org
@paulSpitts	human
@WorldCompanies	org
@thomasmurphy40	human
@Kat2Quarts	human
@joansalgeblake	human
@BiancaSpindler	human
@miamibytesblog	human
@CrazyBaker_Ldn	human
@MontgomerieDxb	org
@FindBoxes	human
@Dankogan89	human
@GeekInfoNow	human
@GoneVillageEat	org
@iwLwu	human
@paleorunnersg	human
@0206yurina	human
@strongtristan1	human
@iVinny	human
@KelseyLeah_RD	human
@dorohedoro	human
@restaurant_hoq	org
@DamianAlgaze	human
@tikichris	human
@mama_kitchen	human
@Stratorest	human
@kaylaskookinem	human
@MiamfromParis	org
@MoonriseHotel	org
@ALESSGIBAJA2	human
@tracyguida	human
@NeuvooHosAtl	org
@darla_carolina	human
@BrainBalanceGA	human
@maichan76	human
@fiza_ahmad	human
@Banane_Heureuse	org
@MummyFever	human
@PonorogoIdol	org
@KrollsDiner	org
@lollipop516	human
@heybeans	human
@DRUMRAGE09	unknown
@ElyshaKrupp	human
@kelli_cakes	unknown
@chd310	human
@NourishRDs	human
@TheDLNYC	org
@CultureTripTLV	org
@evaaakan	human
@EggSlutLA	human
@OBMG	human
@5873robtaylor	human
@IgersAbruzzo	human
@blue_sea45	unknown
@nelai0123	unknown
@FreedmensBar	org
@maryseeo	human
@impecam	human
@JimmieLilpr28	unknown
@illeyg_01	human
@Didiroula55	unknown
@Neysha78	human
@WindhamDarthmo	human
@CSHofood	human
@ldnfitnessguide	human
@yeeelverceles	org
@BurgundyLeeds	org
@AndrewDyble	human
@laxplorer	human
@BBabushka	human
@The_Red_Ring	org
@bomberypsi	org
@belgian_foodie	org
@IamDencio	human
@LiverpoolTweeta	human
@lushdeli	org
@CarloSays	human
@kenjitanoto	human
@JuiceRep	human
@ClaudiaCarturan	human
@nooraini19	human
@jinkikay	human
@lunchbot	org
@kojbfilms	org
@gotandameshi	org
@Casper_theGHOST	human
@JonAlloggio	human
@basicndelicious	human
@PiolaPlaya	org
@frandysahureka	human
@RevoRish	human
@TJsTwist	human
@ManUtdGram	human
@TheExtraPounds	org
@KakaPerseus_	human
@Lamplighter_Pub	org
@BoldskyKa	human
@DailyArtApp	org
@SanchLivingLife	human
@WordenFaye	human
@shikibon	human
@BridalNewsUk	human
@qatthekitty	human
@roosnun	human
@CurbingChaos	org
@thavibordee	human
@MuximaMuxima	org
@singo_vegan	human
@kanegal11	human
@DaMovieLover	org
@StLouis4Lunch	org
@saljun	human
@DMAW	human
@FoodHopeandLove	human
@piezbistro	org
@miss_dar_a_lie	human
@Primos_Condesa	human
@CelticCeliac	human
@MAYORrific	human
@nancyeljudge	human
@libertymarket	org
@97gisaT	human
@ForestHMarket	human
@AsitaPatel16	unknown
@cristinapina	human
@MrRapperGuy	human
@PrincessHouseCo	org
@iamAccounCHAN	org
@NV80GrillandBar	org
@isanghee	human
@HatchHomerton	org
@worthafork	org
@arvinchester	human
@Google_PPC_SEO	org
@aE_dARKER	org
@senseofsugar	org
@HotellerieLuxe	org
@yamagutibot1	org
@TheBumpercrop	unknown
@AbangOmar	human
@JoriWhitePR	human
@followdailymelt	org
@CaesarsSteak	org
@Stephanie_Oram	human
@besociallyaware	org
@AethelmaerOzzie	human
@TenyaMoravec	human
@ventanadelmarpv	human
@EroticCuriosity	org
@xoxkitchen	human
@rodneywroy2	human
@SarahMShaker	human
@dewiekadarmawan	human
@leesh_mellz	human
@laurabeth21	human
@CrimsonMei	human
@Oregano_EL	org
@sassymouthphoto	human
@AghazarM	human
@meliafresh	org
@HotelMontRoyal	human
@TainaBrown	human
@TasteBudsCardif	org
@brunchinbees	org
@evonneteo	human
@KeriGlassman	org
@3d_diner_	org
@mbmbusa	human
@LadyPetrangelia	human
@LMiami517	human
@tujawellness	human
@OvermyerBrian	human
@elcolordelasg	human
@chriselemos	human
@dressinparis	human
@TASTECulinary	human
@zagufashion	human
@inBANDUNGcity	unknown
@jmkapust	human
@jokuti	org
@jimmytheflorist	human
@torochobi	human
@NqbZhrm	human
@Stargirljen	human
@cherylandaya	human
@VinumEtc	unknown
@portdouglas	org
@MikkoUtecht	human
@djkingjames804	human
@bouffista	human
@bouncestyle1	human
@Organise_events	org
@inspiredinvestr	human
@priwziest	human
@xBubbles501x	human
@CatchaJob_us	org
@annlynn57	human
@MrFabulous915	human
@jevontanugraha	human
@kamonohashina	human
@cjkimdesign	human
@PrepperSilver	org
@jdwtweet	org
@MarLaElGhazal	org
@goodfoodAU	org
@Reuterdahl	human
@FirearmsQA	org
@YeahThatsKosher	human
@nenamazira	human
@ChiraChiras	human
@yumikabelle	human
@FeastingInHeels	org
@anasdesingshop	human
@soowincci	human
@PlatformBeers	org
@cafefirenze	org
@scribblesofval	unknown
@DetroitTalkRad	org
@dricmushroomm	human
@jelly_telly	human
@jokerj	human
@cupcake83	human
@ilvolofancrew	org
@LetterFromTahoe	human
@FrugalSwap	unknown
@melissakarras	human
@thecookspyjamas	org
@minxi1992	human
@marije9	human
@cookameal	human
@Phantomzon3	human
@CeeJayAbalos25	human
@thefitnut_	unknown
@constantwining	human
@wholeymomma	unknown
@michy25elle	org
@stephlolie	human
@ElenJohns	human
@iamgeorge13	human
@Sydney__Harper	unknown
@purelytwins	human
@nehpyh	human
@DenzelDavon	human
@waffletruck	human
@MealPlanMaven	org
@iTsMe_jmee	human
@HowardAhhon	human
@DowntownDayton	org
@sugarmoon1017	human
@YelpQueens	human
@paco39_114	org
@Racheyrox	unknown
@Lordavalo	human
@Saghie_Balcacer	human
@sarry2haaaaasan	unknown
@imaglife	human
@TornBardulf	human
@raymaulany	human
@MomCommunity	human
@LeePeiyang	human
@Lucca_mx	human
@weat28	unknown
@GabriEstLa	org
@Vamos_feli	human
@ooblar_blaroo	human
@SincerelySemhar	human
@ImMadraasi	human
@Short_Orders	unknown
@therealarfarina	org
@HisPlaceEatery	org
@jackmiller192	human
@VintageMacaroon	org
@MorganFabulous	human
@haylstormdanger	org
@momomomovie	human
@ChesterFoodPorn	org
@Silhouettetrend	human
@tomoconozaki	human
@taytaylovesreal	unknown
@Lawrenceengyk	human
@JeVeronique	human
@FoodLoveFreedom	human
@AjahAlburt	human
@JimsCountryEats	org
@sakasin_happy	human
@thestrawhut	org
@StGermainPR	org
@lovek0226	human
@SukiDragon	org
@adrystyle	human
@Erina1018	human
@maroochyRSL	org
@DDDDJYOU	human
@Bin14Hoboken	org
@msarilla	human
@FoodTripandMore	human
@RouxTampa	org
@Shadowfreak86	org
@HappyPoloka	human
@Gigolocalypse	unknown
@ciao_felicia	human
@thisirishguy	human
@Fe_kristanty	human
@cloudyypuff	human
@AMBERbean_sammy	human
@imm0rtality__	unknown
@kurtisleehermes	human
@robiwama	human
@bisbasfoods	human
@jhoivillamar	human
@Glabbergaster	org
@scottseton	human
@calabasheats	org
@ElementsWhistlr	human
@The_BlueCrab	org
@PerfectStashBag	org
@shoheyyamamoto	human
@UseSignalHouse	human
@Marlon_Ranilop	human
@gnutritionsavvy	human
@BJigg	unknown
@ixviixc	unknown
@vivaroosky	human
@mobileapps2013	human
@SlateWineBar	org
@krystal_babyxo	org
@NasiLemak_MCR	org
@themomjen	human
@juicy_plums	org
@Lisa15781	human
@lwvogue	human
@kumufatz	org
@inJAKARTAcity	org
@e124836	org
@kiddingcool	human
@gidget2121	human
@justine_911	human
@EveHandmade	human
@iam_kevdidit	org
@NaseemNb	human
@Bungalow9_Mum	org
@janesneakpeak	human
@foodmusiclife	org
@KellyAHomer	human
@Vinified_	human
@MIAstickfighter	human
@ladebrouillarde	human
@JoelBerumen67	human
@ProductivityTOP	unknown
@ChedosCafe	org
@AngieW0ng	human
@AvikoUK	org
@ScubaDiBaDude	human
@lmaydak	human
@a7md_a_7	human
@CookeryTO	org
@brunchspotting	org
@PitiJK	human
@EfraimRichard	human
@W0RK0UT	human
@theangrychef	human
@RafiHairDesign	human
@math38wan	human
@ikumi_md	org
@shootdelishness	human
@ohanaeartheagle	human
@docnolz	human
@seantcallahan	human
@LaurenDCooks	human
@izqrdo	human
@qbanB	org
@lisa74	human
@pednoiz	unknown
@Onlineskorr	unknown
@ForbiddenMeal	human
@eedgerley	human
@mybubbaandme	human
@shlee1418_i	human
@VerdeFoodTruck	org
@MaggsRahman	unknown
@nelehelen	human
@adayinthelalz	human
@asajikan	human
@shopwithelisab	human
@shoebliss25	human
@WINAANG	human
@milanosatavalon	org
@thelondonergirl	org
@TheErrieRimba	human
@teapodlondon	org
@SALOseries	human
@DixBonoan	human
@ck_toledo	human
@DrakeandMorgan	human
@s3d_a7med	human
@WholeHeavenly	human
@KarmanRD	org
@AllThatImEating	human
@krismongao	human
@mamiewatanabe	human
@nananecoko_73	human
@GobbyChef	human
@LowCarbZen	org
@jamescduliakas	human
@MommyMusings	human
@TorKw	human
@Rainata_Tjoa	human
@fifth_store	human
@thecandyburke	human
@TweetRwanda	human
@BeatCancer10	human
@ArtGateDesign	human
@WeEatStuff_STL	org
@TarianGreen1	human
@mrpeterelliot	org
@LoavesOnLong	org
@PeterSerrano888	human
@V_B_Boutique	human
@ElChivoNosara	org
@MegansCafe	org
@KimFaria	human
@RebelTrends	human
@hiplibertarian	unknown
@vivianwskwan	human
@booksumightwant	org
@lushlifepromo	unknown
@roxannunesz	org
@Qianathegoddess	human
@b_1an	human
@GeeksWhoEat	human
@SFMRadio	org
@B_AbdullahLee	human
@ikurasan0129	human
@imNATHinthemood	unknown
@pitfieldlondon	human
@_Bran_don	human
@catamorahall	human
@Brought2UbyMom	org
@Canderlyn	human
@hitchwriter	human
@SardiniaMiami	org
@Samingtonlobo	human
@CarolinaGal81	unknown
@kunikikuni	human
@tea42uk	unknown
@katnissnataliaa	human
@MattAngse	human
@apik_media	org
@OnTheGoOc	human
@BrunchDivasLV	human
@SametDincoz	human
@thaoism	org
@limejuniper	human
@ana054	human
@chris1012009	human
@Kylah_4	human
@NoBrainz420	human
@Pakjijay	unknown
@MaryanAryonna	human
@brixtonpound	org
@MartaWootton	human
@fabixfiliaggi	unknown
@e3f	human
@laurammarsh	human
@MelanieBoria	human
@Racxian	human
@JulietteWonderl	human
@StevenKK_Tan	unknown
@Johnsonville	human
@BritainIrelandR	human
@4442A	human
@EmmaRazak	human
@STEVE6560	org
@wulan501	unknown
@1313Main	org
@leonygustine	human
@yorkvillewfm	org
@alexgmoney	human
@rizal_ninodeale	human
@JulieNocella	human
@acmesmokedfish	human
@ZoomDaily	human
@DiCastellanos	human
@xLoveLucyLiux	human
@Village_Kiryu	human
@trattoriasapori	org
@eatatpalmieris	org
@ThomasDuxGrocer	human
@lupetto858	human
@atozfoodreviews	org
@mymomfriday	human
@chaosncookies	unknown
@tamavivatama	human
@type2db	unknown
@alsoajourno	human
@doaazaghloul	human
@dinneratthearts	org
@iamBLeah	human
@KatiePrentice2	unknown
@MysteriousND	unknown
@lavitaspuntini	org
@mvaldez2488	human
@ameliepietri	human
@HotelOT	org
@restguiden	human
@BronxPepe	human
@agilberht	human
@makeandtakes	org
@MichaelsonHo	unknown
@sheenobi	human
@Lyla7312	human
@burpees4bfast	human
@FoodNutriMag	org
@saladbarlady	org
@ritacschan	human
@JarKitchen	human
@DailyDoseGrill	org
@DAMNboiii8	human
@DCMETROAFRICANS	human
@DiablosLV	org
@madamerumiko	human
@Shubies	org
@antepdeyince	human
@kristykk	human
@funmom91	unknown
@catseyefotos	human
@catilin_me	unknown
@MetroHondaUnion	org
@Markizchozen	human
@tristanjchavez	unknown
@ReboExpresso	org
@BrineBarrel	human
@MomStart	human
@rosequito_joson	human
@ChengWeiYu	human
@BklynTavernTO	org
@Calibaby126	human
@RichardTMoody	human
@rmsazizul	org
@ziopasquy	human
@competitonbot	unknown
@nerinadinunzio	human
@meyTjong	human
@MyEyes45	human
@rachgalperin	human
@westoakvan	human
@elmirainstagram	human
@GoatKING	human
@BabaGhannoujDUR	human
@maikerumichael	human
@Likalottakeyz	human
@Ikkese94	org
@EsquireDaDon	human
@cucinagalileo	human
@SankaraKatering	human
@DocsWC	human
@chit_me	human
@ReserveOutAD	org
@JamesGannaban	human
@ftmlosingit	human
@bredle030	unknown
@thefoodhack	human
@KateGens	org
@PuertoAntilla	org
@scanway	org
@susan_tjhie	human
@Vana_Lucy	human
@RibRoom	human
@iammkeita	unknown
@DanczuksDeli	org
@nicomonogatari	unknown
@LawlorMedia	org
@BowersWampler	unknown
@MrHariCovert	org
@rezaolga88	unknown
@xx_aimin	human
@DC_Mjun	human
@nontuun	unknown
@AllyLoprete	human
@iheartLiezL	human
@thirdguevara	human
@aldomauri	org
@Joe_Jetson_25	human
@saetae26	unknown
@louloufrance	org
@nilanthamanjula	human
@erina517_s	human
@mableisme	unknown
@GloriaMbrkWz	human
@ifancyxo	human
@Chokk2	human
@McGettigansLK	org
@OZNERofficial	unknown
@aksita_fenich	unknown
@swkillamarshs21	human
@NoSupermarket	human
@GoodnessGuru	human
@jillanskie19	unknown
@shelbie1406	human
@noshthetruck	org
@javee86	unknown
@sera_19871118	human
@umigamieru_bot	org
@GochCo	human
@ljoe187gp	org
@ezu888	human
@LondonLoverUK	human
@MopedOnKrak	human
@janelle_yeexuan	human
@BurgerHouse41	org
@Gmaston	human
@sekiya_ramen	human
@WeePinchofSugar	org
@ZuWeeStore	org
@RiptidebytheBay	human
@HallfritaZayne	human
@teenagewanderer	org
@trainwithjc	human
@NutsRT	human
@EdotTheDon	org
@sexy_gravy	human
@cheshire_tweets	org
@paolobee	human
@breakfast	org
@Eileen811218	unknown
@MattehPee	org
@old_queens_head	org
@ToldOverBrunch	human
@BebeLoveOkazu	human
@ShayShay812	human
@DeiwghtPShow	human
@Linus_Miranda	human
@INivysHEAD	human
@NagoyaYom	human
@Clever_Cooking	unknown
@BarWarriors	org
@xamBoo	human
@AJakubovski	human
@AperiTivoNYC	org
@RacksBristol	org
@hotvideogb	human
@niiils0421	human
@julieako	human
@MrProjectM	human
@VeganFitnessCom	human
@gaceri	human
@SitstillMonkeys	human
@fad_kulis88cute	human
@juliembd	human
@cmb1112	human
@sjm9095	unknown
@skylondon60	human
@MamieTaylors	org
@as_365	human
@leo_aloi	human
@puddinghup	human
@MuscleFitness3	org
@Mizz_Sayre	unknown
@MiltonRebeiro	human
@HKKustoms	org
@He_SheEatClean	human
@eventCERDAS	human
@bistrolabonCLT	org
@ASOS_Alisha	human
@FitFoodieMama	human
@SntiDiaz	unknown
@PaolaVenanzio	human
@TerpsichoreGA	unknown
@CherylAdorablee	human
@MiracleHappy199	human
@ChristopherLe17	human
@healthynibbles1	org
@VodkaNewz	org
@georgette_81	unknown
@WaypointCafe	org
@IsabelCantina	org
@Fadly_Fharaell	unknown
@HappyWife2014	human
@BestinHouston	org
@RebeccaRouhani	human
@GringoSTL	human
@haruructh	human
@ByWardMarketBIA	human
@annieschiswick	human
@we_heyheyho	human
@misslynette	org
@Caligraphy215	human
@Automne_	org
@chefshayna	org
@CurioGastro	human
@KeeleyMcG	org
@tatstruck	org
@Stina1010	human
@GFAcoffee	org
@yida88	human
@walkingtarts	human
@ikanouve	human
@sarwendah29	org
@BuddhaBarLondon	org
@coffeeckecardio	human
@GriguolBrenton	human
@99throses	human
@PriscKillah	org
@mychefkiki	org
@cinnamonsnapers	human
@ChloeAndYou	human
@funassitubuyaki	unknown
@L_Appartelier	unknown
@Beyond_Milk	org
@Platanos_Plz	human
@DineMarket	org
@pushpz	human
@TomorrowsMoment	unknown
@Teay_naka	human
@d7L77	human
@JackH4	human
@wilde_borj	unknown
@jomel86	human
@cheriecity	human
@Celsius1414	human
@TucciTucciPrada	human
@chiquitaaa88	unknown
@fatlittlebuddha	human
@supernupurnyc	human
@nathan__1990	human
@Veggiesgourmet	org
@YhenRicaplaza	human
@larsarvids	human
@missjacyln	org
@Ajbomb	human
@JPUnplugged	human
@BloomingMolly	human
@CollineDax	human
@sandwicheese_ph	human
@Koodzie	human
@ms_kmo	human
@ypdc	human
@theparishouse	human
@renh77	org
@Natalie1Thomson	human
@NeFerro	human
@Dior_Jones	human
@arybackova	org
@langernutrition	org
@celinefanonline	human
@mimipie	human
@AtlanticaHfx	org
@Missty125	human
@DizzysDiners	org
@dananwahyu	human
@WorkingMomin20s	human
@Harder_Erection	human
@TheGanderNYC	org
@bumpkinlondon	org
@SunInBloom	org
@aivows	human
@teejorg	human
@LaCasaBistro	human
@vancwi1128	human
@gothgourmande	org
@magicb77	org
@EzdanMall	org
@thenardcast	human
@Missycalb	human
@CatchAndCarry	org
@cochonvolant_	org
@ArohaIbrahim	unknown
@Cris_Grandi	human
@ilovegottinonyc	org
@CFAStafford	org
@MealMakeovrMoms	org
@aadvark	human
@snoske	org
@CheeseMTBot	org
@prettywaen	human
@anboulware	human
@ZbigniewPawlak2	human
@MissShirleys	org
@NickMunier	org
@sacollins3	human
@grancaffelondra	org
@iambrentemerson	human
@aZZed	human
@studio987	human
@KatrinaLoop	org
@KariStuart	human
@SightSoundRead	human
@Christine_M1	human
@BigWaveBurritos	org
@mike_newshoes	org
@TOWingFestival	org
@DisisMrC	org
@poohkie0502	unknown
@IVONNEHZ	org
@lisawellcoach	unknown
@fashionful	human
@jackjackattacks	human
@VLtoronto	human
@Uwn6chW62CuGrGL	unknown
@ChuckPagharion	org
@MinervaHorio	human
@SmokersMatch	org
@Vanity4TheVein	human
@Smok3mim	human
@obaykaner	human
@JoshFentey	human
@Tery_PeP	org
@marbig662kenshi	human
@Arrabbiata_vonP	org
@GolfitIt	human
@LodgeCastIron	org
@CapellaSIN	human
@chizu0611	human
@westgatehotel	org
@zumKochen	human
@Bear_and_Bean	human
@Kalxyn	unknown
@RitaHCobbs	human
@hail2you_cameo	human
@tea_nj	human
@EmpressShuby	unknown
@ZofiaWieczorek	human
@OopsCafeyum	unknown
@inthelighturns	org
@plumtreecafebar	human
@ChrisADroguett	human
@ursula_9	human
@kitchen_js	human
@indraPRGroup	org
@shutupandeatMTL	org
@VealityScoop	unknown
@SalinaBeaudoin	human
@SanchoVanRyan	human
@MoKNYC6	human
@stateofharzie	org
@HiveBeachCafe	org
@devikambing	org
@TomKime	org
@bestofthislife	human
@TasmanianFood	human
@Zoeeyy00	human
@GoshDarnGood2	org
@topeattitude	human
@liisa_liisa63	human
@SuemyLpz	human
@pennymor26	human
@LizWeiss	org
@cachanisa	human
@BenissimoOils	org
@iHustle8o8	human
@gabyanes	human
@brookemackmusic	human
@LaKtaSoY	human
@ripecuisine	org
@AmelieBuhr	org
@eatfeastly	org
@GabbysQuilts	human
@emitaro2010	human
@branchfood	org
@grub_club	human
@ThreeBlindMice6	org
@BiljanaLeone	human
@DJWAKEUP305	org
@TheVidaVida	human
@apstyle	org
@beccawilliams95	unknown
@3p4fishwharf	org
@BettyRuzickova	human
@jsaphier86	human
@thesteakbar	human
@supercherish	human
@charmcitycook	org
@thebaconjams	org
@__justbeingme_	human
@lux_traveller	human
@cookingandbeer	human
@martinacarolo	human
@lik3_a_pearl	human
@Disc0liz	human
@DineVaranese	human
@aidanscanlan	human
@hanasitai_shinr	unknown
@kiyo616	human
@peonytail	human
@pawichoy	human
@CooknParty	org
@LondonKiwiEmma	human
@chEfvanmf	org
@meah06	human
@getbonedbroth	unknown
@_jfleeve	human
@ChefSalisbury	org
@GF_Delights	org
@therealkikij360	org
@therandolphnyc	human
@alenjohnf	human
@Resto_LeSamuel	org
@CityChickDining	org
@1KlazzyDiva	human
@AngelPistachio	human
@HulyaSenlik	human
@Lucaincam	human
@ourfavstyle	org
@AvenueStJames	org
@mnm_clubot	human
@SilviaBortignon	org
@janengui87	human
@Ms_Stylistik	human
@koreankitkat	org
@meerashah	human
@kelmayoralgo	human
@newinnharborne	org
@7201210	human
@FMFBlogger	human
@missdatuin	unknown
@camimaiucci	unknown
@ChooseChicago	org
@karleeeeeng	human
@dscaturchio	human
@chinahutch82718	org
@EliLewisXXX	human
@Monzerack	human
@Maybellinelim	human
@not_debbie	human
@AjaranKenyotah	human
@kristin_chen	human
@HamburgeseriaRM	human
@SonyaDLoca	human
@miyomisteriosa	human
@BettyBakeBlog	human
@hotelsdelmundo	unknown
@ScotlandEatsOut	human
@joniiiie	human
@lafetechic	org
@chinswimmer157	human
@michelemoricci	human
@Estefania_miu	human
@kokushokuwari	unknown
@Misticolls	human
@YummyStuffGoesH	human
@beaumontslj	org
@Adri_Navalon	human
@randyanto	human
@mmyellowhk	human
@justinxxi	human
@WholyCheesus	org
@MaggieLim	human
@RepublicaPlace	human
@ChrisHummel	org
@McGettigansGWY	human
@MrTIMtastic	human
@HazellBrown1	human
@jp_tazmania007	unknown
@PizzaRustica	org
@ghamks0z	human
@pepeskitchen	org
@AimlessMoments	human
@juancmanteca	org
@kumakuma13ayumu	human
@IAMKNUCLEHEAD	human
@sassiJams	human
@Schlagergarage	human
@hungryvancouver	human
@VocalSearch	org
@Markkimac	human
@to_never	human
@Jets0000797	unknown
@lanch_tsushin	human
@inheadkay	human
@thegetfitdiva	human
@puttu09	human
@alwayswinner786	org
@hot4tennis	org
@sarahallynbauer	human
@cortonatuscany	human
@SilvermistFood	human
@BeaTarizzo	org
@Snack_Xpress	unknown
@Charlene_Garth	human
@goreobssesed	unknown
@ShaJenPR	human
@SNSalgado	human
@BlueprintCafe	org
@PerlediSoia	human
@GadgetFreak4U	org
@freakveggie	human
@QatarHappening	org
@ImpalaDC	org
@MikeSportsmedia	human
@mausekindmom	human
@GR_Winona	human
@tonylook95	human
@wsfarmersmarket	org
@leongjiahao91	human
@GraceManning	human
@InfoMumbai	org
@vicvicthomas	org
@BriteandBubbly	human
@LaComidaDeClary	human
@NACmayfair	org
@KateAloeLife	human
@Mootsinkahoots	org
@OrkhanGuluzade	org
@OfficServe	org
@MsChris1221	human
@im_yelling	human
@annaschiele	human
@DressToFete	human
@stream_organic	unknown
@ArtisiaStarlght	human
@geraldhallsf	human
@ck_legacy	human
@FairmontRYH	org
@PiquantNY	org
@jmmferraz	human
@Sufrati	org
@HolliesSteak	human
@KihnElwin	human
@CHScuisine	human
@shmaizey	human
@LexiHenegar	org
@van1136	human
@Gareth245	human
@PKsStatenIsland	org
@TopgolfAllen	org
@JudgeandJury	org
@MySweetSanity	human
@lizcelineb	human
@YoHobbyEdin	org
@jamchups	unknown
@thriftyshops	human
@lasalagibraltar	org
@SuzieLovesFood	human
@FizzyCitrusy	human
@pantagis	human
@JimboWhen	org
@djmikemasa	org
@jeneomeVoid	human
@MtlBrunch	human
@nomnomclubcom	human
@Just1Shei	human
@ShopSaveSequins	human
@MomOnTimeout	human
@Chef_bailey	org
@GroveSpot	org
@PinaCocoblog	human
@melvin522	human
@ElaineSP_Ho	human
@Faro000o7h	human
@zzzAxBxzzz	human
@MalinaSawicka	human
@Fotofeee	human
@PrichardBryan	unknown
@PhilippinesLUV	unknown
@Randalljr11_	org
@hdiskyway	org
@ginawilms	human
@NkanyeziKubheka	org
@AmzarLegend87	human
@surfnux	human
@BetsyRamirezRD	human
@305Neptune	org
@Amaya_Fitness	human
@ChucksBBQDarien	org
@femshaper	human
@yaniyummy	unknown
@Stilettoes_Diva	org
@BassManQuick	human
@buddybatch	human
@TinyEdiy	human
@dgrreen	human
@ioannouroi	human
@NIKKINEU	human
@foodbyphonebkk	org
@NoddyDazed	human
@Jonnydoesdinner	human
@MMCKuwait	human
@McisawNowakowsk	human
@guiibh	human
@mighty_duckie	human
@iamjillcook	human
@KaifengKosher	org
@Beforesunsetmon	human
@shutter_gee	unknown
@kosherstreet	human
@CAReyes125	human
@AlejMLara	human
@HerreraUniverse	human
@hotrecipeco	org
@alice1227now	human
@alwysmaggie	human
@maxinefbrooks	human
@alreadytaken218	human
@rescueranjazz	human
@nilnutk	human
@jimmy23352550	human
@singitabeach	human
@HiltonHotelFans	org
@princess_lilbit	human
@ArtsMalveda	human
@MarcelleChow	human
@jonapotkivanok8	human
@alohameisha	org
@EntertainEasily	human
@odambrowski	human
@JasonPanggg	human
@HellaTan	human
@FreddyJ_23	human
@PopArtDiva	org
@BerrinYigit	human
@SpiceMarketNYC	org
@JaniceFion	human
@MPSellsDoral	human
@deveresdavis	human
@aberdeenklein	human
@herheartland	human
@OceanSurfHydro	org
@juliamayko	human
@charmy_stl	human
@Tatianac_30	unknown
@plymouthcanteen	org
@HotBoxLDN	org
@tianm122	human
@LifestyleSoul	human
@ShellZero	human
@JohnPatrick_101	human
@youterni	org
@Angela_RamirezG	human
@yus0dakine	unknown
@rafaela_fdias	org
@DivaQBBQ	human
@redjennifer2	human
@BairdsonB	org
@SmittenChicken	human
@Glen_Ring	human
@TheTradesHub	org
@StephakaFrenchi	human
@Richard_Chan90	human
@SnackK_Wing	unknown
@Portuguesecook	org
@TheMindfulMango	org
@CauseMusicIs	human
@rawtransition	unknown
@kotashibazaki	human
@Beau_Wine_Tours	org
@Sarra_BenAmmar	human
@melissaswaffles	org
@JenniferMV13	human
@myfoodhunt	human
@rolipop_mam	human
@Omurices	human
@YukonAKAJack	human
@KathiLittwin	human
@CookTrainEatRce	human
@Engie25	unknown
@redsoxferris	human
@inYOGYAKARTA	unknown
@JohnJabaso	unknown
@RolondaWatts	human
@JoesKitchenAus	human
@VcareMKT	human
@bandrainfo	org
@primadonnafaye	human
@YOGUE	human
@ierephaan1	human
@hellyesmakeup	human
@OracleLeeds	org
@Stylisoulstar	human
@MikeEstacio	human
@bbcoachmichele	human
@Rarisaxx	human
@TheBake_House	human
@davidloo0129	human
@bassbiz	human
@GPZY	human
@LPQIN	org
@JandyJean	human
@chikako_724	human
@SoupSpoonCafe	org
@gordo08_	human
@zackylicious83	human
@jhezper	human
@younggogi	human
@stefani_emily_c	human
@JimmyDean	human
@mrWAYNE17	human
@sensitivemommy	human
@fanyshoulders	unknown
@PiquantHydePark	org
@BecomingMrsKim	unknown
@JennieBRUTAL	human
@Stuffology101	human
@BuckHotel	human
@botineee	human
@1331york	org
@2850Restaurant	org
@SloanSquareMI	human
@SedefUlufer	human
@TBYCONCEPT	human
@FergiesBites	human
@Anything4MyCat	org
@CrispyLens	human
@thetwistediron	org
@Flyjmd76	human
@ViduraCollin	org
@StephanyShanah1	unknown
@marcgarreffa	human
@chermaz	org
@chrisvaeth	human
@Malik4Fareeha	human
@KouzinaBistro	org
@BethStarkRDN	human
@Sale_Andrea	human
@AllisonFoat	org
@DaCienfu	human
@LisaMajella	human
@CurryUpCafe	human
@LESMARCHESCLUB	human
@Jinqle	human
@CafePontotoc	human
@LeoWrightEagle	human
@AjhaFrideswide	human
@Thunder102	org
@CairnsRSLClub	org
@BrunoFrenchs	human
@GemCoffeeLounge	org
@MercaditoRR	org
@MoehNykomentia	human
@aegishealthfood	org
@Kensington_BIA	human
@TrattoriaDaAnto	human
@artistic_ange	human
@ThisBeezie	unknown
@liquidmarmalade	org
@LorenCricket	human
@YesHotelsGroup	org
@cubist160	human
@MiteshKatakiya	unknown
@sayaka401	human
@Nurserydreams	human
@Bellmont_	org
@LaMexicanaCanti	org
@ESPY1124	human
@kentclint	human
@keyingredient	org
@Luminarcintl	org
@foodtravelblog	human
@SOHO_Coffee_Co	org
@ThePennyNYC	org
@Cupoint	human
@NahidsFavorites	human
@chiftf_600w	org
@RamoRozalinda	unknown
@Jeannyfer_Tan	human
@MarioPhillips	human
@under5foot_za	org
@iamhorhe	human
@JMauboy	human
@iamvonhawk	org
@TemptationsMA	org
@1LombardStreet	org
@momsbistro	org
@WoodvilleBanan	human
@elkepalmaers	human
@burgerak	org
@JustBatterUp	human
@ssavvyliving	human
@KRYSxxxSTELLE_	unknown
@RecipesRt	human
@stupidwolverine	human
@TherezH	human
@VillageGMarket	org
@BlackNLA	human
@MBigshoes	human
@RyderMast	unknown
@LilianaNavarra	human
@mailovejeje	human
@BennysTacos	org
@drwigginsjr	human
@loveslicking	unknown
@CafeBolton	org
@sirjonesmag	human
@Giritto	org
@TheMarketByJen	human
@DaidoBe	human
@Fabmeenne	unknown
@2SPNewark	org
@antoninaparker	human
@KerryBerquist	human
@jackray34	unknown
@BlueBearWood	human
@KA2HZO	org
@MikeyFUCKINGpee	org
@JaceeAvon	human
@AI48676190	human
@MarinaT1982	human
@lindseybbridges	human
@VirgoVj	human
@corponaldi	org
@AmyBakesHealthy	human
@singww	human
@DCgal62	human
@CriticChef	org
@vallensev	human
@CrafthouseNY	human
@jay_coool	human
@ame_no_i_o	human
@ellysa_fashion	human
@ericaaxelsson	human
@islands_pizza	human
@chayoPerez_	human
@verokitchenrd	human
@grafton02138	org
@HungryChronicle	human
@al_haqi	human
@deegerwiilen	human
@C4enterprise	org
@MarikadeVienne	org
@CATRINASCOCINA	unknown
@TweetLikeScottF	org
@PlateLsOrdinary	org
@FoodAbhi	org
@LOSTWAXSTUDIO	org
@Charrafty	human
@spicec	unknown
@jabsplethora	human
@JennyBeanCafe	org
@cecimeza8D	human
@solinogroup	human
@JordanCascata	human
@ManyMaleMen	human
@morrisonpubla	org
@cafechismosa	org
@mary_riani	human
@MariaLifeFood	human
@bmagcarang	human
@Naples_Shulas	human
@annodle	human
@MaiMagic	human
@maximcatz	human
@nomadicfitfoodi	org
@Gliesperimenti	unknown
@rochkirstin	human
@iamsuperJDee	human
@ADollopOfMe	human
@chapebolso	human
@polarzbearz	human
@JohiReal	human
@HistoryBeauty	human
@BistroPierre	org
@_mslbreezy	human
@FoodieDateNight	human
@pOp_booth	unknown
@eastdulwichchef	org
@ChasingJonas	human
@thepantryman	org
@TKRaleigh	human
@proanamystic	unknown
@NajwaRosealia	human
@techmb8	human
@LouisandraGan	unknown
@daisie_whoopsie	human
@TajBrusola	human
@withclee	human
@retweetjava	human
@tacham05	human
@ManonPavelich	human
@SpicyJessica	human
@TopTravelRates	human
@Chanellangford	human
@KEDAIPAKBEJO	human
@fioladc	org
@Taste_of_Nature	org
@FoodstyleCoach	human
@OSereni	org
@LaPiqueAssiette	human
@shoreditchtrust	org
@janzeebabyy	unknown
@HooperPritchett	unknown
@mahati_tati	human
@wisyealexa	human
@SearsFineFoodSF	org
@xavierzb	human
@RitaMistry	human
@DrinksfromWales	org
@JermaineRyan527	human
@rsims24seven	human
@714dave	human
@manosioa	org
@Im_jeeZan	human
@070guy	human
@mayoxmayonxdoll	human
@guildford_mina	org
@CMLayton88	human
@sparklequeenuk	human
@NY_Places	human
@ZaiZayfrell	human
@nightlynibbles	org
@CaboFlatsDelray	org
@kumaya77	human
@BigSlickPGH	human
@paulamedlands	human
@EatBrownBag	org
@MalaysianFood	org
@CardiffLovers	human
@artistbeckmedia	unknown
@PascalsonPonce	org
@louisclaparols	human
@Zialleer	human
@SchoolYardStyle	human
@reikokiyono	org
@abbey_bell	org
@MoneyMailerMD	org
@TheChickenTruck	human
@Taneighsha	human
@OldBengalBar	org
@Breakfast4Champ	human
@DishingDelish	org
@the_cakebunny	human
@Follow_The_Food	org
@Rob2563	org
@nakedhighway	org
@omeng_dvr21	human
@victorpurnomo	human
@princesscowboys	human
@Jachang08	human
@Saucerockboyfed	human
@AThriftyTable	org
@ChrystinaZavrin	human
@thehalfcutcook	human
@VGallacci	human
@AnyStuffOnline	unknown
@SolihullReTweet	org
@intira3213	human
@Toffeepiglet	human
@joejoetill	human
@mokodompits	unknown
@BecciStrange	human
@GoldieChan	org
@DDPoultry	org
@CharruaBistro	org
@a_foodgeek	human
@superflysal	human
@dsorah	human
@MharkRhyan	human
@NYNYVegas	org
@karunaQ	org
@atypicalhuiyi	unknown
@SugarlessBrunch	human
@durrahkhazalle	human
@fe051	unknown
@rica_ricaa	human
@kaldon84	human
@LawrenceHnyc	human
@celinaleneindre	human
@KraylFunch	org
@adina_kelman	human
@McGettigansLM	human
@Elerocca	org
@VIprincess_b76	human
@asrashakoor	org
@Kayla_Sherman22	unknown
@SingerFood	human
@Seirayoshida312	human
@LouiseLewis85	human
@meechharris	human
@fermizzle323	org
@keep_going_hard	human
@PaperBoyParis	human
@feedmepronto	org
@EsperantoNY	org
@azaiberry	human
@MalibuDinerNYC	org
@oomphcoffee	org
@ittybittyfoodie	org
@neptunosRD	org
@MilenaLazzaroni	human
@joshie0801	human
@DietDelightBH	human
@Brandykaystarr	org
@laceybaier	human
@Isidra_Cebu	org
@Weege001	human
@Sherzy_G	human
@ChozaTaqueria	org
@faithismysight	human
@LoveLaneKitchen	human
@angelalinda604	human
@Mrs_Milnes	human
@mr__oliver	unknown
@Fancyfactory_it	org
@_TheLuvlyNay	human
@ElmStGrill	org
@CoolTonyTweets	human
@theharbourdiner	org
@2write4health	human
@josjm93	human
@HamamaOussama	human
@PlacesinFrance	human
@jcac1927	org
@WoodyElvie	unknown
@hotelmadero	org
@giuliac92	human
@mondevilliers89	human
@VisitLK	org
@healthysam	unknown
@FisheyBizATX	human
@maryfarquhar	human
@OWBakery	org
@flyGAGA0817	human
@vinylcupcake	human
@CAFEMIRANDA	org
@eMazingChicago	human
@GBoardwalk	org
@OswaldRichmond	unknown
@ThePullmanKitch	org
@socalsonibs	human
@paulwreynolds	human
@TastyHealthyNow	org
@iam_ruthie_md	human
@dizzydelila	human
@GoWinNutrition	human
@Life_and_fruit	human
@MariiaTeresaa06	human
@ChalkPointNYC	human
@RoHare246	human
@gelytayz	human
@travelqueen23	human
@mommacansing	human
@iamnishi1	human
@ETGoesPlaces	human
@MsKungfuBokchoy	human
@framboise_ginu	human
@muscatman4	human
@yodoo307	org
@wizardxp	human
@CarolinaAlfaiat	human
@michael_stamper	human
@cwilsonphoto	human
@angelicbakehse	org
@ferraznicole	human
@creatorbekmedia	unknown
@cardifftweetbot	human
@EHsandwich	human
@HotelNikopolis	org
@shingo4549	human
@winechix	human
@GorGraew	org
@JoeFortesVan	human
@CallMeMovid	human
@Anya0423	human
@desayunoideal2	human
@NoChillMan	human
@corohichang	human
@hoteatscoolread	human
@LesHallesParkAv	org
@Cri_Ciuffina	human
@FranksDad100	human
@manofsteel83	human
@FedericosClub	human
@treefullofscone	human
@sumirehana013	human
@clarendonnights	human
@SheilaBenl	human
@elenatravel	human
@Broadway_Mkt	org
@alacartekitchen	human
@xx_thereseaopie	org
@iamcarlomallari	human
@Helsalonika	human
@ivansaputra_a	human
@SakuranScream09	org
@nyfoodiefamily	org
@s2cohc	human
@FindRecipes_	org
@ugly_bbq	org
@actressmbonilla	human
@MarissaVicario	human
@PretzelCrisps	human
@BagatelleNYC	human
@TotallyME_davis	human
@luchaliverpool	org
@anthonymerchak	human
@pancakeparlour	org
@xl681V1	unknown
@WestSteak	org
@jpdromina	human
@theyoopergirl	human
@Dom_mano	human
@jouyouheki	human
@legendapcy93	human
@TranslateBar	org
@strickygirl	human
@tweetsbytracey	human
@GiftzyRx	human
@gourmetproject_	unknown
@Otoehija	human
@TheSaltyDogSker	org
@Enterprisefoods	human
@Donner0	human
@vykwhrdjksndy	human
@MandiJMusic	human
@_aSh28_	human
@ngtyk	human
@CurbsideBites	org
@EatPrayLondon	human
@sarahsmiles2105	human
@bass_tuner	org
@KenichiAustin	human
@ESPLJxn	human
@hazespore	org
@mihyanga	org
@DeepFork	org
@mi_sangre	human
@HolleyAdram	human
@CandySmitty	unknown
@tablefortwoblog	human
@VisionPhotoBTL	org
@bedfordhallbk	human
@CrystalandComp	human
@kimberley_hotel	human
@jazeerapalace	human
@mspakouxiong	human
@jbpad	human
@LeanMeanJourney	human
@veejayfloresca	human
@ProductTestUK	org
@starryjan_	human
@BethJamesFit	human
@FreeStyleMama	human
@emilynminer	human
@thisiskhairin	human
@aeinbutterfly	human
@hungry_fifi	human
@Official_Epi	human
@74Styushina	unknown
@LibertyVCam	human
@HipNewJersey	org
@lepabe	human
@cha_ri_3	human
@RunninSriLankan	human
@healthsafety1st	unknown
@Kish_Vadher	human
@JamiesFifteen	org
@renmiu	human
@JimmyWhoo0	human
@cjng1996	unknown
@MehtapGulseren	human
@dan1959	human
@heleneisfor	human
@leahjoevans	human
@JessieLoves2Run	unknown
@BrentEvelyn	unknown
@_fandomtrash_	human
@TartesKluger	human
@riichano	human
@LaBelleIbiza	human
@shancrockerRD	human
@BrcelonaOntheGo	org
@LibrarianPince	human
@JaGrillHydePark	org
@ThePictouPuffin	org
@VidaDowntown	human
@superdivakerry	human
@coco_lui	human
@serge_destroy	human
@erikolesonLPS	unknown
@Mesadedos	human
@KnightZ_	human
@NoNameSteaks	org
@AngelOverdrive	org
@salu_salo	org
@luxury1115	org
@homegirllondon	human
@claire_emma1	human
@FoodiesLove	human
@hdjr2	human
@MistaTmg	human
@cArMyTh3LaZYbUm	human
@MrsLPA	human
@TheSaffronGirl	human
@Platform_RS	org
@LadiesOOq	human
@RideandDine	unknown
@jen_lopez_	human
@siriuslyheather	human
@Jankirei24	human
@TreatnTrickblog	human
@luvinlife_m8	human
@RobertaMuir	human
@luislinares39	human
@lucasaguilar	human
@cheesim	human
@deckyiskandar66	human
@502MonkeyWrench	org
@JeanzChong	human
@hawnrealtor	human
@TavernLa	human
@hanpen_masami	unknown
@juanitamart47	human
@sharonblossom	human
@BlogABookEtc	human
@katiebhughes	org
@VillaTriagoz	human
@PusaterisFoods	org
@kymnasium	human
@KarenQKQ	human
@KensingtonMums	human
@therealjaimej	org
@Grande_Rockies	org
@AuBonPain	org
@kuromiya_bi	human
@DinnerAtXtinas	human
@ditchlingbull	org
@Jesslam03	human
@TaiylerJamerson	human
@LMC502	human
@Cocinaheritage	org
@CupsTearoom	human
@PSYCHE_tom	human
@honeywhatscook	human
@emma_cerny	human
@warrenjrp	human
@JoBorjas	human
@CBandJA	unknown
@OneTokenBlack	human
@MxKstyle	unknown
@afterthebite	human
@zurinabryant	human
@Origenesorganic	human
@soonph	org
@daniellebeder	human
@Martybenny	org
@KamilahPowell	human
@lovefoodau	human
@shetaraparker	human
@NikkiPerelli	org
@GriggsAnne	human
@best4u56	human
@lisabonner	human
@UrbanTavern	org
@missy_jellyjam	human
@cstace1	org
@Pascal_Tepper	org
@Canal_Bistro	org
@monikaphotolife	org
@HETOE_	human
@BrittneeJoia	human
@Zer_birus	human
@BeeftroDublin	org
@idontdoclubs	org
@thehealthcoop	org
@14thstreetpizza	org
@ToscanaDivino	org
@CherryKiki8	human
@AngelynGoh	human
@wizardrecruit	org
@TeemingEdge	human
@happeninginpdx	org
@travellerblog	human
@Boma_Green	org
@BentoLife	human
@NicolleJR	human
@chefig	human
@piyapat7911	human
@Senthil557	human
@marsha_guzman	human
@railwayec2m	org
@ivanezmo_17	human
@HolleyGrainger	human
@DomiMomi	human
@slimwithHayley	human
@spring_savage	human
@iekayangghazali	unknown
@eGhassan	human
@JaniceFreeland	human
@5spotseattle	org
@AdamKasim	human
@shinigamishiva	human
@Sheana19	human
@Nakarin_J	human
@DKarivalis	human
@PamSweetLemon	human
@BandraTimes	org
@candeJoce_	org
@sarara0904	human
@TrainEatGain	human
@LatAttitudes	human
@VilniusHotel	unknown
@lesushibar	unknown
@manitobaharvest	org
@audreyangcos	human
@AlanLkar5	human
@EatFirstHQ	org
@BerkeleyWell	org
@NurWani92	unknown
@dytmervetigli	human
@Miyacore	human
@sweetmiley3	human
@CharleyCreekInn	org
@hultman	human
@highlyblessdK	org
@lepetitparis_la	org
@Sky_Ng	human
@GermanBltr	human
@pipaandco	org
@ClubbersGuides	unknown
@PMJC07	human
@elizakellis	human
@LinkousLogsdon	unknown
@HumphreyBays	unknown
@Emerald_Kitty	human
@gimchuanlow	human
@FashionBrunch	human
@FKufahl	unknown
@you71racing	human
@ashevillehilton	org
@Hattycakes	human
