@newport_grillks	org
@Tastyfix	org
@samfanslave	human
@finerDetailx	human
@Ale_Lambertucci	human
@nel_son08	human
@Organic__Care	human
@SimplyB	org
@AngelaGwaltney	human
@SarahAnneS	human
@GracellaKarin	unknown
@DarcyCameron7	human
@geryblaser	org
@PamWhitham	human
@Latonya4hair	org
@basibaglikiz	human
@DafamhotelPKU	org
@fitbydanielle	human
@adriach	human
@JillFilipovic	human
@DJMarkus72	human
@tinne_loh	human
@drpunkster	human
@NamaasteKitchen	org
@DouglasGan	human
@Mydailyshowroom	unknown
@jackyrich168	human
@elodiejcs	unknown
@Guttahbxtch	human
@vGoliaHoney	human
@a_memon77	human
@NataliePP	human
@chuaenlai	human
@JenniLynnRobins	human
@rio_lv_vly	human
@jvg18	human
@SwissZahlerArt	human
@SavorStCroix	human
@therealmegan	human
@angelnicolexoxo	human
@manxuan1127	unknown
@cyclhops	org
@fradramaqueen	unknown
@AdrianaFDSantos	human
@ArtsyArchitette	human
@shinee_l0ve	human
@jayceechang	unknown
@memo_pad	human
@emilyokey	human
@1dutch2310T	unknown
@BEX_Kitchen	human
@StuartPunnett	human
@NikonLady	human
@racheleliza	human
@aleguti2k11	human
@Helen0324	human
@JCMFitness	human
@andreaavelino09	human
@MauiGarrett	human
@miazubirr	human
@VinVinPhilly	human
@elosoconbotas	human
@lemonlemonpie	human
@Fruitations	org
@Jibby13	human
@2hearts_1soul	human
@SallyEkus	human
@teeeeejz10	org
@subetik	human
@MavericksFM	human
@Bestof_Cardiff	org
@WineBeyond	org
@alingpoleng	unknown
@mandarin831	human
@classicsilhouet	human
@LiekePater	org
@ctstv	unknown
@aysontespli	human
@igorcostacoelho	unknown
@Relipreeti	unknown
@fashionariablog	human
@DalilaAbella	unknown
@RosericGarciaO	org
@aldamarijo	human
@funkaliciouscak	human
@SbrigaMelbourne	org
@hitomi_fukui	org
@TattooedMartha	human
@PauletteSaxon	human
@dijaah08	unknown
@VandaDitaGallo	human
@bordercitybites	org
@Eggs4innovation	org
@MuhammadRyzalHM	human
@SimziiN	human
@ajeipayat	human
@fedecabillon	human
@clinton_z	human
@tenchim_1119	human
@lakis_lucky	human
@craftypintcbus	human
@IvoryTokromo	human
@RaisingChaos	human
@DiankaFane	human
@hiimeden	unknown
@LimPeter	human
@loztanner	human
@fahrfahr	human
@MonteRegio1	unknown
@JEtihadTowers	human
@hptomo	human
@CapitaoZeferino	human
@CravingCreative	human
@Eaveysmom	human
@riasatrahman	unknown
@DJComposure	human
@CitiviewCincy	org
@Nikki704	human
@debbiecat4	human
@vincentanjlks	human
@Darylmatla	human
@BrittanySorrow	human
@NLGBullock	human
@ViPgoodie	human
@zeth_l33	human
@OBRANIofficial	org
@Olive_Diana	human
@TwistandSports	human
@kahnamacadaeg	human
@Matyushkina_K	human
@rollaeva	human
@bonnie9520	human
@EvaHell	human
@Gemini_Elen	human
@thestylevoyager	human
@NizamMechaniZm	unknown
@Jacquessoficial	human
@JackieTane	human
@elewana	org
@wing_ng4	human
@oszscarr	human
@marcolouis85	human
@Nachos4Bkfst	human
@jsmileu	human
@ZOMT	human
@StephanieKing44	org
@lilbeesmommy	unknown
@KempinskiNile	human
@funkyfish586	human
@tereseask	human
@NellieCantone	human
@CommonGroundBOS	org
@CRAFTEDport_la	human
@deisuijiman	human
@karentokaren	human
@_Primrose_Hill	human
@yanami_kobo	unknown
@AshleyMGilday	org
@inka2504	unknown
@unsendo	human
@MyDesignSpace	human
@GAYWOWW	human
@djzodiackillah	human
@mdemegeve	org
@chrisdigerolamo	human
@Indriwidyaas	human
@levraichicblog	human
@PandaDawn91	human
@foreverr_mad	human
@Labelleoolala	human
@ren_joy	human
@marcofidalgo	human
@bebiesarah	human
@Brinschank	human
@pastrystudio	org
@SparkleDublin	human
@VicCudi	human
@JoyJackson21	human
@rufongwong	org
@carrievmason	human
@WLHJared	human
@AdrianRdrigz	human
@lauramalteser	human
@beyazityagdoken	unknown
@pocoespresso	human
@Kimmercane	human
@_KeyzWorld	human
@KevHatesHipHop	human
@Bedders1991	human
@UrChef77	org
@MrOphe	human
@ZetaJax	unknown
@WorldsAndDreams	unknown
@serenavanderws2	unknown
@StickyFaygoLuv	human
@IamPrissy	org
@Liggayu23	human
@Kiatyd	org
@Jihapumpkin	human
@InstantFashionB	unknown
@omoshiro_DwRb5	unknown
@Vicky7399	human
@MioPaternoss	human
@FactorsDeli	human
@AzizFaresMF	org
@TrendsnstyleSV	human
@spellerine	human
@chesatendido	human
@realgreenfan	human
@MsQueencitydva	human
@ep1curi0us	human
@readyfreddie23	human
@EnidaBerhami	human
@_r_a_s_h_m_i_	human
@CocksDaily	org
@iCONic823	human
@sanddyyr	unknown
@Sharonthj	human
@BeGenevieve	unknown
@shanuramirah_	unknown
@CHEF_BLAX112	human
@PkuLover	human
@herbutterfly	human
@AlexKStevens	unknown
@Cheka_Boo	unknown
@BreakfastonOne	org
@mkmk_46	human
@Burger_Craft	org
@M3lissaJohnston	human
@kaoryuness	human
@Poyaoh	human
@JeffreyMichaud	human
@sebousan	org
@deeadachi	unknown
@iChris78	unknown
@pizzacero	human
@nrlnnn	unknown
@asya_sheelf	human
@AsYouDish	human
@Beatstory_	unknown
@Vivelsfcardiff	org
@GeumsungAhn	human
@yoof7421	human
@putrifirdausi	unknown
@Desastrologo13	human
@lordfranzg	human
@TheBeautyBest	human
@Joseph_Santoro	human
@Piaisabell	human
@sofi_russia	human
@lakshmiskitche1	human
@MetalBella_13	human
@MediaManiac123	human
@PizzaHutAus	org
@theSassy22	human
@ser7837	human
@monidiaries	human
@kelsjack7	human
@SUNMI940721	human
@BestBitsWorld	org
@_BeaSimon	unknown
@ug_weekly	org
@justineprange	human
@noxbloom	human
@JesminJs	org
@JasonNiu	human
@Doblerin	human
@rajan_khurana	human
@askachan100	human
@NeuvooAdmChi	unknown
@samhjong	human
@citraayuaja	human
@cochonnetnmaman	human
@SI_Lovebird	human
@CraigAMaxwell	org
@Cale_Genesis	org
@chuckschicago	human
@BARRUANY	unknown
@Yunggvett	human
@NaNiNaNinBeTa	unknown
@britt_newell	human
@iamcarloluna	human
@AllenStace	human
@DrElmo_MD	unknown
@figandbarrow	human
@gincarlorosario	human
@Irw4nT4n	human
@MaevaRa	human
@longcham88	human
@PureCanadaMaple	org
@Liljohnny6	human
@MiaTapas	human
@thatscoolha	human
@pbjclothingco	org
@ya1000_4	human
@peachestopearls	human
@yelpzurich	human
@ceciliaaroberts	human
@faithful_victor	human
@sakie69	human
@thecopywriter84	unknown
@pammijolly	human
@mstanetrapatte1	human
@rivercottage	org
@Estafano	human
@SheratonKL	org
@thisgirlsiobhan	human
@annonymrs	human
@nickygarcia07	human
@AllieOoop3	human
@JasonLeeGimbel	human
@TheMontyShow	human
@misskennedys	human
@AliyahSRFQ	human
@ALICEinMaryland	unknown
@chedz007	human
@Potbellyuk	org
@Beanyjojo	human
@MrsMF_L	human
@ValentinaSpano	human
@jurnirayne	org
@cybershaz	org
@gallywag	human
@PollyLoxton	human
@shauna_ora	human
@IgiriDr	human
@7volution_	human
@Tinz519	unknown
@JOHN_WESTBROOK_	human
@Smiling_Amy	org
@MydahT	human
@EjhayX	human
@Kaiology	human
@superTHICK	human
@MGloverPhoto	human
@CbqLm	human
@rk_xoxo1	human
@kathleenlyon	human
@boooooki2001017	org
@glasshouseadl	org
@Alessio_Off	unknown
@farahsourity	human
@Stillamess	human
@shareasecretMag	human
@LucasBonVivant	human
@gotaquiz	human
@desireecheer	human
@lxxsxxyggg	unknown
@Garrett4NKLA	human
@GrubNJ	unknown
@Loft_Daglas	unknown
@andrewslattery0	human
@d13thgoddess	human
@luhsarika	unknown
@A_Drea_J	unknown
@iRyan_3	unknown
@EsReanimation	unknown
@camifleitaok	unknown
@sometimestammy	human
@Geezus_Piece	unknown
@leahfuller_	human
@Mr_Ro1	human
@monjabonia	human
@NUTTZ_CHICK	human
@BestBlogRecipes	org
@ahmedjohn7	human
@sandrinewanki	human
@xKonstiBerlinx	unknown
@JasonLowenthal	human
@MyStyle_Fitness	human
@gallegosizzy	human
@WhiteLionNR33AQ	org
@MaydeliseColumn	human
@mareeismyname	org
@LTJ81	human
@Alberts_Dids	org
@teresaibanez85	human
@itsmejoviejames	unknown
@Go2Grocery	org
@Ann01655278	human
@ImOneHunned	human
@teramc	human
@amrhelweh	human
@Woodstock_Arm	org
@Mooncarolina	human
@AngelaCYang	human
@ChiteCS	unknown
@afsheenjalal	org
@m_picci	human
@DyeyArCruz	human
@ali_mccluskey	human
@jinyongmin	human
@bloorozez	human
@Jackie_pink	unknown
@shez786	unknown
@lusciousfood	org
@FarhanFake	unknown
@Sfragulia	human
@EverydayAims	human
@men19691029	human
@SoozieSoo1	human
@si0007	unknown
@lauren4reals	human
@SEXY_SHUNDA	unknown
@Mara_Carlesi	human
@Rebecca_Laing	human
@sbo2406	human
@NaisenyaFoods	human
@AttiFunDirector	human
@an_ONK	human
@healey01	human
@1313Tlewis	human
@RustyPotCafe	org
@Superkingbaby	human
@ArturoMaerker	human
@art__agent	human
@LaurenWales	human
@Bonvoyagefriend	org
@AlyssaHarding11	human
@mairapucheta	human
@22JMeL	unknown
@synelra1	human
@Yhanne	human
@DebbieLLusk	human
@thanop	human
@RuthieOtani	human
@FHauzie29_	human
@mosaikhomes	org
@IraDivo	unknown
@sylvain7	human
@JoeZak311	unknown
@Hikkiee	human
@KaterinKace	human
@ChelseaTafoya1	unknown
@hoppingchef	org
@LikeALocalTours	org
@cv99995	org
@Kristanomonomon	human
@zarroph	human
@andiiystyles	human
@Mokaliciouss	unknown
@Nick_Kiraly	human
@ShidoLionheart	org
@canyon_creek	human
@MrrrrG	human
@AKoleilat	human
@FrancisMilligan	human
@Beh737	human
@tazza1000	human
@Nuii_RB	human
@xyzrayxyz	human
@ianmsantos	human
@tinaluz	human
@HitchcockDarlin	human
@carlie_david	human
@raymondafoss	human
@Juan7CarlosRMA	human
@wsweaz	org
@ninifrancesca	human
@rubylin_TY_RT	human
@ion_nutrition	org
@cazz_lj	human
@HighDro	human
@lamnism	unknown
@thisisviiic	human
@kirti91092	human
@CameraGirl_CL	human
@jo1reyes	human
@ZhanHuiZhen	org
@lubnegi	human
@keyernest	human
@mercanacar	unknown
@AlexxFurness	human
@xaviersanTIU	unknown
@Ova_A_Chi_Ver	unknown
@GiftedSon86	human
@imjohnrayobiedo	human
@lyallr	human
@KawanTuahKuat	unknown
@FanessaCB	human
@NordicTreats	human
@GarrettMcCord	org
@OuilamChua	human
@gmtgiftbaskets	org
@kenbisnar	human
@MezaMGrill	org
@jordydf	human
@ally_gan	human
@LovelyGreens	human
@naturalicurious	human
@CeciMiretti	unknown
@VeeLeonardo	human
@natassiaroslan	human
@LonBeatz	human
@queendlosreyes	human
@GT_eerythang	human
@TendenciaNereMi	human
@SyElleChau	unknown
@projectpetiteuk	org
@Hoagitos	human
@louishotels	human
@koknatha	human
@Bellagoold	human
@MrCELTIC05	human
@kmt0912	human
@MarcusKawa97	human
@MatthewKenneySM	unknown
@HolcombeFerro	unknown
@CoralClash	human
@xuxnxax	unknown
@flfullavet	human
@anneyhere	human
@akira_kasyou	unknown
@roseywinter	human
@diegomajluf	human
@michwhathappens	human
@LazyCowSolihull	unknown
@MargeauxMaloney	human
@NoemySuzzzana	human
@cojean	human
@GenWino	human
@ZuhairiNadzrin	human
@nycfan2013	human
@YMMEEKS	org
@Niblince	human
@LSLondonDeals	org
@Chadillac23	human
@ScafuriBakery	org
@TajaraINC	unknown
@PowerNuggets1	human
@george_uhas	human
@lnrcreatived	human
@getenvy	human
@DowntownClayton	org
@AdelaideBiz	human
@ITZANDREW1121	human
@DonatoDebbie	human
@WesternDairy	org
@lu_machado123	human
@Tax_Barbie	human
@HFIpanemaPark	org
@BBradshawUSA	human
@crystal__price	human
@SofiaDC01	human
@DC23hobbies	human
@FoodfitbyCara	unknown
@IamTexasDR	human
@CafeSov	org
@HungryGoWhere	org
@PoshMaitland	org
@Rosti_Mepal	org
@gcg_Gabi	human
@Benavidesleee	unknown
@beccalynn1396	human
@RRAHUERTA09	human
@StefanoLagna	human
@AmericanSocial2	human
@jpappaterra	human
@monsterdonutkid	unknown
@BrandonEska	human
@dreamingNYC	human
@ClaudioPalazzo1	human
@Farahnyza	unknown
@CavemanCooking	human
@Mattman34	human
@TeresaTam	human
@Love_Meatballs	org
@RanitaRegen	human
@ritvikachopra	human
@TheCeliacScene	org
@WhatsOnEdin	unknown
@ed_maule	human
@1CaramelBeauti	org
@ChanBoogalu	human
@SUNGMINx_86	unknown
@MrsPEdTechTalk	human
@SoFLFoodTrucks	unknown
@sebasrojas	human
@604jenn	org
@rizkiamelia73	human
@Chaibahrain	org
@CornejoBerger	unknown
@MimiSomerley94	human
@specialodds	unknown
@salad4president	human
@x1red3x	unknown
@PaulynnGoh	human
@Voltamanchester	org
@afireworkinprog	human
@shemakespasta	org
@NiedriaKenny	human
@vdiogene	human
@makariya24	org
@Ogagus	human
@Karak_chapati	human
@steeledarren	human
@RasheedaHaddish	unknown
@Miisz_Misha	human
@enaidrerips	org
@melvin_alex	human
@FreakOffLeash	human
@lepetitchou83	human
@mrssarisetiawan	unknown
@PaleoInspo	unknown
@agiusmc	human
@GermanosGagall	human
@ChefJohnTesar	human
@urbangirl710	unknown
@Rashii_Jane	human
@MartinSilverFox	human
@cpalmaHM	human
@C_BridinGsXr	human
@rangareprawuri	human
@farayas	human
@AdamTodd310389	human
@_itsreg_	human
@epattie7	human
@BabyAbbz12	human
@dr_bakasur	human
@PappaRotiCanada	human
@PaindeMieLTD	human
@SarahJunner	human
@ayaka1221kuro	human
@ohyeahbuddhayea	human
@IAmJayMullie	human
@arvinshichi	human
@miacucina_	human
@LuvCheshireLife	human
@CafeAzafran	human
@anthonyrussano	unknown
@iamdomzramos	human
@MmmFlavourFull	unknown
@fern_wara	human
@KAlMarzooqi	human
@Clautjeclautje	human
@ShoppeGirls	human
@A_Perfect_Lie_	human
@LoicFerrie	human
@octamunchy	human
@ConferenceWise	org
@Mandie_93	human
@mpmhawkins	unknown
@SheriRobertson1	unknown
@TheGermanWander	human
@TheRepublicGH	human
@epoy_ajam	human
@xtinepena	org
@RyanSCole	human
@LordWaheed	human
@verocorza	human
@runnersnuthut	human
@Meg_An_Hahn	human
@ScandinavianMum	human
@HanifaS	human
@AvantGardeVW	human
@MLCalentitasPy	human
@itslittlestuff	human
@JiaxinHugKelvin	unknown
@anthonyberklich	human
@Reoinstagram	unknown
@Jabarrioh	human
@Johanaortizv	human
@PatriciaSuelinK	human
@Bearmountain	org
@yadiracatt80	unknown
@ALICE_time_	human
@GoooNads	human
@spotstudiohm	human
@ThePalm_PHL	org
@starbeautygirl	human
@starryvibes	human
@AmyBrenner	org
@Misssy1010	human
@Mikemelofitness	unknown
@Mrtouchdown81	human
@SallyVatin	org
@CATAMUNDI_MX	human
@thatpinkrose	unknown
@bLankviE	human
@SuperYeowYeow	human
@iamyanichi	org
@JucySbucy	human
@fujinosachiko	human
@akkitch	human
@myselffarhan	human
@Potbelly	org
@mustafasmr_	unknown
@savorysweetecle	unknown
@Fastinista	unknown
@cattydavo	human
@1particularhrbr	human
@gsdreams	org
@dodo_nabjeracka	human
@fashion_press	human
@ElisabettaC90	human
@ChitraladaW	human
@rabbitstar	human
@MaKranda	org
@StherFelix	human
@ItzRaydonxD	human
@MsJEVA	unknown
@usori_blue	human
@aweBILLYsome	org
@sillydodo	human
@Capocacciafinef	human
@Jemsnatural	org
@lnez4	org
@resy	human
@lydfp	human
@MikeBikeHike007	human
@MakeNorathe	human
@uingjung	unknown
@pentanthera	human
@MaureenLarter	human
@LadyJaeh247	unknown
@R_ennie	human
@CikAtenAziz	unknown
@Maggie_zoo	human
@YeeChee19	human
@fetra2266	org
@LordTrafford	human
@DavidCTruong	unknown
@jacquelynparra	human
@giligiligil2	org
@AshleeVoda	human
@katebritabroad	unknown
@SarahDussault	human
@pinkenergyblog	org
@syazana1609	human
@liezlnazareno	human
@Ellez_Mardin	unknown
@irluxor	unknown
@therealmeDIANE	human
@85BORICUACHILD	human
@ERSAOofficial	human
@CHELSEYHERNANDE	human
@DallerNaturel	human
@lucie_ehr	human
@LCsCloset	human
@gggg0526	human
@andrewbigship	human
@yuriqha	human
@zorbacafetw	org
@andycoyne2	human
@ClassicRoyalty	human
@xAliceXiaox	human
@SJ_Selina	human
@vickystoklasa	unknown
@SingleSlave	unknown
@bloodybigspider	org
@gud_BF	human
@natalie_venesa	human
@Uwanma	org
@JasmineNgYL	human
@LamaRami	unknown
@bieganski	human
@intheTARDISigo	human
@savannah_barlow	human
@Mi_vidaenRojo	human
@KGraham76	human
@Nadz_Azry	unknown
@fufykins_	human
@ELn_Carolina	human
@WiredCo_London	human
@CongVanDuong	human
@izumimohamad	org
@leahjanetomo	human
@SirioNY	unknown
@youngmonop	human
@bguerrev	human
@im8paper	org
@cruzdelrosario	human
@HarrisJones96	human
@BrumFaves	org
@hiiinaaa13	human
@DerrynFrench	human
@Earls16thAve	org
@1mstorc	org
@ellatran91	human
@Home_kiri	human
@gnthestreets	human
@SpeedyBlueBlur1	unknown
@CsabaOveges	human
@TheBeauchampBar	org
@SybilHiew	unknown
@kszphotos	human
@lrtpublicity	human
@Kr15st	org
@shopeattweet	org
@SayuriDokuro	human
@scratch_london	human
@ayacozo	human
@DivineBrasserie	human
@marcmurd	human
@JoshuaF18	human
@Muratiniz	unknown
@adripopo	human
@GeorgiePie27	org
@hinlovesblue	human
@hollywoodgraham	unknown
@shorte123	human
@CentrumLemmer	org
@yanyan926888	human
@SchoolHouseInn	org
@payne_amy_	human
@winehag67	human
@WessMarcus	human
@jessehardesty	human
@dodoSV	human
@BrownBagCafeNC	org
@ipropertynet	org
@JillianMae	human
@PiscoVillage	org
@0817nichole	org
@WFMCharlestown	human
@martha_guenne	human
@AlfalasiSarah	human
@LauIsPerfect	human
@EmsyLouWalsh	human
@quirkybookworm	human
@rhaa_revees	org
@Large_Hrt	human
@MelissaRWagner	human
@Palminator	human
@ASFitness__	human
@ViBE_ub_peach1	human
@LeMeridienCoimb	human
@vanillaholicz	human
@alexandrefkd	human
@aleksan18	human
@oNicolaJaneo	human
@DeckardErik	human
@simon_tweeting	org
@bar_chiu98	unknown
@RailTrailFBCo	org
@MavyPalacioUS	human
@Momo8631	org
@new_york_living	human
@RheRhe95	human
@Mommamia09	human
@absolutrunnr	org
@NoreensKitchen	org
@emmisaltis	org
@monetaputri	unknown
@UshunterGlen	human
@janeyq123	org
@OzgErdy	unknown
@JashilReddy	human
@DCFitnessFoodie	org
@chowwellington	org
@RachelRene3	human
@Sophie_Official	human
@PromoTupper	org
@_superb0i	human
@SimFit100	human
@CasinaDeiTigli	org
@JenNikolaus	human
@SourMillie	unknown
@migueltaverasRD	org
@AstroPhilos	human
@CreativeMish	human
@MyDelightTruck	human
@greenmuse84	unknown
@mstylin777	unknown
@beam727	human
@emyztik	human
@MillieRenae57	org
@itschrisstime	human
@victoriawickes	human
@HowardLeach	human
@avitalkarmi	unknown
@sergioloro1	human
@loooove_rain	human
@lashpants	org
@robymalagutti	human
@dee_ach	human
@swiftysista	org
@janastasi72	human
@Todellaleuhkaa	human
@coyo_NL	human
@MrsIndridson	unknown
@am_taste	org
@ChilaHoy	human
@ProyectoModa	org
@_ninaninako	human
@StrayOri	human
@michelle656	org
@Jenychooz	human
@ANNMENDOZA	human
@flywillfly19	human
@sarah1807	human
@ksully23	human
@listicleco	human
@TalhaAwesome	human
@RheaCairns93	human
@EpicureCulture	human
@ragefmuk	org
@maamsaparvata	human
@daniellebeaty	human
@trampolinah	human
@kwood108	unknown
@faiya	human
@misscarlaviolet	human
@emilyboocock	human
@MiamiDiva_DLP	unknown
@deboersjyuonne	unknown
@MarbleandRyeVA	human
@stitchcraftsew	human
@Big1Mike1	human
@mizucchini824	human
@VandaVague	human
@jessicaxupcraft	human
@Sal_Valent	unknown
@MimaFernandez	human
@rascality	unknown
@angelized91	unknown
@Woofbed	org
@ThankYouMiami	human
@shadiactivewear	human
@BrisParkStreet	org
@aehtnaeam	unknown
@SamuelsSeafood	org
@chandlerwarrior	human
@amazingactor98	unknown
@Katelon4	unknown
@yanacassiopeia	org
@ll24332998	human
@itskc_	unknown
@jakesgarage2010	human
@dollfacedancer6	unknown
@Ronz07	human
@NeuvooFortWorth	org
@k3k3ku	human
@MandalayBay	org
@TheReginaFong	human
@GreenVale	human
@aabdullah91	org
@VilniusGrandRes	org
@RoukozEid	human
@rooster_2000	human
@camzbutterfly	human
@Next_GenKitchen	org
@BassSpielberg	org
@evasirgi	human
@scarsremain1994	unknown
@simmermag	org
@queen_jay79	human
@helloLiyah	human
@FlemingEvents	human
@WowKungen	human
@kevinyeoh1130	human
@divajebabn	unknown
@Inatrendytown	human
@BlanchardNeely	unknown
@FloydHillman	human
@degante_rayos16	org
@BlueGuardian08	unknown
@CaldwellNJRW	human
@Juliana_laksana	human
@Carm3nn	human
@TheMarcDonato	human
@ShowOutMici	human
@WorldPatentMKTG	org
@CallmeeBelly	human
@Angiolangel	human
@sorappyruru	unknown
@SAVOYrestaurant	org
@n_weezy89	unknown
@JohnHammer	unknown
@txhomesforsale	org
@LallaLoub	human
@AiimeeHeathhxXx	human
@linda161288	human
@asiulouiesa	org
@BockingsElmBabe	org
@IndigoLitho	human
@madamejoules	human
@lisaevs	human
@rihara09kara	human
@poppyatsmarts	org
@miyatastyle	human
@RobertCWebster	human
@HealthyCoffeeee	human
@jasmineejassy	human
@HelloHARDcANDY	org
@jelliemendyosa	human
@chrisblair1	human
@fredlucalandi	human
@CARLITOSPANAMA	human
@KrystZimm	org
@crosswaze	org
@Nobu241925	human
@suzanne_greer	human
@daoacebedo	org
@xncampos	human
@PaulJohnKearins	human
@wholisticshine	org
@Wave48238	human
@Kingy1304	human
@mariaelenatan	unknown
@callmeEAN10	human
@meinefabelwelt	human
@Barnsley_UK	org
@lisarogerson3	unknown
@ypanos	human
@ThePalmerston	org
@bygone7	human
@fitchicbitch	human
@luckys_cafe	org
@Givemeurdream	human
@ariosoerjo	human
@GBH68	human
@TeknoRob	human
@ParadisPerdus_	human
@SandraaLmy	human
@B_Morson	org
@firesidechicago	org
@Vinayak89	human
@sarahn105	human
@adebsantiago	human
@Radikalway	org
@leonjohnmurphy	human
@THE_TIKTOK	org
@HighFlyerCoach	human
@Inunka	human
@AussieAlicat	human
@joelbudiman	human
@florjill	human
@ChefRSandoval	human
@wyliewinter	unknown
@tshelburn	human
@elmercanasjr	human
@MRESPN21	human
@iAm_MrParcore	human
@BavyNov	human
@huishanes	human
@Marggie45	human
@GeoBerryKF	org
@wayhaywoowah	org
@loveiconblog	human
@MrCPT	human
@Rendyyy_S	human
@NobilisMagazine	org
@highlyspirited	human
@OYB_L1F3	human
@FatX101	human
@NIQUEelodeon	human
@livingsouth	human
@MarvelGoddess24	human
@macjojo1	human
@mymhsystem	human
@yuriquattro	human
@MonicaG93772989	unknown
@BobalJirka	human
@paulssparkle	human
@oliviermaron	org
@jAyhawK_ArtGirl	org
@OriolindaL	human
@Walls_Delivery	human
@hot_rikan4sho	human
@natydenegri	unknown
@Karhow_woHraK	human
@Lovesatellites	human
@1aimee9	human
@KatlinZobel	human
@pricelesstemi7	human
@YSBerger	human
@OceanDriveMag	org
@Yukitankun	org
@AlJazeerah_rest	human
@ohitswee	unknown
@VictoriaRej	human
@andymeholick	human
@gleyjhu	org
@ArthritisHM	org
@breadlovebkny	org
@hudairi	human
@seling97	human
@badjonphoto	human
@Beauty_111	unknown
@AimanAtiqah	unknown
@KARLETHAL	unknown
@ByIYOMI	human
@hastabanana	unknown
@lovesimfood	human
@Sandra_Frangieh	human
@LauraAvnaim	human
@gishellamaya	unknown
@alyjo85	human
@makeupbyyelena	unknown
@Mei_Mei90	human
@tweez100	human
@raffi_del_core	human
@qq5277	unknown
@jamespercysmith	human
@GoArabic	human
@ViewsFlash	human
@StevenSalanny	human
@NatStacksss	org
@LittleMrsTB	human
@mehlwashere	human
@diana_paredes_	human
@kar_vadillo	human
@chantel_bayybee	human
@gothjhonna16	human
@FiLizdasdan	human
@JessicaFermor	human
@ohhJENNN	human
@airyngale	human
@KarenRawlin	human
@victorlai2011	human
@JoieLZE_	unknown
@RezzyGhadjar	human
@JungChang07	human
@YKorchak	human
@sohobarcork	human
@clairebaybay	human
@skyred75	human
@i_r_maximus	unknown
@Caterina_55	org
@AAnissai	human
@BradfordLoverUK	org
@rm_harrison	human
@lost40beer	human
@MightyKarine	org
@MandaRivera	human
@THEBESTXZiiBOOK	human
@dakeez916	human
@LuismiCorts	human
@sshawntt	unknown
@LexiLovelock	org
@nadaabby	human
@TerriLyndie	org
@photoallan	human
@dreamydee89	unknown
@JenMayHuang	human
@callmekemmy	human
@masa_punx1981	human
@SONutrition	human
@askomo	human
@baaaaaaall	human
@courtneyiscalm	human
@KLBInc	human
@rrr_rmmr	human
@Ry_Ry87	org
@ClaudiaSerraCS	org
@AgentCortez13	human
@autumnw65137823	human
@JustineMoras	human
@shortcut3	human
@treehuggs4u	human
@thaisbackyard	human
@kirawelland	human
@nengrince	human
@Amazoniann	unknown
@mikeijames	org
@dieselmad	human
@hajar0049	human
@BE_at_the_Trend	human
@VirtuScottsdale	human
@GlennOstrosky	human
@DavidALeePhoto	human
@504Eterno	human
@bornwithsoul	human
@poloniova	human
@DibsOnDaRibs	org
@mscleverKJ	human
@lovelyjeab14	human
@plaza_americana	unknown
@MaisonPremiere	human
@UsaginoLeoMama	human
@djumadrin	human
@aqil_nurfhana	unknown
@prettylilxlara	human
@LiveAquaMexCity	human
@sukma22	human
@saraoettgen	unknown
@B4IGO_Travel	org
@bellfieldclo	human
@_MarieKennedy	human
@Michelle_Karen	unknown
@VintagegoodsOH	human
@chrismansour5	human
@Guernsey_Market	org
@Sweet_Nicouze	human
@TridentBooks	org
@shinherself	org
@JennicaGomez	human
@naudayon	unknown
@jihanalame	org
@MoraesRodrigo	unknown
@brick_glitter	org
@katherine_amos	unknown
@MaryJackie	human
@sarc_gentleman	human
@SpicesHerbs	human
@zaymenthrixkenn	human
@jtmormoney417	human
@bon_yuen	org
@Everitt2Becky	human
@ejc_elsoldado	org
@EpyPojie	unknown
@Triple_Threat_T	human
@MeganGrothman	human
@Coco_Pebz	human
@Norbatronn	human
@adamvdb	human
@Thirdie003	human
@PearlsPolkaDots	human
@jazzwriterchick	org
@hiltonponce	org
@withluvrui	human
@LinhCafeVan	org
@_cristen	human
@DepotKanton	org
@s3xyAtom	human
@LettieNow	human
@RDastweetz	org
@put_chan	human
@PeggylovePk	human
@david_lund	human
@KebaMcClendon	human
@AungcoonG	human
@Miaaribeiro	human
@ElleSpann	human
@SeasonsMildura	org
@TheReal_DEWBABY	human
@wearunique	org
@Canelayjazmin	human
@VRAI_Mag	org
@justrhenz	human
@beyondthebite	human
@_and_etc	human
@TAJMOLOBA	human
@askjesi	human
@terebomba	human
@RealJonnyKing	human
@ChloeCurie	human
@artgoodies	human
@ourpassion4food	org
@Feb_Luv	unknown
@ABNORMedia	org
@chocol8boomboom	human
@Dave_Seifert	human
@ciirecii	org
@MemoriesDevelop	org
@Olive6789branch	human
@Mavi_Greci	human
@whiteboxcupcake	unknown
@WesterholtEmily	human
@aroisme19	human
@BCDigiPhot	org
@SimplyFancyCuis	human
@kcrenshaw1234	human
@UTZAAKE	human
@lowcarbfoodies	human
@MARKvelous	human
@RamadaGurgaon1	unknown
@NarlyFresh	org
@lfeins	human
@spaceship_earth	unknown
@RudsFrias	human
@deecoloay	human
@me_cassandra_	org
@LV_Ruben	org
@SmutExchange	human
@MDACosplay	human
@kelly_abc	org
@DianeHaller	human
@tuuba_dmr	unknown
@tomas_tam	human
@bethanyamato	human
@seabreeze_vr	org
@camaleone19	human
@pentagrammiDF	human
@dragonfly777	human
@OhItsTBrown	unknown
@RaginCajunRc3	human
@Fx_advanc	human
@AyeeYoChina	human
@edwardsetiawann	human
@rawlingmcqueen	unknown
@Eliita_92	org
@JuiceCentral	org
@PtheP	human
@kerstmis	human
@hotvideonl	human
@AnelGonz	human
@Angelok_Yuliya	human
@Vanessa_Gon97	human
@anthonySAER	human
@StarsSebon	human
@gyonm	unknown
@KateCarson93	human
@nana_mhd	human
@LaMoradaMexican	human
@ClaireRKearney	human
@DivinginColours	org
@StuffMummyMakes	human
@wawanDuatujuh	human
@AnjeliqueMrs	human
@Dbeatstro	org
@RDonlinetrainer	human
@NikkiOonSC	unknown
@MamarosaBCN	human
@anitakayduvall	human
@alyscal	org
@StephSaysGO	human
@love3ii	human
@MariaMurumets	human
@BinaryTrading13	human
@FUTP60Arizona	org
@93Isilay	human
@tcbiiatch	human
@jackty_sundah	human
@spazkosmack	unknown
@efanizar	human
@edgardp20	human
@fivestepsbeyond	human
@desinunes	human
@NeuvooColumbiUS	org
@jiaminn	human
@XXKUREACCXX	human
@Shine_Proof	human
@iamromanpaul	human
@nagisa_007	human
@chuckielu	org
@sharizamy93	human
@bluemoonstar	human
@weixin93	human
@MsDreamGirl_	human
@aislingmulcair1	human
@opinionjustmy1	human
@samatdolotbakov	human
@JessMesses	org
@collinekc	human
@areydarafid	human
@BritainyBeck	unknown
@Itzel_ve	human
@steelnpurple	human
@sinta_kwok	human
@TheMayraB	human
@mostlysunnyblog	human
@Mert_Efekan	human
@busylittlebees	human
@samanthaawrites	human
@AutoBinge	unknown
@JackyyDp	human
@elisamoralesss	human
@CLEJuiceBox	human
@MikkoLovesYou	human
@cutiecumzie	human
@Kekoci	org
@Emperor_Ams	human
@snowmystic	human
@Sonyhato	human
@ektaakumar	human
@carlopitter	human
@peteroen	human
@3weekdiet_	org
@Toninho_sampaio	human
@crisdieta	human
@DanniMarie1994	human
@ZamuAndrea	unknown
@TheRealGio12	unknown
@Richard_Brans	human
@SweetleafLIC	org
@Briamoga	org
@learningtower	unknown
@ZozZaina	org
@DubovetsSenya	unknown
@betho_chan	human
@AzraPhoenix	human
@Pw_9	human
@jbryx7	human
@YEPitsMISSA	human
@TheArtofBeer	human
@daungsamorns	human
@ferly79	human
@MisterDaniell	human
@717South	org
@EllenHobnob	human
@kennyjonesradio	human
@abisfitness	org
@smsesteves	unknown
@ABLesClefsdOr	org
@itsthestar	human
@inestsabitah	unknown
@kingrobin03	human
@KSanTanMan	human
@TheSassyNation	human
@GilesRedman	human
@solmarie04	human
@relaurelrel	human
@la_andreozzi	org
@Creativojohan	org
@bobbylejon	org
@FebresLabeby69	human
@jorliocom	org
@ebisunakayoshi	unknown
@AgustinaVW	human
@CookOnYourOwn	org
@AndersonsBandG	org
@memz_x	human
@rubyraza	human
@YogaGuy108	human
@sharonjp1	human
@2minutesago	human
@elifsagsoy	unknown
@aldo_marcucci	human
@mykpalayan	human
@dustjunkie	human
@92chicameisti	human
@AyieDaChaosz	human
@RyojiToronto	human
@Melissa_Lew	unknown
@ThePorchester	human
@GrowthBible	unknown
@justinyap_jy	human
@chaaaaaspiyo3	human
@HubertC_	human
@SardineEater	org
@kissesmuah007	human
@Hubert_Zna	unknown
@spotonwellness	human
@SLIRobyn	human
@moneyvsdebt	human
@itsmeraydaniels	human
@HappyHousewife	org
@Jikan967	human
@KristenLong3	human
@LaLaLunchbox	human
@McleanGemma	human
@SCEmmons	human
@anacatty7	human
@OFochesato	human
@HackeemAsharrie	human
@midettealvarez	human
@punto_letra	org
@Donnaly20	human
@Saturnfly18	org
@Draekian	unknown
@WFMDarien	org
@ClaClaValera	human
@yvonnesenosa	human
@jreliznyok	human
@yyi_gt	unknown
@summerwithmonik	human
@JustJacobMusic	human
@janicewright70	human
@AdaGaming	org
@SweetSoftKissez	org
@Wotshernameagai	human
@4evamamii	human
@Rebecky86	human
@AriannaRilovich	human
@chef_sameer_ali	human
@Sabrinax3x	human
@aincruzz	unknown
@artsy_kay	human
@AmelieM21	human
@cherylovescake	human
@arrentan	human
@Alexis6534	unknown
@JoshuaDNSR	human
@annnnasjexo	unknown
@sheen_ssc	human
@AmandasDish	human
@dabenz09	human
@kbajus	human
@SweetnessBakes	org
@DidiTeixeira78	human
@KatieOrr22	human
@CityParkBD	human
@LeawoodPC	org
@LindsaMae	human
@nicomorphined	human
@CuteJessy95	unknown
@suzanne1245	human
@liyingscribbles	human
@Gelatogo	human
@cohenleoncarlos	unknown
@aizzedcoffee	human
@natashanahran	unknown
@RicettaOnLine	human
@NickyLake86	human
@MVeeckmans	human
@abbyabbyabbyy	human
@CarlD135	human
@brunettediariez	human
@HoshiYAH	human
@CanteenTweets	org
@ZeeShaanJamal	human
@ShuliiGigante	human
@junyamadera	human
@MaxPower6	human
@XgangkkX	human
@Lo_Butler_	org
@indradha	human
@Druchechinna	human
@CravingsNorwell	unknown
@misstyaaa	unknown
@ZaraJayne21	unknown
@linamonteslo	org
@foodiecure	unknown
@nemenpour	human
@mdvp05	unknown
@CHEFnMOM	org
@nandoaja	human
@heytingsquared	human
@anastas26953682	human
@damianvelasco	human
@corygeearr02	human
@IHeartRecipes	human
@mhadssalvacion	human
@briaanne	human
@claudette_nyc	human
@asano_emi0603	human
@ismejoanne	human
@pestolad	human
@dekproject	human
@Needa_alhabeeb	human
@steezyneevy	human
@SWLisaHallglen	unknown
@lopesmedia	human
@psephy	human
@RoniVeeCuhh	human
@citracitobelii	human
@NewIndianXpress	human
@masonjambon	human
@SpencerfuckinW	human
@LopezRhi	human
@japonka31d	unknown
@creativekkids	org
@ChrisScafidi	org
@BernieMadoffJr	human
@AnnaPFit	human
@ChicagoBuckys	human
@tacho11094	human
@KeziaFerwari	unknown
@SandraGStyle	human
@BKFilmPro	human
@LMDministry	unknown
@prbdiva30	unknown
@TheNativeCowgrl	human
@momvstheboys	human
@reina_o1992	unknown
@ntanyola	human
@orange_Q	human
@SarahGadon	human
@DivianConner	human
@zyncyln	human
@DreamDWTN	org
@ArchRicupero	human
@eagerangel	human
@SerapKa_	unknown
@zinks41	org
@oneida412	human
@Rosylita	human
@fonsjordan	human
@luis_carlos_00	unknown
@hp_hotels	org
@silverlakewine	org
@ChristineArdigo	human
@pheys1973	human
@mishikun08	org
@taraskitchen75	human
@stickyrice13	human
@pramesemara	human
@maljasteffilee	human
@ClasigoTR	human
@RachBellDesign	human
@superlaentrada	human
@silviazefanya22	unknown
@LecceAdreana	org
@slimerdubstep	unknown
@adiDido	human
@mandikaur123	human
@thehipeone	human
@mattyladdy	human
@elffar	human
@DanaReneeStyle	human
@MyNameIsEase	human
@Bauke_ST	human
@thomasrseltzer	human
@itsaboutNIKKO	unknown
@mayahoodblog	human
@CatPR	human
@maax1923	human
@saveenkaur	human
@_HeidiSylvia	org
@tikaayupw	human
@LadyHoshikari	unknown
@LauPM_	human
@JamieLefkowitz	human
@Jprahl	human
@muscleworldnow	human
@oldschoolcook81	org
@L1ndyL0u	human
@leonardoamilano	human
@thatoxy	human
@titilove69	human
@Mahadevi1025	org
@maferstcruz	human
@LatinGoddessT	human
@Ashy_M_T	human
@DrVondaWright	human
@utopiawellbeing	org
@Glendavero07	human
@gianmarcofac	human
@ParkRotanaAUH	unknown
@S_Slickepinne	org
@Lifestylechic2	human
@mentatbabina	human
@tassos_antoniou	org
@ZacPlanet	human
@koefficient1	human
@Karinne_Ribeiro	human
@Vika_Vikakaka	human
@drewxeron	human
@HectorsSandwich	human
@jewl_zzz	human
@EckelbergerS	org
@mysark	human
@kitchennandoos	human
@Ikescafegrill	org
@BodieBoostChar	unknown
@Naizui_Yap	org
@RPimpsner	org
@TheAquariusView	unknown
@RichyCalderon	human
@SupplementHub	org
@fitapermatasari	human
@Lynnsolsona	unknown
@MatthewMichell2	human
@tiarahannum	unknown
@judijo	human
@laulea_MK	human
@ryandrushel	human
@Kanjitoronto	human
@Jun12Nyan	human
@renotastebuds	org
@manuel261984	human
@The_Ting_Thing	human
@novhy_lhatova	human
@Sh3DidDat2ya	unknown
@TommyEurope	org
@Akilah958	unknown
@0810Princess	unknown
@ViazcanV	unknown
@NutritionSci88	unknown
@MayeLoyola	human
@OldGranadaMCR	human
@zencefit	human
@vrayduhvoe	human
@itacatepenfield	org
@priyapathiyan	human
@hasegawa_tomomi	human
@pauielau	human
@PerlesauxCochon	human
@theScarletHotel	org
@sakuranonohime	unknown
@bcmusic1st	human
@sangelame	human
@abokado_uk	org
@EHawkNicole	human
@justbionda	human
@beka_blue_eyes	human
@Sweet_Virtues	human
@fearlessmellah	unknown
@michi1715	human
@tiffinmusic0829	unknown
@anonimastudio	human
@atidra	human
@DivasandTheCity	human
@MK1488	org
@VillaExpressKir	org
@EddieWang12	human
@BonyAbalos	human
@darrellfishbeck	human
@ChaConsul	unknown
@adamwade	human
@GraceALowe	human
@kateskabin	human
@MaruNator	human
@SarahRadford82	human
@MingLe_Scott	human
@raiderette507	human
@CentoFineFoods	org
@tacchiacavallo	org
@GTFDanceCompany	org
@MsSexandTheCity	human
@ManicMomDay1302	human
@Lizerds82	human
@hautePJones	human
@Ri2ki_k1k1	human
@dare2emon	human
@nofreshie15	human
@originalmadn3ss	human
@mimiallure	human
@sailawaygirl1	human
@yaeltamar	org
@MIMIHOUSTON2009	human
@vanonymous	unknown
@naomi_y122	human
@xxJENLIU	human
@ChantelKeates	human
@WilliamHallet	human
@ai_fai	human
@GabeSaglie	human
@_FatinIzzaty	human
@ShirikitukoB	human
@d0ensii	human
@sarahiscreate	human
@BimoCarskecau	unknown
@_TheOnlyKJ_	human
@muniramstffa	human
@ShaunSutton_	human
@MASSSAKRA	human
@_wallace_chen_	human
@AiNaTow	human
@angieclara09	human
@MassimoGrippa	org
@sherrysharena	human
@dubbsvision	human
@t0m0qz7	unknown
@LananFizz	human
@MolaProduccion	human
@AouLiea	human
@xoCharlottexox	org
@benedictmonica	unknown
@StaceHolland	org
@FoodFromFlossie	human
@DubrovnikStory	org
@R0ger26	human
@ArtieKenney	human
@VerdejoNicole	human
@amorcitogoloso	human
@marijamanda	human
@bonappetit_2	human
@paz_a_p	human
@SarahHerrnandez	human
@tony_pie_flip	human
@gercapp	human
@katfje	human
@angelsanswer	human
@astro_Marketing	human
@amelia4691	human
@PavlovskyPark	human
@laura_vargasD	unknown
@madamchatcha	human
@Janay_C	human
@susanwalnut	org
@NutriJnctn	org
@oolcyk	human
@bobokittie1983	human
@renezabubbleart	org
@IWUDining1	org
@wegetnaked_	org
@adaredia	human
@the_hardihood	org
@meowxcat	human
@bakehousedevon	org
@jethang	human
@Em56Bean	human
@StreetBoutiques	org
@gttomdubber	human
@SierraSugar	human
@geargiannnqa93	unknown
@GandolfosCW	human
@AlexChancexxx	org
@WrapperSnapper	human
@serrahanim	human
@sunflwer1975	human
@NarutomakiRamen	org
@freep	org
@SaiForaVadia	human
@miezarmsq	human
@xDeugene	human
@TotalEpicurien	human
@LoveDigita	human
@EggsPlusPan	org
@dominicsofny	unknown
@CanAhmet	human
@michellevivas	human
@syazreenwoot	human
@culberg	human
@AmalTayssir	unknown
@QCryss	human
@phamschottler	human
@Zhenlinlyena	human
@kyozaii	human
@HealthyMamaMag	human
@fidmonion	human
@Lvu8888	human
@OregonLovers	human
@susannova28	human
@laroyal06	human
@KPKillerQueen	human
@powerlift4gainz	human
@erbettalucas	human
@FortCarsonGAH	human
@ATasteofTherapy	human
@d00dsky	org
@martaferram	human
@JuciResults	human
@Wh1pper	human
@REDFAhardtoget	human
@malenebcarpets	human
@twizzle73	human
@chrysolite010	unknown
@CrushedWineApp	human
@EllieMayDay	human
@imEnanVillareal	unknown
@NJHTheIrishOne	unknown
@AmirMogharrabi	human
@Mikyblu	human
@Markki07	human
@TheWhiteWallSyd	org
@LiveFromALounge	human
@famstyleschool6	human
@emmacdavidson	unknown
@Angorfa	org
@arcasela	human
@cbg1973	org
@sarafpete	human
@ChristianSmutny	human
@gingersmommy	human
@AmbassBlooms	org
@kelliuna	human
@jondardis	human
@tritha415	human
@DudasPriest	human
@SuselCarpMalik	unknown
@Ginger_Sheridan	human
@alinaswhisper	human
@Hanooie	human
@JmxTanhueco	human
@Andarchef	human
@Liuk54	human
@ronensuarc	org
@AmandaASouza	human
@charmoon	human
@jixingong97	human
@AnilBolukbasii	org
@GraphikosMktg	org
@nellyrosiana	human
@173ToFit	human
@Collins_Square	org
@Renzo_food	unknown
@RebeccaHK22	human
@HooperHolmes	org
@Dibauwenssocial	org
@DJAM2611	human
@sheswanderful	org
@DesmondKatie	human
@aaron643	human
@usojungbabo	unknown
@ValentinaContat	human
@dineratlanta	human
@JessicaAvey	human
@afsluvme	unknown
@_karlitacz	human
@shauntae521	unknown
@TrueYummyItaly	human
@Tempie3300	unknown
@wh3eiiesiao	human
@nyc_evertonians	human
@CallieReiff	human
@BrashAlexandra	human
@SarabethsCPS	human
@el_globetrotter	human
@604foodtrucks	org
@thepickypantry	human
@farzadme	human
@i_am_alex_silva	org
@Kaleela4775	unknown
@GreenGiant	org
@TroubleSum	human
@brix_angelo	human
@jes4life	human
@_NOXQCES	human
@sams_sams88	human
@henkvannunen	human
@gidgetsafreaq	human
@siriornmanee	human
@yuichannuu0720	human
@starsoncam	human
@02Seon	human
@nko0373	org
@snowgreenviolin	human
@RicelandFoods	org
@JMC131	human
@bheeyaa	unknown
@BestWalkingTour	org
@MarkoFederici	human
@xs_group	human
@rodrigo_cvieira	human
@eunicah_	org
@SeeJessRun711	human
@paula_cisternas	human
@zestforfood	org
@amandaioannoy	human
@4ladiesblog	human
@villatombolato	org
@DayanaDeZoysa	human
@crowcr	human
@calandrerp	human
@BX_Bunz	human
@SusannaRigato	human
@_nanJJ	human
@rasket	human
@SuperMommy247	human
@LG_number1	human
@PaYingHergn	human
@seannoble	human
@yashi_mushi	human
@carolineadobo	human
@TangYuenMing	unknown
@marinx666	human
@KrysLojek	org
@LD_MedicineHat	org
@josierestaurant	org
@SAMMYTARANTINO	human
@ELNOTICIEROVISU	human
@DANAFLEYSER	human
@AllgoodFoods	human
@mgirotra	human
@cecemechell	human
@BananaHamble	human
@23LaSexy23	human
@JORGECARAZOCHEF	unknown
@CafeRoyalHotel	human
@lemonetrocks	human
@kokichame73	org
@Cherylgigolo14	human
@kivasbagel	org
@TJMarconi	human
@Ahlyn97	unknown
@Yumokoco	human
@STOCKToronto	unknown
@MFrazierImageG	human
@IjahEmoTemo	human
@michella_Lcb	unknown
@ThePrizeDraw	human
@brand158	unknown
@rph5587	human
@Rain__Goddess	human
@TE2Perform	human
@robjhoward	human
@debbiegail89	human
@piggybelles	unknown
@06101226	human
@kishore3128d	unknown
@EastParadigm93	unknown
@glennnesting	human
@MatteosRestLA	org
@kelly5150rn	human
@Massawa_NYC	org
@hudhuhudhu	org
@littlebrdcoffee	org
@djoooya	human
@VoiceBoxCouture	human
@nomo_Sherryo	human
@Andrea_Buckett	human
@jlojenn531	human
@MCordoAnasta	human
@SewChristinaMae	org
@BrigVanOsten	human
@pure_outdoors	human
@DiningClub	org
@RoloCantu	human
@Brroonaa	human
@consyrrakos	human
@tinyperformer	human
@Rdelmar	human
@farisalhakim_	unknown
@slcfoodie	org
@flyscott5	org
@IchibanVegan	org
@susanhutchinson	human
@jnishimura	human
@mynameisive	human
@Mart_iSkys	human
@y_Erina17	human
@MartaCespedosa	unknown
@CA_Lavash	org
@2MoMsNYC	human
@nuacho	human
@jamesvaliente	human
@JohnnysWindow	human
@DishcrawlSTL	org
@mentsuu	org
@stylemindchic	human
@loremeguard	unknown
@ruge88	human
@kevinasir	human
@KHALAIdoscope	unknown
@carolinaanasole	human
@ciexia	human
@nayt890	human
@benaazp	human
@Kaldorana	human
@T_H_A_T	human
@prosenjit_pb	human
@theJennyMorant	human
@nanako247	human
@HardRockCafeSP	org
@KayLF4	human
@annazrulan	human
@GaryRiis	human
@As_ilhan	org
@kbbasaran	human
@analauravm	human
@ChieFoucault	unknown
@SunshineB_21	unknown
@l_teare	human
@ansonr1980	unknown
@Andrysurya	human
@woodenspoonco	org
@windee_19	human
@RitaAnnEvans	human
@cocaoplant	human
@marilenmonte	human
@ParkLaneHotelHK	human
@akuadin	human
@jennfultz	human
@iambudek	org
@acpnn	unknown
@300east	org
@lLlLOYlD	human
@DhikaQR	human
@ElarsLechon	human
@Leena_Paul5	human
@johnlyrizbarkin	human
@20metriquadri	org
@cwangxoxo	org
@nosemajj	org
@thunderkawar	human
@chrisdeep	human
@cashmerebonz	unknown
@APGkelley	human
@VBRealEstatePro	human
@Huddersfieldis	org
@DFGrilleNewYork	org
@darrylblando111	human
@Elliepie1986	human
@Stephia26	human
@harrahsresort	org
@Royal_Empress	human
@rinakania	human
@chiododi	human
@CEW72	human
@rjei	human
@QaysarPizza	human
@vsandman1	org
@tacosadrian	org
@puzzlesshum	human
@leanderk38	human
@mellameic	human
@LopezSarai	human
@210Tom	human
@goro08090	human
@FalafelMore	org
@RyzalZain	unknown
@Gooner91TS	human
@nathanharmon	human
@isabelseja70_	human
@calpastachico	org
@Chef_Epsimos	human
@myaELzack	human
@HyndlandCafe	org
@EcuaDiva1123	human
@sexiexoticmami	human
@smooochhh	unknown
@mehhlchristine	unknown
@mr_ericv	human
@flictorious	org
@gdewira	org
@JessieMcVicar	human
@johnkruze	org
@LaDiDa_T	unknown
@incidentalbaker	unknown
@promenade_	human
@sexy_papa	human
@littlerachelkim	human
@wilolobo91	human
@novasgala	human
@maris_c	human
@chrisbenally	unknown
@henrynyash	human
@foodieforsure	org
@ClydeFraziersWD	human
@IvMiyuki	unknown
@bajliva10	human
@VoyageVixens	org
@riverrange	human
@ExploriteFan	unknown
@NicoleGuarino16	human
@DharmenParekh	human
@xtremeboy	human
@flowmarbella	human
@anasrshd	human
@xavierch	human
@MikeeRuiz_	org
@dsilver71	human
@kerriegreen_88	unknown
@NishaCollection	org
@wendyswayhealth	human
@RyzalEffendy	org
@WashGateMainSt	human
@MurdochProduce	org
@Raquelilith	unknown
@mccsicecream	org
@Smorleylacroix	org
@daveutdjones	human
@Arbihut	human
@zhelgandako	unknown
@LadyCatchy	human
@yeraLOO	human
@sudakkusu	human
@FarmHouseSoBro	org
@KosAktisHotel	org
@PaellaProject	human
@smartapps4kids	human
@thetwelvehotel	org
@PrittyMthaFkHeR	human
@DRINK_A_PALOOZA	human
@WeightsBunny	unknown
@Tablebookme	org
@karaphobic	unknown
@mhacky	human
@Mark_Northall	human
@PranaGoddess	human
@bubatenders	human
@AFRIDI_KOHLI	human
@Herreranos	human
@dangunam	human
@SusyLeto	human
@STRBUK1	human
@ShoreditchHype	unknown
@healthyishlife	human
@810617	unknown
@shaunniboy	unknown
@Mark5261	human
@TravelwitBender	org
@C4U_sa	org
@ClemenceCSLG	human
@ugwandaccbranh1	human
@ahsanali88	human
@brypw	unknown
@reghCam	human
@emma_goldstone	human
@corrinearanjuez	human
@LeellaaBlog	human
@RMariaRennyC	unknown
@liindakyx3	human
@nadiaishere	human
@ThamesValleyExp	org
@MsVixen69	human
@KathrynH440	human
@philliplett	human
@big_breeze	human
@QuidgQuihawk	unknown
@leelithong	human
@hemelchavda	human
@AkhterNoman	human
@BodyBuilder0506	org
@coffeecraftbcn	unknown
@amieladdress	org
@Chris_Ivanoff	human
@4432okawa	human
@salsoola	human
@NanditoSnuff	org
@AndreaDispenza	human
@OfficialTums	org
@annasahmad	human
@DimopoulosG	human
@vicente_tamayo	human
@Manuel___Jesus	human
@escocesaN16	org
@NeuvooWellingt	org
@BetoRediia16	human
@ovieredblue	human
@tattoobakery	human
@cocktails	org
@MySuperAlex	human
@NannaRousGuest	human
@RealKumru	human
@DenisePalmer	human
@HealthouseLD	human
@Charcoal_Dining	org
@kelese23	human
@aleah_87	human
@missa_est	unknown
@MasterWebChef	org
@Iris_Oak	org
@Loven_Ambition1	human
@pepez04	unknown
@livcashin	human
@OntVealAppeal	org
@Poppinwheelies	human
@nokidsaround1	org
@Matthew_Rosen23	human
@StateAndLemp	org
@redheadtravels	human
@Dadouchic	human
@iklanpengusaha	org
@mrswages	org
@talekjr	human
@kikyerizky	human
@sachi_kodok	org
@MartinaLoffi	human
@ImAllenD1	unknown
@RootsStirling	org
@pishposhbaby	org
@fitness_jo79	human
@909SeaFM	org
@AstoriaHaiku	human
@artlifefood	human
@yanyan9	unknown
@HonkeysISHood2	human
@AtotheJ_	org
@msjuztineagena	unknown
@gregorymwhite31	unknown
@cookingforfido	unknown
@Nicolaweaver	human
@KonyNoirlin	human
@CatarinaIAP	human
@Lilgoo15	human
@DWACOent	human
@Sann89	human
@Aasje	human
@yukilufpink	human
@foodie101pty	human
@emilyjwhite91	human
@kimpirrella	org
@e_snacker	human
@claudiaverela	human
@shychiguy	human
@Peterrificality	unknown
@thereadwritemom	human
@Kat_LynD	human
@carolinenatasia	unknown
@ROSasEve	human
@Foodie_PV	org
@PrinceChiwest	human
@RustyTacoPlano	human
@Fanni___M	human
@LoraSutton00	human
@LinDexia	human
@ethel2urlucy	human
@KerenhapukhV	org
@Karyakii	human
@akhmetoffnargiz	human
@mharvinna	human
@EPSherrington	human
@Moshi_15	human
@ThabetAljayousi	human
@ShubhaHiranya	human
@kirimoto1	human
@Trademarck	human
@pringles01243	unknown
@psuitofhappyNIS	human
@GelaTiAm0	org
@lissydrg	unknown
@Maya_Onike	human
@LozzCC	human
@RIZQOCH	org
@PhoebeAurelia	human
@jaaanaaaHAHA	human
@BrittanyJane716	human
@diyira_	human
@MarlooseB	human
@DebbyEunHae	org
@nalinidesai	human
@Elishia_Ortiz	human
@meringuetoquee	human
@Zellyboy	human
@sthekubeka	human
@DHOLLY0422	human
@JosieInDubai	human
@EvieHunter90	human
@No1SkaMama	human
@Lockenmeister	human
@SoHeresMyLife	human
@iamHarbs	unknown
@TxokosKitchen	human
@HelenaMarmPhoto	unknown
@venof7	human
@osiemstop	human
@karavelar	human
@I_Am_Sandrine	human
@citykittyyogini	human
@MisPark_Dempsey	human
@sweetsassyinsa	human
@nanonat	human
@twi6901	unknown
@FanyJingga	human
@LeftInTheHead	human
@yohsandy	human
@gmtchang	unknown
@itzisvg	human
@dansilvaph	human
@ctinakydd_	unknown
@xaxier	human
@LaNinadelMezcal	human
@kogisdgds1	human
@nicolettareggio	human
@LaBohemeBistro	org
@zinsmith	human
@Riki_FeedMe	human
@sebastiaanhooft	human
@alamodemaya	human
@greenteablondes	human
@JohnSmithNV	unknown
@celinecrudo	human
@Billy_Sanz	org
@MulberryHouse	human
@Monishpop	human
@RestaurantsLeb	org
@DanyFit	human
@RadiantCristina	human
@ItsJennyBolden	human
@ActorMicky	human
@littlebirdysays	unknown
@ambercrystalrox	human
@SWEE69T	human
@noisestart	human
@NordstromYYC	org
@kinokensuke143	human
@CollingwoodInfo	org
@pdunaway7	human
@shhy_hotoke	human
@Hernan_Moreno_	human
@a_soo_chang	human
@smhakkaya	unknown
@_andreablu_	unknown
@NippleHuggers_R	org
@caritocastro80	unknown
@TerezieJPelikan	human
@LSU_Doll	human
@lessan52	human
@awakenedgourmet	human
@rieriecupcakes	human
@georginamarmoy	human
@itsa_bagelstore	unknown
@LuftiLotz	unknown
@chiaki_reine	human
@kapdl	human
@TheSantaFeVIP	human
@socmane11	human
@brendanloy	human
@PortoPalace	human
@john54wh	unknown
@LoveDidd	unknown
@lovelyfaffair	unknown
@jeans_boyy	unknown
@JeremiahEvans	human
@StoneforgeEastn	org
@nigaayu	unknown
@nekoashi_natsu	human
@Margo_Streben	human
@VidaGastronomia	human
@sugabee	human
@briseyda	human
@nyenyaa	unknown
@itsFlyTy	human
@FanyRss	human
@xSweetPrinCeSss	unknown
@Kare360	org
@MartaUn	human
@jscapozzi	human
@Cambro1	human
@Adriana_love91	human
@jenrhicks	human
@LindsayRowntree	human
@Helenalmighty	human
@immadhuchandra	human
@FromABCsToACTs	org
@EllisePaige	org
@FMDF_APP	org
@mariangela_iula	human
@georgieolaci	org
@KingP914	human
@KKRuble22	org
@HeneghansTavern	org
@NigelEngle1	unknown
@LibCoffee	human
@emmalooney	human
@wii0519	human
@DanieFBaby	human
@hadiCkusuma	human
@pilydlacroix	org
@campiteli_p	human
@jadedlou58	unknown
@VikingPoint	org
@gissell22	org
@_Hockey_Girl_	human
@HopscotchnJB	org
@AlQasba	human
@brownwilliamart	human
@A_Hopkins	org
@analilia76	unknown
@a_topher	human
@eventsgeek	human
@szanyhero	unknown
@Alishatitfootat	org
@LauraRaDit	human
@LindseyOtta	org
@RulaBula	org
@aeriskong123	human
@Jagers_Official	unknown
@MatthewWoody	human
@opprtunityknox	human
@happyarp	human
@bloghealthy	human
@aisyah3212	unknown
@ScarpelloSerena	human
@JohanDihani	unknown
@TravisH1973	human
@lavinianitu	human
@zonanortedf	human
@eMi_925	human
@josephluis89	unknown
@jscaldwell2	org
@joyceroxanne	human
@monbento	org
@Richard_Bruschi	human
@LeanneacMoore	human
@nancitaacosta	human
@gelflinglm	human
@RachelFawcett92	unknown
@KeepCalmFannyOn	human
@vendaaa_	human
@ecyt_susan	human
@sarahrizvi	human
@ThatGirlAsh88	human
@brightonmums	human
@AligarhSelfies	org
@RachelPerez581	human
@NeuvooBurlingUS	org
@piecesofhome	org
@AgathaPasini	unknown
@photosandfood	org
@ThrowACupcake	unknown
@AdrienneEC	human
@Amaliacake_dhie	human
@hitabito	human
@coffeeology101	org
@Miss_PSanchez	human
@FtGtYL	org
@t0ffeelici0us	human
@atravelingWife	human
@MustChup	human
@sfn_ayano	human
@BurntoutSTAR	human
@ModernMummyUK	org
@KevinCastro07	unknown
@GreenVogueGlam	org
@Maria_Massoura	org
@sassbynature	org
@foodathome	human
@Mr_Kliff	human
@katiehannerxox	human
@azamhashim87	human
@Funkyrob0t	human
@AndWeCanTo	human
@smooth_cigs	org
@GalleryMess	org
@PoloBoy	human
@JimClickBPN	org
@BromleyMencap	org
@WildChild_Est81	human
@ChrisKasteler	human
@DJOGGY	human
@revivetrad	human
@louis5149	human
@karansayz	human
@CantinaColumbus	org
@rindi_matilde	human
@sinotuyo0807	human
@KtMiller25	org
@ModernShoppingY	human
@GayhussarsSoho	org
@gaylevanwely	human
@BeautiLost	human
@YangAgatha	human
@RHelmreich	human
@ihotelsi	human
@AxxoxIzkt	human
@TheGeneralLogan	org
@buchiisae0911	org
@kizzter	human
@BaeBridge13	human
@IamKatCasacop	unknown
@BagelBrospanama	org
@DopeCuisine	unknown
@m_margaretha_m	human
@SodaPopTaylor	org
@veryco	human
@bucujuice	human
@SabreTooth4	human
@PaintedJeans	human
@elleweild	unknown
@rikireina	human
@gotwoodgordon	unknown
@iTaj_Malik	human
@ChefToddEnglish	human
@CuppycakeKitty	human
@nawa_ssi	human
@mikuun	human
@BOliveTX	org
@mediachick11	human
@Giapeloggia	org
@jmeguay	human
@lamodadelorena	human
@melaniethelola	human
@AbuIpan	unknown
@BunnyLafee	human
@tony_hung73	human
@besekoma	org
@chefcentral	org
@meech4peace	org
@thoughtfox	human
@iamsuperan	unknown
@Yogurberryvzla	human
@princessvhana	human
@goodhabitbox	unknown
@ParidiseParties	human
@odyness27	unknown
@aydeejay11	human
@thasetya_NSR	org
@AlBustanCentre	org
@illyoman	org
@Ali_Nicole_G	unknown
@ChampionBread	org
@jenniferajanes	human
@mohamedsoumah99	human
@bowsforbellas	unknown
@Nunzia_B	human
@BonnieFuller	human
@Ru2ke	human
@atiqahbari	human
@ctlifestyles	org
@lalimarie	human
@etj77	human
@daivelight	unknown
@AXhotelsMalta	human
@MabellDamiron	unknown
@ruthkristi	human
@TataCatasTophe	unknown
@saviocaixete	human
@full_of_fun_mum	unknown
@Orchard_NYC	org
@dapurigajogja	org
@ellemeelo	human
@hswolff	human
@BizNetWales	org
@TreasuresByBren	human
@TREATgreekdeli	org
@errshytavet	human
@ken_gtz	unknown
@Stobsbroski	human
@JaMEzBaLLaBaBy	unknown
@Partsdeplaisir	human
@planettreasures	human
@allan2pdx	human
@MKakko	human
@lovewinegirl	human
@samsats	human
@yapyithong	human
@Loverallpretty	unknown
@alisharp88	human
@ANDIELAPIRATA	human
@EveryDChampagne	human
@BeccaBullen	human
@localireland	org
@jessbronitzki	org
@jen_yang	human
@JONATHANBLOT	human
@jenarosereyes	human
@chinajapan_39	unknown
@stoskafode19721	human
@chobiiiiiz	unknown
@caravanpenyllyn	org
@Logine2014	human
@zurichnee	human
@appleofreak	human
@jessicacimbrelo	human
@NandosPeriPeri	org
@fabiogarro	human
@judgebrix	org
@Mekeyko	human
@MerlynShowering	human
@VittoriaRaia	human
@KatiePiierce	human
@weparestaurante	human
@melissatjia88	human
@EmmaSuzor	human
@lubell_z	human
@kenichijose	human
@KhaoPadResto	org
@TK2U	human
@abigailhellens	unknown
@amacateer	org
@azoro10	human
@jehhane_14	human
@fredglozanojr	human
@Melissa_Bozovic	human
@MarinaSuviri	human
@SugarloafB	org
@Kanpai_Dubai	org
@BrizMastaFlex	human
@YasmineProbst	org
@2013_highlife	human
@_chefdigby	human
@Seloki	human
@erathboneeeee	human
@barretobello	human
@LilyKaradsheh	human
@RatriJolie	org
@T_JayDee8006	human
@read_geoff	human
@WoolpackBar	human
@ReciRich	human
@what_theowlsaid	human
@MalikaGodt	human
@shawnimal	human
@mayur_thali	human
@MissMaraFtL	human
@wecreateharmony	org
@celebracionesrd	human
@jeremyrichie	unknown
@kaykay_chong	human
@Wonderful1Woman	human
@VictorVEnciso	human
@heyerhyck13	org
@ProRhetoric	human
@HoptonHouseBnB	org
@WildWestBpool	org
@angelmag	human
@ElliesBakeryRI	human
@blackdaylight	human
@MosesAvila	human
@D_Mo_	org
@naturangi	human
@ManoharDairy	human
@meawbree	unknown
@Paulita_Lausen	human
@AlecCarley	human
@Kristy_Floyd	human
@Bodinesteph	human
@SilentJoyShop	human
@lezizee	human
@OdiviaCaroline	unknown
@MuzioDeAngelis	human
@vieviedee	human
@SABAHtwt	human
@anrafes	human
@MG_R2	human
@officialAprang	human
@thevoyager7482	human
@RedaDubson	human
@Mr__Jones__	unknown
@Postie22	org
@michellempress	human
@cadadj	human
@MayraMorenoTV	human
@sjpjuiceplus	human
@ThatsTrakeisha	human
@wolfheemy	human
@SchobelsTX	org
@8mountstreet	org
@kimbifit	human
@Yuko_Oshima777	unknown
@smile_eBiso	human
@HealthCaribbean	human
@Lapetitchef	human
@glozu4ia	org
@ianianlorenz	human
@shinappXXXi	org
@CharoIzquierdo	org
@Funkie_Barbara	human
@denniisorozco	unknown
@word_has_it	human
@megmonerawela	unknown
@pp___wwwmi	human
@Yojeidys	human
@DBGBDC	org
@SenzoDhlomo	human
@drewbabydrew85	human
@chuahyapwin	human
@kikoso3672	human
@IamDianneAbella	human
@Da_1st_Sin	human
@LaResidenceDxb	org
@rani_desiana	human
@markgunnoe	human
@omoshiro__aruar	unknown
@BuyplayaInfo	unknown
@pedromamede	human
@lovely_ella	org
@IbtissamAmine	org
@iyacastillo	unknown
@AmmarAronz	unknown
@SuperSaf	human
@deezytaughtya	human
@_UncommonGround	org
@thecoupedc	human
@veganderbycat	unknown
@Rahna_Fathima	human
@Nataliexnyder	human
@polsalac	human
@meldaderingor	org
@sass	org
@FloydieHojilla	unknown
@J_LewRichKid	human
@larissakim23	human
@melissa_826	human
@JudyandJoy	org
@newportshipyard	human
@adellagonzalez	human
@cheniezz	human
@Marta__Oliver	unknown
@swytiekath	unknown
@JosephD0612	human
@Baderbrau	org
@DanielSLawrence	unknown
@BringsyApp	org
@pixelarniam	unknown
@Tobacco_Factory	human
@BridgitDanner	human
@natanncan	human
@almacubacafe	human
@GinoCampodonico	human
@cellarstars	human
@KINGfenty	unknown
@ZuoShan	unknown
@honey_dashey825	unknown
@Shivani_breeze6	human
@atu0128	human
@NamasteChef	human
@chongcoprang	human
@DarrenKelly93	human
@vgnsocjust	org
@karimel03	human
@UnionHoteli	org
@OlivierJPDuval	human
@MaxHansenToGo	human
@EatInOutReviews	org
@SO_CHAMBER	org
@gocabajic	human
@cikalevi	human
@OBeyYourDoctor	human
@SoftwareReborn	human
@MakNutritionUK	human
@ssvqpu2	human
@erieqaerine	human
@princeshowcase	human
@BardsPhilly	org
@Khaylen_MY29	unknown
@LittlePinkBones	human
@boochlopez	human
@SasquatchAOTC	human
@Caeszartz	org
@sandman2984	human
@tkimBW	human
@alyamursyid	human
@hideaway_cafe	org
@AmberLyricz	human
@RiikDaan	human
@stevenali	human
@Albegupi	human
@NordicBaltDine	org
@aaakapg12	unknown
@rhialiciousss	human
@ombelineparis	human
@davidb_560	human
@missladytia	unknown
@Titodadictator	human
@stefaniacabitza	org
@ParkerRiverFan	human
@ErlyYoonGyu	unknown
@EdwinsBorough	human
@WatchLAeveryday	human
@emleec	unknown
@_IAMBRENT	human
@KhalBoboAji	unknown
@akb9784	unknown
@syafiqahwahie	human
@mamamakes	human
@earlssouthcomm	org
@fbbbingo	human
@EliseBraa	human
@RomeroBoukman	unknown
@TopTowerPhilly	org
@BigBearCali	org
@spotas	human
@novoswhobrunch	human
@JoJo_hilton	human
@Raq420oz	org
@mightymic	human
@BPDGtravels	human
@ArtOfMart	org
@ss_tsubasa	human
@SeeEugene	human
@MissMo_NL	human
@melbdelicatesse	unknown
@RobbieW62071871	human
@medinasadinda	human
@artstylelove	human
@washfirehouse	org
@DeCruzSon	human
@AlcarazSheila	human
@ScribbledRosie	org
@alisifission	human
@henrykland	org
@AlexMyStyle	unknown
@_AssassinPanda	human
@Anrichelle	human
@SWEETPOT2	org
@emmadecinque	unknown
@marrionezz07	unknown
@whoisbiancah21	unknown
@KatyRoseDid	human
@BettyBree	human
@danaprigge	human
@Tanytata_D	org
@elevatedhr	human
@ElizabethParker	unknown
@AimWolf	human
@hiteshbhatia	org
@themacadame	unknown
@RIE1011GD	org
@MiZEdWardCuLeN	human
@owenshinoda	human
@bdebiamx	org
@thequartzqueen	human
@morethanfoodinc	human
@_JillyneMUA	human
@cjsohot	unknown
@mouthfulmindful	org
@XKeaii96	human
@yrt_red	human
@Wahoo_Bill	human
@goodrichlind	human
@tjioreni	unknown
@ItsKatesChannel	human
@LeBrebant	org
@tomokoimadedyen	org
@kelseyanna	unknown
@megan_mack	human
@chefsherrisw	unknown
@MCRFreshers	org
@cmwilfred	org
@Goustaros	human
@irishpaleogirl	human
@FSLanai	org
@jamesiddon	human
@AfraBinFares	human
@anggiesulistyo	org
@EricaAddThe_B	human
@kkkat222	human
@joashmanning	human
@sianwaller	org
@SoulLoungeLagos	org
@ambie1255	human
@hadjeas	org
@Carla_Goycochea	human
@xxx_shimo	unknown
@thedrewnewman	human
@MelAJennings	org
@iWearOddSocks	human
@Lucky_HardDenim	org
@usehurrier	unknown
@ariel1206news	human
@katheba	human
@Nicky_Rei	human
@YukariHsiao	human
@nerdgirlism	human
@din_prosymnus	human
@Cebo_S	human
@TuttiFruttiLeb	org
@BeardedYoung	org
@Trump20I6	unknown
@Shahn00	human
@christavidya	unknown
@icreativejunkie	human
@tulipmillroad	org
@CrazyCebie	unknown
@jamilarxh14	org
@missyjace	human
@followjax	human
@soopersized	human
@ysshhh	unknown
@lola32	human
@kimberly_naylor	human
@BethFevrier	human
@heinzsingapore	org
@MrYLLEnt	unknown
@SARA_sweettweet	human
@iameiiwaiieii	unknown
@ArvinRae	human
@CintiAlvarado	unknown
@diniutomo	org
@dieylayusof	human
@MissLeyaCapulet	human
@pattybetita	human
@acatpig	human
@diazrjuan	human
@HobbitManda	human
@JanNicole_Resus	human
@Gisela870	unknown
@diego_pinero	human
@Carmen_Niemand	human
@Stanzione_87	org
@cookiesncheez	human
@RealesFe	human
@GOD0FMETAL	human
@pnsibanda	human
@Natasha_Gann	human
@princessbritt17	human
@HarnHam	human
@BostockBakery	human
@monmonica89	human
@HollyRamblesOn	human
@G_Mack10	unknown
@jasonleegarrett	human
@wandergirlana	human
@LyDiego	human
@PeteZoaB	human
@zanekeith	human
@GrinchMichael	human
@emo_boi708	unknown
@emmesiobhan	human
@emmaeustace	human
@KevinKrenojr1	human
@Brianmcse	org
@Auction4Pets	org
@simpLyssa_tea	human
@von_Wartenberg	org
@amanda_dewitt	human
@cafeloetje	human
@PinAndBreakfast	human
@KineticaSports	org
@twliker004	unknown
@Coff33L0v3r	unknown
@DJEST3	human
@Less_Stop	human
@Jac_Says	unknown
@Luu_Goonzalez	org
@uuk105	human
@HtcCtnr	human
@lashopartida	human
@SSeymaNur90	human
@sundeejo2002	human
@Cicitaaah	unknown
@Roman_Cardo	unknown
@2RoadsMegh	human
@TheSeafood	org
@scamble446	human
@us4ztmlrekn7	unknown
@Rikers	human
@TheDefinedDish	org
@Seamaas	org
@JXavierSantiago	human
@FlavourCurator	org
@DontGetChopped	human
@whcny	human
@TokaLoke	human
@Faye_Fishcake	human
@CiayoZ	human
@itsmeyiel	human
@KComeo	human
@i_am_bieyha	human
@kimjavier1	unknown
@ambelene	human
@Picobrox	human
@oohlalalia	human
@pastalauro	org
@KAYRHlNE	org
@loupaige	human
@07shio	human
@K_a_i_C_e_e	human
@CocoEstlander	unknown
@kilianlilla	human
@MuhannadQahtani	human
@asssclwn	human
@Claudia_NBA	human
@mikocatral	human
@upintheear	human
@christravelblog	human
@alesiito93	unknown
@infinitymkcm	human
@fxca46	human
@TheFabGinger	human
@Deluxe_Dining	org
@doshabadosha	human
@MacDeLLaH	human
@keiji220	human
@bagelbareast1	human
@Saflute	human
@kojimaruyamajp	human
@luxury3e	org
@Lollie_SVK	human
@SheikhsPalace	human
@Sj_wrightx	human
@ChelseaSue9	human
@vudofyweceka	org
@kasadillababyyy	unknown
@rachel63j	human
@GoBowlingdotcom	org
@Mz_PiNkii	human
@Angie_thedevil	unknown
@whitecat2012	human
@cokelatcoco54	human
@Glutenacious	org
@MiO0611	org
@ProYoTreats	human
@veropp79	human
@samiam102854	unknown
@iamvladimyr	human
@sailo80	human
@Ian_Rui	human
@BeautyWithinSin	unknown
@bumblebeenush	human
@trowelandfork	human
@washoku_lovers	human
@SDot_Beautiful	unknown
@zarulashrafza	unknown
@Beckster_Baby	human
@ETT_BreadBar	org
@pearlsegura	unknown
@kiwihamac	human
@AlexSk49	unknown
@NPaikidze	unknown
@CoachRaymont	human
@restaurant_nuvo	org
@dleyvoy	human
@dpumgt	human
@nmgonzales89	human
@pixeemje	human
@residentfoodies	human
@lettucedine	org
@baloney_cereal	human
@hannadane	human
@CalumNicholls91	unknown
@sanae_kakei	human
@meldita_ody	org
@KnozTweets	human
@LarasKumala_	human
@StriptSnacks	org
@dodojuan	human
@nemomarlie	unknown
@DianaJo11	human
@ExportPaolo	human
@jHiE_aL	human
@mcin68	org
@LuisMOfficial	human
@gigieluchu	human
@JohnnyRocketsSA	human
@6Nations_Rugby	human
@IamMarccolis	human
@lounge_twt	human
@gelo_rt	human
@bearyfunscrap	human
@JankaraWines	human
@Beautystic	human
@NatashaJaneFit	unknown
@iPatrickM	human
@boomp01	human
@TexasBabe512	human
@Soomi_nim	org
@iamJanHarMan	human
@Sarahsbasket	human
@kasih_sutera	human
@sel_magique	human
@jimmy_u	human
@jennsteezy	human
@TulipPaperGirl	human
@slcorstin	human
@ManishaPatelMUA	human
@CinqueUnoNove	org
@shinyan79	human
@SWEETMONA_	human
@serpentillon	human
@MooLidia	unknown
@mica_dears	human
@lucianaldritch	human
@GreggCOOLet	human
@sammyredefined	human
@RPizzaCulebra	org
@themommist	human
@dimpooolll	human
@LegeayAurelien	human
@TheRhinecliff	human
@kuro2pu	org
@necessarybeauty	human
@allisonmbagwell	human
@zerofull800	human
@visionsnews	org
@CaldwellTrucks	unknown
@Qwekunazy303	unknown
@rie1208rie	unknown
@babitamall	human
@Cinderelish_	human
@SoCalDJAce	human
@Blaky91	human
@KatyH714	human
@msjingting	human
@AsliCoop	human
@DR_Natural_Hair	human
@VanessaBaked1	human
@16_gioia	human
@AMPlifiedPhotos	human
@airbender_jandy	human
@LivingDolly	human
@NurseMarta	human
@jb34irac	human
@andrinam	human
@LTTL_foodblog	org
@SwanLavenham	org
@jaum1981	human
@nberemblum	human
@WarholNyc3	human
@VisitCCTexas	org
@SongHuntress	human
@anjanivilla	human
@HoustonOasis	org
@bonita_16	human
@allaboutmkt	human
@bellacinos4me	org
@fmd518	human
@GoodwillBistro	org
@Food_Wine_Lover	human
@Hunter_Spears	human
@ninachick98	unknown
@patriciapassar2	human
@ale_Bosses	human
@Y_sqaure	unknown
@Charlie16951875	human
@Nastya_Perunova	human
@_RoxanneWalker	human
@paulymartinezz	human
@lingeriekink	unknown
@DevinSmithCo	unknown
@mfernandez2004	human
@teefan85	human
@BigDaddyBowman	human
@HeiMao3	human
@becky_babycakes	human
@anitamariaes	human
@DebbieNjai	human
@finegar	human
@basoglu_merve	human
@iamporsche_	human
@middleparkhotel	human
@tonydoring	human
@fayelouisecoman	unknown
@iCorrine	human
@DinaMKader	unknown
@frani_lieberman	human
@TBessence	human
@RiccardoCimatti	human
@MissTammyDowen	human
@m_de_campos	org
@paulinehoesni	human
@xoxo_anna	human
@duchessliljinks	unknown
@Global_NTT	human
@leroy2the	human
@LA_Food_Crew	org
@MELiS_aktalay	human
@CompanionBaker	org
@cakeboutiquept	human
@tatioq	human
@LOLitsjake	human
@li9ht3s0ut	human
@finnygo	human
@MaRi_928	human
@TheOnlyParagon	human
@fenixvag16	human
@oquelguerra	human
@bloggbean	human
@_Darz_	human
@FemFitnessWell	human
@mikekindofcool	human
@karenkartini	human
@SaltandCharcoal	org
@PrettyFashFwd	human
@snailironique	human
@Amber_xox4	human
@knbrowneyes	human
@MaritzaRmro	unknown
@NikiGasullasole	org
@S_Hoxha	human
@CadetHotel	org
@NikOnDemand	human
@MyFitClubLA	unknown
@thedamicology	human
@LaughingGravyUK	org
@rachelannbowes	human
@farmfoodies	unknown
@StylishPetite	human
@CuencoJoanna	human
@cute_tulips	human
@justTWTme	human
@Lisamlem	human
@Kirusutina	unknown
@1887vinyldecals	human
@FirdausLemonz	human
@DelicaKitchen	org
@snarkbiscuit	human
@ava4eva	org
@CirocTucuman	human
@Civico35	human
@kilimanispeaks	org
@WhatsonWirral	org
@Junior_Chamber	human
@mollydolll	human
@0hfcvk	unknown
@sisca_mariani	human
@Cobb_SA	human
@MissPinkiii	human
@HiltonHRGplaza	human
@YumYumFontaine	human
@i_am_peachchan	human
@TasteMontclair	org
@elienuan	human
@CheFreshcvg	human
@soophieparker	human
@Tigerchen_Hino	unknown
@Holley_Wammack	human
@janemiller6	human
@nictorday	unknown
@REALLOOSETEKZ	org
@Angiesways	human
@wintervillegirl	human
@Paigee_Hyndman	org
@amoyliana	human
@Rizkymemmo	human
@Deliarias	human
@joeyz95	human
@Tabledonkeyinn	org
@TheREALJPESO	human
@thereal_rickE	human
@BrookeMWarren	human
@Steamuplands	org
@essusweetslife	unknown
@MtvJess	human
@starchelle15	human
@dino_haryono	human
@oeazydmg	human
@Blueangel30	human
@mtk0209	unknown
@funnygurl36	unknown
@BondCoffeeCo	org
@edescootauco	human
@Razamataz144	human
@AngieMBarry	human
@Floyd_HeIs	unknown
@bokebowl	human
@VitamixUK	org
@Ypractice	human
@hailybarwick	org
@alicefra111	human
@thedietchef	human
@johsmith	human
@yusufyaran	human
@WiseOwlDesigns	human
@IndieCakesPastr	org
@martonciaina	human
@reflekshin	human
@aRFa25	human
@MauriLourdes	unknown
@ameliasefton	human
@glamourpods	org
@halifaxbloggers	human
@Yulizambrano	org
@emmhai	human
@kiki_lebowski	human
@alapaix	human
@giubernaola	human
@DunnGaherins	org
@K1y0eK	human
@antonyoz2soz	human
@chloelennox	human
@fatinismil	human
@sepidii	unknown
@DPeeplez	human
@meag_16	human
@ASNLimo1	org
@Wenzi1993	human
@magdajoyce	human
@NikoleAngela	human
@sorciere4	human
@awrestoranid	human
@LisaDMZ2010	human
@GabsUmbrella	human
@mhieamay	human
@Mysteek84	human
@phyp	human
@HarMoment	human
@FRESLYLLC	org
@carlialexab	unknown
@yulikondratenko	human
@malikabk	human
@SmilingHill	human
@saarbeau	human
@amirfxfx	human
@nadzrisurani	human
@DumbnSilly	human
@ingridgloria	human
@RafiSahanoor	human
@thecoopSI	org
@The1_guNNz	org
@miavipclubs	unknown
@jonnealeman	org
@StephWalters14	human
@the_laundrette	org
@norabakes	unknown
@Lizssie1234	human
@LaYuuno	human
@thegreenelife	human
@yunjinnnn	human
@DateNightBand	human
@TheGoktor	human
@RMLasquite	human
@LovelyVirginia	human
@KylieLee83	human
@DrTruth247	human
@YvetteLWilson	human
@AntoCaracciuolo	human
@annalisa1078	human
@kezziebeat	human
@micfollowJesus	human
@NiftyMom	human
@DT__xyz	unknown
@Heavenlyink	human
@grainsandgains	human
@Lapdanzer4u	human
@StLeonardsEst	human
@TengkuMaya15	human
@Kate_1Dlove	human
@nane_escola	human
@buttercakeshop	human
@Rikateddy	human
@hapinesscook	human
@jenlovatic	human
@aile_bs	human
@Jepu	human
@karonliu	human
@nealkb	human
@NeuvooHosHou	unknown
@jessakhiyiya	human
@jojophilanin	human
@MonkeyBuzzle	org
@chernggoh	human
@Brittles526	human
@veinzee	human
@GinaLawriw	human
@2traveljunkies	org
@MishyCo	human
@jody_tracey	human
@rickydjauhari	human
@ecko_loko	human
@fanykho880410	human
@sam_amsay	human
@cristinaasisdee	unknown
@SilviaVecchiTCC	human
@rose_chacha	human
@bswagger8	human
@JamilaVitiello	human
@LeonardDini	human
@taipeitu	human
@OneSillyFag	org
@DiniBjm	human
@TMDA_MI	human
@VinciCatering	human
@WTdaska	human
@AnnicaPeeters	human
@VeggiePopy	unknown
@NewInNOLA	org
@BigBands_5232Ls	human
@jmruiz127	human
@mcr_smile	human
@ColorfulEnglish	org
@Desdemona90	human
@marcusskj	human
@TravelwithTaraT	human
@andyjhwang	unknown
@Christeeen_a	unknown
@mackzz17	human
@trianatibal	human
@JeJeFoxy	human
@JtuChika	human
@dinhoinho	human
@VictorMrqzs	unknown
@TheZinfandelOrg	human
@AlishaLiker	org
@BeaGh19	unknown
@hagavaf	human
@shvetasalve	human
@Farreys	human
@LibexRealFood	org
@crashpanda	unknown
@McD_NorthernInd	org
@ImAGoonie	human
@Cambyo	org
@kittoni_10	human
@darkskyez	unknown
@ShannonKirsten	human
@_Nathan_Lewis_	human
@madamagatha	human
@svetlanka2209	human
@avasaAE	org
@Ladyt86t	human
@NoMercyKxR	human
@48Dk74	human
@eleonorcitterio	human
@ashimataneja	org
@JumeirahFRA	org
@sLbxO143	human
@JMEplus3	human
@TheIslandPF	org
@deeHaydz_0592	unknown
@Celito01	human
@KINGCG	human
@shafiqdawson	unknown
@pattyfromars	human
@AGarrett23	human
@ClauferJimenez	human
@amfulay	org
@TootingAbout	org
@LdnPaleoKitchen	human
@IShouldBAshamed	human
@Dori_Division	human
@KnoxTeamRE	org
@Davelong2015	unknown
@AshleeBlissMFC	human
@LeAuraLuciano	human
@Baiba8	human
@Nuaey1234	human
@Stewartmoore	human
@smather21	human
@AshBENSONfan2	unknown
@carol_ck86	human
@RealDCervantes	human
@PaulettesMem	human
@Liliana_Battle	org
@CraftHouse_NY	human
@peppinoiorio	human
@djrogerescobar	human
@nightlife_info	human
@MartaRamos3	human
@damienmichael75	human
@ndiniarti	human
@GioAngileri	unknown
@lisarosestarner	unknown
@waynesutton	human
@mvarga18	human
@MegantYO	human
@May_Oo	org
@easyxcooking	org
@bkonersmann	human
@simplyhuiwen	human
@chynongcurly	unknown
@Pcheen	org
@cnmodnA	unknown
@iheartpgh	human
@jessfm	unknown
@Love_Liena	human
@cachejobscom	human
@deejaybarte	human
@girlofyarn	human
@ThisisJIMhi	human
@Don_3855	unknown
@RosscarberyReci	org
@copatinto	human
@ItsMitch03	human
@yingan51	unknown
@Amparo__Sanchez	human
@lizjns	org
@SoviExperience	human
@yujung523	human
@ChefDejo	human
@Sarah_Fulton	human
@AskDr_Jen	human
@Theonly_Kushluv	human
@iqizaziz	unknown
@Scogsrestaurant	org
@shenyfidai1	human
@Felink	human
@N_Acostaa	unknown
@wunderworkshop	org
@NatashaLukes	unknown
@Dmcromance	org
@mangal1_1	human
@Hale_Buzz	human
@KababjiLeb	org
@JisephHakim	human
@willesmamma	human
@reireico	human
@HoleNOneAZ	org
@MannyGoleon	human
@AziemahYusof	human
@addictedToV	org
@ellesbubble	human
@warota_kusowaro	unknown
@KeithPR	human
@TiffanyHoran	human
@marty_ilagan	human
@NubaHealth	org
@SherylAlfonso	human
@SandyBu95	org
@NutritionProUk	org
@dennisschutte	human
@seikaotk	human
@Benji10uk	unknown
@iventurawtf93	human
@Maria_Ardhita	unknown
@buffalosports28	human
@ayumirikura	human
@GalyaBarl	human
@tareyagreen	human
@maiteirazu	org
@ekachamporado	human
@figueroamoni	unknown
@KatyaArias	human
@jacob_mosley85	human
@CynthiaSMTZ	human
@ChristSuprapto	human
@popchipsIreland	org
@TapHouseDC	org
@dollopofyum	human
@RogHal	human
@Japan_Info_	org
@stefaniazaretti	human
@HadeeelN	human
@CrazyNouss	human
@MyThaiMadness	human
@CH0DA	human
@Kepo_JAKBAR	human
@WhiteHorse497	org
@aloveleeday	human
@thenatedaniels	unknown
@SavorySalads	org
@adrianaryeana	human
@shakebakeparty	human
@verosnow	human
@tommogassm	human
@rebelfoodie	unknown
@AdaVenton	human
@etrechiic	human
@mpad_mark	org
@tstrawh	human
@quique_carp	human
@luizreall08	human
@OaktownPirate	org
@imprintlab	org
@Anabel355	human
@acardiel	human
@YRFan82	unknown
@LeanneDelong	human
@angga_gee	human
@kaidaguy	human
@Kelkiwha	human
@michihiro_uchi	human
@IDP_Vidya	human
@n916m	human
@tammytenpas	human
@ibraei8	human
@December21st201	human
@RickyGotDaJuice	human
@RaeChwee	unknown
@thecypressroom	unknown
@rreddooctoberr	human
@Whazy	human
@poeticblogger	human
@GulatiTanpreet	human
@SolaEnNuevaYork	human
@day_molina21	human
@petitejetsetter	human
@MInutritionist	human
@YechullaElfs	human
@shandilee	human
@keyra130393	human
@RedheadQuarters	human
@BucksCntyFoodEx	org
@zeebascafe	human
@SuperNupe6	human
@NeuvooBedford	org
@aleen_mike	human
@BarnetWills	human
@LoreGzzR	human
@mollsgreenfield	human
@onzabox	org
@KhrissyKhreme	unknown
@Sarah131076	human
@youngdocNYC82	unknown
@yocinyan	human
@sheriffdoodle	human
@MilkMeansMore	org
@DW_Coop	human
@OpenRice_MY	org
@stasiaschultz	human
@SeeWooFoods	org
@EccentErica	human
@FelipeHamilton	human
@TradeBoston	org
@IamMushtak	human
@ChiBangerz	human
@YourCupofShanTi	human
@angel47630	human
@barbiebethh	human
@abeljesusjuarez	human
@RhondaHeadley	human
@RaniKucrit	unknown
@svenwieland	human
@MrThom08	human
@casviayan	org
@SimplySupps	org
@Qulinaristi	human
@rionakun	human
@SQTraveller	unknown
@RalUbi	human
@qrivocals	human
@PianoPianoRest	human
@ambzlou1	unknown
@tweetdree	human
@terhikki	human
@shelleyb99	human
@uxkaxko	human
@chrisiain	org
@mstoria85	human
@rcirujano	human
@sh7RoOr88	human
@mickycastelan45	unknown
@keeimm	human
@JAEGARCIA99	org
@JonesIngrid	human
@Breaker_Dario	org
@justinitialsJJ	human
@SpecialtyRV	org
@Zubarahhotel	human
@SMGB25	human
@jdawniee	human
@Ksavera2000	human
@aremstar	human
@waterfreak09	unknown
@Vanilla_Bakery	org
@economia_feed_0	human
@mariakardami	human
@KokiriAufEis	human
@giegirls	human
@beautyfrosting	unknown
@RaychelCaviston	human
@JeremiahsMom10	human
@balthaser	unknown
@GeneciaLuo	unknown
@EnigmaGrill	human
@JCCavallero	human
@DelilahJames	human
@Milan_Jara	human
@GGroveTavern	org
@Plus_une_miette	human
@MicModePhotos	human
@christlleanne	human
@emil_hutagalung	unknown
@JowenbergLena	human
@kiranablues	unknown
@monzavenue	unknown
@_SouthernSailor	human
@NupurKejriwal	human
@karminsoo27	human
@genn_clifford	unknown
@fazakbreakfast	org
@Vioonaa_	unknown
@JoNosuchinsky	org
@LhaGanaa	human
@iam_kixter18	human
@Crazycook_bitch	unknown
@RogerGarth	human
@JuxtaPalate	human
@OmarConchaG	unknown
@McHaterATL	unknown
@BegoodPartner	org
@summerbellessa	human
@carla_dewald	human
@bigspooners	org
@alkaye8	human
@a1ex	org
@ENA0568	human
@w_heutmekers	human
@paulgorse	unknown
@angelaswann	human
@iistiiqomah	human
@marvin_dabu	human
@VinoWineApp	human
@AshleyBendiksen	human
@iamezza18	unknown
@bailygaga	org
@urbanmommyinc	human
@CurvyGirlExp	human
@bodanerius	human
@0AmyChu0	human
@SaydeBayly	human
@HsuMJames	human
@AmyO_Indy	human
@Experience_Box	org
@vegaricky1	human
@PrairiePGH	org
@gourmetglenda	human
@amylwilson123	unknown
@FollowGousto	human
@Memetta91	human
@alexLvalentin	unknown
@FullCaffMama	org
@FissaLifestyle	human
@ronykeintj3m	human
@AlicesArbor	org
@jerflash	human
@NikosKarabas	human
@Wilson_Tiong	human
@remibriders04	human
@TheVirginiasLI	human
@kelly_mcalpine	human
@stanleysd2	org
@allyhg	unknown
@mafhe1013	human
@Between_TheEats	human
@wongsakorn_yon	unknown
@keko424	human
@chickenfarmers	org
@Orsan_Demir	human
@YangDeLaLivie	org
@idzZz31	human
@extreme_pum	human
@Mavsmendozaaa	human
@elanoness	human
@radiodeactive	human
@marieazevedo93	human
@InduHuynh	human
@T_Nix_03	unknown
@hashirikozou	human
@HeatherWeather7	human
@Belonging4Us	human
@OlneyBBQ07	org
@jasycm	human
@antzMOD	human
@bryanjavee	human
@cowgirlchef	human
@JackiieeP	human
@QueenRhonchai	unknown
@lynnetd	human
@CheloBlossom	org
@ArifW84	human
@AileenNunez22	human
@hvroland	unknown
@twotonedubai	org
@OteeaLand	org
@ClemsonFeature	org
@FarmshopLA	human
@pesekside	org
@Ndyz_Ir	human
@SBSuperfoods	human
@BeautyAndWhit	human
@Lisamulligan	human
@ThuggZeeh_	human
@Kiiro_Hasu	human
@JulieW17	human
@MezzacoronaWine	org
@ezbreezze44	org
@bing_sensei	human
@TheScientifiK	human
@OBaconland	human
@fjbcaballes	human
@ZieTamtam	human
@razzmatazz_7	human
@AnaCaroline21	human
@jvan023	org
@LinusTheGamer	org
@LizOhHotDamn	human
@BobbyBuckeye41	human
@DonFCritelli	human
@PortiaHughes	human
@beyatooth	human
@TrendyCat_	org
@jfab_thedon	human
@jarant35	human
@mikepaduatorres	human
@WomenMall	human
@londensloan1	human
@SuzVegaz	human
@i_7ori	human
@TeaTestolBuffa	human
@jessapfohl	human
@Renmeleon	human
@resroggo	human
@jenn_carson	human
@kazzacomp	human
@fariamunmun	human
@Haaloma	human
@ovie52009	org
@SanneBuren	human
@NAPIZZAME	human
@learnteachwin	human
@aleelorenzana	human
@TAPat1180	org
@BigTimeFootball	human
@SlapYaMama	org
@theD0Y	human
@Home_Recipes	org
@HumzaMian	human
@JyePGettit	human
@KellyBender17	human
@BellPubFetcham	org
@GetActiveGetFit	org
@900Midtown	human
@YangChienHsuan	human
@jerickgrant	unknown
@LeBonEvent	org
@chan_iac	human
@joyceeeeen	unknown
@Sofiferri	org
@nsg1	human
@happymercado	human
@IAM_DJ_Michael	human
@Pegleglheureux	human
@WMTT4	human
@AlyAlexe	human
@rbnwanderlust	human
@1BrianLo1	human
@TherealSerg_	human
@talithaclaudia	human
@me_eryn	unknown
@Makeitcozee	human
@DRobertPrice	human
@CarambaWhistler	org
@smugglerscoveL	human
@nourhashem99	human
@sanbaaaaa0817	human
@nattycakes	human
@Lmeath_fracker	human
@2Petunia	human
@DianaLono	human
@iwanttheish	org
@cindyfoo	human
@craig_tyce	human
@mattgoktug	human
@angelshell143	human
@OCdrumGuy	human
@carlabender	unknown
@TaxiMagic_LA	unknown
@ellmazur	human
@Mommys_Busy	org
@EzequielFsa213	unknown
@EndyZhang	human
@Berkyozgen	unknown
@leencnblue	human
@stevenfarandyy	human
@asong300	human
@soniakruas	human
@GageMadeleine	unknown
@joshwoodman	org
@MorganeDebenath	human
@Sh4nn0n_Dunn3	human
@cercandolavoroo	org
@TheCookTop	human
@mueslilover	human
@Cruxy57	org
@_clutchMYpearls	human
@candzlong	human
@shawnmsoles77	unknown
@BhataktiAthma	human
@RacingGirlKaz	unknown
@laurynvelez	human
@OfficiallyMilty	human
@LaCasaHotelLB	org
@rockymtncoop	org
@NeuvooMadison	org
@allnaturalme	human
@FellaMmd	human
@MorkelJunia	org
@LynneLaird	human
@zeebrown_92	human
@momo_k1014	human
@missoliviakay	unknown
@RockCreekSea	human
@masheen18	human
@SirSmiles13	human
@jaytoner	human
@alakalam	human
@cliff611227	human
@mmerciencore	org
@DustysDubai	human
@_bigSHADY	unknown
@Sharon2Rusty	human
@Jumeirah	org
@yoon0301	human
@fatmaol	human
@itsKamilicious	org
@Aniszimnan	unknown
@marklavina	human
@Naaiiii_	human
@SantanaMarquis	human
@Kelly6931	org
@RDFitnessCombo	human
@macaztek	unknown
@blue_lemon	org
@gfadelaide	unknown
@Rhosigma58	unknown
@B0YCEKiNGD0M	human
@haoneymine	human
@LebaneeshUAE	org
@Gbeesha1992	unknown
@epiphana_	human
@AvrioartJan	human
@ForestOfCries	human
@MElTSiNYOMOUf	human
@sarahmceneaney	human
@lpena016	human
@Lauren410B	human
@JennDavidDesign	org
@cynthiandrea_	unknown
@kimberlywyn	unknown
@DehSurian	human
@WGbergDesserts	org
@GirlyandGlossy	human
@lahraineee	human
@ediblepaperclip	unknown
@dannybthehustla	human
@sasasattinn	human
@Arwenation	human
@chrislockefun	human
@AndyDBall	org
@akosiVEENO	unknown
@ivan_kjs	human
@callmeliaane	human
@MegyJL	human
@DiamondSpangles	org
@Campani_Luca	human
@FrancisBogside	org
@ilovecrazyChi	human
@GreekIntlMarket	org
@GIce216	human
@RaceWanderley	human
@nurturhealth	org
@HildeBCM	human
@Mao_Morales04	human
@GoGayWedding	org
@ChubritsaBlend	human
@anchamindesu	human
@JJonesing	human
@Photography_xxl	human
@Jroofie16	human
@koco_bean	human
@itskurtrevilla	human
@Biaya031085	human
@elsa_miaomiao	human
@Meemz_Dreamz	human
@EnRedSuenio	human
@AgentB82	human
@p0ach	human
@PPatree	org
@Dragoninfighter	human
@itsmybeautlife	unknown
@diemondi	human
@FitMamaHansen	human
@matcha_pekoe	human
@O115_	human
@Acs_Jr3	unknown
@FruitsLegumesFR	org
@Texanadian214	human
@kaycie_lim	human
@ko______ki	human
@chuchomeco	human
@agussiswoyo	human
@judiialien_0620	human
@Brett24012	unknown
@CyprusPictures	human
@ch_andthecity	org
@meals_balham	org
@JetsFarragut	org
@alvinboongaling	human
@KayleighRose11	human
@_yrrahc	human
@Ozi_Jess	human
@Afifaaaahh	human
@giveawaynord	unknown
@RoRivero22	unknown
@parkingdude	human
@johneldz18	unknown
@LeatExpress	org
@erick_fortesque	human
@belle12dance	human
@pandulce1918	org
@ItsJustRJ	human
@West3rdCommon	org
@AndrewRadioDJ	human
@emarxbooks	org
@NutritionInLeam	human
@frgrace92	human
@etfadaloandena	human
@CarvedByHeart	org
@gsxrdanny	human
@gmsunrivers	org
@kjllore	human
@kymberlii868	org
@MELondonHotel	human
@sarahmichael0	human
@RasKass	org
@BarbarianTable	human
@ladylisa50	human
@soomilk	human
@aiimasaki	human
@mEaNNe_13	human
@grumpy_leen	unknown
@Roemenie	human
@yogactive	human
@MelissaOtero	human
@wisdomlily	human
@lrnzxxi	human
@bilinskisausage	org
@EvaRealitijd	unknown
@Coffee_angel89	human
@RobertLive718	unknown
@tiffers1912	human
@Luv07y	human
@Bluestockinette	org
@quiet1stormin	human
@marciaawonka	human
@MaddoxRealty	human
@HealerTwins	human
@PurpleCarrotXO	org
@Blossomthenice	human
@aantonella17	human
@natugadaisukida	human
@ZinnasMobile	org
@kabloemski	human
@PEARLSPetCare	human
@98_rossato	human
@DiamondsODemand	org
@missKrisana	unknown
@servicex2	org
@jooleeannBQ	unknown
@Staci4Real	org
@danientrenador	org
@nutrmariotellez	human
@aislingw13	human
@valleyviewcafe	org
@eatdrinkmalt	human
@AgnyteShorty	human
@Mlikescupcakes	org
@SuettYii6	unknown
@PinnaclePier	org
@ronanzzz	human
@Daniela_Ferolla	human
@Amber_SKBblog	unknown
@pettifera	human
@adiktus25	unknown
@wills_fargo	org
@Flosephine	org
@Mint_Nhae	human
@Caffebaci	org
@gieannecangco	human
@Chef_MauricioM	human
@walkmelb	human
@AbbyDinges	human
@beingawordsmith	human
@kapilbatus	org
@sara_lucchi	human
@OutsiderTart	human
@HerbsForBeauty	unknown
@CIRCUITToronto	human
@nhasfia	human
@N2eN2a	human
@KibritKutuCafe	human
@thomasliza	human
@pitterpatter4	human
@H0neyBeez	human
@sinbot2013061	human
@figandpepper	human
@Izziebleu	human
@LetMeStyleYou	human
@marananmabel	human
@PalominoRustico	org
@s_lim1984	org
@NabeelEjazQutub	human
@ichigotomairo	unknown
@citra_anjani	human
@uw_thuiskok	human
@melnbutterfly	human
@brozeli	human
@Nat02C	unknown
@ArtiDesigns	human
@Labrasserie272	human
@miyuromano	human
@COACHELLAEVENTS	human
@Stjuni	human
@IamReality24	human
@sole_disicilia	human
@BldgBlocks4Life	human
@itsRoxanaM	human
@KjFai03	human
@MsAnnie26	human
@Domestic_Dee	human
@Caitlin_Marie94	human
@BojanMS	human
@Eli_van_Poeyer	human
@missmyrayaya	human
@OwenSoundHotel	org
@roel_tine	human
@omgitslivia	unknown
@airdrawn	human
@JustinbArnault	human
@WeissKathrine	human
@ChristineDwerry	human
@RLMProvisions	human
@ChiFrenchMarket	human
@extazresto	org
@Morrisseybond	org
@Functional3	human
@Chrizzy215	human
@MELANIExDAWN	human
@OhhNoItsKat	human
@HighGearDani	human
@ThisIsLucey	human
@HandyImogene	unknown
@SheisheSaputri	human
@SH4HRUL_4DZH4R	human
@onawhimsicalspr	org
@DarayaJ	human
@DesireeMoyano1	human
@dian_gerrard	human
@DetSamSpade	human
@DelMonte	org
@Main_St_Market	org
@pigoutbangalore	org
@SpuntinoWineBar	org
@msaishakristine	human
@SarahEBoutin	human
@mimiCorner	human
@DirHilbert	unknown
@BlueBoarLondon	org
@EYE_LUV_ONIKA	human
@RizosRizados23	unknown
@therealMrCEO	human
@shiii_chaaannn	unknown
@thefreejinn	human
@carmenblur	human
@kasmelaah	human
@MeHiii	human
@jessbar	human
@beannaichte	human
@David_PerezS	human
@texos20041	human
@RepzForCharity	org
@ThomasKhool	human
@CoensVwaard	human
@DanaMcCauley	human
@MarshaYunita	human
@dinerevolution	human
@lydiacks	human
@PHAMOSCHE01	human
@MegganMartin	human
@mblancartejr	human
@qicsyv100	human
@1011YeongHye	unknown
@zeefolio	unknown
@cavalliclubdxb	org
@ShesNeon	human
@pinklemonjenn	human
@gematos33	human
@ShayKennz	human
@Pornifiic	human
@Powercakes	human
@Lilyenurainul	human
@Zaz_Pinkwave7	unknown
@29MMJ	human
@jpcyr	human
@steffanburgess	human
@StephanieKelsey	human
@onhighheels	unknown
@MagalieFerrand	human
@CelineBieber08	human
@Tokyostylebook	unknown
@SeemaMuhammad	unknown
@satyaprem	human
@SardunyaKarakoy	human
@RosessAreRed	human
@thislilgecko	human
@ChanteAmy03	human
@Ashutoshsamal	human
@RobGreenTV	org
@saki__g	human
@Alimarzouqi	human
@lottecharlie73	human
@JenGrifs	human
@jamesstsouth	org
@NeuvooHosTor	unknown
@kawaii_KAPE	human
@xpandachuy	human
@iamshemsi	human
@eccschrades	human
@CaslinRose	human
@TajPalace_Hotel	human
@itoh4980	human
@nikowui	human
@Ferchef	human
@ilmariel	human
@tooFATtoFIT	human
@AlexisHerrero2	human
@charickaa	human
@Fiteasyrecipes	human
@makrusio	human
@outlawyachtclub	human
@DesiAppetitePk	org
@simmo_uk	human
@veganindustries	human
@VocabSahab	human
@BlackpoolLovers	org
@TsukishirMujina	human
@Blake91511	human
@imperial_blogs	unknown
@akosijohnjohn	human
@rahsiindud	human
@AgnesSeidio	human
@JusteenSibole	human
@AmericasBarbie	human
@AlnowiserA	human
@ohandBEVsays	human
@GastroAsturMad	human
@iiambia	org
@RAULMDPRI	human
@FBBootCamp	human
@Dan_Bailey_Fit	unknown
@LenMastaler	human
@lariviera_19	human
@isladundas	unknown
@nutritional_fit	human
@stephaniedobies	unknown
@Trisshxx	unknown
@AliciaReich	human
@princessfrani	human
@peppy3	human
@mariskaV	human
@vjoa	org
@bonnaviebona	human
@larisjewelrydes	human
@EvilOne71	human
@rashidkhan_6	human
@barenakedfoods	org
@noel01525day	unknown
@wlfxnwoddl	human
@BraisdnaKitchen	org
@dreamstory69	human
@HornblowerNY	org
@tasteatchesil	human
@MissAshleyJoi	human
@justEllyn	human
@William_F_Nicol	human
@toto1010yui92	human
@BudgetdWanderer	human
@Benznaka_Kyu	human
@osiyradzuma	org
@kidsizesara	human
@1ikea18	unknown
@rita_anggoro	human
@tita_adisti	unknown
@Bellssss97	unknown
@GiuAvitabile	human
@DlxAfrica	org
@UtAh_lovesick	human
@nanita_88	human
@kanakaakanak	unknown
@xoxotoki	human
@BuckitBeer	human
@tmmarielle	human
@TheGreatRiza	unknown
@AdilaKhalidi	human
@Raykosen	human
@jpv240	human
@Livehealthier_1	human
@love2sellhomes	human
@Andieexox	human
@LashawnPerking	human
@botoosaki	human
@Sharon_Marks12	human
@Im_angel19	unknown
@michellerenee74	human
@historicinnschs	org
@ItBeginsWFood	unknown
@cynthiachanhk	human
@sTaIrCliMbElItE	human
@JtshudoPhoto	human
@oscar_mangas	human
@furrylittlpeach	human
@Julian_M_D	human
@hendrikpieter11	human
@totalNGOnews	human
@hauntedattic	human
@le_re_le	human
@aSnaRezwanSati	human
@Shibaa_	human
@MaMa_4D4M	unknown
@yushihyi	human
@NatalieMilner14	org
@sinbot20130614	human
@joshuajosey	human
@dhikakhaira	human
@PulumLee	human
@NomMiStreet	org
@trishalohand_	human
@ZincWineBar	human
@GlobeFedFunds	unknown
@LilChuKun	human
@alonthemove	org
@Officebreaks	human
@DrRoachDentist	human
@ViewtyPorapitch	human
@veggiexperience	human
@Galuh_Harjaka	human
@puiyinyip	human
@FowlesMeatGirl	org
@nataliewebbMUA	human
@gracieluv_u	human
@transition_zone	org
@Vegan_Trainer	human
@espaciomadrides	human
@aka_molkas	human
@JohnSBaybay	human
@alamoworldcom	human
@Movement19ENT	human
@bowiedj	human
@CPGFoodBevEquip	unknown
@AllisterNH	org
@unintendedfood	unknown
@ErumMajeed	human
@kharlalalalala	human
@DannyCastazz	human
@TheKingZombie	human
@pn2409	org
@mybsweet	org
@EatCraftParent	human
@distrikt_leeds	human
@RebeccaGarate	human
@MaxineSamuel	human
@chianca	human
@CrazyScoooter	unknown
@lolmaurice	human
@timafli	org
@plusixfive	org
@jindidays	human
@sheijim_wu	human
@aarcc9988	human
@seyfiusta	human
@ElmaNovitrianta	human
@NassimaBenaicha	human
@silvyfauziah	human
@motherofchaos3	human
@thisisVanessa	human
@MissKarlaJ	org
@kriszti203	org
@hanayaka9887	unknown
@ademulyaputri4	human
@LavieaMTL	human
@catimfrau	human
@yusufcanboz1	human
@eurogirl01	human
@tootril1	human
@VictorAmaro69	human
@Renisha_K	human
@schmacon	org
@lapoule2010_g	unknown
@Tl2evol2	human
@dipalkhatri	human
@chibi_pammy	human
@cntien	unknown
@cococarupi	human
@VickyDJ1love	human
@glutenlibremom	unknown
@julesdeverala	human
@oh_diplodocus	unknown
@hotpinkapron	human
@Netta_shiber	unknown
@AzarChristelle	human
@GeorgePillas	human
@wedo222	human
@Potato_Skinz	human
@FranchiseMall	org
@Grandmas_Bakery	human
@blanchevaughan	human
@NanaaFJ	human
@loveyourchia	human
@tinkerbri1212	human
@chrissvirguez	human
@JenEunson	human
@kempsisters	org
@thegaf	human
@tweetsfrompstar	org
@LennarSeattle	human
@joeltonsousaa	human
@HeraclesVillage	human
@OpenTable_CHI	org
@myleneymylene	human
@ricagudelo	human
@anggiayuniarti	org
@hamburglizer	org
@jasonyong_	human
@hoyastongue	human
@harmonicmama	human
@select03	org
@EdibleLifeinYYC	human
@iamdelafuente	org
@JunineJarabo	unknown
@NikiDiLanda	org
@tessdewolf	human
@KracherBonn	org
@littlebearcakes	org
@FrankThaSnake	unknown
@EarthBurgers	org
@chikoriiii	human
@chacharaissa	human
@RosvithaP	human
@nikki85oneil	human
@woodaustin96	human
@HerudiAgusu	unknown
@Kamakacci_Juice	org
@Wadworth	org
@NiccsTang_	human
@celii3586	human
@MiaNikki1395	unknown
@saray213	human
@nindiipurwaka	human
@HolleysHOU	human
@InimitableMayra	human
@fdalila	human
@staceylouisem1	human
@csm_z	human
@EatAtAllo	org
@mikhailargel	human
@robycusato	human
@fokubo	human
@TheBusyElf	org
@valdifiemme	human
@Douceur2014	org
@ahamedzaneer	human
@britt_zajack	human
@behindthepale25	human
@GaleriUKMIndo	human
@NapturallyRootd	org
@joan1380	unknown
@NicoleSanchez38	human
@SWT59z	human
@frecy	human
@carculturetv1	human
@AimanAnis	human
@ChefBradCurtis	human
@Radiowadoo	org
@trick_world	human
@sergetrad	human
@paulmendozam	human
@acid666	human
@One_Love1102	human
@lovieleli	human
@HohokusBagels	org
@RetnoSetyorini	org
@Nengperis	human
@A_MichelleGibbs	human
@theFoodStache	human
@Nixhotel	human
@daynecastaneda	human
@KNezTalk	human
@silversurfer8	human
@HelenRLittle	human
@unnovhe	human
@LaFourmiGracia	org
@MooTheMadCow	human
@tinakeita	human
@anaisetpedro	org
@propertymike88	unknown
@_13thirty	human
@PatriciaVoets	human
@PatriziaDuella	human
@ChezBoulay	human
@rowdiejones	unknown
@Bar145Avon	org
@ohsoimbee	unknown
@LizaRowan	human
@JanakaEkanayake	org
@JessicaBesana	human
@DNRoofer	org
@JChurros	org
@heenamagoo	human
@nicolemelendezc	human
@BelfastHourNI	org
@SERENAGOLD	human
@RBFBeauty	human
@thehousehotel	org
@Ace_Alanz	human
@1103chii	human
@thelondonchef	human
@NewDelhiFoodie	human
@mvks1	human
@_YoRasta	human
@rollopack	human
@SingleMAhoy	human
@BreatheInOutRpt	human
@vicsanchezmateo	human
@onlinerecipeorg	org
@maevegobash	human
@Radenfeat	unknown
@Guyingreenshort	org
@BVTJ1980	org
@ChocoCocoLoco	unknown
@sasith__	human
@carolsoreal	human
@ideafortodaycom	org
@ladyknight33	human
@amandakay716	human
@sfiziomanonsolo	human
@lihcaS	human
@NootJunjan	human
@NoE_pv	human
@Danettelong	unknown
@acmazo	human
@FactoryChef	human
@HakunaMatataRes	human
@swimsuitaday	human
@nakahito8	human
@WatchHouseSE1	org
@jrjCom	org
@nyduong	human
@JhulianaGuerra	human
@NiaNiabrown	human
@eda_antonio	human
@Binu_Suzan	human
@selfmadedxb	org
@iKicko	unknown
@sequintheday	human
@JZEBB	human
@azhuda07	human
@CoachJenMathews	human
@The_Suchabetty	org
@HealthierYouLLC	human
@reeeina18	org
@PranzoVeloce	org
@franklies	human
@Samurai_Justin	human
@riodelano	human
@Ol_Brown_Eyes	org
@_Reyovo	org
@o7boha	human
@amine01411	human
@DrPedre	org
@LeonardoRuizzz	human
@mame_shima	human
@MangoTreeUAE	org
@JryneB	human
@5IdiotsInHead	human
@Tsukiwarrior	human
@Deaf_BSL_Usher	human
@WendellmondLife	human
@Salah_AlBastaki	human
@birdrestaurant	human
@jessmdza	human
@Ad_Chowder	human
@ecr9495	human
@Dandelcastillo	unknown
@LakelandUK	org
@getwildewithmw	org
@MonicaBlckBlssd	human
@VioletAshes	human
@HajjFlemings	human
@Dian_ayu	unknown
@iedamus	human
@RochyPalencia	human
@shazmnelson	human
@ayapon18m	human
@brian_nath	human
@GlendaBurke27	unknown
@inneadi	org
@YumbabyShop	org
@Marcela_pazzz	human
@blondin3tteuh	human
@JC0692	human
@mobad3	org
@hungryforpoints	human
@Missyee78	human
@roguejaguar	human
@MsJamieeB	human
@TigerTamra	org
@bettyvivfitlife	human
@MattBasically	human
@PortugalLovesR5	org
@akitchenbox	org
@chadmarra	unknown
@foamlennox	org
@biankabrunner	human
@know0619	human
@Vivienonguyen	human
@CurryYou	human
@lauraknaub	human
@nocreolecookery	human
@CarylMarquez	human
@MarriottEABh	human
@Johupet_	human
@SOLECALcom	human
@swanfacegrace	human
@Oak73	org
@dizmelonz	human
@mond0721	human
@AFood_Odyssey	human
@MokaDfoka	human
@ChrisCakesSTL	org
@MacondoNYC	org
@Pratab_JeE	org
@nakobaby711	org
@deanwilloughby	human
@HusseinKhalil55	human
@palmiijung	human
@yolennymora	human
@PlatinumEvents	unknown
@FreshTraveler	human
@lucysewell_01	human
@allvertto	human
@ShawnIZJack13	human
@sushiandshrimp	human
@sherlypangan	human
@entertainvic	org
@slavakarimov	human
@TsuiRen	unknown
@SharaM13	human
@SwaggaBo0	human
@andyohism	unknown
@nikkicxn	human
@eatdrinkduck	human
@olivialmka	human
@bradleebone	human
@DeniseGittins	human
@darrendei	human
@rahmahf08	human
@RchrdChn	human
@licca88BB	unknown
@MommaMoski	human
@MelinaHartwig	human
@cc_uxm	unknown
@ayrtonsenna0909	human
@AygEs	org
@YoSoyDaniiela	human
@montereys	org
@BlackbellyCO	org
@WhiskyCraig	human
@Jaflongcurry	human
@pooh919_JKS	human
@Bistromd	org
@kojiharumegami	human
@SaraGuerard	human
@HeartbreakPie	unknown
@charltonmanor	org
@Sexychix_24	unknown
@SEXYBKDIVA	human
@Yae_f	human
@michkaforever	unknown
@craftyyuppie	unknown
@IsabellaE2807	human
@aussieinbrit	human
@10010325km	human
@JulianBailey81	human
@dripsyche	human
@aaronvandijk	human
@Polly_18	human
@AromaCafes	human
@oycellarsdavid	human
@theneverfull	org
@heartlove09	human
@HasreTSoysaL	human
@BenSyazmin	human
@Deafboiii	human
@pusspitoutomo	human
@AlMansharRotana	human
@MURontheDL	human
@SuperMommyClub	human
@SnowdenFlood	human
@vrapriskila	human
@AshfordRafe	unknown
@REMRAFinc	human
@floorchuuguiu	unknown
@bloomingfox	human
@Timiochukwu	org
@Travelerbliss	human
@lucacinacchi	human
@Elrheynn08	human
@jackyfung	org
@OCNetworking	human
@eduard_grajo	human
@ayeshaaleem	org
@hazalseref	human
@RamadaChelsea1	human
@ramennagimanila	human
@26jeanna	human
@Kenesha_Dynae	org
@unstoppablemthr	human
@AzuraNasmi	human
@BrizeidaHLeon	unknown
@Buster_UPG	org
@AngilaMallard	org
@MIRD24	human
@CUTI3PATOOTI385	human
@drogonthedragon	human
@Alexandre_Sim	human
@chanie_11	human
@PhoenixNewsUK	org
@DuanTing	human
@keimayumi23	human
@lamujerdemonod	human
@CoconutHealth	org
@Vvsay7	unknown
@AnnieBi	human
@MsPinkDiamonds	human
@iggkrisna	org
@JunkCarsMonroe	org
@erintris	human
@johannatania	human
@missmoneynica	human
@kaede_bg	human
@cynthiabece	human
@Billboard4387	human
@SamVillarino	human
@LLebronGinorio	human
@DJJoonieC	org
@EnoraLmj	human
@allegedlish	human
@MissTravel91	org
@danielleismavic	human
@Sue_Rocks	org
@lamlett	human
@HERSHEYCHIP	human
@don86cher	human
@mj_oleary	human
@TiaReneeG	human
@austinprotocol	human
@imrow22	human
@TacticalTony702	org
@UpinAce	unknown
@serasparkles	human
@inkstained_rain	human
@FictionalClown	unknown
@rosalyngambhir	human
@ERIKO_0204	unknown
@Jurgensmeier	human
@OTRKitchen	org
@Nutrizonia	human
@SweetBoxTruck	human
@iselima91	human
@WendyWendyp22	unknown
@Wydad_Serii	human
@Unspun_1	human
@egadvj	human
@himawariCANA	human
@theJJAlvarado	human
@miera_asriz	human
@aida_mio	human
@MaryinVancity	human
@shareourshop	human
@piterpanjaitan	unknown
@WhatTheFahd	human
@mikewowayu	human
@domesticgoddesq	human
@Lotts29	human
@lvanquaethem	human
@SafeenArif	human
@AlmaModaAldia	human
@japiriyoi	unknown
@ditalollyta	org
@Summer_0406	human
@hayleymackay24	human
@Tjandra_URL	human
@poyo_mmk	org
@Ponpondd	org
@imJohnAustin	human
@whittleLDN	human
@Wahyu_20408	unknown
@CharlotteLewis_	human
@MelvinSupernova	human
@developmenbytes	unknown
@onestrawrising	human
@bass250g	human
@DaniaDnCloser	human
@TestKitchen	org
@Yua_hyun3424	human
@TidefordOrganic	org
@king_of_miami77	human
@rose20012	human
@SleepyV209	human
@vuance	human
@karenledbury	human
@SpyBRE	human
@Riittalicious	human
@merilynperryman	unknown
@alenasbdesign	human
@kevinjohnn	unknown
@SaskiaVDWDR	org
@subtel1	human
@boboya_chan	human
@Baltimore_James	unknown
@vincefilamor	human
@hassanaqeel2	human
@DebbyKaesang	human
@khun_noo	org
@RyanWong_MUA	unknown
@hlystroud	human
@pen_awa	unknown
@MingTangEvans	human
@erickchang	human
@ZhenZhenYii	unknown
@CharlotteCamden	human
@DaynaWilley1	unknown
@katsaire	org
@kitchenetteru	org
@EsraAkeroglu	human
@Nadineannthomas	human
@hooonyooo	unknown
@stephdollie	human
@manardpama	org
@tttttonkichi	human
@gretarybus	human
@fritehaus1	org
@iJonessara	human
@accorjobs	unknown
@Thelazyone78	org
@SLarochePhotog	human
@StacyVonDoom	human
@Earthform_pei	human
@morrowchris	human
@Khatieb	human
@AllStarBurger	org
@tiolutha	human
@thestylependant	human
@lickedspoon	org
@Soca2k2E	org
@Twitmercials	unknown
@MsDee	human
@thejaredow	human
@FultonsDunmow	org
@pornnoppa	human
@LizaMoscatelli	human
@LavalleeGmail	human
@ClaraBMH	human
@dchthediva	human
@NewsAAPL	unknown
@tweety_jalz	human
@ThidaratKaha	org
@gfullenlove	human
@doctorsglass	human
@LauraMueseler	human
@causeforalarm	human
@Iyubinest	org
@CM22LR	human
@julesaj1	human
@AlbySalisReal	human
@IdolaMekarPR	org
@luckfordays	human
@WhatsTheT	org
@noireabsolue	human
@lisalicious13	unknown
@azzir12	human
@jamollison	human
@_fionaforsyth_	unknown
@desynatasya	human
@timjalvin	unknown
@iTALI_emup	human
@Rockibby	human
@Miju1018	human
@shiny_feathers	human
@iMehreenSyed	human
@Tony_Boccara	unknown
@AkBecerril	human
@smplyrealhealth	human
@djkayris	org
@FunkmeisterND	human
@JennyPacey	human
@eatstk	org
@_MuscleDiet	org
@Senorita_JMarie	human
@sugarcrush	unknown
@itsErwiN08	human
@swimcharlieswim	human
@KedaiBunda	human
@mishyclusive	unknown
@TizianaFerrieri	human
@prince0324	human
@kaz_rockwell	human
@tiptree	org
@mikaelpersson	org
@KasandraBodie	human
@Beckyhanes81	human
@mataisawesome	unknown
@Capt_Kid	human
@The_Andes_Cafe	org
@leleyrachel	human
@Asaro_Lover	unknown
@FrugalKris	human
@Mayffins	org
@hazwani_hamzah	human
@Flavahoove	human
@GreatTeacherRiz	human
@glitch_bot	unknown
@ferretbite	human
@dododut	human
@GregHaerich	human
@Reup_Rio	human
@TChienCheah	human
@chieeicy	org
@marim01214	unknown
@JLipz_	org
@LBfindmystrong	unknown
@mollyraftery	human
@balgaa	org
@westfieldstrat	org
@OyienOCB	human
@snowcitygirl	org
@Cclavaud	human
@garythefoodie	human
@ArielleLauren	human
@ElgauchoIndo	org
@PSuito	unknown
@sweet_dee75	human
@Tualekz	unknown
@spaceseeker	human
@Modern_Romantic	human
@IroquoisNewYork	org
@heylichen	human
@hokabear	human
@gillianlynch22	unknown
@Ziziilfana	human
@kenneth_Weweet	unknown
@Kattyluy	unknown
@BrandAndreas	human
@abqnobhill	org
@Oilly_Piiza	human
@CharlKell	human
@HotelCentar	human
@Aj_adam	human
@Ruzandi93	unknown
@UpulTR	human
@KG_yurika	unknown
@QueenCDJ	unknown
@LeaPoupelin	human
@abbyjohoff	unknown
@TolentinoAneto	org
@zubeisme	org
@AlbertsonsAZ	unknown
@HydePanaser	org
@jhonikasim	human
@cutiesfie	unknown
@amaliewichmann	org
@LeatherApronCom	org
@bfrielg	human
@theshakergal	unknown
@homebar_suigyo	human
@Dejvi_93	human
@aquafuzion	human
@Amalikazmi	human
@aidacht	human
@eatbrunchcafe	org
@mrsmoore77	human
@DMVGirlsPintOut	human
@BuyangIcha	human
@Jabbash	human
@Mac1RoyC	human
@SicilyAuthentic	org
@DrFumblefinger	human
@NehzHus	unknown
@StillmotionYoga	org
@katiesheadesign	human
@charliedwatson	human
@chefshorne	human
@TheTinyHooker	human
@TharaAzzam	human
@ang_yeo	unknown
@AliceRook	human
@cmssupport247	human
@BryanInMiami	human
@nima850405	org
@maruyumi	human
@besoulflower	org
@weengineparts	unknown
@DEEJAYROBREEL	human
@peekaboopotty	human
@KenLeeYinnHaur	human
@esavalente	human
@DJHennieV	human
@jaMESulikecrazy	human
@AiroldiFineWine	human
@sibarra39	human
@Juhaida80	human
@nikij214	human
@NitaB305	human
@ark614	unknown
@Delshad8	human
@NatanyaSA	human
@yunkmr	org
@DENUBBIO	org
@sunburstnaples	org
@Lasmolinas7910	org
@munchwows	human
@jongseena	human
@MARIOLOIS	human
@PaoAustria	human
@BigLilJNigga	human
@goldenoatsplus	org
@IrmizaS	human
@B_NARKSAKUL	unknown
@jr1ny9	unknown
@Port_Robinson	org
@nikigator	human
@JuneJoone	human
@jessiiiieebooo	unknown
@prettyfanclub	human
@BushraChaudhry1	human
@ChanHoyle	human
@reur12	unknown
@SGiornal	human
@Caro_Pellegrini	unknown
@Deehluiiz	human
@MOKKSHA	human
@Cafeonhedges	human
@pereira_kev	human
@ikamarizka	human
@MinokoNg	human
@thaalfionithaa	human
@OlliffeButcher	org
@iameiljohn	human
@yingsteh	human
@Romelaine	human
@perez_hall	human
@ChChChianti	human
@Kruella89	human
@MacyNessa	human
@WorkExpBlog	org
@HempUniverse	human
@Sm00thT0ny	human
@1944Ocean	human
@Dimmetro	human
@HoustonTParty	org
@yurikarikarika	unknown
@rockstarnate	human
@ShopCheshireUK	org
@lppdcha	unknown
@Charlamee	human
@thetweedlets	org
@sbquarterly	org
@iAm_MaraG	human
@EmilyMiller53	human
@Henry0828	human
@steamshipgrill	org
@5exasaweapon	unknown
@BYTeventmaker	org
@SFSUCafes	org
@huebnermarquez	human
@LueersPartner	human
@TramyardDalkey	org
@MosconiBertani	human
@walphweyes	human
@GizellaMaldita	human
@Andym6769	human
@MartinPlaceBar	org
@lfoy62	human
@BigFishSXM	human
@r_u_aware	human
@vanheelh	org
@thebuzzagency	human
@TheJennC	human
@DianaGrig	human
@JimmyPeeeee	human
@jawn3	human
@TUMBOMB94	unknown
@Doc_Adrian	human
@HectorHiidalgo	human
@GoodLuckSh3Man	unknown
@foggybottomgal	org
@asmaraniminie	human
@TheAngieChu	human
@rmrmrm20134	human
@cjia28	human
@marsya_imelda21	org
@markpdaniels	human
@NomNomPR	human
@setobelihater2	human
@mipoin	human
@drsharnael	human
@wineinmom	human
@IchibanSushi_	unknown
@thebinblog	unknown
@IrishMamiduh	human
@Loamanui	human
@smilesallen	human
@dlay15	human
@currentafare	human
@MOJARRAA	human
@Aprilgunn	human
@biiCarmen	human
@ch_Rena_M	unknown
@rosieteare	org
@SociableApparel	org
@CliathAthaBaile	human
@RapperE	org
@Rj_Rein	unknown
@imhbha25	human
@Nyomiko	human
@Myhealthydiaryb	human
@eli_marongiu	human
@GoBerryME	org
@Fern_ka	human
@OskrCA21	human
@PaulTonge1	human
@tbflowers	human
@JoMyGosh	org
@FraserSuitesEdi	org
@Phepheskitchen	human
@tastemanchester	org
@indahayunda	human
@AshCatHoffman	org
@MssTius	org
@Leighleigh521	unknown
@lwoods604	human
@itsmejody21	human
@marcos_ven	human
@Make_ItCouture	human
@Ladycaja	human
@ollomalibu	org
@ClaudiaVinco	human
@HawaiianDiva35	unknown
@catherinexxwg	unknown
@ClaudioOyarzunL	org
@DenaDollBAD	unknown
@MaseJoJo813	human
@cielosky_esse	human
@JuniperCafe	org
@SimplicityEthan	human
@YWSToronto	human
@lemonjellie	org
@CaroleHrm	human
@SicaLai93	unknown
@BrianChinzo	human
@TriposoHamburg	human
@PyjaMassam	human
@aoi_maaar	human
@josue_prudente	human
@elleestgemma	human
@mark_shakedown	human
@babciapat	human
@nurulhafiza93	human
@windymsa94	unknown
@dechy_ariani	human
@NatiSebiElla	unknown
@DirtHammer_Crew	human
@Miss_Tab	human
@iAmMuziq85	unknown
@jjstrucketeria	org
@kaitGAY	org
@mado_pu	unknown
@raysng0630	org
@AilaLamigo	human
@MariachiRB	org
@PRCPSDVI	human
@OrialiArroyo	human
@RaggasCafe	org
@Martainirlanda	human
@PennyloulouGTA	human
@BruceABorders	human
@AfreenIman	human
@WthaHatchet	human
@marcegigi	human
@kenny_bneo	human
@sushavan	human
@NanaCikRafi	org
@foreveryond	unknown
@denim26	human
@Lombroso16	human
@Istnblrstrntny	org
@TyAirrah	human
@itsmekaleb	human
@MargitamMary	human
@A1R_RUN	human
@OfficialJevaaa	human
@Viva_laArie	org
@TheLadyCupcake	human
@A_meilaisna	human
@hhlim991	human
@naromehafyjy	unknown
@SauroMartinelli	human
@williamsonsrc	org
@feakins25	human
@Crazy_Reinaaa	unknown
@daveilarroyo	human
@RedMilkOnLy	human
@dimmi	org
@pakwanCuisine	org
@toyz_c	human
@hamishmelbs	human
@IslandLawyer	human
@Erin_Vincent35	human
@kapitan_luk	unknown
@ZlataThoughts	human
@Theo_Syrette	org
@KekkoStrosciaEM	org
@healthybox_jkt	org
@MelisaAlicia13	unknown
@majabruha	unknown
@123UkuleleTuner	org
@mrtahirmohamed	org
@eatupshrewsbury	org
@robby_jenks	human
@hill13_graham	human
@TheCravory	org
@mrsmoon91	human
@ElijahGarcia_	unknown
@jakeyboie	human
@tamela824	human
@DiME_DiViNE	human
@chrisandclick	unknown
@lydia_loca	human
@thejpXpress	human
@TokyoSukiyakiT	org
@L0v3yi	human
@WeTrendNation	human
@CharlesTucket	human
@teenieeweeni	human
@CasaBermeo	human
@YummyCuisine	human
@fungse_wilson	human
@iWESrodriguez	unknown
@trini_virgo	human
@orsoshesaid	org
@YoungChefsIntl	human
@mireia_thalia	human
@ihimberg	human
@GoMarketingHub	human
@Cossetnz	human
@GON_ZO_THEGREAT	human
@Liapedroso	human
@crossroadreview	human
@ttprd_np	human
@t0riigiRl	human
@GettinToDaGwap	human
@PianoTalent	human
@14Kappa	human
@wallsie2712	org
@aMareRestaurant	human
@FinchCagle1	unknown
@meganfergy	human
@CakezNoSweetz	human
@EstateFinds4u2	org
@foxxdoll1223	human
@Bobjohnson1word	human
@VancouverPlaces	human
@adomani	human
@alicegourmet	human
@briag79	human
@alkalhyn	human
@wsnizam	human
@Coleendk_SWS	unknown
@Brothastep	human
@dawntroversial	human
@L30p	human
@rheiinaayu	unknown
@jazzelfuertes	human
@Diva_VIP	human
@ViStylin	human
@dynamic_girl1	human
@satarupaseal	human
@ceciliademejia	human
@rockvalley	human
@cerenkasap	human
@marianne_00	human
@ImmortalPrynce	human
@DIYMelissa	human
@rosiespeaks	org
@marymikesell	human
@therootblog	unknown
@TelegrammeTls	human
@Marketer_UK	org
@therealautoblog	org
@mediaevalgirl	human
@misangela	human
@smillie32	human
@imNursePreh	org
@CintoAjram	human
@NeuvooRaleigh	org
@NTCcn	human
@Erwin_ProuvayA	human
@RRizkishabihah	org
@DitmasLA	human
@hayleetiong	human
@liaraven	human
@Youiing_s	human
@JarrydKellett	human
@saraalmulhim	human
@Kreative_Eye	org
@SarahK1rby	human
@CarmellaT1	human
@kayeccendreda	unknown
@LaBasDiest	human
@frenchieyankee	org
@KSrealestateInv	human
@amandaklopez	human
@JennyEvolution	human
@SLAPFISHseafood	human
@Kumihomiko	human
@Olivernome	human
@DodeySwagg	org
@JennyTindlle	human
@PATRICIOLOPEZZ	human
@apwitter	human
@CowboyGamedevBt	org
@michellebowran	human
@frecksyclan	human
@tml_style	org
@CzechBlondyn	human
@ComedianTyRaney	human
@akoZitiZay	human
@donatellafb	human
@Autis_tic	human
@intanumbaran	human
@bridgetslewis	unknown
@MarlonTadle	unknown
@rebeccaglover7	human
@lakshmi____14	org
@CSOrganics	org
@Ashley_Danto	human
@kentroversiall	unknown
@Chris_RojasC	unknown
@Fan_AdriFonseca	org
@Thidawaree	human
@YorksBakeryCafe	org
@RacquelBeauty	unknown
@DunkinNC	org
@modernverity	org
@LHWHITTAKER	human
@Bernsteinsdeli	human
@nhunuuwbachry	human
@WuRie_ri	human
@IvanLeonheart	human
@rastaEsi	human
@ToVogueOrBust	human
@OfficialNobita	human
@TamTinaanne	human
@djJohnnyExtreme	human
@vivia_paula	human
@undertheLBD	human
@benzza5929	human
@airrescue112	human
@pedrovllvc	human
@Joshep1990	human
@UnMalin	human
@mcheza03	human
@savenmi	human
@losaway	human
@TheFoodieJen	human
@PicThisDublin	org
@RestMercado	human
@FisherELF	org
@forkontheatlas	org
@michkaytay	human
@AuctionRSSFeed	org
@adelinayasu	human
@NK8Kirman	org
@RumahSnackInd	org
@joseivanez	human
@TGRBattersea	unknown
@RamsesTMagnum	human
@FoodTrailersATX	org
@stampmeup	unknown
@coldmountaindew	human
@BonnerTurner	human
@joylmh	human
@CanadianGlazier	human
@Silvestrin85	human
@letscookyallah	org
@glowwithsummer	human
@FakeLondonerJrt	unknown
@Freelunch_nl	org
@jraychula	human
@24stgeorges	human
@Romikaram1	human
@SophiaStJames	human
@Love2blog_uk	org
@andysampe	human
@clone9design	human
@NazarBlueUK	human
@nbatash	human
@trotters_cafe	org
@SharonMercado03	org
@majid_sabb	org
@JaiManny	human
@Choco_Oppa	human
@KpieTheMua	human
@AnnaGamboa	human
@gaileancheta	human
@caroline_eliz	human
@PaulLeitnerWise	human
@zatiromli	human
@moran1999us1	unknown
@angelbarb316	human
@aRoseandaPeony	human
@TheRealBubbly	org
@haaaananananana	human
@ieseon	org
@King_Mu	human
@ApiratNomnavi	org
@DrumsofDharma	human
@ShAkEsHeArE4	human
@malcriadota	human
@ShwuMin	human
@mfguada	human
@lbdkloma	human
@faithwconsult	human
@Seriouslyok	org
@OnSight310	org
@Rovertino	human
@polvspolverz	human
@MOB_espresso	human
@wolfphoto	human
@eliselao	human
@1_Majestic_1	human
@mejr_bauzon	human
@leeeakiii	human
@MyDailyRndmness	unknown
@salliemclean897	human
@dyingfromtrying	human
@ms_rebirthink	human
@inWestmetMik	org
@agustronin	org
@MyRunwayDiary	human
@jeenawade	human
@Mz_X_	human
@cassiebuss123	human
@SeaPearlVA	human
@milestomemories	human
@MissTallas	human
@rosecort_	human
@Shanae_SweetK	human
@PooLoozajung	human
@AfonsoRodrigue5	unknown
@ShellenaG	human
@sound_sandwich	human
@FuturArqSD	human
@eliburguera	human
@Icyhish	human
@memyselfsarah	human
@izzatie_nasir	human
@PARKROYALmlbair	human
@abigailisa_lc	unknown
@espressoplusuk	org
@StackChefs	org
@BlaqEcko	human
@hoecheyong	human
@vizcaya01	human
@Brenachinelli	human
@joy_lane_456	human
@Ck_Mohammed	human
@doclesj	human
@rmarshallsmith	human
@vickiiotegui	unknown
@Maricela_Rod	unknown
@prpltz	human
@PjSimonaticz	human
@purplesekar	human
@chocolatefrosst	human
@FreelancerModel	human
@Finchayy	human
@nnisulia	human
@TomCarrBWFC	human
@MichaelCamerlo	unknown
@amndgo	human
@QSHYT1	unknown
@JElhage	human
@samnmi10	human
@Fabulosity_She	human
@_Inndah	unknown
@NumSUG	human
@dawnyelly	org
@oaxacaonwheels	org
@FABULOUSLYFLORA	human
@McGrathHotels	org
@johnkhor777	human
@PatuNolasco_	human
@yayank_fld	org
@eri2kurukuru	human
@cottonhousebcn	human
@NeuvooOCCA	org
@JaymieLoach	human
@SoSoulfull	human
@ManojSethiSEO	human
@850veecee	human
@GirlWalksIn2Bar	human
@EgiRozten	org
@JoshuaWilliamD	org
@ChefJayFoodhall	human
@my_ish_cray	human
@alessandraio15	human
@AdibSamara	human
@IRENEBOLTON19	human
@OurNakedAus	org
@ahotzDC	human
@8bitwonderland	human
@TRIZAIFOS	human
@Ann_NuhBell	human
@JM_CuSan	human
@kphilipk	human
@okay_kit	human
@Ichacunz	human
@aryannas31	human
@SallyEgginton	human
@foodtruckslasve	human
@ResultsFitTrain	human
@angelica_rosa92	unknown
@cedartreeae	human
@TokyoTable	human
@Tetra_Pak_India	org
@lee_the_vegan	human
@LindaTurton1	human
@aininaAlAwal	human
@HungryCockroach	human
@dial22tone	org
@annmariew85	human
@amILanguishing	human
@sikokubot1	human
@ELAINEDALE1	human
@michaeleejiang	human
@Elize_Skriker	human
@oliobymarilyn	human
@typhlsn	human
@plunkster	org
@hidri_dp	human
@mitchoy0205	human
@didine0807	human
@thejohnmeredith	human
@ShoreTravel	unknown
@GroksiSnack	org
@akomalove	human
@KaewQpiz	unknown
@porziaparkdale	human
@KatieGreenaway1	org
@RealBenFiner	human
@opensantamonica	human
@GmBangalore	human
@Rodhenmeyr	human
@rogelioandradea	human
@Mahantesh19_	human
@JomeL_Anthony	human
@StanislavMusic	human
@tezzierika	human
@HFCFilm	org
@HIMaidstone	org
@randyhigh62	unknown
@DaisiesforDaisy	human
@rosariopipolo	human
@kowjecks	human
@IsraelEuceda	human
@bobhammertool	human
@irenademarco	human
@Shinobiobi	unknown
@fluffymisskitty	human
@childscg	unknown
@butterflyeye21	human
@kanadens	human
@MaiaBongiovi	unknown
@proudlibran	org
@EMYCONLAIPSILON	unknown
@ashmigosh	human
@staticmm_nyc	human
@jsomethingmusic	human
@derabrain	human
@PurringGirl	unknown
@amintaonlinecom	human
@English_Rosiee	unknown
@WainuShiao	org
@jenny51226	human
@JaPurpz	human
@ByblosHGroup	human
@StyleWanderer_	unknown
@JonesyC88	human
@handmadedealer	human
@EmileVillalona	unknown
@RouseRengert	org
@Il_Comico91	human
@OttoOrlandi	human
@howardboon	human
@killingpepper	human
@Pinkgherkin	human
@Fourk440	org
@Senor_DonJuan	human
@TuscanCafeNY	org
@GreenEyedAmazon	human
@kristinesumugat	human
@iDidGo	human
@yuumi_t1029	human
@shyness12	unknown
@stephanie_cis	human
@Burritobox	org
@Soggyman636	human
@naa_taan	human
@HajasAdam	human
@SHOUTatJAMES	human
@henkdekapper	org
@AKenyanGirl	human
@VictorHugoDeli	org
@jac31	human
@Mandyi44	human
@irmaJW	org
@KernowSausageCo	human
@Muti_Keiken	unknown
@myleneuh	unknown
@TdkD6	human
@Kartabar_	human
@DreIzMe	human
@JadenKale	human
@no1_0911	human
@man_cm	human
@GroutsTheBakers	org
@noophyy	human
@jfmlconsisa	human
@cheer_for_beer	org
@Palms2Peoria	org
@glowiegorgeous	unknown
@schiavetti_gaia	human
@stefffmichellle	human
@suzyq_	human
@alixjuillet	human
@elifaleynaerdem	human
@NSyazwane	unknown
@AryLissette	human
@gourmetfoodwrap	org
@pcanarinho	unknown
@AndreaCooktales	human
@sejostarsky1963	unknown
@carterasonforge	human
@maysam220	human
@JuanjoEnf1	org
@AntonelaDeMarco	unknown
@AbbieFit	org
@YOKOTANOACE	human
@gunNADIA	human
@blueskyinmypkt	human
@zuperiris	human
@carenmagdaong	human
@FrinetteVic	human
@julescomps	human
@BlaQueen_0119	human
@ShubliFaka	unknown
@CarPrice9	human
@TokiUnderground	org
@FaZ182	unknown
@brownbeautysim	human
@mabel_rose	human
@KimHans39020801	human
@cafegc	human
@spicesix	org
@gaby4cantu	human
@WitsInnNOLA	org
@BluewaterChatt	human
@TeacherRosa	human
@MiaPinchoff	human
@Shannon_Wylie	human
@ericdioquino28	human
@fitliving_blog	human
@skypaints	human
@Eddy_Rojas	unknown
@AnnelieseTooke	human
@ChelseaWidener	unknown
@hilaryrfeldman	human
@pikachu051881	human
@lizville4e	org
@mijorecipes	human
@sabfashionlab	human
@Emilie__William	human
@bk9421	human
@oh_corcoran	unknown
@callynnlynell	human
@inBENGKULUcity	org
@MelodyMir	human
@Jeremyfreak	org
@RL_HiouzKey	human
@itserwin	human
@xanggaa	human
@SeasonedbyChefs	org
@JenkinGrey	unknown
@BeTrueHlth	human
@TheBackYardLemo	org
@ElenoreAldridge	unknown
@JennThien	human
@jessielevett	human
@WFazackerley	human
@yahicafe	org
@Jacsafterparty	human
@CINZIAMERCURI	human
@rungurl28	human
@mshellbarillaro	human
@TornRanch	org
@princesablue85	human
@Chi_Ify	unknown
@citramartin1	human
@melanieleduc	human
@_meltedskittles	human
@Jesussrom	human
@YolandaGranados	human
@MenloParkMall	human
@Jer_Godfrey	human
@calspoon	org
@bewakeman	human
@Irwansyah80	human
@minori_shibue	org
@RidgemontPizza	org
@milanopizza1	human
@FUOFY	org
@bomsamaai	human
@StarringUJewel	human
@saraaukasyah	unknown
@sixelagarcia1	unknown
@Jig_C	human
@RenataBoruch	human
@csstahl	human
@mayara22dani	unknown
@tweettz	human
@LE0ports	human
@Rpastaitalia	human
@aizhidalgo	human
@myeyesseenitall	human
@NikkiKaapke	unknown
@CockadoodleRest	org
@crisnycgirl	org
@coolworld74	unknown
@Courtneyb_318	human
@goreclg	human
@QuintusJansen	org
@peniselectrix	human
@NanooWz	human
@NoviDwiAzhar	unknown
@kickthemonkey	human
@jxs606	human
@cuisiquepremium	human
@michaeljstory	human
@HotelTeixoeira	human
@nlyce	human
@Qtbear	human
@EverardBess	unknown
@PreserveBayClub	org
@adv_maru	human
@Free_BFines	human
@fitcliqueafrica	org
@TeamWPMaine	unknown
@Loobydooby24	human
@MsMelanieSykes	human
@YYZchef_cult	org
@Valeskamuller	human
@misskikillala	org
@kristen_leighh	unknown
@DonalSkehan	human
@HudsonMaloneNYC	org
@itakzui	human
@LTshibesa	human
@mattheaosinga	human
@maggietranquila	human
@PrincesSquare	org
@AtlRepublic	org
@poetic_sound	human
@KungPowKings	org
@GuamanianVixen	human
@Joseph_Cookies	org
@fitcoachdana	unknown
@PinkpuffLoves	human
@Alix_Crothers	human
@haiderodes	human
@jeanne_nana	human
@Jinath_Hyder	human
@SabaiThaiKanata	human
@Vivianchu96	human
@puppetfut	org
@GiuGiuLikes	human
@thehouseofzella	human
@Limeyard	org
@Marie_Chesnais	human
@nata_green	human
@joantungul	human
@sInta_Cipinky	human
@PixelsAndPumps	unknown
@TheFitVet	human
@Latinfoodie	human
@alxndr6	human
@PassioneCirio	org
@Zee0207	human
@ChefMonser	human
@i_am_apollo	human
@xtristessa	human
@ankm8922	org
@imredpula	human
@LynnLeeYee	human
@AL1_Z4MAN	unknown
@iSeruhio	unknown
@carlmahoney	human
@IvorRadanovic	unknown
@twinsrus90	human
@NEBuzz	org
@iotupdates	org
@BellevueClub	org
@iMaczthon	unknown
@naaa_tyun	human
@AkyuAkky	human
@sofoodsogood	org
@bestcapetownSA	human
@bekapath	human
@PerrierUSA	org
@LinaNauli	human
@finessethejawn	human
@MBOA237	human
@HomenHearts	human
@ahmedtweeeets	human
@Spikertaz08	human
@ALittleBitLaura	unknown
@DitsyNagle	human
@BRB_Eugene	unknown
@ArthurBovino	human
@princhesta	human
@csuuarez	human
@ServoVendi	human
@halfmilecabins	org
@xJennaLouLou	org
@Fleursaison	human
@ayeshatb	human
@bbclisabiondo	human
@TyreeTautogia	human
@PulpKitchenSA	human
@AdelaydeKP	human
@Misusan	human
@nattcandylover	org
@97_meggy	unknown
@crystaalle	unknown
@diostebendiga01	org
@laloPonc_	unknown
@Cobham_Tandoori	org
@TriposoIstanbul	human
@marimarmat	human
@FoglifterCafe	org
@JvacAttack	human
@_samhara	human
@MHAWIRAL_	unknown
@AECHyBreakyHart	human
@Juampi57	human
@spud_sleepy	human
@Discriminating2	human
@jesshawthorn	org
@mary_healthy	unknown
@preciouseyebrow	org
@LivingroomR	unknown
@KamelaHurley	org
@xx_kapi	unknown
@bohwestlake	org
@bare_bowls	human
@Tasteohsoghudd	human
@msbrooks98	unknown
@thesuperallan	human
@TheBlonde17	human
@EmmaFLPuk	human
@rullos618	human
@JacobHanrahan	human
@sofiacollib	human
@Titi_KamaLL	org
@AyyRoc	human
@DebbyArts	human
@mehrotra_neeta	human
@GordanJordan	human
@ZhanaZulkifli	human
@BrunchBites	human
@geekandahalf	human
@Vendee_Live	human
@eridondon	human
@Des_D_Diva	human
@keenankris	human
@RedOneRabbit	human
@HPRLONDON	human
@itzniques	human
@DjNovocaine	human
@EatingOutInMTL	human
@benalewis	human
@HealthcoachSJ	human
@farahliyana18	human
@Nabilu	org
@urbartender1	human
@Lyndzzz	human
@emjhaybillones	unknown
@Hiphopbattlecom	org
@HavanaBankSq	org
@laika_1987	human
@Troy_Williams	human
@TheSnakeGod	human
@jefftalita	unknown
@chamsogiallo	human
@ItsGiaNotGuia	human
@toscaaliceen	human
@ZedBarAlbury	org
@littlecaesars	org
@kattra	human
@FollowThyQueen	unknown
@happeninginnela	human
@LGTattoosGirl	human
@msbelladonna82	unknown
@koyuri719	org
@robintagus	human
@itsmezippy	human
@SeddonSins	human
@EdenOnBigBay	human
@CatrinAlDaHama	unknown
@MadamSudorgina	unknown
@SanctuariBar	org
@ICHIEFLOCAL	human
@SoyMajoH	human
@MamasCoffeeShop	org
@pandpbirmingham	org
@JanLAshby	human
@nnattee	human
@fernnye	human
@MAJOPADO	human
@afleurdorgies	org
@peramel	human
@Camaraaunique	human
@ehollywoodpro	human
@HDandQ	human
@Venues_org_uk	org
@MichaelLevy	human
@TayloredWines	org
@jaja_aly	org
@auniaulya	unknown
@johnnyrocketsBH	org
@Yinka_idol	human
@happeemonkee	org
@PetershamN	org
@Louiejr2988	human
@MortinsMonica	human
@indah89_kwok	human
@L0ND0N_APP	unknown
@LSTMLibrary	org
@DakotasHoweTo	human
@CWESI_KAGAWA	unknown
@alyruiz	human
@crobertscookson	human
@kasyno_sc	human
@gandhi_armas	human
@CafeFedora	org
@_wickeRmoss_	human
@ybra1903	unknown
@janicajace	human
@CocosHKitchen	org
@uksnapper1989	org
@Tumt	human
@cravenmavenblog	org
@me_xia	human
@nicoleyta	human
@cagimo	human
@stayfitmomof5	human
@mar15jon	human
@MEagleHodgson	human
@tonyromaslondon	org
@harurururu0530	org
@SweetieVidh	unknown
@MarilynChoo	human
@Minktea1	org
@kraftmaking	human
@_TiffanyRussell	human
@DjYSL	human
@1davidschmidt	human
@lifeofmelissah	human
@HayAdamsHotel	org
@dose_espresso	org
@Aru_Preaw	human
@PrayLiveEat	unknown
@Polevshikova	unknown
@BobMorella	human
@elljem	human
@atrillion420	human
@goglazed	org
@bensoncecilia1	human
@akachuchutrain	human
@agaveseattle	human
@sunshynepennix	human
@relina_rose	human
@xsophiestar	human
@suhara3000	human
@tsumu_tumu	human
@fazbj	human
@G4nZ0	org
@basittt	human
@hataemi57	human
@TonioPasto	human
@SunitaAnjum1	human
@AlexScott1792	unknown
@Alamedadelcobre	human
@Belovedates	org
@itzyahaira	human
@Hennners	human
@kikirisaa	human
@Canterbury_LC	org
@timctimc	unknown
@Kr1stine_	org
@Bridgey23	human
@BP8Promotions	unknown
@FranDoug	human
@Gabozunino	human
@badbrian24	unknown
@uglyducklingdub	org
@toniboiser0822	unknown
@LpogorelchenkoZ	unknown
@NAOxxxGD	human
@dnick2111	org
@WholeFoodsLI	human
@FayeedTAN	human
@EmiFielding	human
@Fashionlovepam	human
@IndochineJogja	human
@Fallenros3	org
@ayakamuu	human
@misa1017yuuko	human
@MPHPublicHealth	human
@MysteriousKibby	human
@chayneesboy	unknown
@JackGunns	human
@MannyNavar	human
@CrazyAMbrosia	human
@ClerkenwellG	org
@Friday_Studios	human
@ramonylaschivas	human
@asyrafrodzoan	human
@singingowl	unknown
@julipr4ss	human
@OneBlueDuck	org
@ZzzaggaZow	human
@riadhrebei	human
@tweet2u2	org
@nemobeatz	human
@NQManchester	human
@CrimmyNull	human
@dynamitriPL	unknown
@viennaonline	human
@HelloKittyStor	human
@suey104590	human
@foodfever	org
@breezeemc	human
@standsays	org
@1905dc	org
@IamKushKash	human
@Shaw_Flo	human
@WaiteAdrian	human
@VIAUNOItalian	org
@ThanyuzhK80	human
@akarixx55	unknown
@arosebrown_	org
@clairesgg	human
@Tom1976Tomas	org
@usama_amm	human
@chickadee_cymru	org
@ullmerbabe	human
@seanberry	human
@highkatt	human
@OboroConvCtr	human
@TWAustinAtHome	human
@abipot	unknown
@prricardosantos	human
@FeerAranda	human
@UFGator4PR	human
@taka_143	human
@Zatknis	unknown
@LauraEisler	human
@SawyersMagor	org
@H37Yasuyuki	human
@BigHiggaHigga	human
@foodwithmustard	org
@klin03	human
@VOrlovaz	human
@osekova_jyldyz	human
@twtyfive	human
@kevin_enriquez	org
@babyhprinsesa	unknown
@Vommichelleyaj1	unknown
@2SpryDotCom	human
@TumiQ_2	human
@ShrivastavaGhun	human
@SwathiMandadap1	unknown
@omkar_magdum	human
@diabetesblogcom	human
@norstargenetics	human
@domme_shinobi	org
@mmfrenchfood	org
@joylynn_Fang	human
@nyronius_monk	org
@julia_yp_ng	human
@ComeAndCook	org
@stjoehealth	human
@ArensBar	org
@dfmjr477	org
@lindsaysue	human
@CoCo_Chrisp	human
@millie_katie	human
@BeerGeney	human
@MackAriate	human
@NAshRichie	human
@aanarianto3	human
@antanialt	org
@jacqseneta	human
@sweet2sahar	unknown
@EmmaBlackwell12	human
@ndiyira	unknown
@TheLadyGriffin	unknown
@hyuganakatani	unknown
@fahmi_ismail78	human
@celestebethany	human
@kims_ang	human
@FineTuneHealth	human
@sarah_yacob	human
@FoodFood	org
@ShopsatLiberty	human
@Cmplylhiantotz6	unknown
@running_thru_it	human
@agapiarest	org
@harleysheffield	human
@diyana207	human
@Ebony_Moody	unknown
@dragonaries	human
@Tityws1994	human
@cobiusblack	human
@lovemrskush	human
@alexflora	human
@sangmin7431	org
@JustBri2U	human
@ocfemiaronalyn	human
@Waffles_Chicago	human
@Nivine_k	human
@HiAlejandra_	human
@Dolf_DeJong	human
@kayf2dar	org
@ARbeeMuh	org
@kapp323	human
@moozicfreak	human
@AlesiaMichelle	human
@DenuBourlot	unknown
@dwightenriquez	human
@Oscar_Lee96	human
@Luthfionel	human
@PetraCvelbar	human
@JanieGPhoto	org
@ItsTheoryTucker	human
@AnitaDundovic	human
@Juzer03	human
@bastianveiser	human
@FitriRumodar	human
@Der_Lebensbaum	human
@PizzaRockGVR	org
@LilMaMMaBoSSy	org
@MarieFyoung	human
@katielmcmurray	unknown
@carolynpavelkis	human
@Ciarachanel88	human
@FNicoleeee	human
@RosannaMili	human
@JJThrusta	unknown
@DaDi_DriZZy	human
@Paoloskitchen	org
@coquettishmish	unknown
@nicolette027	human
@JenifferVP	human
@simanovicki	human
@nynka_s	human
@CatererME	org
@djbigxatl	org
@mazsincere	human
@AJTrevino1824	human
@prorepsuk	human
@itstamsi	unknown
@BlackjackJerky	org
@DCMN2013	human
@bluethunder117	human
@fioridifragola	org
@HoneyforBear	org
@FizaAzmee	org
@cik_combi	human
@egemencengiiz	human
@smendesmusic	human
@IsherGhuman	human
@syonpintan	human
@DTBaltEvents	human
@Indomitable69	human
@manekenthe	human
@leilatinasian	human
@Marssbar	human
@DierOfficial	org
@jasonkim1006	human
@massy1176	org
@ArmsParkCardiff	org
@larznl	human
@_maysuri	human
@FredyTakiomusik	human
@SpinMyAd	org
@kdunbar1991	human
@KitchenetteNY	org
@BlondeTexan71	human
@CoachCMMotor	human
@DeanandSammy05	human
@browneagle44	human
@MHalshaiba	human
@djnyce77	unknown
@DianaKay10	human
@irralishah	human
@music_item_s	human
@flukeiiz13	org
@kyiv_insta	human
@droogs87	org
@lovelydenver	human
@peplinski	human
@bondappetit05	human
@Saladita12	human
@persemobile	org
@TroubledMan28	human
@EquinoxRocks	human
@x_Abb1e_x	human
@helenhngs	unknown
@Bngsviewfinder	human
@HumiraChic	human
@mynamekwan	human
@JesterOnYonge	org
@frenchyrozay	unknown
@BrittaniaJW	human
@kuni_iroiro	human
@peterparker1230	human
@Jken_ken	unknown
@titymemi	human
@eyrisesperm	unknown
@BeccyKateMayne	unknown
@ForestAcad	human
@womanblitz	human
@FahChariff	human
@jessking78	human
@Nicole_GHills	human
@Chef__DR	human
@sunnydayfamily	human
@Kiqiqiqi	human
@deenecuisine	human
@Spinneysqatar	org
@_OneTrueEdge	unknown
@yerennaicir	human
@Avenue86	org
@i_am_summerj	human
@zurichvienna	human
@chefkamil_LA	human
@ParisGrenoble	org
@TialTechAus	human
@oliverpozo	human
@The_Fab_Times	org
@parisbistrojazz	org
@ZaiGeem	human
@MealPlannerPro	human
@BlakkHoodie_562	human
@EdTheakston	human
@migell_17	human
@thom_us	human
@Ushiee	unknown
@vegan_bob	human
@LoniFredryx	human
@tuttysan	org
@Wolfit3	org
@mizthang29	org
@HanazLevia	org
@dylantaylornow	human
@Cabeza79	human
@richeleanne	unknown
@_LaurenRoberts_	human
@mnymnymi_na37	human
@FrankDelgado16	human
@stef_21	org
@JCWnutrition	unknown
@Tocksique	human
@theneuroticchef	human
@Lokomatsimela	human
@sandwichczar1	org
@TanzyRestaurant	org
@domicilioskilla	human
@ele90_rito	human
@JOEmrFAN	human
@CourtneyButton2	human
@threedifferent	human
@FD_Angel	human
@Kate_Wyy	human
@CallMeLord	human
@Aira_MARS	unknown
@earl_johnm	human
@RezaIqbal_	org
@Eatitmilano	org
@DanChapman_	human
@icha16_	org
@marinamm	human
@RachelZatcoff	human
@bellaheneggs	human
@Jorge_Tobar	human
@BlaqDot	human
@retrohousewife5	human
@tmaki0929	org
@anandhyta_yunan	human
@artisangabb	org
@AsaMsutu	human
@UrbanTeaRooms	org
@AkillElskane	unknown
@PrettyBiNature	human
@rewaa_87	human
@Boogymnstr	org
@m_enkhuush	unknown
@ChloeContiki	human
@StonelockPhoto	org
@UKTeam_Optimum	org
@hejatycamica18	human
@anasabdlh	unknown
@Cafe26A	human
@jenniferkx	human
@Ajaksdad	org
@mhadznocom	human
@AmdSadiq555	human
@Bluecarpetclown	human
@cwing88	unknown
@Biryani_Freak	human
@Jeetsab	human
@ashccalm	unknown
@MaShambles	unknown
@00JH5	human
@revatipujari	org
@Katie_16	human
@ByeolNY	human
@HappyMamaNNJ	human
@ZimVim	human
@gullallie	org
@natsulani	human
@kgaysenko	org
@Bargnhtr	human
@asrify	human
@mubinhaq1	human
@abelleabbs	human
@cocolabricotine	human
@jussisolja	human
@MoulinoTan	human
@Miriam_ZZ	human
@markitrokis	human
@ApiwutNG7	human
@GVincentini	human
@B_Bimbo	human
@hottmess055	human
@shieromie1993	unknown
@pswinnauthor	human
@djdavidmolina	human
@bagtasadrian	human
@GusReid	human
@InfoBreakfast	org
@CarrieElks	human
@BBCGoodFoodME	org
@andreeamateiu	unknown
@Fidzo88	human
@doubleyoukei	human
@ZoliswaKewute1	human
@gceixel	human
@Wilsfang	human
@CabinetsDesigns	org
@HiDelilah	human
@fbonetti	org
@Bbrianne18	human
@LaurenCosway19	human
@LaTavola_Italy	human
@Lisa_jigglypuff	unknown
@Shioppi_	human
@SteveKubota	human
@sukhoui	org
@MarcusNiklasson	human
@Jeric_cirejboi	human
@SoFieNuR	unknown
@CPEXRealEstate	org
@BarbieEncinas	human
@Property2Insure	org
@tomsthumbmarket	org
@HarborDocks	org
@bairinwaikiki	human
@Nasichigo	org
@dineon1	human
@CopelandsATL	org
@MdsVivendi	human
@CuseKicks	human
@Pupkia2	human
@ConshyBakery	org
@lotsemann	human
@RAMENCoNYC	org
@4NHour	human
@Anitaf28	human
@Baoru_missyouso	unknown
@ad_dakh	human
@ASHRAFREDZA	human
@allthatsall	human
@TomNouet	org
@DigitalSEME	human
@EverZelaya1	human
@AndeoCendana	human
@DisBodySoLean	human
@athena_cuisine	org
@FumeDubai	org
@hollyarchibald1	human
@pjptl55	human
@ChrisKriag	org
@frankkklin27	human
@valiant4life	human
@tokstarr	org
@kiannachiyanne	unknown
@HartriaDewi	org
@GotEm_TwEATn	unknown
@frenchieart	human
@JiiLoCaNtik	human
@TheFlipFlopper	human
@RigbyCWTS	human
@summeriswayne	human
@cahyanikn	unknown
@Jizmo29	human
@jesvia	human
@jeffreyrogador	human
@turnipHed	human
@baxterball	human
@Pookey2007	human
@kenangasekar	human
@LoganMortimerLy	unknown
@DjKaneDrumSquad	human
@liu214	human
@URaUseful_idiot	human
@MzHunyDiip	human
@PriyaKapoor100	human
@lefournilchile	human
@artwmn	human
@yihwahanna	human
@909turtle	org
@559_RAIDER	unknown
@gordonespanol	human
@mr_antofrans	human
@acesia	org
@GoldenJack_	human
@newnique_mag	org
@JuanPeGarciaRoy	human
@rap_happy	human
@Thomas59580	unknown
@LizzyMawy	human
@Sebas_Pinzi	human
@vyxajaz32	unknown
@officialgastone	org
@SheeshaTZ	human
@dianabart08	human
@oystertheory	human
@rabbitglove	human
@selincaglayan	human
@seem_lowe	unknown
@parasophiaStaff	org
@NutritionTwins	org
@autumnsbbb	unknown
@DABOIGENIUS	unknown
@EatSmartNY	human
@Cookies_4brkfst	human
@_dEjaVu2u	human
@piatobrekkie	human
@angielin555	human
@theplantcafe	org
@ttt6990_1	unknown
@ShawermaPlus	org
@WeltDerTraeume	human
@vedantanator	human
@nonayume	unknown
@DeannaBisbee	human
@kristensaywha	human
@whitehouselk	org
@MicksEelSupply	human
@essex_live	org
@OfficialMeeya	human
@FedericiGiulio	human
@being_a_blonde	human
@BreezySocial29	human
@sp_pppp	unknown
@GeziBosphorus	org
@sandrakamiak	org
@sarahjanenavy	human
@Sooria_Slayerzz	org
@JonnyFoody	human
@gloinwonderland	human
@nicole_monse	human
@LauraJPrice	human
@EmmaVaughan_	unknown
@MilesOMG	human
@OxFamFitness	human
@RSHuffman	human
@WorcEatsVeg	human
@BMBEdinburgh	org
@crazygeekJERR	human
@raqbap	org
@erlitafirda	human
@Tuliogmz	human
@jetski800	human
@PICKYOURPLACE	org
@pankun9612	human
@ZuSh143	human
@tenaciousacorn	human
@SamantaVela	human
@ETrubacova	human
@PelaMarela	human
@MessingerMeats	human
@Madalinafloreaa	human
@itsnkenge	human
@Ivanaamiya_	unknown
@watermelonlovei	human
@TheCrapLab	unknown
@the_eriklee	human
@bilbaoberriauk	org
@AP_AllDay28_	unknown
@gustavos0213	human
@EricaWagner23	human
@AisYatuLRaihanA	human
@NurutamiBellia	human
@Greekcitygirl88	human
@arcmitha	human
@ImperialNtimacy	human
@marvingil	human
@oatsnbarley	human
@krakms	human
@hanoofaziz	org
@JulesBohomolenk	human
@Gen1_29	human
@seandalypoplife	human
@MissH_ireland	human
@Nannantaa	human
@komazo00	human
@iloveeiann	unknown
@nursejenny27	human
@izzyliscious	human
@LisaRianiS	human
@becandbaxt	unknown
@rahulnanavare	human
@llenori	human
@jDkud3Qq3DaCsbU	human
@lainetags	unknown
@saviorlives	human
@Dj_Hennessy	org
@kimlarran	human
@heybabysmile	human
@Ryev	human
@EPIPHANY_TREATS	org
@JKing75150	human
@manateedugong	human
@heathercore	human
@Cemilan_Import	unknown
@Leesha_Hanan	human
@DelightfulToni	human
@TiffanyEvelyn	human
@Royal_Orchid	human
@This_JustIn	human
@EmbranNawawi	human
@vinicius_lc	human
@aly012	human
@AgusBuraschi	human
@Nisus	org
@NEWMILLIE	org
@ma1Dya	org
@xocourageox	human
@annoyingcouple1	human
@greenblanket	human
@AllThingsBTC	human
@steviejonsmith	human
@iAmandaLia	human
@TwistedEggs	human
@guillermo_loor	human
@MellitaDsilva	org
@nnoonniinn	unknown
@TheSensesResort	org
@koxkikkixsummer	org
@StevenWongTS	human
@Kev_Little_	human
@fcreamz	unknown
@Comidadosul	human
@MulotBricole	org
@modaduygusu	human
@Shashaliow	human
@easy2bvegan	human
@Abdullahs_World	human
@nikkiwatitdo	human
@Max_CarDi	human
@sixfortheroad	human
@chengyee83	human
@tamaractct	human
@tjoriwo	human
@espanolinks	human
@koong_prapaipim	org
@Mangogelb	human
@chef_alvarez	human
@craigwilde	human
@DjKuttz	human
@UaeSushi	org
@LMeermaidd	org
@rhellarlln	unknown
@pushprlondon	org
@guyl4rj	human
@NtinaSara	unknown
@MsZayraHerrera	human
@DolceAmore_cafe	org
@iabhishekk	human
@V__Rossi	human
@theaprilnoelle	human
@mlwoodward	human
@rinidorry	human
@Sigmunddd	human
@SkinnyonLowCal	org
@lovaticliarisaa	unknown
@JennicaChavez	human
@kevputz	human
@PetittroisLA	org
@YoHobbyLondon	org
@IceDevil105	human
@iniAlex	human
@silv76	human
@minqmiiiin	unknown
@AkMalHaZiM_	human
@ciachrestella	human
@JxLostInStereo	unknown
@JekaSanchez1	human
@RRitaG	human
@Chanel005	human
@sojLam	human
@imonthesun	unknown
@dishandchips	human
@shopfactoryGRL	org
@DenverListBiz	human
@badbrad002	human
@DIVAwithlovee	unknown
@muhamad_pitt	human
@FarrahBenoit	human
@clps04	human
@bloostr	human
@Stephcc99	human
@Crazy__Corn	org
@bephaus	org
@Mia_Blake	human
@swagmania1988	human
@cha14lovu	human
@uag34tdy4m	human
@OriginalJoes_	org
@thefairyfoodmum	org
@BachecaHotel	human
@mhharnois	human
@ThatsMyKimpoy	unknown
@_Jubii	human
@KayCaballero	human
@RaubontheRoad	human
@LOOkinAZZkelly	unknown
@JowDirectioner	unknown
@atkhilya	human
@YiscaShalman	human
@refrshingapathy	human
@TerryBoy101	human
@Abhitha	human
@DishKhoj	org
@haleysvintage	human
@vinastudija	human
@ReverseTheLeon	human
@APPLESToNEPiX	human
@CahuengaGenStor	org
@ekmektatlisi	human
@karenmariely	human
@jaimeemcmunn	human
@henrythehuck	human
@meetingstcoffee	org
@Sarah_Bond2012	human
@EliaDubai	org
@Ballettonet	org
@bot36102738	unknown
@Vixen0587	human
@minakhtaria	org
@toyz015	human
@IgieBinuya	human
@mxcomps	org
@Tobodobo	human
@terencecher	org
@juniordreadton	human
@AKASANDCANNON	human
@Mspoken_	human
@KerttuHeath	human
@kkaraolis15	unknown
@yayyuayu	human
@_edgarfranco	org
@Kopperss	human
@ahiaCHINZ	human
@bistromais	org
@Especiale2000	org
@lostdogcafe	org
@EllDawwwg	org
@idagreyss	unknown
@ACHILLES__1992	human
@Mid_West_Media	human
@strijen_info	human
@captainmadani	human
@bubblesatb	human
@fena_penguyen	unknown
@allenbpascual	human
@TheCapeGem	org
@EricaPH429	human
@austinpjones91	human
@snap_223	human
@bugsmehui	human
@BIGHOMEYCASH	human
@thtlogan	org
@PornoHoernchen	human
@AgaveCocina	org
@Miratuevento	human
@Marcouxcooks	human
@MaryNavratil	unknown
@manulenox	human
@ricardo30001	org
@runiboy	human
@RockwoodSports	human
@marmoe56	human
@MacKellarFarms	human
@DaRealMrHunts	human
@lookgoodletseat	org
@MunchFoodCo	unknown
@Mamio3o	unknown
@brookekeam	human
@adianthi	human
@tippypj	human
@LisaHumphrey19	unknown
@__Bubby__	human
@DominicaHisey	human
@kasialindsay	human
@MusicreationTJ	unknown
@gregmclark	human
@Mikaeljoko	human
@AbieAziz	human
@IamARoberson	org
@SpoonEdinburgh	org
@EvonSeaver	human
@_EmmaHands	human
@daleoufc89	human
@italopendola	org
@mrsbabybash	human
@CinnabarPink	org
@AndreaMonizza	human
@AB_dotcom	human
@_tukilla	human
@cuisitive	human
@JSmiilez	human
@jamaaltaher	human
@flexiladiesyoga	human
@jakebostwick	human
@JessOntheBridge	human
@wholehousewife	unknown
@Roske_Donna	human
@UrbanGirl_Mag	org
@McKinleys_Nmore	org
@TheOldMan55	human
@carlieannburton	human
@sHeakaYe	unknown
@Epestheper	human
@domthe10	human
@ISYnaGOING	human
@the_royjr	human
@solita_valencia	org
@MyNashvilleTN	org
@amln2go	human
@marsmallow76	human
@LinosVersion	org
@reginaguerrero	human
@BlessyMP	human
@ktsonos	org
@aenneken_sky	human
@FirkinPubs	org
@bcgs_ca	org
@jane_ariane	human
@The_Local_Card	org
@Sheila_1212	human
@queensheadHP10	org
@bAdEbAdz	human
@mtlblog	human
@House_of_Coco	org
@Audrey_Boutry	human
@delightfultasty	human
@shadowadrik	org
@AustinLonghornz	human
@steveeypips	org
@kayuO4	human
@nobunyon1122	human
@manuelstellato	human
@_25DegreesHB	org
@HollywoodWerd	human
@alias_dabe	human
@JANTONIO	org
@MKCollective	org
@EiAmHere	human
@rayhch	human
@Budget101	human
@Vegoholic	org
@NickOlai24	unknown
@markthefifth	human
@AthensCypria	human
@thelmaonclinton	org
@vo_7s	human
@marketingHolt35	human
@MikaC21	human
@2SDM8	unknown
@TyhahhHashimm	human
@Sara_bint_Talib	human
@CharliesVan	org
@Arriaguista	human
@kohfuqi	human
@EvgeniaNefedeva	human
@TheVlogDieters	org
@KevinRay	human
@Thehounddoggy	human
@FeministWed	human
@novotelnusadua	org
@jennhamiltonxo	human
@Dani_Triana03	human
@Olivellas_Pizza	org
@ciegecagalawan	human
@Contagi0usessnc	human
@Mydog2_MJ	human
@VineandTap	org
@AfropolitanAR	human
@iiegaii	org
@OffBwayBoutique	org
@ChantellDawnSny	human
@NEBULAjkt	unknown
@gypsy18	human
@KGiuggy	human
@tonybiancotti	human
@whoisbenjacoby	unknown
@ChloeWebster92	human
@MissHollyGS	human
@75thStreetInn	human
@pocockins	human
@HannahBanes	human
@Kelly_Goss	human
@shahrin313	human
@Abdu_Azzy	human
@1804grace	human
@iNattakarn	org
@AngelinaTala	human
@ASSHIFAAA_	unknown
@lee_gav	unknown
@lucianaaguilar	human
@e_giorgio	human
@haneuls_polaris	org
@dxbcshin	org
@Johns_Pix	human
@Chris_V_Wood	human
@ruuuuf_sun	org
@KachunEric	human
@iamAciee	human
@AsianSenzation	human
@keke722	human
@INDIANATONEMRC	human
@imJAY_R	human
@fruiticana	human
@JosephinecH00	human
@kristynnicole1	human
@casey_kettleson	human
@FrankieYve	human
@Megalina_13	human
@PizzaPortalpl	human
@AlfinCircus	human
@panda_maemae	unknown
@simply_stephers	human
@sinyeedotcom	unknown
@MSuitesHotelJB	org
@GreenisBetterCL	human
@zulz_zizou	human
@andreiaxavierc	unknown
@CFAMissionKS	org
@A_B__	org
@mathiasgillven	unknown
@bree_m90	human
@KellyHoganRD	org
@ilovejax_us	unknown
@Francisco_Mota	org
@shannahmhanks	human
@The_Lava_Girls	unknown
@KatRisnen	unknown
@Iiida_Emilia	human
@Chipsycophate_	unknown
@Nene_betta	human
@devina_hikari	human
@EllieT0215	human
@Lil_Bins	org
@erinxxstewart	human
@Anno_Mi	human
@Dadoushka	human
@adis_AA	org
@DunneCrescenzi	org
@Moiale7	human
@BistroDuMidi	org
@iBangOutBaccs	human
@ShoeRepairLady	human
@DummoMarx	human
@GemmaHilton1	human
@vitayasintha	human
@Pernelle3	human
@Charl0tteeeee	human
@Dan_James89	human
@LilyBow	unknown
@rsschuster	unknown
@caro_warr	org
@Lili_1511	human
@cloister_honey	org
@tancam1983	human
@kewlzero	human
@viiolence	human
@ItszJennersz	human
@PellyChong	human
@rawichin	human
@combisteamqueen	org
@neilrgsmith	human
@Isabella_Lily1	human
@DulithK	human
@wifeyfeedsmefat	human
@Mee632	unknown
@sarasahaida	unknown
@VistaGlassTechs	human
@ananyamukherjee	human
@Crispas0108	human
@MichaelalaCour	human
@JustaPack	human
@freekbass	human
@soniaclare9	human
@jennideguzman	unknown
@spiritualfoodie	unknown
@imdafukiinbest	human
@onikohshi	human
@DetoxAmbassador	unknown
@MarkettoMarkDj	human
@SeePack	org
@jm_casique	human
@_c_h_o_g_e_	human
@sottovoce595	org
@charlie_insik	human
@DominicPiper1	human
@AlyzaFisol	human
@Trinichadwick	human
@MarketonHolly	human
@chimchloe	unknown
@30dayfitness	org
@MariisolCorella	human
@ghost_sound	human
@_EpitomeBeauty_	human
@itsashben	org
@_Aidah__	unknown
@payfrenzy	org
@georginaann92	org
@guelmiswager	human
@yhissie09	unknown
@funsize4ever	human
@pureblonde21	human
@jeannixa	human
@aliyahbindawood	human
@Your_Avon_Lady	human
@LS_IA_CKNG	human
@ITSROSIEB	unknown
@IsleCasinoCG	org
@Je_Katsuo	human
@SBkkkiri	human
@mado0o10	human
@thesocialpostSA	human
@dianaciumenta	unknown
@lilienz	org
@MicheleDellUomo	human
@enliten84	human
@ellashayedmore	human
@jtgqatar	org
@HumbleHero_90	human
@fearlessFAmom	org
@Jdevents	org
@imaleetuh	human
@TrekterOfficial	human
@Bar_Du_Marche	org
@RositaVai	unknown
@LiuJie80630667	human
@datesyruprocks	org
@samalalala	human
@AnitaaVegaa	human
@UKBelieberTeam	human
@christinetvhost	human
@MrsStaceyCamp	human
@Monsoonbreeze1	human
@Beauty__Power	human
@david6of7	human
@Jeunique_raquel	human
@lianshing	human
@saggal_mary	unknown
@jmfp06	human
@deliganspub	human
@girlwithhat	human
@MamasHalfShell	org
@jaiehummingbird	org
@ose7seveno	human
@arminbarducci	human
@ENJOY_ICC	human
@DjornMo	human
@dimasoprunov	human
@dailystylecz	org
@JasmineA2011	org
@RedDogSaloon_Mi	org
@StephBell71	human
@Wideylives78	org
@okinawaKTM10	human
@alliiisonmay	human
@fitmama1982	human
@yahnietonz	human
@rafmonzy	human
@BeaBepunkt	human
@1SkinnyHippo	human
@stlyergirllove	human
@crisricoferrol	human
@imcheyclem	human
@GlowMagNL	org
@radiantrose1	human
@ajaychhabria	human
@martinp1983	human
@saveinal02	human
@kitellita	unknown
@AndreaJanev	human
@vale11001	human
@Andrea_1410	human
@FSBahrain	org
@x_Horacio_x	human
@oakwinebar	org
@cari_001	human
@Yuzrifa	human
@DianTamara85	human
@TheAgapeVox	human
@5adijaxx	unknown
@somethingextra	unknown
@chloesucree	unknown
@prisselizondo	human
@moshinMN	org
@shakira1992	human
@Mohdfaiz13	human
@juliocesarc81	unknown
@anuruokanen	human
@letitBERN10	unknown
@samikechairi94	human
@ChrisCYYbluE	human
@cutegurlsrock	human
@adambornak	human
@CMLcaballa	human
@ThorpeFarmTweet	org
@AewSploddee	human
@yuriohishi	human
@TravelBrabble	org
@Avrs_things	human
@DIONLOY	unknown
@katemillercny	human
@mariviera93	human
@gabri3lla_p	unknown
@AmrinMalek	human
@FlaaDC	human
@LauraJayneMusik	human
@igive4life	human
@Sleeps12	org
@HorseshoeBmore	org
@ateoclockltd	human
@jewel_malonzo	human
@amisimmo	human
@tiTa_planet	human
@AllyTravels	human
@RollingOut	human
@erikaachaaan	human
@redgfwanderer	human
@kataweb416	human
@LittleCrushLDN	unknown
@nicksrose	human
@VonGheist	human
@Freestyleandrew	human
@VaughanChamber	human
@NathHolt	human
@Christine2Lin	human
@Bin23Restaurant	org
@People_SA	human
@jheeyap	human
@victorturpin	human
@Galanteshoes	unknown
@NoraIzzati	human
@Amburrrrrr	human
@wiogmixshowdj	unknown
@KatieinSyd	human
@dzendrus	unknown
@BrownCowCafe	org
@mwoodlandhills	human
@93Leonardova	human
@BabebabePhat	human
@Lisa_92	human
@digitalbear	human
@OneseEvenson	unknown
@artovermatter	human
@tc5920	human
@AisLikesToTalk	human
@VeganGizmo	human
@Gina3eb	human
@25111990sagar	org
@ah_ka_layee	unknown
@kandradventures	human
@Val_Sumavsky	org
@adammanty	human
@Viryland	human
@Shelley_91	human
@GiaHellerHoward	human
@freshlookphotog	human
@MyFamilyCloudCo	org
@LeoHyuk_VIXX	human
@DabblingDuckGM	org
@psychoPATkiller	unknown
@DCC15042011	human
@SillySheep	human
@cassianogomes	human
@SyelaCindy	human
@zidan_007	human
@MissPiggy4Kermi	human
@Weleetweet	org
@appyrae	human
@KimberleyLove	human
@havenrivera	human
@SocialPaparazzi	human
@MaineHealthLRC1	org
@NoelYourAhgong1	human
@Boiledwords	org
@awthorp	unknown
@Foodie_St	org
@ddaniela	human
@OBEOrganic	org
@TheNegiWay	human
@BrownsMapleRidg	org
@Zekealeek808	human
@TheOnlyRichard	human
@EdelweissLAX	org
@drolin702	human
@QuietFireTiger	org
@dietgirl4u	human
@therhiannok	human
@Miyoko_828	human
@Cia_Siong	human
@Dine_UL	org
@prontopixel	human
@I_Am_Mr_Walker	human
@itsMissVero	org
@yogaintheworld	org
@TouristiqQc	human
@the_derek	human
@nororredePP	human
@merlincansia	human
@Dannel80	human
@bonkure0819	unknown
@Amanda_Chanel	human
@MenuVenueWNY	human
@epsilon550	human
@chriscatkinson	human
@gluttonlucas	human
@PAPA_MALLY	human
@Blamez_Obama	human
@LangweileDich	human
@ShaneerH	human
@tourtweetSA	org
@PaninoICF	human
@longboardstuff	org
@dontplayahate	org
@funkyfareast	human
@alaminTamrin	human
@kelly_sephton	human
@xxLillianna	unknown
@patrickteo0710	human
@claire_robles17	human
@JLittletaylor	human
@ashleyeats2live	org
@mtjacobsen	human
@CointreauUK	org
@Panda_77	human
@missashleymilne	human
@HappinessWatts	org
@KiaScricc	human
@kamikozi	human
@Mimmo_Lo_Nardo	human
@eveline_elim	human
@ThePaddleDorset	org
@Harrietlamode	human
@desriiyanii	unknown
@neilbishop6	human
@ArletteRiveraB	human
@bryankasm	human
@jackieszabo	human
@SaraDoucet	human
@TheChristaMarie	human
@mohdfahmy81	human
@LianeNeviis	human
@vonnirimadhani	org
@Mandys_Tweet	human
@strongtots	human
@julio_gonzalez	human
@mrsheawilliam	unknown
@JRsPillows	org
@cookmebaby	unknown
@PopTrashBeauty	human
@LPKinToronto	human
@JJBiscoe	unknown
@AnieshaMKay	unknown
@brijeshsachde	human
@thenewporters	org
@sachalys	human
@PandoraPeroxide	human
@ShawnaEllenRyan	human
@mr_monkeyking	human
@Bri_BoltBistro	org
@thelittledeath	human
@zombkid	human
@andytanamas	human
@LeyyaaZoull	human
@margo_christine	human
@Official_MattLo	human
@alicetrajera	human
@bevferey	human
@_allisonx	unknown
@WorkBizAcademy	org
@SanazNYC	human
@zalicieux	human
@oca3g	org
@dazzlinggeas	human
@CafeLaRosa	org
@craiseir	org
@IvyGalasso	human
@athiraaziz87	human
@sessionkitchen	org
@CantinaLewisvle	human
@AgustiPT	human
@morima311	unknown
@LairdSuzanna	unknown
@Mundomemo	org
@GGsGourmetGrill	org
@mikc37	human
@GenuineJoBo	human
@JayFredBeastly	unknown
@BienAimeShop	org
@bjkbrady	human
@hmdalqahtani	human
@sabletalley	human
@GelynMLim	unknown
@4x4sam4x4	human
@EldaMontoya	human
@goldenRAYEphoto	human
@CumbriaWeather	human
@dekheel4	human
@JenniferDist7	human
@paulaksouzaa	human
@upeatsocial	org
@rouquinne	human
@GIGI501	org
@GoldenOrchidee	human
@CentralFLTop5	org
@smiggidy	human
@makemecomealive	unknown
@SALLYngketket	unknown
@KelseyLashae11	human
@MonicaLacasit	human
@jocelynslai	org
@MaiaMeralda	human
@Mandiepandies	human
@SHINBAP_96	human
@Erin_Hosea	human
@oline_nee	human
@ChennaiGrocery	org
@I2Kcentaur	human
@ToscanoLasVegas	human
@Eiyffa96	unknown
@insalare	human
@LaPetiteYogi	human
@LovelyG16	unknown
@TopCat1965	human
@StikaBilahmar	human
@pdc64	human
@DeneshTomasz	unknown
@Lynnemei	human
@Maliboo321	human
@HareemSultan	human
@DjAPOLODanny	unknown
@DiParmaPR	org
@TRussell1120	human
@chriscordero21	human
@Yajaira_Rocks	human
@anuarOtm	human
@mariiolapolet	human
@ComfortingVegan	human
@RealAsCanB_21	human
@lauredemazy	unknown
@superkambrook	human
@JMackalonis	unknown
@MonterreyWest	org
@Teena_LaRo	human
@BonAppetitSU	org
@bampily	human
@FarmaSarah	human
@twitarara	human
@letiziaschatzi	human
@nathanshugart	human
@JorgePma	human
@Colchester1891	human
@ikitchensltd	org
@princessnilsah	unknown
@AdamKariel	human
@AlanaCowell1	human
@JuiceMane2012	unknown
@PatrickAustinIN	unknown
@Jenni_Boppa	human
@danielsLondon	org
@mamehouse1029	human
@milksugar78	human
@BoLangChelsea	human
@RasBeirutRocks	org
@nastasyar0se	human
@SimoUtsukushi	human
@kingofkeno	org
@SherryPlemons	human
@PreciseDiff	human
@BlackHawks4343	human
@m_kandalaft	human
@wallacerica	human
@OlineBistro	org
@MSunshine23	human
@WoodsChapelPC	org
@MOtastic	org
@AppleHuiHung	human
@MetamorPoses	human
@liviomilanesio	human
@jrafae32	unknown
@msdeezon	human
@Gori0g	human
@FiraMohdAli	unknown
@gsrestaurant	org
@twilight1515	human
@ParadiseDeals	org
@ChefDaddy42	human
@FrugalFitnessTV	human
@VanessaOri	human
@Fiorinos	org
@spf_93	human
@powercastbryan	human
@MsAnaJocelyn	human
@zubairay	human
@ShaunRajah	human
@michellepooch	human
@zoe_fitness	human
@AllStarHershey	human
@nathalie_nasr	human
@fujairahsicon	unknown
@AlanIsGood	human
@Olivetreelought	org
@Toto1004J	org
@deep_flowers	human
@theclevelandnyc	org
@LaurieTatum2	human
@unza17295	human
@dolphianandi	human
@ZamyZams	human
@FitinCorsica	org
@NEPA_MOM	org
@rramblerblog	org
@lamlivia	human
@StevenMartono	human
@Voromtl	human
@Peters511Sharon	human
@ByzonChurch	org
@safitriinna	human
@wildlifesphoto	human
@simpliyvonne	human
@TheRevJameson	human
@TheFactoryKitch	org
@LustVodka	org
@ChespackHygiene	human
@willantoneill	unknown
@krumpermonster	human
@GoPFII	human
@itsmeSeriTyah	human
@Tabi214	human
@aaroo4	human
@GetMeFood_in	org
@shadyjiang	unknown
@tej26	human
@quinnsgrill	org
@ShvetaSalve_FC	human
@prateekpatil5	human
@Jonathan96_69	human
@JORNKIAT	human
@tabbuli	org
@Stephillie	human
@JanisKuplis	unknown
@tohwanxjing	human
@hanyali	human
@VegasWiseguy357	human
@ThreeBridgesUSA	org
@cla_luchetti	human
@Nazlin_Shamin	human
@foodiecafeifsc	org
@FaraPacan	org
@greenboxny	human
@abrasam1989	human
@SotoMk21	unknown
@mr_al_131	org
@jacobsaywhaaa	human
@Aloeasy	human
@IndiaLive_today	human
@Mrs_Thizz	human
@ajegilliland	human
@Citypath_	org
@EX_BB_21	unknown
@MichValentino	unknown
@thayden22	human
@mygrowthmatters	human
@MadRabbitLady75	human
@KidmanMakino	human
@RosePublicHouse	human
@TheLueBella	human
@leonefinefoods	human
@KTownMerchant	human
@inevitably_JC	unknown
@mehrbodm	org
@tatanonik	human
@MoDirani1	human
@charbar_yyc	org
@FranBrinkworth	human
@AbdulAsish	human
@RaluTimi99	unknown
@TortillaFlatsTO	org
@sylvichippy	human
@missnaydeenad	org
@MariannaWiseBG	human
@Pekisheva85	unknown
@ConnectCannabis	human
@ElisheaM	human
@Village_Dining	org
@albertopol	human
@CaroLemarroy	human
@KindOfRosy	org
@DaerahBintaro	org
@macs_perry	human
@JaYNaL2pm	human
@michalignition	human
@yuminaki_	human
@ilmulinonewyork	org
@Touchealacarte	human
@AdrianDiazFOTO	human
@BATMANDERSON	org
@markhdelucia	human
@milfestivalhall	human
@Khloud88	human
@akaSwedishChef	org
@_MeHanna	unknown
@danacacio	human
@PiiinkFriiiday	human
@1drctnzaynlol	unknown
@OilCulture	unknown
@melissatumoka	human
@R_oyster	human
@KiddLosMusic	org
@NatashajbaileyJ	unknown
@JohnHallJr	human
@mylifeinthesunn	org
@BertRotundo	human
@mkgr2525	human
@RealCadiz	human
@tanuki_1013	human
@fithomestudio	human
@ExoticDetailLLC	human
@TeohKckc	human
@dsmith292	unknown
@HelloVancity	org
@vinosdelplaneta	human
@andoryu0126	human
@sour_wolf	unknown
@Giuditta2305	human
@TrinqueFougasse	org
@MrsNeeyla	human
@abrahamnavag	org
@helijeri	human
@CarlosEspinalD	org
@sarahatickle	human
@spreejopoet	human
@HyattRegencyPNQ	human
@K3k3_Babi3Xo	human
@kaji2608	human
@Qurrochan_YUN	human
@HatsOffToFood	human
@eiheihei	human
@RajaHazirah	human
@Vicious_Veee	human
@R_VanSteenberg	unknown
@Samallymusic	human
@Brugenao	org
@ResetYourselfTM	human
@icoffeei	human
@wehavezeal	org
@monavidiaa	human
@enveac	org
@DayePete	human
@pizzakonfig	human
@creacommedia	human
@AmritaOfLife	human
@Psyched_femme	human
@nomnom_dot_com	human
@laurenprince	human
@Lap13_Ibiza	human
@matthewwdavies	human
@StreamThePlanet	unknown
@ritappe	human
@MikeInSweden	human
@STAR1057	human
@WoodRanch	org
@LAIMITE_	human
@alejo_sherie	human
@Taz_Pricey	human
@rusticrootsd	human
@ginacutillo	org
@GiselleMarks1	human
@StGeorgesBT1	org
@commeunejap	human
@TheGreenWhisk	org
@StuartB21	human
@AssiaDesigns	human
@MissNikkiStar	human
@MarioFrusciante	human
@absbarraza	human
@070180	human
@stephyylicious	human
@thonydaguru	human
@gmelgar02	human
@AdriianOsoriio	human
@majorandmorsel	human
@InLovelyRain	human
@Carcar06	human
@maeborro	human
@TheSALW6	org
@azu_0705	human
@EvilFootLong	human
@MadDogMartha	unknown
@Tawnycat	human
@kristiedologuin	unknown
@TravelRunEat	human
@KenzoEjat	human
@AmirZeeAH	unknown
@Snoop_Yee93	unknown
@BrookfieldPLTO	org
@ScorpioShanni	human
@Maglissa24398	human
@Francescamv	human
@DanielRojoI	human
@F3rs	org
@Blocal_	human
@MissCocoCupcake	human
@MisisNikole	human
@shizoboi	unknown
@winwinL33	human
@Ocataey	human
@LiJarvin	org
@tattedbakerman	human
@RusticMaka	org
@CherishCavallar	unknown
@PrimeauxCheese	human
@Robertomorango	human
@nathan_mtbs	human
@SantiagoRenzo	human
@DBfromagerie	unknown
@bekkib73	human
@karatasvedat	unknown
@archadiahana	human
@NewBornFree	human
@Jnoon_86	human
@themakingsofp	human
@MichaelinPhilly	human
@AlwaysLateNight	human
@wojowuqafux	unknown
@SeanNisbetJones	human
@jmdcd	human
@cgo2505	org
@cassanilaura	human
@Gibbo18	human
@fancynessa12	human
@Nymphashion	org
@iamBEAtch	human
@tenderfootmama	human
@5stars_Up	human
@rachel_maris	human
@pot_head_diary	human
@gobetgocasino	unknown
@GingerAgadir	human
@bearflagfishco	human
@Eyeeeees	unknown
@EndicottPR	org
@2softshellcrabs	human
@uwannabeeameyer	human
@SantiLin_Park	human
@ARCHIGITALE	org
@akanechanmannn	unknown
@Farid_CS	unknown
@mykatot	human
@Gr33n3y3z_X3	human
@tarintino07	human
@amoshyng	human
@KNKChatham	org
@DandyReign	human
@Luxusa2015	human
@thibaudetdenis	unknown
@LoriKClark	unknown
@love2ride007	human
@PP_Chuejedton	human
@BrittneyGrannis	human
@cubadirect	org
@MoneyIntegrity	org
@roxykarmel	human
@jcrads	org
@AFNhkm	unknown
@iammhurzz	human
@Candee_TB	unknown
@EUnderwoodee	org
@TomElwin	human
@rysupastar718	human
@Culintro	org
@nicosolace	unknown
@KDrouard	unknown
@piafouilloux	org
@MahLihSah	human
@rhoda_mae	human
@diljale	human
@fra_bordoni	unknown
@HaggartyJoanne	human
@fatinsamsudin	human
@Bambari_Bengals	human
@AdistyaPutra	human
@Galaxxxy0819	unknown
@ShagDenver	org
@Sari_Lovely	human
@Rsmodeshop	unknown
@mizmaggieb	org
@SodexoJHall	human
@TheatricalLady	human
@LivingSocial_MY	unknown
@RaffieB	human
@mohamedacu	human
@2arisa	human
@HeatherFinlay94	unknown
@EImege	human
@musicpsychos	human
@BurgerKingTT	org
@khiky_waji	human
@YRA_TW	human
@SyazwanSelamat	human
@nikkiphat7	unknown
@hyperrrrrr	human
@ViktoriaBektaz	human
@San_Francycle	human
@oasisbeachtower	org
@Allah_ki_bandii	human
@nookdee	unknown
@Hox14200	human
@babystacks_cafe	unknown
@O_GLaki	human
@michellejailine	human
@ChatLunatique1	org
@mitsu323232	unknown
@DRPinot	human
@emilysookying	human
@hungrytommy_	unknown
@zhang2095	human
@bizilyu_tetsuya	org
@stallimedalli	unknown
@minibea	human
@MattJix	human
@LottieSwann97	human
@VunzaiYeazel	org
@genuhlove	org
@veronicamejilla	human
@Tiffinboxetc	unknown
@ThomasBroutinFR	unknown
@blackKrypt0nite	human
@TanyaParikh	human
@BotCupcake	org
@rustyshelby	human
@Mercuryfjt	human
@Sassy_Saraahh	human
@Amber627	human
@melissafit	human
@RealMissyGirl	human
@DJSONYT	human
@24fitnessLisa	human
@Shinkochiba	org
@Continibites	org
@shootpaolita	human
@TheAndreGeorge	unknown
@JenipherLyn	human
@DeliciouslyWell	human
@ristosmith	human
@HendrikSantoso	human
@dg4ynooo	unknown
@MandylouGraham	human
@elenlith	human
@SPPS_News	human
@BearCreekFoods	org
@vhareenjanny	human
@RegalBeagleKits	org
@TheDJMission	human
@djlewisguk	human
@iFOODreal	human
@teexcedes	human
@OopsItsChariz	human
@waaxxh	human
@josh_ocampo	unknown
@siewlee18	human
@GoNutritionUK	org
@Naomi_Griffiths	human
@TheEdgyActivist	human
@DoubletreeCamb	org
@75Tresser	org
@unklekarma	human
@ktjoygood	human
@Nickle629	human
@BirdieSandra	human
@MelissaFrassoni	human
@AfonsoBeloMaia	unknown
@DonBotellon	human
@PerkinsLawKS	org
@PanchvatiGaurav	unknown
@misslaurab_	human
@killythekid	human
@thipkhaoDC	org
@Jess_Burnley	human
@WXN	org
@Alquimia_Gastro	human
@lorrainekeane	human
@caaaami_m	unknown
@vivalafoodies	org
@RuchisMexGrill	unknown
@bere_him	human
@NicoDc_Ok	human
@irishboygirl	unknown
@hrideek	human
@awescool	human
@CommunitCanteen	org
@emycastaneda2	unknown
@nurjones	human
@ayue_ayuki	human
@Ashelleh	human
@TampaHI	org
@secretspothb	org
@MatysonBYOB	org
@NdNisha	human
@mashi_89	unknown
@iamkingCARLA	unknown
@giulioana	human
@dnGarcia	human
@clamsingsLALALA	human
@boutazakht	human
@kcghostt	human
@MelissaMurder	unknown
@bartlett_kate	human
@ms_shye	human
@Melornelaa	human
@MJCounselling	human
@NataschaBintz	unknown
@IngCristianS	human
@kellyspaulding	human
@RoundaboutDiner	org
@Sin_Face	human
@kylcraig	human
@hectortoscano	human
@fawksheyt	unknown
@c_finchel0226	unknown
@KrinZrngu	unknown
@edelweiss_royl	human
@mizzbld	human
@nubatown	org
@fenomenoyohei	human
@ncybid	org
@Bouquetpalermo	human
@libbycostello	org
@hanitarmidi	human
@cityroamer	org
@GoldsmithsConf	org
@arvinzurc	human
@pxcosplua	human
@clengmartinez	human
@playboiionline	human
@padre_gekone	human
@YoHobbyPhilly	org
@Naziitah	human
@roxruiz05	human
@eelynnism	unknown
@TFIlluminati	human
@felicedandd	unknown
@passerinimilano	human
@TheSwaagMachine	unknown
@ChrissieGrasso	org
@MosaicNoida	org
@EllenCLe	human
@anne_adimahs	unknown
@RageRestaurant	org
@Jack_January	human
@ichapit	human
@MyRecipeMagicus	human
@homecookadventr	human
@DaRuddestJones	human
@roseannab16	unknown
@BarBistroAF	org
@JLilz	human
@Melissaallsure	human
@Gionth	human
@Hadi_DaStylist	org
@sara_miles	human
@debbygrissel	org
@basketpicnic	org
@Meimabella	human
@massmikho	unknown
@pinupjet	human
@ItalianFarmers	human
@sizu1066	unknown
@MclRmrBonVivant	human
@akimhypolite	human
@TheNotoriousMBG	human
@MissJonesShow	org
@_DayBreak_xo	unknown
@Haytham_Sheerah	human
@TeaTimeQatar	human
@WorkOutMom2k15	unknown
@BigDogDJJENS	human
@FrozenElsa942	unknown
@TheKanikakapoor	human
@CarnitasSnacks	human
@ASOS_Gamze	org
@WTV6	human
@Addzz82	human
@karinakeifit	human
@Zu_COBRA	unknown
@seetohmeryl	unknown
@Otaku_JooM	human
@love_my_DD	human
@aedeyalhadiey	org
@ajoengta	human
@Doryan_	human
@homeofrealfood	org
@David_Aquino12	human
@Boris_MGonza_	human
@Violettamc02	human
@amandasaphire	human
@hotdogplace	human
@polengkrisssyyy	human
@NurAdreanalena	human
@littlefishcafe	org
@slimwithamy	human
@nikolaevna041	human
@aracelijaques	unknown
@RBarEnergy	org
@kadenhalenur	human
@CaciqueInc	org
@saam_winkfield	org
@ilhamaqas	human
@jairbear_94	org
@ChelsssB3	human
@MarineisCooking	human
@celibernal1971	human
@LetMeFeedYou	human
@JPCarter47	human
@heavyflo52887	human
@fem_dj	human
@mac2ill	human
@dhtdfth3	human
@metamorephose	human
@iyangSL	human
@loralynpeterson	human
@droy954	human
@KayeAffresco	human
@kat_javier	unknown
@eMazingSchaumb	human
@SuppotDuDiable	unknown
@DonPromega	human
@inisidika	human
@LTippawan	human
@10champ2	human
@Jlo714	human
@chefstigz	human
@Loveolokiero	human
@Nando_Diaz	human
@dessycaa	org
@marimo_Qchan	human
@CutieUnicorne	org
@MaryAugustaAdam	human
@lokapmp	human
@QaMarRiEzMAn	human
@srochelle78	human
@ChefRoble	human
@MartaDfN	human
@JohnVDrinkwater	human
@codie5085	human
@chipmunkiez	human
@inkiiilai	unknown
@xMissTx	human
@MaisonAntonym	org
@botecodobrasil	org
@AshMajid	human
@cen_mc	human
@Eatlo	org
@BackDoorKitchen	org
@KingChefTD	human
@ASH54083	human
@JaazChacur	unknown
@KelseyLynn55	unknown
@MigueVega7	human
@ViviLeDish	org
@_chunhyang_	human
@sandiarojitaa	human
@TheAngus	human
@Harvest_NJ	human
@TrinitiHouston	org
@mind4ub	human
@natsuuu7230	human
@ayk20r	org
@MCNAS_T	human
@paduvito	human
@iamShannelyn	unknown
@choromekko	human
@CamilleGd	human
@mamasmith72	org
@taratease	human
@ansonspei	org
@AmiiCarter	unknown
@Llauger1964	org
@iforideas	org
@RainforestRBar	unknown
@NAsimply	org
@macorepe	human
@PaulusNguyen	human
@ComerYDisfrutar	human
@BinaryLovelace	unknown
@James_pyro	human
@taste_color	human
@CafeAlterEgo	org
@BarnettPenni	human
@gilmoursa	human
@crisvolks	human
@Sun_shine_95	unknown
@yeimixonbarona	human
@astridwidjaja	human
@ycjhung	human
@Jonathan_Swain	human
@KumJm	human
@LoooopyLolo	unknown
@Jess_CA21	human
@CebuRetweets	human
@S__Trada	human
@GoingGifty	unknown
@thahirsyaugi	org
@KarNaKuraGirl	unknown
@LanaSahely	human
@Zelenator	human
@skingdave	unknown
@DaraMusic	human
@cemkral34	org
@NatureSeal	org
@kunhwa1691	human
@akinaStarz	human
@bexsmaldon	human
@SigneMeirane	human
@hitasura	org
@MatthewStuart	human
@Crane_USA	human
@AngelelielA	unknown
@BraNdYWine__	unknown
@karen_04_joy	human
@mattywaldo	human
@shellieschmals	human
@QyQycupid09	org
@rica0229	human
@MummyTries	human
@djbiggdadd	human
@sparklingwhip	unknown
@ciciamelia_LYD	human
@GrifcoPR	human
@TrusRick	human
@ishteph0513	human
@Backyard_Brunch	org
@AshReneedotcom	human
@IndahEyes	human
@SourceCultureUK	org
@wishknew	human
@InspectorDhola	human
@EdwardCalame	org
@shokuseikatu	unknown
@neca_kastel	human
@agnes_day	human
@mwing2506	human
@brubsMMA	human
@InstaMinusinsk	human
@JessRiquelme	human
@DunneIreland	org
@HTKatie	human
@moomiln	org
@compaddicted	human
@TheChefOutWest	human
@nhayz_21	human
@CmKulubu	human
@islamicfreedom	org
@IvannaExposya	human
@The9095	human
@gulf_news	org
@kimmie5657	human
@vagabundo_art	unknown
@j_2_0	human
@Julie2Kool4U	human
@karencitamvl	human
@raraemiliockii	unknown
@DjTrizzyTrip	org
@DAVECASTILL0	human
@TheMissTarah	human
@SarahMirandaG	human
@Yongky_Chang	human
@mollie_garza	human
@DlxSouthAmerica	org
@parlassion	org
@BIGPacificOcean	org
@SebastianAlegar	human
@Scratchventura	org
@GerinyoL	human
@IDontTweet0302	unknown
@hope69phila	human
@IrenaCarter	human
@sara_patience	human
@ehmjthefall23	human
@CustomMadeDXB	human
@PositivelyJoan	human
@hiratareen	human
@Dom_Valentim	human
@chefpeter632	human
@jazzagold	human
@KennedyPI	human
@BlueNileHouston	org
@MsDeanLouise	human
@sommelierkeith	human
@SeemaVeda	human
@MiaEhrnrooth	human
@BostonInsider	human
@concessionroad	org
@arpanparamanik	human
@SuperfluousD	human
@whit_ney00	human
@Mom_interrupted	org
@eby_febrina	human
@TheoryComplexGL	human
@NeuvooWoking	org
@whistle4ahotti	human
@madkuta	human
@ChrizSzitek	unknown
@asianfoodster	org
@ChristopherLima	human
@PopoloBris	org
@brethe1nonly	human
@07asaasaasako02	human
@pfdezi	human
@svelteknoxville	human
@JohnSchlott	unknown
@SIPHOJOHNSON	human
@alrau_ne	human
@LemonyLimeUK	org
@wakeupcroydon	human
@beroo_n	human
@olga_gradiva	human
@FamilyFunFood	human
@marygllrd	human
@DontRushNow	org
@SeanyeBest	human
@GrandMarjorie	human
@TheRunningBug	human
@Car_Craje	human
@citizenkirk	human
@CTheLily	human
@sextantiomt	human
@willfreebairn	human
@laurapelly	human
@MrNesbitt12	human
@miez91	org
@sinemsaniye	org
@sgtmode	org
@NeuvooLonUK	org
@LeonardHolmanSr	human
@smoothie_k	human
@fartuchimucha	human
@AstoriaPerks	human
@totalhomeresour	human
@BruceStratford	human
@BSchoendeBruin	human
@juandematei	human
@NizaAnn	human
@jbeevs88	human
@JosephAndrewThe	human
@SWM_HOTEL	human
@training4itall	human
@Kateb_pilates	human
@SandwichGo	human
@Tienyhaha	human
@JasonChanfong	human
@BaggotStWines	human
@timbal_deadkill	human
@ChefGauer	human
@MS_K_S	unknown
@ReadAholicZ	human
@CeCeKy	human
@JeremyKLutz	unknown
@Olivia_Khin	human
@Thats_Lish	human
@princesskarenx	human
@Gareth__Taylor	human
@McDonalds_NWOH	org
@DanielaLai1	human
@ericadrn	human
@xelvhiie	unknown
@BlackwoodsPub	human
@LadyPropRock	unknown
@eatthissogood1	human
@itszsasunga	unknown
@ChefFactory	human
@LesThomasines	org
@Tach_One	unknown
@NlC0L3_Mari3	human
@JaneElizabethT	human
@NativoCajon	human
@karenmpaloma	human
@ideariviera	human
@bgoogld08	human
@Daina_Wren	human
@Jerelthekid	human
@untitledfra	human
@Kwistax	unknown
@alannauhrich	human
@FrankFrank408	human
@nutlovesfit1	org
@TheTankListNYC	org
@ShopTownSquare	org
@SeregaEvsikov	org
@MinJing_says	human
@oldhickorychmbr	human
@henny_fransdewi	human
@rg553832	unknown
@broomfis	human
@LUXEjae	human
@vancouvergal604	human
@Fit_JustBreathe	human
@aytekinnhalil	human
@pittzahari	human
@tonkslupin	unknown
@silverseaholic	human
@TheRawTeacher	human
@Mai_888_Ling	org
@evakhynesam	human
@FredEnde	human
@FredBrownPhoto	human
@Jesterwins	human
@annadellorusso	human
@Ultra_Michael	human
@allanoldfield1	human
@Chibisova_	human
@SOLFARMERS	org
@derek_madlutk	human
@Zaravella	human
@RommelSantiago	human
@knockout0603	human
@jun_reno	human
@AndrewLambert69	human
@baconclaretme	human
@ThatGirl_Leah	human
@RyanDuffysHfx	human
@iamjosel	human
@MoonFighting	human
@CookinDa	human
@tengkunadhirah	human
@KonnectToK	unknown
@TraceTobes	human
@CoopMusic247	human
@JacquelineInge	human
@ChiyoRisen	human
@Ryansrule	human
@itsmejayte	org
@crispyoinkie	human
@officialbry	human
@Karen_MedinaG	human
@NaachoAvila	human
@KateVDevine	unknown
@Billy_Paine	human
@LJpMcCTwita	human
@SclassNastyJAV	human
@JessicaLimSL	human
@Mr_Deal86	human
@Philipdev95	human
@BakerandSoars	org
@CEO815	human
@ncentonze	human
@TrinityAnaheim	org
@JannaCachola	human
@MariSG98	org
@NerdTera	human
@Twinn23_	human
@rivergrid	human
@2camxxx	org
@SantorosPeabody	org
@RealNaveed	human
@GonzalezVanesa	human
@BohoBuys	human
@su8n106	human
@Lauren8020	human
@DeeptiAbraham	human
@CarlisleScran	org
@missmaria82	human
@Powerbodymind	human
@ducklarkin	human
@akualong25	human
@ChicScienceBlog	org
@backpackerjim	human
@jpdesignsart	human
@Gusto101TO	org
@morristapngrill	human
@petitacarola	org
@HayitsAnimae	human
@John_Arena93	human
@Chonanit	human
@Kingpap504	human
@triffagghione	human
@iAmVivani	human
@freshleejr	human
@redskymary	human
@YC_LO	human
@weddingwires	org
@EggsZachly	org
@eamrichardson	human
@sparklingover50	org
@kristenmcats	human
@Jeff_mahin	unknown
@SocialMediaRI	human
@al__izwan	human
@RoyaltyBLU	human
@ana2_fitt	org
@_nkoca	human
@mafer94fm	org
@susan_hua	human
@celz_instagram	human
@ALAboutAlabama	human
@mymind3089	human
@__MrMiller	human
@pjpink101	human
@Alejandro6290	human
@aldeeeeeen	unknown
@mickkaczorowski	human
@imatakubesar	human
@WBali	org
@Emily_92	human
@Pdrmolina	human
@BrokerStephanie	human
@ElPorteno	org
@RileysChico	org
@MarinersDevon	org
@PriscillaAmado	human
@FlorianneDclg	human
@SebastiansSum	org
@Rose_Rowling	human
@JoseSanchezXll	human
@Vanessi3	human
@JuiceForLifeNY	org
@SUPTOMO	org
@JuzInquisitive	human
@Griffinnnnnn	human
@zflab2004	human
@gurl_k	human
@xoxo21chi	unknown
@EtsyRecyclersGT	unknown
@SnowRoadProduce	org
@tendon_tenya	human
@JoniRobbins1	human
@tha1808	human
@bellaenpink	human
@javonchambers89	human
@Hamadphoto	org
@RatedRBiz	human
@MikeSavad	human
@margarethsilvia	human
@Balls_team	human
@PrincessWaB_pak	org
@mikepucio	human
@DilliDaily	unknown
@BlazingSociety	unknown
@tomylewis	human
@ruiying2000	human
@TheWestinDhaka	org
@Phatnightmares	human
@MiryPz	human
@BHDeli	org
@martMMC	human
@balancEiRIS	unknown
@daisy_cottage	human
@MossValley	org
@tripinmidair	human
@fitfabianca	human
@ricayourbody	human
@fifigracexo	unknown
@CathyCavern	human
@kristalscooking	human
@IndulgeRestaura	human
@AureliaPal	human
@mikayellah	unknown
@Ongya12	human
@vino_uncorked	human
@LeMeurice	human
@asskcafe	org
@xoannie09	unknown
@FshipNeverEnds	unknown
@thenewblacck	human
@superkazuvegas	human
@ineilpatil	human
@sushkova_nastya	org
@RYANLPUTONG	human
@HardRockEdin	org
@SKGPR	unknown
@SYKyogakitchen	org
@YogandH	human
@bridgeinthebox	human
@canustundag	human
@miyaqueenofhair	human
@haiiKARIN	human
@iliyarich	human
@mallsensations	org
@harrycalat	human
@Desinthekitchen	human
@LittleHornOk	org
@mamilupita7	unknown
@FreshMotivation	human
@jlvasquez242	human
@papalbina	org
@aretoladpoi	human
@mzskeen	human
@allinclusiveTW	human
@supladitaah	human
@Jabberwauki	human
@kucharzyca	human
@shannonplush	human
@vikarrieta	human
@pasiiing	human
@BHappy2BHealthy	human
@accepterali	human
@DKphiladelphia	unknown
@FENUSF	human
@maireviola	human
@64Eats	human
@0711jared	human
@simonebr111	human
@lapri_vate	human
@teaave1936	human
@MohdFatFat	human
@RobynStore	unknown
@lifestyledbyj	human
@cutie_matty	human
@pretty_ehlda	human
@YummiScrummi	human
@AHPIS	human
@mlbolle	human
@DomenicoCiaccia	human
@0706_st	unknown
@NSbZ1609	unknown
@thewellnessmap1	human
@HaveMeRememberU	human
@SorinaFant	human
@alitan8	org
@Savinggreenmama	human
@PrasanthSekar93	human
@VillageBurgBar	org
@viccky_vicky	human
@yogatailor	org
@SandraMeier	human
@jjoceyyy	org
@ima00ami	human
@HollandMorris3	human
@Onnie_Tan	human
@kawaiipetto	org
@LazystudentCS	human
@rahman121292	human
@tarntarnoad	human
@diyadea	human
@andraokt	human
@hwilson2009	human
@MissyMooUK	org
@marghyzanni	human
@MissMandii	human
@RedIguanaOG	org
@Vegaleven	unknown
@lilyandarthurs	org
@poojadhingraa	human
@arul_ayish	unknown
@soldecactus	human
@Jim_Graham7	human
@MonicaVelezPons	unknown
@bhavyaholidays	human
@RafikaTriana1	human
@MetroBG	org
@elisa_saioni	human
@joyful_health	org
@imajhay_	human
@Tkpag22	org
@DNM_Bos_Travel	org
@SaeedAlmaidoor	human
@LemontPierreC	human
@FoodAtHomeFtW	org
@dayananajwa92	human
@Shanganagh	human
@ItsUrbano	org
@rachelzhu_raju	human
@KingD_Royalty	unknown
@iamfabuLUD	human
@kooxy14887	unknown
@viajerapolar	human
@sefmusta	human
@SherlySyerils	human
@aiZzyCLe	human
@miss_rubes	human
@shin_nagano	human
@Gina2190	human
@BRAVILORO	org
@Psamomma	human
@mrbrewok_pku	org
@LennaLeprena	human
@MsTasheena	org
@Malachi_Rand	unknown
@LivvyYong	unknown
@Lvcky123	unknown
@TechPatNY	human
@Beautyskyhigh	human
@locandaolivetti	human
@Tranman89	human
@tracieds	org
@Leanmeanmomma	org
@pufu_p	human
@NtrlEpicurean	unknown
@landonsmum	human
@Kitty_ammieZ	human
@boulayounabdelk	unknown
@NorrisGreenSubs	org
@SAcurrent	human
@djam_ent1	org
@manu_cobos	org
@MS_URIV	human
@GentleVans	org
@momepisodes	unknown
@PopStarChic	human
@Cimandis	org
@Arjan_Topchef	human
@Dazy_Daze	human
@mtktavern	human
@jerrinetherese	human
@ifmmanila	human
@DevonvaleEstate	human
@inessukamakan	human
@stylerepeat	human
@skyviewfir	org
@ssfoo93	human
@ann3ro	human
@GiggleLunchBox	unknown
@livinginlekki	human
@MayaAult	human
@giftsiyaporn	org
@EnizYagmur	human
@BuncranaRadio	human
@boonconPIXELS	org
@miettenyc	org
@rudegalchia	human
@Tinapie333	unknown
@give2040	unknown
@Tony_Woods	human
@IremCesko	human
@carelessly_cut	unknown
@Mariel_3	human
@immaclassic	human
@Jess_effendy	human
@YoungJolo09	org
@julyromero01	org
@AudiMidTown	org
@tridentrusted	human
@Lee_Bomzer	human
@BMRTG	human
@PlanetaCerveza	human
@chrispalmer91	human
@FreemanLoke	human
@nishiyan1121	human
@NYC___Fashion	org
@curtisjordan	human
@pedrobastiidas	human
@onndz78787	human
@lizlyrh	human
@YelpBrooklyn	org
@olvelez007	org
@TheAllisChicago	org
@lan9194	human
@Shara29	human
@tenderjoy	human
@pac270	human
@MrStrong2013	org
@LaeCharles	human
@MissPixie1990	org
@JacksonJourney	unknown
@kxhappy96	org
@Caffeatina	unknown
@ZaneWineBar	org
@john_mccoubrey	human
@cik_coki	human
@megandowning	human
@nuttygirl	human
@Hecca_69	org
@ayakam10	human
@zwaite	org
@TheRockwfpYYC	unknown
@Aditya_Apn	human
@The_Holly_Lama	human
@ventero_picoteo	human
@YonathanMarcus	unknown
@Luci_Mly	human
@myrtnn	org
@Ralnouh	human
@oneunanman	human
@QuintenBraem	human
@missiexox	org
@kanaka_snack	human
@MartasTradgard	human
@masamune69date	human
@arahrazahra_	human
@AntidoteWineBar	org
@its_stevefanie	human
@seafoodisland	org
@Costana78	human
@RaziDj	org
@BiggersCraig	human
@judetx	human
@living4two	unknown
@joanamrebelo	human
@SAACChamber	org
@minakula0923	human
@MainLineChamber	human
@Bruce2087	human
@FoodAroundItaly	unknown
@JdObeso	human
@BellaTimmins1	human
@whatsonlasvegas	org
@Beeetsyy	human
@DivineDelectabl	unknown
@myrddinsheir	human
@larcsuke01	human
@Lei_Haunani	human
@_pureindulgence	org
@haincelestial	org
@MinCheong	human
@Maria_17m	human
@davidmhands	human
@rekasg	human
@dorsetcereals	org
@SPUNSTAR	human
@EllyEyustina	human
@its_lou_	human
@MartinJDowns	human
@JeffMatyger	human
@melokayan	human
@aStrie910317	human
@bananasbusiness	human
@joaohanzen	human
@bayleyandsage	org
@UK109070	unknown
@acleynes	human
@RafamerAdnan	unknown
@wana_archibald	unknown
@Chasethechicken	unknown
@ThreeSanMateo	org
@venus_aicon	org
@OldSkoolTif	unknown
@mizzjuliee	human
@J4RAngcanan	unknown
@sparklez_d	org
@Jackiekkboz	human
@alien8	human
@HHTF	org
@ooikennyjk	human
@bospherous	human
@Beulahlondon	org
@numbanil	human
@Elismartin1989	human
@jdwcollier	human
@spankranch	org
@Setorii	human
@sayacaen	unknown
@Gogosbmx	human
@EYE_AM_PHAROAH	human
@F00G	org
@JCVincentNets	human
@GiuliaCoco21	org
@CountryInn_MANK	human
@LupitaGlzP	org
@NescafeLatino	human
@ica89	human
@evriella	unknown
@WhereSanDiego	org
@Minderblender	human
@WhichWinery	human
@cunne_chun	human
@atThalassaHotel	org
@KarenGaignon	human
@runtothekitchen	org
@EVMB1	org
@FatimahElZehra	org
@kofficefma	human
@UrbanTrekUSA	human
@kitamikomae	human
@kiedra24	org
@charlottelavill	human
@aLi_JamShEd	org
@KOKObeware_HM	human
@rbongard	human
@Dana_Naser93	human
@ViiGuzman	human
@atom_auttapon	human
@uzzairitg	org
@kucittt	human
@priernne1689	human
@PatrickKolts	human
@RichardYandex	human
@JaazMerlo	unknown
@_jnq	human
@thebabyspotca	human
@anggunaanggunun	org
@darienyj	unknown
@aikenchew	human
@jenrachelam	human
@brittocharette	org
@getmarvelous	human
@deviayun	org
@jennifer_jag	human
@knitoasis	human
@sorriso_y	human
@Uffee_	human
@HC_Shoreditch	human
@amitsakhrani	human
@MGastalver	human
@AnisMelisa88	unknown
@JustineDenea	human
@apelleshoppe	org
@theVINomous	unknown
@mskristinaerica	human
@JessicaDrue	unknown
@Chris_DePaepe	org
@dukeofalhambra	human
@JuventinoNYC	human
@kokofrigerio	human
@zulfadly	human
@Mersaydez_Benz	org
@thefablebar	org
@FSRiyadh	org
@claudinaringgit	unknown
@Robin_Essex	human
@aimeeflores	unknown
@kutilpa	human
@JHonkakoski	human
@AndroAppDev	unknown
@hanggoyudho	human
@Cy_clops	human
@DonnRagu	human
@JcquCstls	unknown
@sweetpurehoney	org
@SaraLailee	human
@Schullzz66	human
@littlesammmm	human
@EwaGlow	human
@bunny_kang	unknown
@RaquelVK	human
@TheDreamOffice	human
@RJAMCKIM	human
@itsplaytime612	human
@Pingcessx33	human
@islandbeans	human
@What_U_Deserve	human
@jkkyawzay	human
@SplendidMcr	human
@Moamenkhalifa	human
@CasaKirva	human
@T_James4ever	human
@MyRusMa	org
@iammakingmusic	human
@iam2ne1fanatic	org
@fr0stbyt	human
@foodandthefury	human
@astrid_CS	human
@hhhmp	human
@baiatyahoocom	human
@Paul_Timothy	human
@chantekm0lek	human
@YvonneCrossland	human
@OCJake	org
@eimi_fuyuko	human
@FitShit_	unknown
@Jro0021	human
@smilewitheva	human
@Davidous	human
@advcavemom	human
@shantishalayoga	human
@itsdenissemae	unknown
@RedReidingHood	human
@TastesofAnglia	org
@Hiromimmin	human
@Beauty_Sands	human
@McLeodAl	human
@YosraImperato	human
@SecretofAging	org
@itzStephieLynne	human
@hager_adel	human
@cheesekit	human
@cavaswinelodge	human
@Montreal	org
@melinthecity76	human
@LuuHurtak	human
@alllllneonlike	human
@pinkystar_q8	human
@PrettyGyrlEss	human
@akichan10170822	human
@LiamsRestaurant	org
@BevanBell	human
@allurre	human
@Kickerskel	human
@AkichaKawaei	human
@aprealrockyou	human
@PiwPodi	unknown
@MsSugaPlumPlum	human
@LaGioiaEvents	org
@JhudiJhu	human
@The_Crosstown	org
@glampacker	human
@Zahra_Hasan	human
@elizabethsomer	human
@mrsjenningsjr	unknown
@CeregumilMSBROS	org
@KingswayEdin	human
@MosBeef	human
@TheCounterKSA	human
@EdibleArrangeHK	human
@standrewpoultry	human
@BBowsandBeauty	org
@ashleymartin8	human
@lfresh	org
@looking4champs	human
@TheAdamCav	human
@pastarendang	human
@YaDadJB	human
@meg_xv	org
@BenOsbourn	human
@OrganizeDream	human
@shinshoga	human
@SayoSayo318	human
@playwithapparel	human
@Indah_Indaah	human
@JOELMELLENS	human
@luno_66	org
@Spencer_Private	org
@sweirr	human
@Relenquishedone	human
@livinJENeration	human
@Zieloshopping	human
@MarissaSauri	human
@thesortedlife	human
@Nipple_Expert	unknown
@cavelectric	human
@OliverCheatham	human
@DDNational_TV	org
@DebonairsKloof	org
@aishaburn	human
@AndrewBDTRogers	unknown
@pamelafrank	human
@youngjongchung	human
@Milenxa	human
@DinnerDynamo	org
@Toronto_ED	org
@NamrathaJoseph	org
@StacySilvaBout	human
@alekurbel	org
@JulianfAmpudia	human
@TalesofKitchen	org
@jaycatvt	org
@merzibsuz	human
@fitribire	human
@KaNGfu1226	org
@JillEditorTVIP	human
@collectiveesp	human
@pongkibarata	human
@tokyoterrace	human
@jmwest102	human
@ClintonHallNY	human
@Corbett_Becca	human
@MindTheBeard	human
@EddCrmnna	unknown
@neebgirl17	human
@UsmanRx	human
@sofrandom4	human
@FoodyFreaks	org
@FrankInglis	unknown
@LiliyahVDL	unknown
@GusGood	unknown
@newmumtips	human
@dannykuan89	unknown
@zumbavivienne	human
@HelloKitty_Kath	human
@RCsMartinCity	human
@AnisAkma	unknown
@NikkiCatania	human
@fallottie_dina	human
@CTMedina	human
@drosebonbon	human
@XplicitMevon	human
@villagepatpdx	org
@RichGrcia	unknown
@MhdRazlan	org
@franciverr	org
@joebuchel	human
@MarietMuratovna	human
@1MoreThan9	human
@JasonRing	human
@Garfrericks	org
@gogrizzy	unknown
@RandySRobbins	org
@ThiartLi	human
@antloks	org
@Cannes53	human
@nobeeex	human
@avisiontorememb	org
@VeronicaLevam	human
@Iamlinahill	human
@foodfreaks_ch	human
@jamesturnipseed	human
@Dbgm1	human
@x_chihaya_x	org
@FourSeasonsBR	org
@Alexakayy	human
@_AMPMEZ	human
@chrisluvzombies	human
@TsipiLevin	human
@pornhenKAI	unknown
@BlackHippy_27	human
@AH_Theta	human
@Laibalderrama	org
@EricSchouten	human
@newspalmelo	human
@suryatna_dede	human
@yourstrulylia	unknown
@OGS_leblog	human
@Whitsayyyy	human
@Charly_Ndubz_JJ	unknown
@palevolution	human
@jpuglisi1954	org
@yp_0118	unknown
@raannnzzzz	unknown
@perrinkaplan	org
@nixon_paz	org
@SammFuu	unknown
@cleversmile	unknown
@mira_ekawati	human
@Lee_m0nn	human
@infilipac	human
@RobertGCloete	human
@k_konjevic	human
@haneull_pcy	unknown
@ChrisCroucamp88	human
@AnneTC	unknown
@AnyaMihailova	human
@ericasalmons	unknown
@BestOfCarlsbad	org
@TheEscapeList	human
@vijaybrena	org
@thelinehotel	org
@albert88en	unknown
@WomensForum	human
@LesZinfosDu3e	human
@say_17	human
@Duaa2202	human
@TweetCancun	human
@ShakeshaLTL	unknown
@cookiesnsandals	human
@liasetia1	human
@MielYuri	human
@PureJoyHome	human
@caecillyn	human
@mjrwebdesign	human
@Lilymooi	human
@PrinsesaDiannna	human
@sloanetaylor2	human
@StoneParkBK	org
@TioFridays	unknown
@ammaralabbad	human
@Kaviraja	human
@TheReflexBabe	unknown
@pompeypaul30	human
@angelarusly	human
@VALEDIEZ	human
@SuPerSparKly28	unknown
@nataschats	human
@s_1076	unknown
@SummitGrillLS	human
@flexx2004	human
@KeyleeStyle	human
@world_flaneur	human
@TeguhARK	human
@yieZarkasi	org
@kitchenshortcut	human
@JolineNaples	unknown
@JimmyVanBramer	human
@mizmillyna	human
@Runpa5314	unknown
@Red_Dimond1	human
@anaviglam	human
@Marielbrown74	human
@G22Workout	unknown
@tvxqrimi	human
@BleedingBlue132	human
@viewfromalake	human
@nov152	org
@suzanexian	human
@raysstory	human
@ReTweetUrPost	human
@ValerioFranco93	org
@Ele_Mal	human
@BLIPDAFLYERMANN	human
@echaalovaa	org
@harunyan3b	unknown
@mika_chaaan	unknown
@xoxo_brittany7	unknown
@kvn192	human
@bdsvnreal	human
@yukariskitchen	org
@EatsOfAsia	org
@LadayOreo	human
@iggysbakery	human
@OfficialJames04	unknown
@CAPRICEelirosu	human
@na_a07	unknown
@Petcsra	human
@vanessalouise85	human
@collegecubeclub	unknown
@Fio_reeh	unknown
@arielbenz	org
@iamJessicaMae	human
@isoldthat	human
@WakaAhmed	human
@DimaHammouri	unknown
@EsquireDavidT	human
@SebastianAndCo	human
@breonarose	human
@NickBarose	human
@__phopho	org
@DiabetesHM	org
@pookapaik	human
@HenCorner	org
@TasNostalgia	unknown
@ChefLisiParsons	unknown
@SassafrasBakery	human
@musicplant_kiki	human
@luvusassi	human
@Eliane_Sam	human
@MiraJayC	unknown
@WedNBliss	org
@aderizkyamalia	human
@meekob	human
@iambellat	unknown
@olasia	org
@LotusRunnings	org
@fireboy333	human
@CarltonTowerDxb	human
@dayna_churchill	human
@ImDavidGeorge	human
@nicholemckinnon	human
@hellobklynyc	org
@Zdenshop	human
@Catheri40910346	unknown
@BetsyLandin	human
@carmienearing	human
@oooh7	org
@nnnnddaaa	human
@PandoraLou239	human
@JeannetteW_2Ns	human
@Fuekitty	human
@starwarsjunky	human
@EmilieDegioanni	human
@NetishNunnan	human
@LOVEALWAYS_JAS_	unknown
@netteanne07	human
@boshen0803	human
@mtan14	human
@tobefrankmusic	org
@EllenGrace87	unknown
@princejohanes	unknown
@chan_ernie	human
@ILoveLubutin	org
@TWSFBlog	unknown
@whitemyvi	human
@kookailim	human
@donnagauntlett	human
@niilah	human
@0410chic	human
@Nicole_Jenkins1	human
@Katie_Liber	human
@HealthyMenus	org
@algia10	org
@veronikaethel	human
@Camipaillettes	human
@NahirPrincex	human
@pmadhok	human
@Uya_sueria	org
@baerbarofficial	org
@Athavan	human
@uprisingKevin	unknown
@1sammyk	human
@CaroGuadamuz	human
@khristux	human
@cdm5083	human
@nando_oakley	human
@boar_blue	human
@Andrea_Brown7	human
@catlandocat_	human
@AlbertsonsSD	unknown
@Nacol96	human
@The_RainQueen	human
@carolina_bell	human
@SquiresPDX	human
@CrafthouseLeeds	org
@Igers_Salerno	human
@NotOnlyPizza	org
@inet494	unknown
@YuanYiSia	human
@Yaccafella	human
@taniaestrada334	human
@Charming_Rey	human
@BubbaquesBBQ	org
@ainth_gasim	human
@Katlovesflowers	unknown
@lebadass	human
@virdatjiam	human
@Italian_Cottage	human
@angeesantos	unknown
@bedvynewine	org
@sissyjamie24211	unknown
@IamGod_Pickney	human
@AnnelienSegers	human
@foodyphil	human
@PersonalChefJ	org
@Akanen521	human
@royalcliffgroup	human
@MatthewSHyland	human
@wira_pangemanan	human
@lorikeet8	human
@EhAimanMazli	unknown
@strngarmJOKER	org
@SAMBOLLEDO	human
@ladnserenio	human
@Where2goQatar	human
@meredithzheng96	human
@Whitevaleny	human
@OsloGourmet	org
@_LOVEmeFREELY3	human
@NanezR	human
@Joana_Verdu	human
@brianneoeo	unknown
@officialtaro	org
@athleticangel1	org
@TimeOutBahrain	human
@Swaggie_Barbiee	human
@Nano_Roots	unknown
@nopankrizt	human
@Yuyung_NRG_	human
@IndianWineman	human
@Charlie_Ginger2	human
@blancpastry	unknown
@19Cyn19	human
@AbuOmarAlami	human
@boostconsultant	human
@rdvnyc	human
@La_Rocchi	human
@ange_pickett	human
@ayausugi	human
@HelenKkimelen	human
@Alientjia	unknown
@burgermbiraktn	human
@tonycapelli	human
@SeedUNiverse	unknown
@pulchr1tudin0us	human
@bassiturd	org
@hkvanes	human
@itskha	unknown
@savorynsweet1_	unknown
@Daniel_Gadsby	human
@djlammin	unknown
@cdnchoice	org
@DiscoverYLEO	unknown
@djgeminijapan	human
@NinNinjas	human
@LilyAngelica311	human
@WeShopYouSave	org
@_Se_Lena_	human
@yennylove1	human
@UrbanPalateLA	org
@FireFam5	unknown
@p3emkkc	human
@streetgourmetla	org
@JwZhozefina	unknown
@YYCPatios	org
@nnununNS	unknown
@laluzsehabiaido	human
@GALLEGO_ARD	human
@fatirs	human
@iamjohnsualog	human
@taka_mind	unknown
@NeynaYusoff	unknown
@iam_gerome	human
@robo_jojo	human
@sina_paperwings	human
@SariLoveGreen	human
@LookAtThisFood	unknown
@JoelleMardinian	human
@AchuReales	human
@melissajoy89	human
@jaybreezii	human
@graceOracion	human
@Clutch1st	human
@oilabb	human
@apronandbowtie	unknown
@rupiej74	human
@ItsFrankyJ	human
@lotusleafstyle	human
@CreatShimeon	org
@RYORYO	human
@lusykongdju	human
@in0v8ive1	human
@xweetclaudzie	human
@BrasserieM	org
@vecau2	human
@stcymccoy	human
@tucsontamale	org
@gretchenpowell	human
@eggs4_breakfast	human
@meelsky253	org
@steinhardlive	unknown
@revelframeworkq	human
@ShaunPoh	human
@ValiaSkincare	human
@StaticMediaHub	unknown
@babybugz15	human
@sixsensesresto	human
@dpadnyc	human
@cherrilseriru	human
@Food_Thyme	human
@GwinnettMedical	org
@itoHdz	human
@malaysian_pics	unknown
@dek_Ti	human
@SpecialityChef	human
@COCHON555	human
@beckyhartsyou	unknown
@SisterSisterNYC	human
@vhrstrom	human
@Listia_17	human
@smexy_blogs	human
@vangiebagareyes	org
@MTLenLumiere	org
@barbie_ladivina	human
@LulaDieb	human
@pizzapizzaCEP	org
@JamesTheChef	human
@mikesinside	human
@Arriearrie01	unknown
@BelindaChee	human
@candicemelrose	human
@KateringbyKEC	human
@amvonr	human
@AlisonKucera	human
@Lozzahugez	human
@yoda1970	org
@DSConnaughton	human
@d1andonlysouxie	unknown
@MySoulsAnchor	human
@WorthyBook_MY	human
@StickyElbow	human
@DukeInMinor7th	human
@Summerkites26	unknown
@GilantP	human
@ali_danis	human
@lettymoussallem	human
@Kelvin_Chook	unknown
@savske__	human
@JenniferlaylaZ	human
@AntikHotelist	human
@DishforFoodies	unknown
@vinniegoblue	human
@XArea51	human
@cesarthaugustho	unknown
@ShirleyCoble	unknown
@MundaneEnthropy	human
@MaineEventLive	human
@UrfollowinPanda	unknown
@instafoodiee	org
@kyutiepiekyu	human
@BEYOUEC	org
@ayuinoo	human
@krizethk	human
@lfernandez0524	unknown
@tsoetedja	human
@el_gallogiro	human
@madam_Foxy	human
@gameapp_aruaru	unknown
@London1stclass	org
@ElMariachiBar	org
@vieactivewear	human
@Diaanasp	human
@Czardiva	human
@eachacupmy	org
@evijuls	unknown
@MonicaPaleo	unknown
@KermesVanessa	human
@PanamaTipicoCom	human
@WeismanWellness	human
@Watzadealio	human
@charlizzbeat	human
@aiindigoblue	human
@ekasatya_n	human
@nightinafigtree	human
@naaan_03	unknown
@Gusteeeh	human
@Stardlc	human
@margaguillena	unknown
@bibalang	unknown
@hiromichi_m1	human
@CanCanMigan	human
@cherishanggie	human
@1markx3	unknown
@RyukOwnz	unknown
@krupaconsulting	human
@harlancrystal	org
@oliverg16	unknown
@cheftroyknapp	human
@NagoreMinerva	human
@PygottandCrone	human
@csabitamas94	human
@nickpardo	human
@MadihaSobtian	human
@bear_nyc	org
@LaPanthere_Rose	unknown
@Nate_911	human
@clarkdumon	human
@tina1990gay	unknown
@DannyMalfoy	human
@wheatfreely	unknown
@stanleymwc	human
@feneworld	org
@PowerBeautyFood	human
@FrancisFelician	human
@TheHelpDesk_Int	org
@MjkKiki	unknown
@mosamba	human
@Pjfeung	human
@IsabellaOrgan	human
@chadwx	unknown
@Lizzy_kpop	unknown
@JDGraysonbooks	human
@xsayanox	human
@clubpcd	org
@ailinnabilaa	human
@HerFamilydotie	human
@Drewzzi	human
@Giannoulias	human
@SmuvCash	org
@iamF3iMeng	human
@unIMPECABLEjefe	human
@MayHera	human
@iSarii	human
@brxdlxy_	human
@roadtrip_tips	org
@ZoraJenea	human
@rocketcw	org
@cortezaaac	human
@syazahazim	human
@dexibrahim	human
@housedjdyla	org
@NW7US	human
@emstargally	human
@carriejuni0r	unknown
@Cris_Fialho3	human
@Rawxies	org
@NourishesMyLife	unknown
@sabilasays	human
@yumi_gwiyomi	human
@DarlingMsLili	human
@juicing_journey	org
@TwoClassyChics	human
@gliiterbugg	human
@ambrosia333	human
@ToriNicksWho	human
@FoleysDublin	org
@MaidenLI	org
@kristianezra	human
@Tavo_garciaa	human
@itsmynormalface	human
@Royale_Cuisine	human
@___84no	human
@_yumisan_	human
@NazzatulAkma_	human
@merylega	human
@cuisine_genie	human
@DiaryofFitMommy	human
@Simmerer_Agency	org
@97Kuang	human
@lauren_kelly88	human
@Pastorglesne	human
@FoodforMyFamily	org
@Arzuslife	org
@jose_miguel70	human
@VanessaPicker	human
@mtursi2000	human
@COOLROOMBLOG	human
@back10cellars	human
@citygirlhanna	human
@veronicageraci	human
@PerthCityCentre	org
@ditacoco	human
@chadleephoto	human
@admiral_baby	org
@deejaymelody	human
@TheCanvasCafe	org
@IlkleyChat	org
@JESSE_N_DARCY	human
@LeMeridienTampa	org
@bolegrega	human
@aqueenstweets	human
@chapstickgurl86	human
@rainerhen	unknown
@KarmaKittyJewel	human
@DFOTOLUZ	human
@EliteAllurement	human
@NakiaTT	human
@evehfitness	human
@meelissafs	human
@RobRovira	human
@thesowhatmom	human
@mikepayneuk	human
@Mufasaa_Aswad	human
@engage4fitness	human
@DesignCuisine	human
@Stef_fwi	human
@ImNotBillCosby	human
@maurett	human
@STATSatl	human
@TonyPangPT	human
@HashtagHestia	human
@BourneValleyInn	org
@drcoltcabana	unknown
@PureFoodandWine	org
@UN92	org
@MeekAh_M	human
@extrafreshh	unknown
@IdealCheeseWine	org
@MiaOksala1971	human
@sopheanam26	unknown
@TanKissed	org
@liana_G_	human
@imjnalai	human
@Tinktinkie6	human
@EarthingAlice	human
@Valiyii	org
@Apinut_1	human
@ChiroNdel	unknown
@phoebelebrecht	human
@BrittanyGenge	unknown
@HealthToday_eu	unknown
@maltbaby	human
@Culinary_Cam	human
@JulissaBK	org
@keychikAlias	unknown
@Mbanyy	human
@NeuvooNewYork	org
@tomwalker1985	human
@sonyabella2012	human
@ClareBurns7	human
@vrb85	human
@teresamonteross	human
@CAlagok	org
@TheTurtleClub	human
@LuxuryResortBZ	org
@pankmy	human
@MaccusWongHaoJi	human
@MagsWinthrop	human
@eimoxxx	human
@denitimo	human
@wedgail	human
@aloneinatlanta	org
@mirv_	human
@Lou_Jane_1990	human
@tarrantino8	human
@kuyaglad	human
@H_Delicatessen	org
@shuwei_ooi	human
@EnaBReese	human
@LizCachuela	human
@kimsonae14	unknown
@Nieda607	human
@ClaireSaunders3	human
@ChefHebert	human
@mlg2795	human
@AnnaLaurila	unknown
@sassygirlcanada	human
@valeriem11	human
@JosieEsguerra	human
@joanne_lew	human
@BaileyNelson_UK	org
@YuhanLuvNP	human
@leausuho	unknown
@GrandRotunda	human
@FormaLosAngeles	unknown
@yokorobo	human
@AmandaLoveGUM	human
@ArtistLoKi	human
@newstruthliz	org
@LaurenAinscough	human
@andreuibanez	human
@hello_m_hamp	human
@AaronRazer	human
@iambyann	unknown
@ximmeriquelme	human
@GreekBroyo	org
@stelscalabrino	unknown
@sergioparisse	human
@VC_LA	human
@zebedeedo	human
@butterfly198921	human
@arianlvrd	human
@fifitter	human
@butch_86	unknown
@danamaepassos	human
@annemcdaniels	human
@glitter_blog_xo	human
@herbalife_j0	org
@ajochem	human
@finchify	human
@alicia_kay	human
@the_nakedape	human
@Jennpetropoulos	human
@TeresaYuWillams	human
@shadeofcat	human
@JockieBoslin	human
@iDADSi	human
@DinnerIsPoured	human
@KDFF	human
@ivastjepanovic	human
@Baby_Gee25	unknown
@AMummyToo	human
@Jenny_McNutt	human
@akanemanami	unknown
@kirsty_555	human
@The_PoshLife	human
@ingrid_yap	human
@VasilikiGuest	human
@mikichanne1	unknown
@KillaKelSB	human
@THE_COOL_CHEF	org
@BEmpoweredBWell	human
@Judit333	human
@LoveLentilsBlog	human
@yoshimi0117	human
@fit_ting	org
@Bran987	human
@marketingmummy1	human
@johnuarr	human
@SouthernLadyThe	org
@HSUCHUEH1002	human
@ToontricityCEO	org
@vampiregirl216	unknown
@lealucas	human
@k13real	unknown
@VEVOnow	unknown
@Big_Bella	org
@kingsoflean	human
@AnacostiaArts	human
@xcourtnieeex	human
@CalvinLaurenson	human
@anna_caunce	human
@sdfazio	human
@ViJingga	org
@PanDulceCouture	human
@OutSavvy	org
@TheCalmDev	org
@BellaLipz	human
@nadxxxirulafif	human
@AnneBonaCoach	human
@limepanna	unknown
@XoCoHealthNL	human
@thegreeklarder	org
@yon4yon3	human
@bs_sreelekshmi	human
@superkidsblog	org
@LeChateauStyle	org
@TrixLaMix	human
@Eden_Cater	unknown
@MadeinUSAPledge	org
@SakkoTweet	human
@Cool_My_World	human
@Rogerdriver	human
@ItsSarahLowe	human
@yumilim1992	human
@kaity_modern	human
@foersterdanie1	unknown
@MakersLV	org
@_tiny_dancer	human
@yuko_looove	human
@chena0520	unknown
@rafben	org
@mmadhungry	org
@Kilshannyhouse	org
@missmerveboz	unknown
@julia_bee	human
@AllyFranny	human
@Brandon_bolster	human
@mmehul19	human
@pastasroma	human
@mintjonnjonzz	human
@pikeandrose	human
@misraersavas	org
@CPD_PUNE	human
@DanielaAdriana1	human
@thewbraz	org
@FrankeJessi	human
@Brewology295	org
@mchl_sr	human
@SickGamingCliq	human
@Lowlah_21	org
@B_B_4444	human
@Hommefatale08	human
@LibbeyC	human
@Rest_Memorial	org
@Sv_Platonova	human
@NickSamsGrillPC	human
@johanna_clark	human
@sharkiraZ	org
@giveawayhoot	unknown
@nikkisdiaries	human
@JessiAng	human
@_nataaaaan	unknown
@linds931210	human
@KC_WANI	unknown
@amii_ginpdx	human
@traybear	human
@OchsMichelle	human
@serjfedik	unknown
@92sergiomontero	human
@SoCalEatsTreats	unknown
@bonezliem	human
@GuzzleSA	human
@McGettigansNYC	org
@urvashi13k	human
@RidingShotgunLA	human
@dankitti	human
@Artchild	unknown
@kaoli0330	human
@katLnichols	human
@Neal_NDRPG	unknown
@TimothyJubilant	human
@ElConResort	org
@jkanechan	human
@haeeminn	unknown
@jomeara555	org
@MaxBilott	human
@DesignAndy	human
@Minio_V	human
@BarkleSpa	unknown
@stationarylove	human
@Josema2403	human
@Justin_TFC	unknown
@ciiaagnesia	org
@reeyahcamille	unknown
@bubble05rider	human
@kodigdsafdf	human
@TheMarkHotelNY	human
@meals_whitecity	org
@jrc_blog	human
@PenniesToPearls	org
@foodnutrition43	unknown
@OrangevilleDQ	org
@ZagatSF	org
@Noors_Kitchen	human
@CarrieHOlerich	unknown
@dishricky	human
@imbabyzchen	human
@Sudenca	human
@LauraEmilyT	human
@tishworld	human
@lostandwanderin	human
@jumpatthepool	unknown
@WhiteningLtning	human
@LuciDiazJalil	human
@StewLeonards	human
@YoallyCAlanis	human
@ThatDamnTwerk1	human
@PopsicArt	human
@StJudesRanch	org
@MaryliciousM	unknown
@NativeForeigner	org
@lalcrowe	human
@DANYaker	org
@awintersfoto	human
@Moneyhausen	human
@CappieB	human
@maimine92	human
@Roobihart	human
@lhaiplacar	human
@cordovacasino	org
@sakasamana03212	human
@snowflakegelato	org
@itbskn6	unknown
@MokhaladZubaidy	unknown
@Qu33nB33Marie	human
@MaggieeVeee	human
@sarpsvegkitchen	human
@Instacart	org
@TheReal_RobJack	human
@007whendee	human
@pecan_tan_sand	unknown
@blessedgeek	org
@aniitaa90	human
@girlmeetscookin	human
@Fredericks_N1	human
@BetzysMakeup	human
@buddingrose418	human
@live4bruins	human
@davidshak	human
@aptrick	human
@loveinmytummy_	unknown
@SashaSwerdloff	org
@papsislame	human
@j69us	unknown
@ChurchVonny	unknown
@delta7g	human
@racheltre	human
@BLAVI	unknown
@davemuirhead130	human
@kamini88	human
@Clarisse_Acob	human
@Natmarquest	human
@rebbbca	human
@adirissa	human
@RoxburyDee	human
@tieshask8	human
@143Filipinas	org
@MartianChef4	human
@drzaf_pic	human
@anneschulz88	human
@Shmonn	human
@_misspink	human
@alcerus	human
@FollowMe_WCL	unknown
@jjbrigitta	human
@Super_grass666	human
@HighlandDrive	org
@HarvestonHarbor	human
@NathanAlderman	human
@chicandcheapmad	human
@dawnnoce	human
@im_CRAZiiii	human
@vagrantcook	human
@lotuscuisine01	org
@orangespoken	human
@ShellAnn23	human
@the3MonkeysMom	org
@YoungCoogiMane	human
@AndyAunasegran	human
@Lord_HenryQC	org
@victorias_news	unknown
@Amela_Sandra	human
@LuuAlberca	unknown
@theloopca	human
@ArabelleChung	unknown
@MartyandKo	human
@Kekesarizca	human
@daphneem2	human
@__Tesh	human
@CZManahan	human
@SimpsonsPhoto	human
@LSMGuide	org
@KellyMcMullen3	human
@Fitformyfuture	human
@wheelinnscone	org
@Kpreene	human
@TradGiappone	human
@_RAYnegade	human
@J_INFAMOUS_1	human
@Chloe_penderie	human
@Kiski89	human
@myklaurente	unknown
@JeeKahale	human
@i_am_heatherr	human
@the_real_jruc	human
@LeH4C	human
@soundstew	human
@LARODOJR	org
@ex_tgasi724	human
@duane19015	human
@Adrian_HGA	human
@NeuvooMaidenhe	org
@Playing_w_Food	org
@BeastFitnessMJL	human
@JusstJaded	human
@gentleman_ar	human
@leo06m	human
@AppJerky	org
@Dumpallbins	org
@a_ya_no_0129	unknown
@marketwraps	org
@Oliwiagorska	human
@MagicMemMayhem	human
@11_fattkiraa	unknown
@queen_frugal	human
@sabrinadreww	human
@alena_aloxa	human
@ChicagoDuffys	org
@PatrickMcVicar	human
@setafan	human
@luxury390	org
@hypocrite_cas	unknown
@susie_fleming	org
@IAMmp94	human
@CAGRustyRyan	human
@tamiejoeckel	human
@mecarolks	human
@olimpia340	human
@annabee818	human
@shallowshelbss	human
@Loocie85	human
@leathericecream	unknown
@DairyGoodness	org
@Fryin_Hawaiian	human
@Sarang_JJ	human
@ccoconutwater	org
@Analumramirez	human
@benjern	human
@Its_Lbabyyy	unknown
@tytronic	human
@karenchrizzy	human
@ceecherokee	human
@caferonak	org
@PunjabiKush	human
@FeitadeVersos	unknown
@dubai_im	human
@victorlounge	org
@PhDNutritionUK	org
@eatcleandiet	org
@minoza_ralph	human
@jojodvamp	human
@TrevorMcDaid	human
@TravelAwan	human
@Hattiwatti_6	human
@muhd_rusydi	org
@IamReyno	unknown
@RebeCca_Oktavia	human
@Sa_bria	human
@nuttidangorkphi	human
@tombrendt	human
@PinarErguner	human
@jelgueco	human
@MegynKellyNews	human
@HGWSAT	org
@GWinLondon	org
@OrangeBoii92	org
@eriadcrown	human
@NYCNomNom	org
@BecsForsh	human
@melloveswine	human
@PutneySocial	org
@Sham1913	human
@pettore	org
@rae_erikarae82	human
@rte	human
@Gurkan_Guney	human
@Kavalon_TMWprez	human
@SallyAkins	human
@douggilkey	org
@ModernSteakCA	org
@Its_Vanessa	human
@Bill_labongz	human
@primus_food	human
@HipHairSD	org
@BradGouthro	human
@ZulkaSugar	org
@dombaguestlodge	human
@jayrealla14	human
@envishoegirl	unknown
@mitshico	human
@DeniseMenara	human
@Sophieekennedy	unknown
@GoYvon	human
@raulalarconojed	human
@levinesnl	org
@ArmandoChairaTV	human
@todngao	human
@ItsAjYbanez	human
@GCNewcastle	human
@Feibe_Ruri	human
@carlosdefeitas	human
@_siniesfires	human
@DaHealthYouWant	human
@chloeliting	human
@NoreenAmore	org
@RoalDaphne	human
@CrispyPhoenix	human
@sandrabecca94	unknown
@momparkbp	human
@thereal_katelyn	human
@TheCharWhite1	human
@JahndiLove	unknown
@jo_jo_tweets	human
@MsLadyPiiNK	human
@MyCeviche	org
@TheLittleKitch	org
@Ari_Godiva	org
@MrsAshleyWills	human
@EGO_ONIN	human
@KamilahsList	human
@claudyachang	human
@WeDigWatford	org
@Mr_Charming316	unknown
@scharleb	human
@MorganBeanie	org
@rona_alan	human
@Kevin_Canning_	human
@t23hotel	human
@sophiembrady	human
@fp_0909	org
@BBUNGALOW1	org
@TiaRoqaa	human
@x3jaye	human
@PetraMasekArt	human
@FernandesAxelle	human
@smile99_7770	unknown
@ines_3m	human
@hatch22ph	org
@theAbacaGroup	org
@kasselTrankos	org
@piyo987654321	human
@asyreenalias	unknown
@slo1981	human
@ayutyaspratiwi	human
@Anthony22305153	human
@DJMRNICE	human
@Salem_YQ	human
@ElvisJohnFerrao	human
@hikari_0517	unknown
@Samson_LYS	human
@Jona_Flores87	human
@97071009	unknown
@jaleibi	human
@team_wet_wet03	human
@christinac84	unknown
@RomanSchmelzle	human
@ChateauApigne35	human
@kachina56	human
@otohananooto	human
@FoodJourneyHI	human
@_KitchenLand_	human
@paz_zaz	unknown
@lemonkurry	human
@mgomanci	human
@Mortimerjw7	human
@Annie_Babyy	human
@rachelsiong	human
@Mary_Bustamnt5	unknown
@Tank119	org
@Shellnv	unknown
@Doodlebags	human
@aruemjo	human
@zerthuni	unknown
@sephcostales	human
@DStarLoyalty	org
@AnaZorro23	human
@oflaviomaluf	human
@naim_ah	human
@ses_rin12	human
@MOOrmotioN	unknown
@Ainhoavisits	human
@EllieVelikova	unknown
@boyblue_07	human
@imdwell	human
@yo_oGeorgie	human
@WhiteHartePub	org
@Chicmuse	org
@goodlifemg	human
@RayuelaNYC	org
@zupparella	human
@Leytonrocks	human
@natziepatzie	human
@MindShuffleMktg	org
@DaniChirinosP	human
@cloistekin	human
@getsyjenita	human
@fit20Breda	human
@ArchyMcfly	human
@9a043c551213429	human
@ChocoRococo85	human
@cellyyoliveira	human
@healthhunteruk	human
@yoohnana	unknown
@FrontRoomTavern	org
@PancakeHouseSA	human
@yezahk_khaye	human
@wiramodeON	human
@nnightyj	org
@davidkapsner	human
@TobyIlao	human
@cukup_alwie	human
@marlynmaniago	human
@GabsCedeno	org
@therealmaldito	human
@kuo_yuni	unknown
@DiezAlexander	unknown
@nbaroz	human
@CarolineArtiss	human
@aikobear20	human
@GoogiesArtCafe	org
@AplanetMovingco	human
@LizaKaplan	human
@klimmyxv	unknown
@creitmyer	human
@4wdSafari	human
@shabestankw	unknown
@markleslieZA	unknown
@taokmilo	human
@WizThings	org
@vitaleSWEETS	unknown
@DemiPinte	human
@LukeSatoru	human
@Saydafl	org
@juan_perdomo	human
@CH1Chester	org
@Luhrdawg	human
@Loganbar	org
@GeordieJLo	human
@LOCdaGODDESS	human
@Ma11t0	unknown
@LoraDemode	human
@BagelCo	org
@FHFoodFairy	human
@Angela_Jehnsen	human
@giant_wirayos	human
@RiceBallsOfFire	human
@jusPAGEme	human
@Leonelloh	unknown
@mo_es_hu_ar	unknown
@giorgethomas	human
@CresAcosta	human
@franmcamacho	human
@CoachSarahP	human
@ManuelaPerli	human
@Calii_JJ_JR	human
@tomo253	human
@ClareMadle	human
@TwittyTalk	human
@droomvillalux	human
@SkyyProjStarr	human
@iamVera78	human
@Stargorod_Riga	human
@BeccoRestaurant	human
@replicatoreishi	human
@_onysckin	unknown
@littlebeettable	human
@hannahattropic	human
@SumMilkNCookies	human
@CuteEcke	human
@DrewRamseyMD	human
@ZNEINE	human
@L_Toe	human
@steffieonarres	human
@ledzepfreak22	human
@InterContiAD	org
@Tongyunliu1	human
@glynist	human
@omppujmm	org
@BryanBrzeg	human
@renspointofview	human
@Wahlberg71	human
@koufdsiagda	human
@xavi1574	human
@Renee_Robinson	human
@ChinatsuAlmyra	human
@coonsta111	human
@SQGalleryNight	org
@zanmai0425	human
@Killa_The_Great	human
@SanBenitoFarm	unknown
@roeyrider	human
@ediblerhody	org
@ayyhhanlayan	human
@MarysolGarcicar	human
@LunaVoce	human
@itsCyborgtic	org
@maryann_gelua	human
@deRobatteux	human
@cypressinntusc	org
@EatLansingMSU	org
@HBloggersCom	human
@MagnumClubSpain	human
@caritofcisneros	unknown
@SasaStankovic	org
@MartaBlasco_	human
@SteFabulous03	unknown
@OhSoGlamBlog	human
@shlpl	human
@annatoniablume	org
@deavmi	human
@ooh_shayla	human
@yousuf_alkaabi	human
@thepocketdragon	org
@misterding	human
@tyjdryo	human
@hettie19	human
@massiPING1	human
@Mayahra_Enae	human
@Chef_Sabrina	human
@dlbelen1108	human
@SingleMomStyle_	unknown
@Sellaavv	human
@carmen_lim	human
@healthybegins	human
@WhichWichPanama	human
@alrighttreacles	org
@phoenix_sanders	human
@EatinPuglia	org
@Elaine_August	human
@ZazZyYu	human
@RMHnorthernAB	unknown
@CARLY_E_FASHION	unknown
@RealChrisTorres	human
@MissionDispatch	org
@PPerceptions	human
@JAFCaiga	human
@kasialuxo	human
@MMC1183	human
@carlybucks05	unknown
@BooHsu_	human
@gemstaff16	human
@tuanlibra	human
@KheGreen	human
@SealFresh	org
@Flotch	human
@ThomasRuschke	human
@leslielcocinera	org
@DevonKing16	human
@kamikazesparrow	human
@TSFITNESS11	human
@loppys1234	human
@ito_ayumu	unknown
@AmandaMFaison	org
@mikkelcarpio	human
@Manu_el_J	unknown
@youngldnblog	human
@LikeableChelsey	human
@AnabelleVidrio	human
@Galeri_Hajra	human
@FindYourZen	human
@dill_park	human
@iamtinakapoor	org
@tonyromasdr	org
@seymintac	human
@nizar_iskandar	human
@whatthemerika	unknown
@emilylevenson	human
@itscomplicated	human
@KahleyMarie	human
@pearler15	human
@MadisonJMcC	human
@LifeFoodOrganic	org
@ShopAddicte	human
@ashleykehoe09	human
@Pati_music1	human
@sweetfann99	human
@Deliciousitaly	human
@WafaaPowell	human
@AshlynKuy	org
@kristina_dlf	human
@Miss_S_Fletcher	human
@don_zilla	human
@piwitis	human
@chentots	human
@PalomaBianca	human
@fenwench	human
