@Da_StarrYouLove	human
@MixitMuesli	org
@iWantTechNews	org
@26chuckles26	unknown
@YongHan_Peace	human
@PaulSuit	human
@GroveFashion	org
@Ashish10Srivast	human
@Rodny_Barrios	human
@ccrisanti1	human
@Fight4Wellness	org
@kafedoM	human
@OblixRestaurant	org
@MeDicenJackson	human
@7DialsLondon	org
@TheBandBFactory	org
@ThreshersDublin	org
@mindyluna99	unknown
@The_Arts	human
@Truly_Chicago	human
@TresAmigosStore	org
@DyesebelAnne	human
@patolaaaaa	unknown
@TwinlakesPark	org
@AmerGaladari	unknown
@CoachDebbieRuns	human
@feiwenz	human
@Thomas1Cieran	org
@chica_cafe	human
@cafeventana	human
@yumboxlunch	org
@LinkieMarais	human
@CinnabarThrsday	org
@DominosWirral	org
@stylefragment	human
@PFPuffPastry	org
@BradGangTeach	human
@Rosemarino1	org
@HomestatFarm	org
@MyGymDeals	org
@JettRho	org
@RomeCavalieri	org
@IndieArtist_PR	human
@GHOGYFitness	org
@breedykam	human
@bo3oof	human
@JustAddGlam	human
@garel_bonn	org
@kendufault	human
@oscar67wine	human
@EmilyGi52769653	human
@matta_jjtaylor	human
@thattrangstaa	human
@DanielJEstrada	unknown
@sumitsagar_7	human
@BrianaCashMusic	human
@kimikofoo	human
@DarrylCastro	human
@Hamstar_J	org
@Cherry2doll	human
@sillyaudreyy	human
@MissUSA2005	org
@sannvarangel	human
@kaiveloso	unknown
@ChirbaChirba	org
@mansnextbf	human
@aokimono	unknown
@TheMolester	human
@niiTeZ	org
@nubabcn	org
@TheAlma_N1	human
@TraderVicsDubai	human
@TheCookingGuru	human
@sherylsongsong	human
@MissHalloween85	unknown
@AlbiBussi	human
@fatsalsdeli	org
@mrosstinoy	human
@chris_rully	human
@ChristianiSinat	human
@Argentine58	human
@sermarkus	human
@HenriettasTable	org
@tybungalow	human
@TheodoreLeaf	human
@sys_somboun	human
@gregplive	unknown
@TdHenson85	human
@DKallday63	human
@shredder1928	human
@bi_shibata	human
@vivienleeys	human
@Totallydriving	human
@hlynn1993	human
@LibbysMoms	human
@NEFollowers	org
@UBSuper	human
@jonlappinphoto	org
@perez_tonio	human
@MaxwellBrand	human
@JoyTheJoker	unknown
@chprisa	human
@GordonRamsayGRP	org
@luxitup	human
@kozmohairnyc	human
@jhen18ortiz	human
@Livehalffull	human
@fleur_deles	unknown
@OldSessionsHse	org
@ChequersWooburn	org
@wandelproject	human
@bhojanic	org
@SproutHappy	org
@marckwire21	human
@bhufiant	human
@bynreyhan	human
@SLashkri	human
@DorienDriesmans	human
@FikaMuthiaSarec	unknown
@AWG1922	unknown
@bfraccaroli	org
@masutoaitemu	human
@adornedbynora	human
@mamertzsomera	human
@damienpalladino	human
@FarmerBoys	org
@cherylpearson09	human
@CulturedFratBoy	unknown
@WellnessWorksRD	org
@tgra1961	human
@suarasemut	org
@WeLoveFoodEat	human
@Bigboyssales79	org
@TAlBdaah	human
@tiit_takizawa	human
@MaryGenevaNYC	human
@Rabot1745	human
@SedgwicksBar	org
@rad_and_fag	org
@AuntieAnnesEG	org
@stevievu	human
@RebeccaRoden1	human
@ShorterLaurie	human
@zayiiea	human
@IndianaLoverUSA	human
@lovebelgrade	unknown
@FannieSchmoe	unknown
@GrandHyattMelbo	org
@brizakhaolak	human
@GNHBar	org
@MiliiiAguiar	unknown
@freelance_new	human
@Mild_NT	human
@BerthyOfficial	human
@pechi_mam	human
@kolainey	human
@conkis_carolyn	human
@jeffb0572	human
@DrJ0EL	human
@nicoletrisha_	human
@arzcreed	human
@rmhnyc531	org
@ayulhamtaro	human
@ValerieLeeannO	human
@Raven_Verrado	unknown
@Gerson2Rocha	human
@OceanSprayInc	org
@rennathalie	human
@OussamaMadadi	human
@jeweljewelyesim	org
@lori_to	human
@jer_meflores	human
@Danielaeyaes	human
@SharisDailyDish	org
@CathJaynePama	org
@RitaGude	human
@ariesTOTAL	human
@NeuvooMarPHX	org
@Steadarve	human
@LailaSbeinati	human
@Darby27	human
@CURAMETreatment	org
@VEGANgelesHQ	human
@BowyInTheBox	human
@JoyCortez89	human
@nawwarahaaseri	human
@Beeonereese	human
@vkvar	human
@rakugaki_suki_	unknown
@SuperKikka85	unknown
@kikayigat	unknown
@WildBytesCafe	human
@in_YURfaaaace	human
@JenAndrews44	unknown
@beansncornbread	human
@StMazie	org
@TentenFitness	org
@Pearl_OysterBar	org
@melamyra	human
@HigHoffN0VAcAnE	human
@RealJoeRobinson	human
@Jacqui_Stafford	human
@silvia_jovial	human
@ForgotToLove	human
@STMEnergia	org
@MacNC45Addict	human
@JerseyMutt	org
@Selfi_ID	unknown
@Vinny_Lombardi	org
@amirtibdg	org
@zamartz	human
@chicagobars	human
@nycoffeebh	org
@urbanheightsmd	unknown
@heatherrushme	human
@saidani611	human
@HotSpotQuiz	org
@nitaPOP	human
@monsicha6666	human
@HarinaHarina	human
@megorgeousfitz	human
@sheranchen21	human
@official_Ekahj	human
@SydneyLoverAU	human
@LaBalanceTX	org
@ruerivard	human
@BakerMaidNola	org
@sexxiimeli	human
@Mymanoosha	human
@olivia_allen75	human
@YelleHughes	org
@luxury_lover	human
@KhemarySok	human
@keokigunn	human
@RaieLynn	human
@Lawlor224	human
@Hectorgrc4	human
@denialtucker	human
@kelvintangck	human
@jtbazdarich	human
@WaldenmeierGA	unknown
@Andreametcalf	org
@BLResort	unknown
@todeed_com	human
@NightOwlMobile	org
@toprak_batuhan	human
@LynzeeDMV	org
@gigito0o0	human
@DominosWSMCentr	org
@heilei85	human
@madalenaxyz	human
@wentot	human
@GUSTOEdinburgh	org
@gyupanda	unknown
@WCulinaryNet	org
@saucynews	human
@DublinVC	org
@HilaryPapuchis	human
@makhruji	human
@kasraliha	human
@anuo7	human
@jenrah77	human
@Miss_Bre1	human
@BigMarv86	human
@RetailDataP	org
@Magniificent	unknown
@MoptwoLLC	org
@ChinkyKayla	human
@pellicola89	human
@LilyPCabral	human
@gnplndrd	unknown
@shonrahim	human
@pbfy	org
@PHRKCHOPS	human
@KingsHouseBiz	human
@MunchRun	org
@SorsiandMorsi	org
@kishanetaylor	human
@kelly_arnaud	human
@kupujemprodajem	unknown
@TakeStockMag	org
@abfunkyjungle	human
@xxisunny	human
@Miss_ChantelleH	org
@adnan_alboom	human
@nandu_ds	human
@Chef_Andre_F	human
@mailovesxxxxxx	human
@EsraEmad	human
@ifancyadrian	human
@inpatmadiwiria	human
@Chef_Keller	org
@Alicia_MUA	human
@ShiptonMill	org
@mariajannela	unknown
@AlansLocksmiths	human
@joyxeelovesyou	human
@BARBRUNONYC	human
@ImperialKitche	org
@AndreVelva	unknown
@eat_a_Love	human
@deannaritz	human
@IntansOven	human
@bouncy_jam	human
@NotHungryCuzI8	human
@CoutureHotness	human
@Karen_OH03	human
@MPHennessey	human
@emilyishostile	human
@s3r3naa	human
@dokpa2md	human
@Cuenca_Instgram	org
@naghmatehsas	human
@vivianassumpcao	human
@itsmagic07	org
@gulseva	human
@Supreminox	org
@foodwinsdotcom	human
@jforjamieblog	human
@HoosierHomemade	org
@bethwarrenrd	human
@Erna7790	human
@432thedrop	org
@jenxjen814	human
@monchantcs	human
@jennlynn420	human
@abdulmalix	human
@DyanaAdyana	human
@ExpressionsSA	org
@jfplocal	org
@Trissipojkar	human
@ATLDish	org
@Rod_AllMighty	human
@ThaiSquareGroup	org
@NacerVIP	org
@villanicoleht	human
@nappyKAYE	human
@healthyliving_l	human
@ChimesDubai	org
@adamkash21	human
@azza_reen	unknown
@atlantascarboro	org
@SaraCellini88	org
@Saville	org
@SoFla_SageSays	human
@daiju_0210	unknown
@Makeupbycyn	unknown
@Tiffany_Lee_	human
@tillybod	org
@AbcJets	unknown
@BacaroKelowna	org
@SkeeterNYC	human
@hellofoodghana	org
@daytodayMOMents	org
@FreshaaDR	unknown
@foodnuggets	human
@IchelleTS	human
@Chardffm	human
@eymediaprodz	human
@takax62	org
@JuergenSchaaf	unknown
@PhuonginStyle	human
@TaWandTalk	org
@DiegoDld	unknown
@marcosexeter	org
@ZanellaGiuseppe	human
@alarconrfg	org
@nashfrias	org
@artisdiary	human
@MValdez72	human
@inBusandLife	human
@NormaSmith93	human
@dalikaC	org
@themacadames	human
@Tamilelamm	human
@AKTINMOTION	human
@westafricacooks	human
@Miss_Celeb_	human
@wrapitupwraps	human
@DolceVitaEc	human
@Rocky_dayo	human
@Tillie594	human
@kitchenstuff1	unknown
@HungryWelshGirl	human
@GiancarloQuincy	human
@atlantabuzz	human
@unagustina	human
@amirunaiman7	unknown
@enneiviv23	unknown
@rosiecg1	human
@awepastorette	human
@TodaysFrugalMom	human
@sanecheverri	human
@tamara710	human
@BBQNYC	org
@amel_bum	unknown
@Miss_Getaway	human
@swissalmondq8	human
@MarkBiggini	human
@GiselleS6	human
@Senequier2	human
@cat4r4tta	human
@Da_Illest_Chick	human
@BamRestaurants	human
@ohio98babe	org
@angelh_92	human
@HerOvaThere	human
@LocalAuckland	org
@HotelElGanzo	human
@BenihanaRYH	org
@enzoptimus	human
@ericspringson	human
@confettimalang	human
@EralpVanKo	human
@iyassantos	unknown
@Riehnyc	org
@TheMallofAsia	org
@VisitTybee	org
@dewitiaw	human
@fernetdrinker	org
@ClickForHealth	human
@JJNem	unknown
@ellesugden93	human
@Tiramisu1702	human
@youngpreech713	human
@OverthrowMartha	human
@goodstuff_59	unknown
@MyAccio	org
@winciewong	org
@teamelitejoal	human
@LIZ_arddd	human
@leseulcynthia	human
@techinnov8tion	unknown
@stepania	human
@everydayshirl	human
@PastorTanyaBake	human
@BridezillaIvy	human
@gloflothewhale	unknown
@BeckTalkRadio	org
@TinkinAbout	human
@de__Porres	org
@HerbertHayek524	human
@OnellaCooray	human
@coconutrecipe	human
@billtelepan	human
@komacherry	human
@lallbahadur	org
@Miss_SarahMH	human
@Joan_HL	unknown
@lysammy98	human
@lachicnomad	human
@kHyal	org
@Nisamaneesaa	human
@jpandmelbs	human
@monicaisabelart	human
@LodRose	human
@UCGrounds	org
@choo_esther	human
@KayakerMarc	human
@ChefFelisha	human
@soshexy	human
@jecquilinejq	unknown
@Aescano	org
@TheChris1920	org
@bocx_pot	human
@CoachDonnaWard	human
@NeldaT1	human
@thePositiveMOM_	human
@geoffrey_dalu	human
@JPatrickStudio	human
@xxHealthy_LEe	unknown
@theresortmumbai	org
@my_pastelicious	human
@Jocesy	human
@spekehotel	org
@shiraringo	human
@REIZA_N9S	org
@ChikaObih1	human
@EatsVan	org
@baccowinecheese	org
@OrangeAnchorDC	human
@DarrenStehle	human
@alyssa8924	human
@shopeatsleep	human
@lolaelleSTAR	human
@LaGattaEventi	human
@Dempsters	org
@ajohnsonnutri	human
@PhuketRadio	org
@KimStrijd	human
@Laconny81	human
@amandahmorgan	human
@DevitaChrist	human
@RestoLaReunion	org
@SpidersCantFly	human
@thecreativehen	org
@MuseumWeekBotUK	human
@Yinz_Chen	human
@JustPaulii	human
@RestoLouNissart	human
@defera	human
@AureliaDevie09	human
@lstarkdesigns	human
@tanka_chrisw	human
@HuatSiang	human
@golftod	human
@feastvirginia	human
@haeranayo	human
@featuring44	human
@sns_reznicek	human
@samkfrancis	human
@brasserieblanc	org
@AnnaBelleArtist	human
@TheGlamOfficial	human
@jawad257	org
@Cezzy81	human
@John_Champion_	human
@kikiverde	human
@aiuta__	unknown
@xKirstyCampbell	human
@HammockResort	human
@freeman_moscow	human
@oxide_photo	human
@saleago	human
@antonio_aveta	unknown
@FrkWeltz	human
@smars74	human
@CateAdair	human
@JK577Ong	human
@SixthStTavern	org
@HadadDNA	human
@Ale727	org
@generousbabble	human
@AnnKok_AFC	org
@ZinnasBistro10	org
@ladridos_es	human
@Nadezhnadia	unknown
@Kenskelly	human
@SabineElize	human
@mouthsofmums	human
@MoniqueT17	human
@Ferbaccarat	human
@kaulysliwka	org
@Wholefoodsgtown	unknown
@SanDiegoWom	org
@manita_kapoor	human
@MSIfoodiesbox	org
@Ebonyepiphany	human
@ModeloLounge	org
@bellemichelle89	human
@FoodzeenNottm	org
@ScarletOhHara	human
@DeerParkHotel	org
@sala_ky	human
@ArrDeeLicious	human
@MEFLIPA_LAMODA	human
@pwm4u	human
@Vau_de_Route	org
@BcnFox	human
@GoldfishSmiles	org
@apsroberto	human
@DominosBridgwat	org
@coreyjfoodie	human
@SylMaurits	human
@etiennekarenv	unknown
@madmaheen	human
@gallardomark	unknown
@7seventhofjuly	human
@dnlkenyon	human
@giangio87	human
@acuriousgal1	human
@hafiz_akib	human
@CapitalDime	org
@weddinganddress	org
@sheenapadington	human
@NO___SMOKING	human
@BistroCoCoLier	human
@m95007	human
@viqueent	human
@QPAlicehouse	human
@SVMullins	human
@niannelynn	human
@Gracelane31	human
@ayidivannie	human
@TexasTalkRadio	unknown
@VickiMazik	org
@radspuniani	human
@iamurjm	org
@panoround01	human
@maggielynn07	human
@TVFHPhilly	org
@rocknrollerbaby	human
@Woosh55	human
@sunkissedgarbie	human
@InfraRedDot	org
@anniedan_happy	human
@TurtleJacks	org
@ElyseBrittany	human
@yuppy_j	human
@BigBiteHawaii	human
@thewilliamcecil	org
@AntoinetteTulsa	org
@mo_ustad	human
@kosikyou2	human
@_happyharry	human
@Fede2090	unknown
@ziyarestaurant	org
@LaReserve1	human
@CaffeGatti	org
@Q_Raider	human
@shqipthash	human
@niametany	human
@pinterestdecora	human
@acookblog	human
@MizzyAngelz	human
@swappinspoons	human
@TapHouseLogan	unknown
@Chefs4Passion	human
@TheFoodieChef	org
@lukaborghi	human
@opens_doors_YPR	unknown
@daniyoon	human
@67biltmore	org
@d_pustay	human
@Blackshop_Rest	org
@y_kuratako	human
@Southendtweets	human
@tandeminlove	org
@nattyspantry	org
@persianslondon	org
@AromesBakery	human
@keeganspub	human
@ladyofthepack	org
@laur_k	human
@spiritspure	org
@Carlitoz123	human
@juliekauf	human
@MagzMx	human
@TonysPastaShop	human
@judymkim	unknown
@carlo_daveri	org
@LisaHungryGirl	human
@DNL_Risa	human
@tiexila	human
@MoodOnAir	org
@aakosikayee	human
@Shine2007_mj	human
@caramellberg	org
@LMouseF	human
@GerardoRosas24	human
@sd4david	human
@NowiiiBrighter	human
@CafeOranjeHam	org
@MotherFlipperuk	org
@simplybudgeted	org
@SunTimesDEN	human
@CoryRayburg	human
@AnderaRaskin	human
@twitstagram	human
@winedanddined	human
@khooperTHEgreat	unknown
@sandrineL78	human
@Jos5050	human
@raissssa	human
@MovenpickPhuket	org
@FeLixKiiki	human
@stonefacedollys	human
@junkie_boi	human
@itsMiziel	human
@crazydavebehere	human
@yu10sa8mi11	unknown
@JessOdysseos	human
@apesara	human
@Cafe68Gillygate	org
@manchan_account	human
@Gangsta_Gossip	org
@mytabyyc	human
@LauraTalaga	human
@GooseFeathersCf	org
@almonds	org
@jewelosco	human
@cochisetaylor	human
@fionakhoo	human
@echocentrism	unknown
@_AllisonLindsay	org
@kinnajonsson	human
@DominosChester	org
@campus_bar	org
@VegetarianZen	unknown
@leonawrote	human
@Fattmustard	org
@_hurdy_gurdy_	human
@winner_hearts	human
@caassca	unknown
@nffcnnr	human
@knnsatu_hito	unknown
@runningjacolien	human
@supercheflou	human
@JacobSisco	unknown
@londonwestend	human
@offers303	unknown
@leyn16	human
@Charliezabeth	unknown
@Anariki09	org
@TumblingGF	human
@cinsilatif	unknown
@VeganCommissary	human
@bonnefetefood	org
@lakersselfie1	human
@bargor2012	human
@cheytowngirl	human
@LoveIsExtinct	human
@SlashArtMsic	human
@GoFitGirl	human
@myLNDnutrition	human
@bilofranco	human
@fraumatote	human
@PHLondon	org
@MorneDuPlessis	human
@sanchanko	human
@ElFarolSantaFe	human
@OneLeafWellness	human
@BabycakesPK	unknown
@elliedanny	human
@Angel_Forgets	unknown
@NuevoFloribbean	human
@brainbalancenc	org
@Kaka_Laux	human
@kiquedc	human
@valintoronto	human
@Razberrii	human
@BarbarasBakery	org
@GBBFarmer	human
@Rotti_Iren	human
@Judy12Olson	human
@ToscanisDining	org
@pnadira	human
@DSuchende	human
@arundatir	human
@EleanorLumber	human
@FitandFabMoms	org
@hafiezdaniel	human
@YushanChen618	human
@saddiquemed	unknown
@VeryCOOL8	human
@McD_Ozarks	org
@cescpaibregas	unknown
@OllysanKokoro	unknown
@RoyisRoyal	human
@TheFoodTrace	org
@sjb2332	human
@michih00916	human
@eatlean	org
@pcelinaferreira	human
@hello_im_kind	human
@HortonGrange	human
@shannonlkaiser	human
@Bella623	human
@xelesteganda	human
@IrishHouseNOLA	human
@Mayo_CM_Clinic	human
@LuvDoncaster	human
@cfoundas	human
@michaelangelos	org
@TheFlyGuyCB	human
@NicksProduction	human
@USPlabs	human
@juttalenihan	human
@threebiterule	human
@I_Peep_GameBiH	human
@GeneralMills	org
@iqy_piyyeh	human
@djyahud	human
@_ezbongon	unknown
@poikoidesign	unknown
@NeuvooCsrLA	org
@boyfacebusy	human
@JustynaKszton	human
@sam_stewartetc	unknown
@myeh629	human
@Tasteandseepcs	human
@DaryaZinina	human
@natuurkieker	human
@TinRecabar	org
@itselomi	human
@davaolifedotcom	org
@glitz_doll	human
@drowsymama	unknown
@nyttyabw	org
@0901Takamitsu	human
@MarioCipriano	org
@radblufujairah	org
@BusinessGypsy	org
@SneakerEngineer	unknown
@jp_poppy	human
@BloodyMariaMix	human
@YeleysaBsb	human
@DJGregColombia	unknown
@JoyAfterTrauma	human
@ma_imo	org
@mrpostogna	human
@Shipang93	human
@VisitJustVisit	unknown
@ChiDailyNews	human
@eddren	human
@LostInLagos	org
@DaintyDaphney	human
@sutyumurtarecel	human
@TweeterBham	human
@lorsofsmile	human
@XtraBrett	human
@orangemarket7	human
@WildWingDorval	org
@couchpotatoco0k	org
@bax_andrea	human
@Edstaff	human
@hanaiyzm	unknown
@TotoMato_8	human
@TheMrsPowers	org
@LorenaRal_	human
@ProhibitionMTL	org
@jessiekardash	human
@Mechant_Mangeur	unknown
@piggybackrideAZ	human
@ilknurse	human
@EmilyPalios	org
@fistcliqueuae	org
@honeykanii	human
@GL2T	org
@NakedLEOSoul	human
@Certified_Chef	unknown
@MisionDeSA	human
@gvannostrand	org
@DanielaFreidlin	human
@GlendaRoig	human
@WalnutKitchenHS	human
@omiikochii	org
@guaniocrystelle	human
@Mountainking	human
@the_a_stevenson	org
@GoldieKnocks587	human
@ivanbernal22	human
@DoryZogheib	human
@vie_phevie	human
@JijaAznam	human
@anggaprasetya	human
@shashash123	human
@ShaikhxxxxAmina	unknown
@7Hens	org
@Schorpionludo	org
@SWoakham	human
@gardner_ash	human
@SinulogPhotos	human
@OctoberGlasgow	org
@k_albekheet	human
@amylieberfarb	human
@sayucky0613	human
@PalaceDowntown	org
@grokgrub	org
@discoverstc	org
@CafeFromCrisis	org
@elbavaro	org
@missDVIP92	human
@Isabelle_Spiri	human
@EdCotton77	human
@Lora_Hogan	human
@DWDESIGN11	human
@N0tFamous_yet	org
@Maren_fma	human
@FoodnessG	org
@RRDurant	human
@iLoveJhowee	human
@MVfoodblog	human
@ryan_dealwis	human
@Ai2Ghiottoni	human
@loavesndishes	human
@AlisonCJ1965	human
@DomainNameStock	human
@wohnungleben	human
@Mso808	human
@M_Otaka	human
@_K__S_I_	human
@laura_cphtales	human
@yoichiwaga	human
@TSCArlingtonHts	org
@FremontVillage	org
@beoutrunning	org
@Calrtipper	human
@NovotelBKK_PS	org
@rmmojica	human
@hairshaftfred	human
@Coochifritoscom	human
@moodleprof	human
@brianholland	human
@riotgirlnat04	human
@Fashiontangled	human
@OliveOils_es_US	unknown
@kbramer242	human
@reshi92	human
@ayanyanco	human
@dalevillar	human
@taem_rinco	unknown
@bettyboodubai	human
@Heliosxv	human
@Annasyogalife	human
@xiaomaan	human
@JadeShyu	human
@Canadean	human
@maradesalguero	human
@RogerMichaelM	unknown
@EatTrueFood	org
@felixsaputra_s	human
@ArcticWines	human
@SofiaVeraM	human
@benwomanizer	human
@Mike_Scorpio81	unknown
@hotelsandtour	org
@Michelle150295	human
@bishopbala	human
@Hanksbbqvic	unknown
@BlueHavenNYC	org
@GiovanniAlabiso	human
@Moh117	human
@ArepaAndCo	human
@SmithPInjury	org
@BV_Nutrition	org
@Kazm8son	human
@RobinBirdsWeeds	org
@kafesfirin	human
@AntonioToday	unknown
@pzanchi82	human
@Judi38	human
@EkahRefqah	human
@ClaireBear72880	human
@DayreneSilfa_	org
@HashtagJoy	human
@ensynctravel	human
@chezus	org
@SheenaMav1712	human
@Ai2daKAY	human
@DairyFuelsMeUp	human
@Alexsa_Glance	human
@_tikots	human
@cheesesue	human
@AldeburghMarket	org
@ChinaGrillDubai	org
@BeanMarci	unknown
@Chrissyann12345	human
@ericatlas	human
@PabloLF_003	unknown
@mallhaciel	org
@80s_kids	human
@Table41Cookbook	org
@jiarunchen	human
@By1847	org
@popchipsBenelux	org
@AsSeenAtIUP	human
@missalexx13	human
@nurvahnah	org
@DonovanPhua	human
@nickispindler	unknown
@SarahKing669	unknown
@Ashleyjddb	org
@filipagonzaga	unknown
@ayaxchika	human
@Sevenderby	org
@easyfittness	human
@hootersdr	org
@conceptacassar	org
@ElenoraWiesner2	human
@axellemnn	human
@kneesell	human
@MyeonCandy406	unknown
@Doucheminic	human
@iKierci	org
@StaceyShortxXx	human
@JimRHenson	human
@BarEstiloTapas	org
@Amaris_Acosta	org
@MarcelCocit	org
@GDBROTRUCK	unknown
@atornadox	human
@iamonig	human
@sofiamribeiro	human
@JohnnyDs_SC	org
@florradikal	human
@suddenly__you	human
@brianawoody1	human
@MavenTattler	org
@nikipr_patel	human
@non__official	human
@roughtrademark	human
@chefmez	org
@BikiniExp	human
@NestorArre	human
@districtofchic	human
@JameArty	human
@tommylawrence91	unknown
@FoodCloudIndia	human
@QuitoRetweet	human
@Broker_Azca	org
@bett3r	human
@LaurenVaknine	human
@travelingmoms	org
@yulisurianty	human
@ZoexGraham	unknown
@thePearlGuideUg	human
@Ms_Attitude2	org
@Jessietr	human
@RetrofitChick	human
@ToriGr8ce	human
@fdp4life	human
@RoyalVacationsP	human
@kathywm99	unknown
@Debi_RG	human
@m3mingnyc	org
@Eliyani_yuri	human
@R0xyR0cks	unknown
@zhouwaniey	unknown
@ElUnicoElCorrea	human
@GGentswGCtents	unknown
@Taiwangirls	human
@JosephsDowntown	human
@pancakeshack	human
@xuhsworld	org
@fujigaya0623	human
@AShAdEOfWILLOW	unknown
@Fabonski	human
@FRIGGIDY	human
@live24seven	human
@dawidwolinski	human
@cheriff_sobhy	human
@sk8terboyz212	human
@bertotweets	human
@Darren_kudo	human
@IzeSeminyak	org
@ErikSuwanto	human
@Pastriesboy	human
@Para5933	org
@STUFFEDsd	org
@JoyceMimiko	human
@Alittlepartof	human
@athena_gianne	unknown
@sunshinesam83	human
@MackTsang	human
@Vatniss	human
@Darkrose1987	human
@DavidGellert	human
@healthytravel	org
@2tsps	human
@BellinisEatery	org
@FMCoast	org
@NutriNai	human
@claritadnz72	human
@Timmiejoe27	human
@KirstyxAshley	org
@ManuM83	org
@Stefanie3027	human
@RozaliaFashion	human
@riccciard	human
@break__fast	org
@Althamsbutchers	org
@Dainuke	human
@phillippa01	human
@GaurDisha	human
@owlcat75	human
@RokaAkor	unknown
@Supervr4	human
@kianajaz	human
@Aayushi_seth	org
@TwoGo2One	human
@victoriabudiman	human
@MichaelEging	human
@vmaryvaz	human
@IAMJMCO	human
@raeskitchenco	org
@madelny03	unknown
@MillsRivard	unknown
@modaeres	org
@Leah_Tennant	unknown
@FatGuyMedia	human
@CbradyM104	human
@haritvii	human
@ThatsItalianExp	human
@Thieven4800	human
@oonatweets	human
@cinabar	human
@Muzi_Z	human
@fatburnman	human
@nikki_ochoa	human
@FishEdinburgh	human
@novia_denugraha	human
@SocialSavvyMom	org
@harlemsmover	human
@BeautyHealth12	unknown
@thehealthminded	human
@HealthyWay2Cook	unknown
@VB3Restaurant	org
@proteanmom	human
@wilda_huang	human
@MusicEmm	human
@manizhe	human
@pandax68	unknown
@karimelhoussami	human
@DKristianawati	human
@southplacehotel	org
@alissarumseyRD	human
@ClarissaVintage	human
@dinnerat630	human
@WhatMickyEats	human
@PunchBowlPDX	org
@tonguetastic69	org
@JetsPizzaDFW	org
@rebrandtoday	org
@annie_yep	human
@GourmetGetaway	human
@Violetbites	human
@SugarJones	human
@IlariaRiccardi	human
@Sandra_Chabot	human
@TheFussyOne1	human
@jackie331959	human
@hulyameral	human
@TrisyiaSyarah	human
@AnnaStanziano90	human
@BENJAMINSITALY	human
@BtoBUAE	org
@MrsBeautyscene	org
@dulynoting	human
@ScouseMattSmith	human
@_chill_yourself	unknown
@ChopsSteakhouse	human
@honeyperez03	human
@thetomatohead	human
@carleeeeq	human
@panda_cold1	human
@GonzalesEgo10	human
@Angelicarian	human
@Suger_23	human
@BristolLoverUK	human
@thesewingnook	human
@Ali_Izq	unknown
@gridirongranny5	org
@ninasaycheese	human
@JiaQi229	human
@thatmadstyle	unknown
@Gurj_D	human
@comp735	human
@d_vaz	human
@fallowcafe	human
@pansy_pk	human
@Evelynk9	human
@manfreedom94	human
@ShadrinaO	human
@vaniapatriarca	human
@fa_frogham	org
@Paperchase2014	org
@Bollywoodarian	human
@RealBali_com	human
@WholeFoodsLNK	org
@hurucartagena	human
@harrietb	human
@MaggyVargas216	human
@jmanninghouse	human
@shawnatrick	org
@lerryo	org
@thesagecafe	org
@AaronElla23	human
@HudsonsSW15	org
@SparklemissA	human
@sandrixlx	human
@manjulabhishek	unknown
@EmbraceBex	unknown
@paparuna766	human
@AlexRybska	human
@maxmedi	human
@RocabellaMykono	human
@_cajones	human
@luiscardona	unknown
@tofarzeen	human
@MostWanted313	human
@tamomi88	human
@filippofreskiz	human
@imberryscary	human
@hanstar12345	human
@SecretGCafe	human
@gegewgunawan	human
@AnnitaRodriguez	human
@lalanomelo	unknown
@KashPoLoDowN	human
@Anitarubi	human
@gotravelbug	human
@paulatodora	human
@CignaTTKHealth	org
@meetinghousedub	org
@raquelkitchen	human
@Luxury_Lvng	org
@lilmonster9999	human
@notcode4	human
@Fitgirlseatburg	org
@tlstracy	unknown
@BernersTavern	org
@tabithapye	human
@findmeabreak	human
@dhcooks	human
@roccopizzapasta	human
@Lizwell4	org
@donshagwell	human
@livetoeat628	org
@RobNYrican	human
@Robinohhappyday	human
@RosaRegina85	human
@Fina411C	human
@maryfaheykrause	org
@Kathryne18701	org
@TheSpicyRD	org
@TorontoRCSH	human
@NaturesSleep	human
@cafediningnear	unknown
@IrvynWinton	human
@alejandroliras	human
@_iku_	human
@agaqueen	human
@kook_kookkaii	human
@oftenKIMitated	human
@SG_Darwin	org
@WithJamandBread	org
@cucucucum	human
@halloffame81	human
@PatrickT75020	human
@RAMBOXTREMITIEZ	human
@41DAN	human
@cloud_9nine9	unknown
@MarivelLuce01	unknown
@KerriAnastasia	human
@roxytter	human
@MrBasabose	human
@SharonC12	human
@katphysch	org
@FrozenInferno	org
@brunchbrigade	org
@iexisted	unknown
@hlast	human
@imprincesskiran	human
@tavinocalpe	org
@Cobhoza	human
@Portallis	org
@Patti_Cullen	human
@BusinessTalkRad	org
@foodreuels	human
@Rachaelpardoe	human
@fsuselfie1	human
@bar138	org
@MathersMahmood	human
@alfritz04	human
@MoneySharma	human
@GlasgowLover	human
@aLienRabbit	human
@Fabij5	human
@craftfoxes	human
@Shon__21	unknown
@KenTippens	human
@kdungul	human
@JameDeis	unknown
@TavazoDriedNuts	org
@ReviewzBlog	human
@saidhariri	org
@SangaraCafe	org
@leisnarcotics	unknown
@Rckayla	human
@TYOsoekamto	unknown
@DanteFresh	human
@oharu1021	human
@Langtomboong	unknown
@spramp	human
@OlivierTarek	human
@Brandy_GAN	human
@COEggProducers	org
@priyangkam	human
@philwingo	human
@HerefordLover	org
@paradores	human
@YungSickSwag	human
@paiyachat	human
@DoriansWorld	human
@Totalcornwall	org
@legna_1029	unknown
@Adrianita242	human
@TheGladly	org
@dan_laubscher	human
@thegroovyfoodco	org
@MomBlogTips	human
@bestbrunchever	human
@Hartley_House	human
@chefpatsoucy	human
@Sofritogastro	human
@ChiongPartyBoy	human
@dejibu	human
@caldwelhousebnb	org
@Lauretta_32	human
@LO_LEE13	human
@iKarlo	human
@SofitelMelbourn	org
@stevenando88	human
@Vern53012	human
@madeinUSAfoods	human
@CreekEllis	org
@Catespa	org
@SalsRushdi	human
@michaelhogan	human
@SaluteDeezNuts	human
@seowwei	unknown
@Mailena_Oliva	human
@hapchanofficial	human
@mayfairpizzaco	org
@DetourBistroBar	org
@sprouted_roots	org
@matbild	human
@ieiehoo	human
@COSMICGIRL2009	human
@TheSalisburyN21	org
@koorber_mary	human
@butterbrot4	human
@SavortheMoment1	org
@kerlchen5	human
@johnnylapasta	human
@TheShoreClubCA	org
@RockFLL	org
@TheKindPen	human
@DcSusana	human
@OmaigaItsPaka	human
@MrsHungryAsian	org
@mommyvegas	human
@JoujouPreviati	human
@UNION_REPUBLIC_	org
@mamaluvqis	unknown
@marikkasvego	human
@miszdaia	human
@xxxhuenk	human
@CarolineKong	human
@ZerinaGrace	human
@BonnieBanters	human
@SanfooraAna	unknown
@villar_armando	human
@hendriksugi	human
@VivaceCharlotte	human
@melissareneefit	human
@VIPrene	human
@Parlez_me_nTory	human
@mommymatter	org
@CameronHodgins	human
@NO4z7	human
@clemsonbcm	human
@GoodLuckChinese	org
@LeMall_Lb	org
@Allswell_NYC	org
@TmarieHorn	human
@BarTopolski	org
@msfashinista	unknown
@druptiSDstylist	human
@Qooway	org
@Maurizio_Genio	human
@JohnDelinger81	human
@Asiyebrylmaz	human
@cjoneshoward	human
@stephmwise	unknown
@NYFBofficial	human
@BBCLeicester	human
@MarYSolRestBar	human
@Stylewerx	org
@CThumij	human
@angel_celia_cen	human
@BrazasMaloka	org
@OrbisCaffe	human
@balmeras	human
@GuenterSeeger	human
@AstaLeena	human
@GrtrNbptToday	human
@LiezPilarcaShow	unknown
@yes_moreplease	org
@shirleysmario	human
@NgChubby	org
@NoeyCakes	org
@GrciaSra	human
@SoHoLoDo	org
@alyvan	unknown
@J0eLsiM	human
@MarvinGCosme	human
@BachirNader	org
@Anxke	human
@partsnlabour	org
@ikura_sushi	human
@RRfayers	unknown
@shellybeans55	human
@AllahrizasiOrg	human
@Recipe_Corner	org
@Lyndrey	human
@jryanbrooks	unknown
@120streetcook	human
@bestdealhotdeal	org
@vividevavidevu	human
@No0ouraAlajmi	human
@joygonzalez	human
@PaleoPortal	human
@bicepsandbacon	human
@KennyStevens8	human
@FlowRider23	org
@shanelian1229	human
@PhongsuphaL	human
@ColleenKessler	human
@asi_cebu	human
@TaikaImages	human
@_trueformhealth	human
@Kartikapsc	human
@liverpool_sdb	org
@robbyvp10	human
@vrl_trivedi	org
@FerPeonG	org
@BakersRoyale	human
@cathy_tjahjadi	human
@HJsFlavorFusion	human
@FineBabyDiapers	human
@qsmithpbg	org
@millerfit	human
@cillydancer	human
@OlivierdeCroock	human
@CabooseCoffee	org
@sgrebenisan	human
@theshelbourne	org
@hrnisi	org
@MytheClothing	org
@DanRossoneri	human
@WheatWatchers	org
@SetinStyle	human
@Morningside_DC	org
@Hays_Helpings	human
@ysldale	human
@mrpachara	human
@RoyalTulipHotel	org
@Keishashenelle	human
@Psychophski	human
@d72b8d1db4924ad	human
@guiadeestilo_	human
@rovinghaggis	human
@lulusvannuys	org
@CityBizLeeds	org
@ATravellingCook	human
@Aurea_Lara	human
@RestoranOff_145	org
@BesaGrill	org
@JoyHinnant	human
@Alysheadavis	unknown
@ImYoungHov	org
@jdherrera1	human
@kalbonomore17	human
@Lynadi	human
@buTicomeporn	human
@Traveling9to5er	human
@DriftingtheBlue	human
@RomecaAcharya	human
@DiepLicious	org
@Ex_Forno	human
@Kiki_Blog	org
@TeeSso1005	human
@PersonalChefLPD	human
@chatDaniG	org
@decaturwinedude	human
@Zo_janvannassau	human
@thedrron	human
@firdaus4130	human
@GourmetGypsy	org
@EarlsHornby	unknown
@Joyisinmyname	org
@AKFITNESSde	org
@cityfirenash	org
@rexnewmark	human
@GrubAndTheCity	org
@iluvchennai	unknown
@svetmakeup	human
@poodeo	human
@TaanugFoods	human
@guyonblackybx	human
@BamboushayBVI	human
@Zemrag7	human
@Jem_Mermaid	unknown
@jknyc316	human
@WBDGBN	human
@Cowthran1	human
@superden	human
@cyou__	human
@skeepy_boo	human
@cyracaguioa	unknown
@Sevist	human
@Belczx	human
@DollySch	human
@terrio007	unknown
@414SirQuincy	org
@RoxaNDCoParis	human
@likwan	human
@Kelloggs_AU	org
@KnottBumpAndUs	unknown
@Insta_Sochi	unknown
@EvilWhiteRabbit	org
@L85Vega	org
@WellnessMorsels	human
@ThoryaTravel	human
@InKarsKitchen	human
@BrickMarketDeli	human
@WillPhi	org
@lu_138	human
@runnercharb	human
@Korrawish	human
@0oLaureeno0	unknown
@cassandrayenn	unknown
@skoogfit	human
@kellymiyuki	human
@matiagoglia	human
@MarieBica	human
@Lala_Bangs	human
@ZarosBakery	human
@foodsniffr	org
@ahappyfooddance	org
@NicomyConcierge	human
@trufflebertfarm	human
@TastyNilous	org
@PlymouthStore	human
@McEliasson	human
@Ini_dara	unknown
@07150811	human
@LindseyCatFit	human
@TerroniTO	human
@MAConsultancy1	human
@DeadWalkingLucy	human
@ericamtucker	human
@codavinc	human
@Funnygirl2911	human
@eatsharelove	human
@thinggtwoo	human
@kffkidgdtdg	human
@rawfruity	org
@thebeachshed	org
@carissacrosdale	human
@LauraSigyn	unknown
@Kanakosalon	org
@thorthursdays	human
@MunicipalTweets	org
@jeerard	human
@larrysdavis1989	human
@G____B____	human
@FandJCarpeDiem	org
@DonPasco	human
@Sarinhas17	unknown
@Mufefi	human
@DrSaraSolomon	human
@prasinoeatgreen	unknown
@TCOdenver	org
@RizkiAChrysan	human
@Oldlady12345	human
@nozomi_0727	org
@TheSuiteLifeLA	human
@SimoVielmi	org
@MixaHamid	human
@loramarie03	human
@Jazzrockman	human
@Wasabi_UK	org
@lindencollo	human
@ParathaNRolls	org
@BigTwan83	human
@missbeii21	human
@Eturnalpdp	human
@lauraberg_	unknown
@isabelcirillo	org
@Tiffs_23	org
@aylaharris_xo	human
@AegeonWarian	human
@erwan_susanto	human
@haaa914	human
@InfoEtvegan	human
@caliscenestoday	unknown
@irocksid	human
@miki03110	human
@Alba_Rigantti	org
@JalapenoTruck	org
@tapasrevolution	org
@SteelerBill13	human
@pete1986	human
@AranelJawbrker	human
@DubbPaYaDuez	human
@ramona_neil	human
@SaraZavernik	human
@VTRoots	human
@IiroLunki	human
@mewyhb	human
@SonaCreamery	human
@RedHookBrisbane	org
@MHrizukPhotos	org
@FitnessbyDS	unknown
@TheCaravanTrail	org
@ronnwong01	human
@KileyFox	human
@LinusPaterno	unknown
@Fab_Twinlife	human
@thebluemermaid	org
@krislimcaoco	human
@nabilazainin	unknown
@MrChrysoliteAD	human
@kzarr	human
@MrDMrC	unknown
@Melissa_Meyers	human
@TheMrsMuffinTop	human
@CrumleyDanielle	unknown
@MBegelinger	human
@FlorSantos98	org
@zhab6002622	org
@rayrayuk	human
@alexandrita57	human
@CreativCulinary	human
@jasminesocial	human
@JohnnyCRSr	human
@DitzyDimi	human
@GhadahAbdullah0	human
@pandaxiiao	human
@strutturafine	human
@1RainbowSpoon	human
@TajWestEnd	org
@Anne_Minc	human
@rish4bh	human
@hangulat	human
@plainsimplegood	human
@AaaBbbEeeTtt	human
@akbske4rena8	unknown
@RajdeepRanawat	human
@desperatediva13	human
@AnnieYuFox5	human
@Piccolino_Knuts	human
@missserykim	human
@TheLibertyGen	human
@SeaStarArts	human
@JohnSchaefferJ1	human
@FoodiechatsCHI	org
@homeemalone	human
@everydaycook	org
@Patrick_Ryland	human
@golestaneh	human
@symigoddess	human
@procrastinazn	unknown
@DASASIN	human
@Drinksandfood	human
@cbcsolutions	human
@RebeccaBetts1	human
@oliviavanw	unknown
@ajhamad10	org
@PedroL78	human
@FlynnsBrasserie	org
@GuileBranco	human
@ChattyCarnation	human
@ribbiz	human
@AnjaBezjak	org
@HeeXiaJae	human
@emilyneels	human
@msvanta22	org
@sandfashionblog	human
@jusberry69	human
@paulayeesing	human
@mrlippman	human
@shariahlow	org
@WPHDine	human
@BeckyMirando	human
@peachyescorts	org
@chama_tahiri	human
@AshleighPasty_	human
@JenniferEugenie	human
@julia_nghe	unknown
@AlexVittadello	human
@MrClickPhotos	human
@ITS_TOCKIA	human
@kannammacooks	human
@Nina_kic_4	human
@Cardiff_Finest	org
@mariorutero	human
@JBlacks_Austin	org
@mdixoncastillo	human
@CathyHoo	human
@reshii	human
@SamBolo223	human
@lyssathelionn	human
@4649me	human
@aphilli83	human
@karubinhk	human
@Cubana_BFN	org
@Overcome_Life	human
@ShineinGold	human
@AioliTapas	org
@ekojewelry	org
@leightaylor58	human
@oneills_carnaby	org
@DatinMazitah	unknown
@RuzgarTasarim	human
@andreasivarsson	human
@ravishingmaiden	human
@ocu317	human
@emipoyo0518	human
@Fuckin_B	human
@LRbakery	human
@yodacci	human
@alesiarg	human
@Marla329	human
@SweetPeaCafeUK	org
@peteryeap0205	human
@CanterburyLover	org
@BijouBistro	human
@emiliosturlaf	human
@aya_ganpro	human
@ManjuDhariwal	human
@CapSMP28	human
@kingswaymall	org
@Prayrful	org
@_sugarsparkles	unknown
@birkadindiyorki	org
@chloearco	human
@corvedacosta	human
@ShaylaShadeG	human
@neriphoto	human
@runnaroundd	human
@harrietcamilla	human
@VLCouture	org
@tweet_app_live	org
@cheee5	human
@xlUvNdAhClUbx	human
@GetFitStayFit_2	human
@bellaypp	human
@zuhairieroslan	human
@eattomeet	org
@LC11285	human
@Cindy_Kuhn_Bush	human
@DominosBarnstap	org
@hayanyonnyo	human
@CarloCremonesi	human
@amalenstwo	human
@TheRealHermz	human
@TranquilRealist	unknown
@AlbaOsteriaDC	org
@Katie_Stardust	human
@CulinaryMed	org
@DaveNutley	human
@lizisgranola	org
@regentarcade	human
@MisyaRecipes	org
@onaturalsa	org
@HaveaBallNYC	human
@DarineHamze	human
@DarrenAshClarke	human
@HealthCoachC	human
@dinndinnapp	org
@Cool_shanti	human
@BoffinsYXE	org
@BymonicaGarcia	human
@puntodelivery	human
@FrugalFamHome	human
@TheCheeseWench	human
@FudoDubai	human
@fionaht	human
@jeaniusNYC	human
@GOSHfood	human
@francescalvmh	human
@AdaMabel	human
@bobwen	human
@teeteeky	unknown
@Lindura_84	human
@oliiolive	human
@piekinglao	unknown
@FitFoodAndStyle	unknown
@katgurl72	human
@MattM1291	human
@deejaydev	org
@drolivo80	human
@SarahBurris	human
@conny_mazza	human
@Princejudah	human
@ChinarBaku	org
@IGrindDotCom	human
@Emil3134	human
@iamjenjheams30	human
@myculinarycv	org
@sagesurge	human
@xXxSpecklesxXx	org
@zurnadxb	human
@RahmaAmelinda	human
@aovari	org
@emptypocketlisa	org
@Glbertcrz	human
@Tyrunsthisbaby	unknown
@breezyIman	human
@goeqcheN	unknown
@floralchild	human
@butchersdogla	org
@katebaumber	human
@vashondasherra	human
@RalpShields	human
@WhaamBanhMi	org
@YDLOVER08	unknown
@rui_ilmigliore	human
@JellibeanJ_Blog	human
@eatsa	org
@jaymers9701	human
@Gardencakeparty	human
@charoltolentino	human
@krizzyangara	human
@AnecdotesApples	human
@_thotn	human
@DKM88	human
@vivdomingo	human
@JoanElfen	human
@EllaPaskett	org
@PastorJonDavid	human
@MonikaSujono	human
@CHEFSMILEY717	org
@Simplify_2013	org
@Faninia	human
@4Gigli	org
@sprinkles_09	human
@wildehorse68	human
@Shella_Rizal	human
@DTLARendezvous	org
@Neicytots	human
@LanceTyler9181	human
@j_pedrog	unknown
@MySweetZepol	org
@TheNotoriusTash	human
@KennyG_420	human
@1andonlyLayne	human
@FashionTeller17	human
@Raysem_Style	human
@Tanhouseshop	org
@pdxcuddle	human
@RexyNavy	human
@superdeluxepg	human
@monxter_	unknown
@ladykirman	human
@cakfatah	human
@chinosuke69	unknown
@RamadaRVC	org
@leanandgreensd	org
@aysegulramos	human
@shiabertoni	human
@GrowerSquare	human
@mattlorenzetti	human
@ARENAWEXFORD	org
@YohannaChubby	unknown
@allan3heat	unknown
@theclassycloud_	human
@Simplyme_JP	human
@jessie8610	human
@Kinoflix	org
@benggarcia	human
@RosebudKitchen	human
@AFINA_Mei	human
@howreyouCOM	human
@NannyShecando	human
@Clawsonspub	org
@r3ir3ir3i	human
@reallyPRILLY	human
@MissVerush	human
@Gingeybites	org
@_kymuxdork	unknown
@fabiost	human
@ItsukiKurosagi	human
@plewfire	human
@rebeccaspiegel	human
@WCWD	org
@TankaBar_markh	human
@iamsoworthy42	human
@br_webb	human
@GustavoEs11	org
@Mmaalleennee	human
@EatWellGF	human
@ScentofOranges	human
@msjennydeng	human
@ElementalFit	org
@reyhanatmb	human
@Alpenpalace	human
@IDGRestaurants	human
@Bastedbaker	human
@thehappinessX	human
@evanbloch	human
@chifoodath	org
@thirdiepalma	human
@PapehY	unknown
@RoundsBurgers	human
@happyendingsbcn	org
@latestcanada	human
@titaniumrunner	org
@IntanLidya93	human
@ernieanne11	unknown
@EzahLove	human
@JClorapimentel	human
@JerryRawung	unknown
@geelaw95	human
@GoldenMochi	human
@blazerwhore	human
@ffrankly_speakk	human
@JadeEatery	org
@TheBiggerPict1	human
@elle_tea	human
@AmyHeartsFood	human
@CosneraJanni	org
@krispooh18	unknown
@HWTthewood	human
@colin_neil_show	human
@wrenagade	human
@SnknW	human
@WestCoastSA	org
@BouillabaisseW1	org
@SynchRhythm	org
@Bianca022	human
@PoppinsBedford	org
@dunjastajic	unknown
@lidopalaceriva	human
@TeashopNancys	org
@mameshiba520	human
@linzic23	human
@goodlife_cafe	org
@IgnatiusEga	org
@NutritionYCT	human
@el4va	human
@SuzejPT	unknown
@RossAlexander74	human
@Nico_Iaciancio	human
@alotoffunmdl	human
@ChefConnieBakes	human
@bigtymer32	human
@outeastla	human
@PapacassKitchen	org
@RiceKwon	human
@Mr_Omega	human
@alancehuang	human
@Boomchampionstt	human
@IdaDesigns4U	human
@KitchenBully14	org
@CailinsPlace	human
@betsy_cat	org
@docordray	human
@zoran24x7	human
@Fustany	human
@zainman13	org
@chuckmarbella	human
@supadad85	human
@hmhkaufman	human
@billy79	human
@James_Samuel7	unknown
@j_finestone	human
@JammsRestaurant	human
@SarahSofiaPro	human
@LAGBarton	human
@diva_met	org
@AshleyLauren809	human
@22ndandPhilly	org
@JeineRobot	human
@CamarenaKaren1	human
@beckhernandez	human
@joymanavath	human
@Showcase_LA	human
@brandeetsanders	human
@mrneversonminaj	human
@WickedDreamer	human
@SSerkal	human
@RoamingRednek	org
@danstonebass	human
@FeastUrEyes	human
@FootstepFitness	human
@chininta	unknown
@Madpoetix	human
@hanny_only	human
@abbeythomas19	human
@littlelululim	human
@TQuanlive	human
@jsahm69	human
@MVPBS	org
@QueenieBurlesk	human
@injtokyo	human
@yuripix1	human
@ELREYSOYYO_	human
@katerzphd	human
@stephaniezen	human
@happylopez	human
@itsmerpmferrer	human
@naj_motso	human
@BernHotelsPma	unknown
@BellaNBryan	human
@hito_new	unknown
@RestaurantMaya	org
@RicardoRicciok	human
@cycloree	human
@ele_tms	human
@agrobacter	human
@LaceyB4	human
@trendytrainer	human
@tote_mag	org
@iamkathj	human
@koukyA	human
@interior_grace	human
@NurietEme	human
@ReignOfApril	human
@PaosFitWorld	human
@Novi_Chikel	human
@Yukino1109	human
@RiverparkNYC	human
@Eliz1167	human
@mixDF	org
@AbhiAftermath	human
@ye11owgirl	human
@monaycius	org
@jperryfilms	human
@creamy_mami0824	human
@oblogdasusy	unknown
@WolfgangBuzz	unknown
@RadissonBluDXB	human
@ClothedByGrace	org
@JoanneTechLover	human
@TheCanvasE1	unknown
@harikanyc	human
@KlaraNekulova	human
@YungPauline	human
@HerBossyNESS	human
@AmyChu	human
@NatBeeBlog	unknown
@invogue89	human
@MobileSalon05	human
@BarrymoreLV	human
@picturesyu	human
@theLOOKes	human
@RjMitte	human
@MeowSays1	human
@EliteResortSpa1	human
@TNuttyRedhead	org
@iamJJSA	human
@ryan_lobo	human
@Amada_BF	human
@LouiseSyberg	human
@ChanceStacey	human
@Mir_SM4	human
@spongefugitive	org
@underxmastree	org
@morganlarue	human
@Dany_goalkeper	human
@erturkgzm_	human
@DecadentDrifter	human
@tinyteatox	org
@cheftimon	org
@StyledtoaTEA	human
@nadja_b81	human
@thebrothersbuoy	org
@zumbidofood	org
@LalyRadiokif	human
@juliechrist	human
@Michael_Taus	human
@noemi_liebig	human
@MisterPoseMag	org
@zzhilingg	human
@lilypdx	human
@stacymolter	human
@aariverabrito	human
@doyouRENEmber	unknown
@springermtnfarm	org
@blanchardlibby	human
@AlexKiva	human
@tinyfishbowl	human
@meganleary	human
@tastebudtart	human
@Mussanaf	human
@AisyahIntan	human
@kristinrusso	human
@ParentNFamily	org
@posrax	org
@DATamanaha	human
@weaker__	unknown
@castecki	human
@GaGaDiEgO	human
@sirlynabireta	human
@Athens_Family	human
@grashyabella	human
@ShutterbugLDN	human
@cecillebabyphat	human
@Afulton2010	unknown
@beeznhoney	human
@nadsy621	human
@ann_kok	human
@VaVa_Nella	human
@ByblosLubnan	human
@Trend_Movement	human
@mahdiyah_snoopy	unknown
@dung_h2	org
@PixByDave	unknown
@Bomberboy88	human
@LrsbearUk	human
@CorinaDascalu	human
@joubertyao	human
@BinaSitaram	human
@manjulika5	human
@TRAVELRSConnect	unknown
@ApoloniaKandoll	human
@MozaicoFlamenco	org
@Amr1ta	human
@528Dublin	human
@ledajill	human
@ahputnam	human
@adamprokopchuk	human
@Zina4f	unknown
@joansonthird	org
@Anggelina_Aling	human
@LaLlosaCornella	human
@foodelizcious	human
@elarrywong	human
@TheRomanFoodie	org
@vacuumouthjesse	unknown
@icha_vet	human
@rajesh1072	human
@rayan2	human
@ArieleMelloni	human
@Chatwakorn	human
@foodies_bot	human
@WwwJkDivas	human
@projectjulie	human
@kennethlkc	human
@BogdanVlase2012	human
@krisy_lynD	unknown
@NinoFranco1919	org
@VillageWhiskAC	human
@tjiptomo	human
@AJetSetLifestyl	human
@LockhartLondon	human
@durhamfoodie	human
@crseco	human
@Sittes20	human
@jeanae	human
@AEB_QPR	human
@BaoaseRest	human
@thelandingsml	org
@CircleBistro	org
@RockSalt_	org
@cosmochi	human
@sezifood	org
@ElemPrintr	unknown
@mayu_nagasue	human
@eatingoutguide	org
@xhui7	org
@Angelasews	human
@slimgoody05	human
@KeishaFrancis	human
@mchristinego	human
@xerophytes	human
@szk_erk	human
@touchfood	org
@fabicavassan	human
@PoachedNYC	org
@Prettyliciousp	human
@JustBidding	org
@namitavsuri	human
@b_boogey_xl	human
@hanif_subekti	human
@simmykwon	human
@noelirossi	human
@myiezha	unknown
@extremecoup	unknown
@yourwellnessnet	org
@EDGENEWBURY	org
@RecipeGeekMag	org
@MustardSeedMrkt	org
@WirtshausLA	org
@Heop97	unknown
@aejawina	human
@marziabella72	human
@CafeSymposium	org
@LAbowdown	org
@aprizal99	human
@The_HummingTree	human
@graniceb1	human
@luisgermangall1	org
@Louvainlife	human
@iam_cantona	human
@HawaiiFoodPhoto	unknown
@Fledermaus	human
@Clairetastic	human
@KOBTHONG	human
@NikCrisostomo	human
@AnittaSanMartin	human
@Fish_dogs	org
@KHolistic	human
@febrina_go	human
@mercuremanchest	org
@JVRDP222	human
@Mikkifit	human
@nasilemak_m7	org
@CLOTHESMINDED1	org
@pochhhhhhhh	human
@eatprayreadlove	human
@FollowbackDevil	unknown
@HixRestaurants	org
@uriasonline	human
@ItaSaleh	org
@covaglasgow	org
@honeyangelia	human
@yycfoodjunkie	human
@navdeepsoni	human
@seiji_info	human
@Sh_AlMaazmi	human
@YCorreaFB	org
@TheSweatGuru	human
@despblogwife	human
@ThePigDC	org
@DocJeFuRei	unknown
@IZAWA2020	human
@CrossingsGrill	org
@Emzie_1998	human
@RockOnStage1	org
@Ladradiricette	human
@Shafrani_Dizar	unknown
@ValeVar13	human
@happensindubai	human
@fitboard	org
@hpprima	human
@twinsforfashion	human
@bianca_vader	human
@debbyxme	unknown
@DumboMayi	human
@AmyCooperEM	human
@tamu1na	human
@RefineryRooftop	human
@KateAnnaLauzne	human
@schahin__	unknown
@NinosOn1st	org
@VeganPlates	unknown
@bryanbelen	human
@FreyaHerring	human
@jumarjomar	human
@denizsaatcioglu	human
@TrendyHotelsTR	org
@jackycoolboyzzz	human
@samickiow2002	human
@AvvaiFornelli	human
@irenekarra	human
@MoontseJackson	human
@ameerjoshua	human
@J0hnJ0n101	human
@lifefamilyfood	human
@tortosaDeanDean	unknown
@Wriggle_Bristol	org
@1practicalsoul	unknown
@RevLoungeNJ	org
@thenixepisode	unknown
@A_B_Fernandez	unknown
@RachelleRoh	human
@DrykaMfs	org
@WearEasyco	org
@tjoonk	unknown
@traceyceurvels	human
@kellieann_b	human
@nicolearistides	human
@DisneyBrat	human
@Greenbottle305	unknown
@bexxyd	human
@laurieinSEA	unknown
@PrimoGCsYYC	org
@paleovirtus	human
@vincisilvio	human
@SunnyRaymond	human
@FSPHealthandFit	org
@Teresajosy_96	human
@MattyEbriega	unknown
@magnoliawong	human
@c_overthetop	human
@ronskie06	human
@_theandrogyny	human
@dukeyorktoronto	human
@dwbh_n	human
@PDRAMIE	human
@AngelCandyT	human
@Steph_NoFucks	unknown
@Cherylwong86	human
@babaluuuuuuu	unknown
@MRNCLR	human
@WendyWings	human
@supersupplement	org
@mulders_16	human
@cwynne13	human
@SammyD71	human
@sebulban	human
@ESRecipes	human
@wiratul	org
@PrinceYuan18	human
@ShonaM91	human
@CaPtDCharles	unknown
@42Sanitonbiz	unknown
@PoppyandPint	org
@Kiwiyee	human
@brynmakesfood	unknown
@TerrelThom91	unknown
@veni_lee	human
@IamNuss_sutta	unknown
@LaPanatta	human
@GrassRootz999	unknown
@fetchadogbone	human
@LionheartDan718	human
@TeakRestaurant	org
@eccent_ric	human
@lyxlyn	unknown
@HelloGorgeousYB	human
@MissMcAllister_	human
@EchiAusasia	unknown
@iR0CK_AER0z	human
@adibeasley	human
@Aspro_Piato	org
@fahad_sumat	org
@skinnymini_blog	unknown
@tarryPramadhani	human
@rechierich_1980	human
@chainedcatdsign	human
@24days2skinny	human
@lisamitchell29	unknown
@RosaliParisi	human
@DowntownNewWest	org
@ForeverZoeyy	unknown
@WhodunitTO	org
@parkmerced	human
@Aniisah_Rawa	unknown
@MoeJoudah	human
@KaitlynBarlow	human
@NatalieJForte	human
@BPTNYC	human
@Steauxn_r	unknown
@ussheffield	org
@akayuchan	human
@patriciapmarq	human
@BorgoBiologico	human
@HildaJuwanto	human
@sophiayayaross	unknown
@EdgeOfMyPlate	human
@_non_tan	human
@_fdprn	org
@randyaitch	human
@Petrofantasist	human
@EricasWalk	human
@ZealRestaurant	human
@hydoro666	human
@djbmr	human
@RichSlate	human
@crazycj2380	human
@mumuee	human
@GlamourGeekGirl	human
@snsd_ym55	human
@funshinekelly	human
@ramonlf23	human
@FamilyFirePit	human
@jasonizumiART	human
@Kareen214	human
@mamacat1984	unknown
@valeriefidan	human
@_Chao2x_	human
@mfornac9	human
@lisvetmatos	human
@CandelariaSosna	unknown
@LadyVelvet_HFQ	human
@mwilliamjr	human
@mk716w	unknown
@kamarul_tweets	human
@tatipolo_	human
@kkamendola	unknown
@loopphotoDT	org
@kevinfoote	human
@savorthefood	org
@TLHDowntown	human
@PRMPhotography	human
@slugqt	human
@RedStarWok	org
@Tallblondchick1	human
@TheRealJohnMak	unknown
@miho0929	human
@lucypezespada	human
@_HealthyMatters	human
@TypicallySimple	human
@SDMessengers	org
@grazeciren	org
@mummina_	human
@SoyChaiz	human
@FarnboroughFC	human
@ChefRob_inRhody	org
@StreakyGin	human
@annsrahyani	human
@twit_everywhere	human
@manzheni	human
@TousLesJoursPH	org
@JenniferJuneau1	human
@ScarlettHarrie1	unknown
@Zsuzs085	human
@AngelTrevarthen	human
@thischickcarrie	unknown
@doveblog	human
@therealcandy88	human
@SweetestBaboo	human
@Gayporn123	unknown
@decoractionscom	org
@Peace_Luv_VDubs	human
@marychochocho	human
@schreiter	human
@AppleHoller	org
@VisitTucsonAZ	human
@ChoGazpacho	org
@JavenOnline	human
@MLRPromoPlus	org
@DavieStreetYIG	human
@UdhamkiGhori007	unknown
@MsCarolEsmerini	human
@byanfeby	human
@lcbadea	human
@calculatedstepz	human
@shazamboom	human
@Loni2910	human
@yazcerdenia	human
@LeilaKwok	org
@wyldsson	org
@declanCS	human
@thedorkofhere	human
@ReadyRock7	org
@BecatBarH	human
@warrengroom	human
@Maetallic	human
@Finestnet	org
@mn08032	human
@Kai01229	human
@NotWoutSpice	human
@hugo4de	human
@meggyumi	human
@NovikovLondon	org
@stuftmama	human
@GrcilHrnndz	human
@nyc_fitfamily	org
@SeattleVacation	org
@ranchgirl83	human
@EarlswoodStJohn	human
@coachmhord	human
@Alhrayth	human
@SunnyStreet_AD	org
@Emily_Shep	unknown
@PSEMATIKAS	human
@alchemyjuices	org
@0urLastKiss	human
@thecrowdedtable	human
@CastawayKitchen	org
@JusTTScoTTy	human
@ebru9292	human
@Superjarrsss	org
@hippiescreation	unknown
@corkyshomestyle	human
@HuffPoLifestyle	org
@kitchen_nv	org
@VanessaRosalada	unknown
@a2mSays	unknown
@jetrekPANDAWA	human
@BsAsGrand	unknown
@GermaineSirMing	human
@Freetimesport	human
@PPlates	human
@CtkuAmira	unknown
@mybestladay	human
@McGuireDevelop	human
@WhereisJhoan	unknown
@JustVan3ssa	human
@FairmontThePalm	org
@CelinosDeli	org
@Shootmonster	human
@kap10bob	human
@Exposure4All	human
@ClubFoodie	org
@Myblogisrich	human
@Celes828	human
@johnsenuta	human
@Agovinoveritas	human
@futurehopecom	human
@ronrondinio	human
@dendy17s	human
@KathyMagsino	human
@J_Wijsmuller	human
@DaWnGiRl58	human
@principessa86	human
@MWDDallas	human
@Voncile570	human
@AbiLeech	human
@sweetycone	human
@spejampar	human
@anastasiadiet	unknown
@KenlysRojas	human
@DerekWilmot	human
@ninaandcodesign	human
@GIOVAS_	human
@Balsamico_ksa	org
@rockalt_grunge	human
@Shamli071	human
@FoMerlot	human
@bibbibobo	org
@asharedtable	human
@AnamArfan	human
@TheMorganLewis	human
@Linsey87	org
@Yung1Swaggie	unknown
@GarpotStudio	human
@EmpireLipstick	human
@templetreelsr	org
@Lala_squirt87	unknown
@TenOakAustin	org
@OnTheLotLA	org
@Momsandkeyboard	human
@30secTravel	human
@ChicagoFoodGirl	human
@lisydancer	unknown
@milaladiest	org
@UrbanDigsFarm	org
@FoodOnTheMonon	human
@gioiahm	human
@mistressmoonie	unknown
@isidro_gomez	org
@momoiropoppy	human
@GelitaGzman	human
@baitjarrr	human
@Ffbot2	unknown
@StarlightOnChem	org
@RubyLaneTreasur	human
@beingjacquie	human
@TheDeau	human
@Raphie04	human
@QueeFawnduh	human
@filmgeek15	human
@Foodsbyricky	human
@shion_yo527	human
@QueensComfortNY	org
@MarieTurnor	org
@sh3y_sh3y1	org
@Quan_Dro319	human
@CarolBedson	org
@ArianaAmison660	human
@Boomb0xOfficial	human
@DaveMcKlveen	human
@jessica_volpini	human
@derekyoung26	human
@meganahoko	human
@Cookeatpl	org
@BeHealthyFeelGd	human
@WildSeaLasOlas	org
@Merr7	unknown
@mapleandfitz	org
@GrassFedMom	human
@Munro_H	unknown
@Purple__Skull	human
@FlipinsQYQP	human
@Ahlam_3589	human
@godalodemo	human
@themoskov	human
@shimax6	human
@Ultimac	human
@Daniela_gym_	human
@HzCHIN	human
@guerrillatacos	human
@i_am_dekdee	human
@shiraari	org
@GiraffasUSA	org
@veghotpot	human
@pinkytwinkieee	human
@delictraveller	human
@TankaBar_Rachel	human
@Caron199	org
@nerochilli	human
@NickBudosh	human
@glamorousByT	human
@Meshari_Alsahli	human
@TheInnOnTheMile	org
@foodlablondon	org
@TestyDiorHarefa	human
@SoNotKayla	human
@erics_estrada	human
@gulsahsahlan	human
@JUSTJDJAKE	human
@catchbaaaaall	human
@marthtram	human
@iTheDrake	human
@WholesomeBliss	org
@dark5un	org
@Girl_inthe_Cafe	org
@MonicaMMingo	human
@WaltersLounge	human
@GailnessS	unknown
@Dianingati	human
@JenineMayring	org
@juancamus	human
@CHIC_HKtour	human
@LOVEnaJOYpa	unknown
@retrofitme	org
@Katie_J_Ball	human
@ronnilie	org
@jpleon91	human
@MyDiyAngels	unknown
@allylikesithot	human
@ModeSportif	org
@BrodyFLZ	human
@cnlow14	human
@RisetotheCloud	human
@pixiedub	human
@MoJoCMO	human
@CITYPEEKpatti	human
@smilelikedemi_	unknown
@staygorgeousLC	human
@ameuhlieb	org
@MiyakoQiqi	human
@LoveMilesTeller	human
@penchan25	human
@LinsDjmario2002	human
@Suthida_Gift	human
@Noms_McGee	human
@therealnatejoel	unknown
@StylishGirl83	unknown
@master_beat23	org
@DaniThomas8	human
@NeuvooHosDubli	unknown
@InfoMoldovan	human
@JimboBeLike	human
@Jashugan22	human
@ChaneDriessen	org
@KDozeman	human
@TofuForThought	human
@josepacios	org
@klongrainbows	human
@jasyuniquelyme	human
@man_hadi	human
@RealCdnSS	org
@BusyBodyCoach	human
@PRINCE_ZF_SWAGG	human
@Masato31541882	human
@gunadihamsyah	human
@EuropeanJorden	human
@BenParker90	org
@DaniellaDamella	human
@ThePhoenixLA	unknown
@SenecaSnacks	org
@Cold_Damnation	human
@ChefsArsenal	org
@InstaTaganrog	human
@FoodYub	org
@rubykelly12	human
@moloko_girl	human
@corrineash88_	human
@BristolPound	org
@CurlKit	org
@jogjahotspot	human
@illusion_by_f	human
@intokatespade	unknown
@millidollawrap	unknown
@PrincessofS	org
@SamTaveras	human
@LickeyKitchen	org
@BEVERLY_MARTIN_	human
@YoungDonnaYoung	human
@ReginiaCordell	human
@littlest	human
@naimrafael	human
@romiel95	human
@PepperKetchup	human
@SuehaizaS	human
@crlooo	human
@sproloyeeh	human
@Madam_Roy	human
@foodlifestyleso	human
@TheKatieSeward	human
@ExplorerMilan	human
@RandomTonee	org
@brando37	org
@Bot_Yogyakarta	unknown
@DrusillaBloeme	org
@onlinedealmom	human
@BPOysterette	org
@jamiefryer76	human
@BermondseyYard	org
@sharlaj23	human
@SandpiperPub	human
@msnehamathur	unknown
@MissKerriKat	human
@colombianinski	human
@LeashaE	human
@ssgastrogrub	human
@BLOODLINE1	human
@xxDollyBxx	org
@Alice_Smith11	human
@HumbertoYamil	human
@michellerattan	human
@maraiza77	human
@TweetingTailor	human
@take015	org
@SheilaWolf	human
@sophiee_amberxo	human
@alexmarfori	org
@wongmelissa	human
@viddyadara	org
@deucetearyknee	human
@SoKarriedAway	human
@OddestBar	human
@whoooca	unknown
@TheeAzureSky	human
@aneumann86	human
@mayajuleshaddad	human
@TheDollarMonger	org
@cheilthy	human
@UpperCrustChico	org
@TAPABISTRO	org
@PerTeDubai	org
@kaskusway	org
@Melb_bars_pubs	org
@EFA_AB_eggs	org
@PeteBlackburn	human
@FFTVToday	org
@eProtein	human
@cask666	human
@RFdigitalprint	unknown
@PeteLovesKat	human
@KitchenTableNYC	org
@sixtyonerest	org
@bestwineries	human
@KissesMaldita	human
@SpecialfyMe	org
@selvajuan	human
@ferdbouk	human
@WaldorfNYC	human
@AshleyWeede	human
@SCOFFQUAFF	org
@Monicawzy	unknown
@mavericking	human
@CandG_Egypt	org
@kimiabdullah	human
@elementalcoffee	org
@LisseRado	human
@TheSantaiUmalas	org
@tony2woks	human
@FollowbackChaos	unknown
@Michi_Evans	human
@Princeboy23	human
@eeeesa	human
@christinetlu	human
@GreatTalkRadio	org
@EQforSuccess	human
@cyndog7	human
@theossblog	human
@NanaGouvea	human
@razza_blog	human
@wfmsavannah	human
@jopiesanchez	human
@bernababes	org
@lolacobley	human
@MarmaladeBham	org
@Slayerfrench	human
@ConsciousMediac	org
@lifeinmontreal	org
@_bitca	human
@DenisCarreOff	org
@Rabiangfah	human
@TWOTWENTY	human
@London_Likes	org
@NTLnutrition	org
@ReubenCheok	human
@MalibuRoadhouse	human
@PhilippaRRees	human
@Lily_plum_1	unknown
@justmepaulineb	human
@AntoniodelasAl1	human
@SelfieChamp	org
@Marcellina	human
@danrundan	human
@Onewleecia	human
@cpogco	org
@HeidehWilliams	human
@bbcmichelle	human
@crabaino	human
@whats4_tea	org
@havayolu101	human
@eatbnb	org
@nez_cyn	human
@ParlourCork	org
@hermanto_zhou	human
@cherrypickdubai	human
@kitty_killuh	unknown
@WitchyDeeDee	human
@_henryrich	human
@Rob_Keijzers	org
@debyortolani	human
@Miss_B91	human
@michelewritesit	org
@masao206	human
@davefiles	human
@djspy	human
@carlosloren	human
@rubybebe319	human
@11Tiagosantos	human
@farihanpadilla	human
@AnneSchlegel1	human
@joyjoypig	human
@GabrielsCarrie	human
@mohdshamsuri	human
@Baoli_miami	org
@fooodaddict	human
@WhiteOakGourmet	org
@PeachZai29	unknown
@payin21	human
@FoodStorageMoms	org
@MrsBigJohnStud	human
@damonwon	human
@jemmerano	human
@TheWordens	human
@f00dventuresRD	human
@yuujisekine	human
@mikeekim99	human
@PetraCanan	human
@mscng	org
@MianZiaUlhaq2	human
@Squachbob	human
@Nathalietaylor7	human
@LindsworthDeer	unknown
@BarniesCoffee	org
@NiallCowan	human
@cosmosale_seo	org
@mayumi0413	human
@mamaleahs	human
@aliakhan111	human
@Kinestra	human
@highlyfe01	human
@davidaquinley	human
@ripat55	human
@ymthefire	human
@uncannync	human
@VeganDisco	human
@Zeekapza	human
@genes_inmotion	org
@mackazapata	human
@RJ_ArjayAquino	human
@PetersSince1969	org
@aprillou	human
@oatasis	human
@food_to_eat	org
@mirkocaiolo	human
@datboyrobd	unknown
@fuzzyduckpub	org
@CypressRox	human
@musicseraph	human
@BricknerTracy	human
@HalimaJafari	human
@soylaroja	human
@reng555	org
@SergioEspinoza	human
@zsundquist	human
@CydniG	unknown
@stylittude	org
@leeunowei	human
@EeahAlhabsyi	human
@CultOurvators	org
@ESTAFOTOcom	org
@HealthHairHope	human
@ktz24	org
@RAMBAM89	unknown
@emmaprew	human
@ad_faisal_md	human
@resovateoffice	human
@farahk130	human
@GingersFoods	unknown
@lmo_22	human
@whitchristine	human
@Chellcial	human
@miss_demi_page	human
@DrRobMelillo	human
@e2emerilseatery	unknown
@olive_liau	human
@hariyonomou	human
@FamLuvStuff	human
@yurista_dian	human
@MurielsOz	unknown
@ozumobdg	org
@ChristineLCreme	human
@AmandaDBrowning	human
@LeilaTougharred	org
@Ah_Mais_Lis	human
@RealFoodDaily	org
@aasho	human
@Sweet_Teak	human
@foodee	org
@SmellofSkinny	org
@WinnitRaffles	org
@LottieTT1	human
@LondonPauseBar	org
@meatpackingb	unknown
@AlexCortrightRD	human
@KaisaLarkas	human
@TheHealthMinded	human
@DoubleDutyMommy	human
@MustangSlut	human
@revista_mirall	human
@RileyHuddleston	human
@TheMemoryTag	org
@Camietx87	human
@RichKnight_	org
@djdonjuan8	human
@SweetsInBox	org
@LilGladysY	human
@things_to_do	org
@kevin_lim_4	human
@libbylangdon	human
@HoneyCrystalD	human
@ChinenYuzaki92	unknown
@HopeBatchelor	human
@Richeeep	human
@soupologie	org
@ChefPaleoBear	human
@doingsplendid	human
@TheDietCare	org
@communalnyc	human
@mariewong	human
@carniccios	human
@AndreaInWine	human
@georgehenry47	human
@MariolaAzores	human
@Ma2mlaFit4life	org
@DolanLawGroup	human
@NiteStar	human
@susienc919	human
@princessofsteel	unknown
@tasinami_	unknown
@ErekaV	human
@kateskitchen	org
@jeroldsc	human
@samanthajuicy	unknown
@NMK_1991	unknown
@eonishiri	human
@quieromax	human
@DAGGERLOVE	human
@marielakawas	human
@okaypanda	human
@swellkos_k	human
@KREATIFashion	human
@car_ortiz1	human
@CeecesTravel	human
@dkarlocastro	human
@DorianGriner	human
@PaulnJoeSister	org
@tamayodenver	org
@theLAW1302	org
@LETSOC	human
@STLcwescene	org
@lunaloveliz	human
@MarissaKoolwijk	human
@pinknlov	human
@sodie33	human
@RoutedelaForme	unknown
@Luii93	org
@CarltonJared	human
@zaki9	human
@woolloomoolo0	human
@hatpop8	human
@emifashiondiary	human
@ChristmasDD	human
@your_gare_bear	org
@yhensatiOn6	unknown
@CharlesWS	human
@thomasjonesjr81	human
@SaludHEALTHinfo	human
@JoliesBistro	org
@CMKWine	human
@justinljt	human
@jeronimovdm	human
@iShookieMichele	human
@LorettaVMN	human
@JubleeW	human
@ZoeBP	human
@kgraphic79	human
@susanyinyang	human
@imaginaryarts	human
@LOVA_CHEFNIC	unknown
@madeleineh_h	human
@djnoodle3pji	human
@GrandCuisine	org
@BangersRoyale	human
@jeffdunlap61821	human
@mytastegram	human
@piniatawkuchni	org
@KyleSimon	human
@erikhui	human
@mechnizmo	human
@stephmu5e	human
@hertfordhotel	org
@JeanieTheLiew	human
@OdwyerLouise	human
@rickysibert5	human
@TeamNutriGenius	unknown
@SugarToadRest	org
@washplacebistro	org
@RockefellerHB	org
@Alexgermoso	human
@ThePurplePrince	human
@LinneaRay	unknown
@FashionAgony	human
@Meidinifp	unknown
@AllspiceJAD	unknown
@iamyursqb	human
@icepack9999	human
@alexhirotetsu	human
@daifeijay	human
@mariaulfa_fafa	human
@Isumbard	human
@FlyFoodGuy	human
@GwynethCheever	human
@TaiaG	human
@raydennis	human
@slapfaan	human
@billy_sarangelo	human
@lovesthefeed	org
@XsassicaX	human
@xxxeriiixxx	human
@Hardrockctg	human
@berniemac82	human
@Victor_Tangos	org
@lunanmaria	human
@laurenavsarabia	human
@valuerater	org
@eXclusiveRuby	unknown
@sarahhsutton	human
@ChusFotografia	human
@notthi0609	unknown
@theorganicboi	human
@gastrochic	org
@suicidalcharm	unknown
@J_woww_ahh	human
@rasamalaysia	human
@tay_republic	human
@ForeignPolicyTX	org
@ReubenChay	human
@thaonguyen0709	human
@pablo_a_avila	human
@usegg	org
@littleshmiddys	human
@GracePengelly	human
@misseyblue	human
@vannymiale	human
@GaunArte	human
@paleoakland	org
@Slimarea	org
@jacobbendana	human
@CHARISMAISM	human
@BernardoDias16	human
@grlldcheesetruk	org
@EleonoraAnanda	human
@yablon	human
@toruko_rice	human
@luckyrabbitsnx	human
@BikiniCountdown	human
@just_sooz	human
@desireekoh13	human
@TBconditioning	human
@venetiasheppard	org
@Ekmaaal	human
@lexarod	human
@LARTenLoire	human
@uchoose4mecom	human
@CafeCaturraMVS	org
@1oLKoRKMaZ	unknown
@ingaintriago	human
@nazrulhisham_	org
@TheJuiceJunkie	human
@TGLRadioShow	human
@Ltwo6	human
@xak_kax	human
@JeroCompany	org
@AnaAlemn_	unknown
@cumachita	human
@JaneKingsuCheng	human
@SlimWorldHarlow	human
@michaeljamessag	human
@EllisGilson1	unknown
@evofoot	human
@LaserSpine	org
@groogruxking40	org
@Ciaraodono_Nut	unknown
@yui_xxxtop	human
@davidtheman30	unknown
@weissometer	human
@deenahp	human
@metekayaa	human
@GloriaGV2	human
@DHJ_7	org
@fashionsavvy714	human
@blenderbabe	human
@NestorQMejares	human
@heinzmeier10	human
@miyuki_squash	unknown
@smooth2385	human
@Armida311	unknown
@stacenag10	human
@DeadDollsPkm	unknown
@doppiozeroUK	org
@zaina_risaci	human
@TuckerWood	human
@teretika	human
@LMKAdams	unknown
@VlastimilKocab	org
@rottamatta	human
@WhatNadineSaid	human
@ashnod	human
@mamitaro0822	human
@GoGingham	human
@Rarepieceofmeat	human
@4mybody	unknown
@juliamaymorgan	human
@twenee_seven	human
@RawNaturalLife	human
@Privatedining_	org
@RavenDizon	human
@NutritionMunch	human
@NeilaNsm	unknown
@CibreoCleveland	org
@kisas_indahood	human
@BHHotelReigate	human
@hamearislucina	unknown
@blackanesecoco	org
@cintaur	human
@sodopizzacafe	org
@bryan_pasaribu	unknown
@imeechan	human
@TinyFishCo	human
@BirgitSSM	human
@MakaniDeli	org
@heyyjasmin	human
@TheWalldorff	human
@delisabrosa	org
@talithagnswr	human
@veganfamrecipes	human
@ForeverFriends_	org
@comfortinn_rjt	human
@yguee	human
@marksandspencer	org
@iyacates	unknown
@TiarasOpinion	org
@SUKU_KAZU	org
@TSENlabel	human
@AlmondBreeze	org
@shalomleong	human
@ohmyitsshelbs	org
@rinee4D	org
@AnthonyYepez	human
@lezzettramvayi	org
@TrendInsightspk	human
@daisuke33461168	human
@SwaggDaddy_Kid	human
@jasonrebornz	human
@313BookieDaBody	human
@comi423_petit	human
@BobClubsAndover	org
@TheChipSociety	org
@borghilaura1	human
@ConfedCentre	org
@MolliSaucesSOS	org
@thesaltyardkk	unknown
@MsControversyXO	human
@ak73451	human
@lookwelearn	human
@LindsayL0ve16	human
@cocomomoholborn	org
@AnaTup	org
@drewbie_g	human
@Andaz	org
@CafeRachels	human
@CafeLAube	unknown
@highlandeggs	human
@Flour2people	org
@psweet253	human
@dayglo44	human
@stevebruno23	human
@TeamDasuri	human
@AstridWilandh	human
@Dame_Rebecca	unknown
@MartaFashionLip	human
@LarsGranat	human
@Cookiesncreamed	unknown
@IRescuedretro	human
@BoBClubsAlton	human
@Get_Yr_Deal	unknown
@RosixWANPA	unknown
@MadridFashion	human
@illogicalbrat	org
@RitchieOdak	org
@FoxyOxymoron	human
@Hope_Center	org
@thedreamluggage	human
@akinaka_aki	unknown
@Camut90	org
@sophiefair	human
@marinQQ	human
@mahenrajan	unknown
@ShiviHotwani	human
@LaMirabelleJo	org
@saaya_jp	human
@TheKitchenGaily	human
@AustraliaZrii	human
@Reese22	human
@PeterStougaard	human
@Kayleigh_1991_	human
@ImranKureishi	human
@CreoleChantilly	human
@MFT_Battle_Fit	human
@itsadredogg	org
@carmelinamusic	human
@leehyunjae_	human
@ka_24	unknown
@GeleenMichaela	human
@zareena54	human
@SuperFoodYeah	org
@qulinaryapp	org
@BierMarktDonMil	human
@laNonnaPaperina	human
@HelpingHandsPre	human
@charismagold	human
@HorspoolFarm	unknown
@TayeHansberry	human
@GenaSeraitaRD	human
@JamiesFoodTube	org
@MillayTMA145	org
@BrunchNMunch	org
@ilove_avehmaria	unknown
@JCotterCraig	human
@loiddy	human
@LadyIshy	human
@historynpearls	human
@karlson_simon	human
@wallys_coffee	org
@FreddieFilipe	human
@Juni_NYC	org
@BAKEDBYBUTTRFLD	org
@thelocalbrand	org
@BrokenEggCafe	org
@jwalker1051	human
@CherriPisoot	human
@dmbieze	unknown
@rowenalagman	human
@Kirk_Lazarus609	human
@henny_wu80	human
@Charthye	human
@tim_un	human
@Macols	human
@JessSargent87	human
@Abipotimous	unknown
@RazzleFuck	human
@tsu_yopon	human
@KatieBrigstock	unknown
@orishavit	human
@mii_tmo	unknown
@KESFit	human
@Marc_Bastos	unknown
@thecubancamden	org
@4NSandbach	org
@HahnMade	human
@crimangel	org
@charlie5125	human
@EatDrinkSF	org
@BrainBalanceWF	human
@jess42508	human
@xSabrinaJonesx	human
@gonzalomartin19	human
@Borage_bistro	org
@agialek	human
@AllyCakes4	human
@dhariofficial	human
@d_sardine	human
@punkshouston	human
@elaineheng	human
@MrllFgr	human
@LasFuentesMG	org
@henkhaane	human
@freesoul1705	human
@Sophialovezxcs	unknown
@LianaLG	human
@NaseemMohdBasto	human
@JadduJhapi	human
@boppinalong	human
@CristinaLaRusso	human
@arihuniarto	human
@JackiLace	human
@giveawayblitz	unknown
@mellokitti	human
@Clairenright	human
@CheccoParolin	human
@JeeWPark	org
@edo011	org
@_kimcha_	human
@Gladvillian_	human
@ruthsaxon	human
@allpolkadotted	human
@anaabrahamhagar	human
@blazinpink	human
@ClaudiaRomani	org
@atomo	human
@VietnamCoracle	human
@Cinroro	human
@ShudddUppp	unknown
@FollowbackLaser	unknown
@lastminute_com	org
@mytabyeg	unknown
@AHandrehalim	human
@jidaiyasw412819	human
@LondonChaiparty	human
@dianabauman	human
@SuicidalSorrow	human
@government_info	unknown
@yourtownreigate	org
@TKWhisperer	human
@TheCarbonBar	org
@QUESECUECEENBCN	human
@MarieMusicM	human
@RenePaulT	unknown
@dave_verzosa	unknown
@wdelatorre	unknown
@__Taisiya__	human
@AndazAMS	org
@lovefromleyla	human
@EdwinNg93	human
@yoongkeats	org
@Maduhhleen	human
@MsLatina	human
@dj_tom_k	human
@Tee1990	human
@BristolRevs	org
@ZobelSeattle	org
@Kynski_	human
@PaigeDeyxx	unknown
@okanewa_kiiro	human
@TVProducerLady	human
@im_NujNuj	unknown
@AnthonyBowers5	human
@turiyen	unknown
@MrPesticcio	unknown
@PrymNotProper	org
@TheGersitow	human
@AmericanoLA	human
@Am_Charlie	org
@rk0l23	human
@rominaanzorena	human
@pandaknife	human
@marcgraellsv	human
@GetFoodGo	org
@chengyee89	human
@DopoEast	org
@syl_lee	human
@AuntieBooms	org
@Halibel14	org
@WoodthorpeComms	human
@SaveraPaneer	org
@kellyb00n	human
@iGarthWilliams	human
@CraziMomOf2Boys	human
@colby893	unknown
@subwaytyseley	org
@k_hanson	human
@BeautyDoll_Blog	human
@footballinit	human
@Mouthology101	unknown
@thewperry	human
@ZuccheroWH	human
@Spaniel01	human
@jonat108	human
@paperbk_reader	human
@ptnk05	human
@gruenervogelinb	human
@MassivelyEpic	org
@perezaleria	unknown
@KhamphoutS	human
@amazumdar	human
@SonnySpina	human
@CamilleTaylor34	human
@Slybugerdatsme	human
@evechaichua	human
@_balagii	human
@LilMama0086	human
@vertigo1337	human
@glutenfrittgott	human
@theKaliDiaries	human
@MrRicheRich	human
@tripsLONDON	org
@didiwija	human
@KatyBazooka	human
@ozhai_harianto	human
@MissSavage88	human
@ying_pathomrat	human
@tisonlyme143	human
@AddCooking	org
@JACOBCROOMS	human
@lisadonsn	human
@lrbloomberg	human
@krisFitt	human
@originaletika	human
@PublicFeedz	human
@PenguenGida	human
@NorthbankLondon	org
@w0nd3rL6nd	org
@ViktoriaBraylov	human
@WineTrvlFood	human
@istdailytours	human
@hnrsupply	org
@Phinntan	human
@chrstna_carrero	human
@community_buzz	human
@justsissidiana	human
@naturalfuelblog	human
@GoGoQuinoa	org
@Flanas	org
@Raguel1	human
@modernwife	human
@dadwithapan	org
@Indiana_May	unknown
@CareBass	human
@gomezhampton	org
@ABFlowersEvents	org
@ladychwadu	human
@TexasSass	human
@Systembuilt	human
@StRegisDoha	org
@PaternosterSq	org
@georgeweld	human
@eggcartonpdx	org
@sweetstacks	human
@Nathan708v	human
@earlslangley	org
@CallMeM00ham	human
@kandeliz809	human
@trish_erickson	human
@Bronzekissed	org
@TourOutaouais	human
@sandeep_r	org
@MattNewnhamZA	org
@womansneed1	org
@NeuvooHosPho	unknown
@fitness_caro	human
@Cervano_Garda	org
@beetlerica48	human
@ButtonsBetty	human
@THE_STEER	org
@balthazarlondon	org
@DevinCarnes	human
@gaurav_agrawall	human
@TheQ997	org
@flowerstbeats	human
@Njonk_angel	human
@asamixAKAchina	human
@BravoAlissa	human
@cloudbansal	human
@FiveStarPRZA	org
@Disgor_	human
@kazuyo_a	human
@golysucogacihy	human
@KarenTranSF	human
@medinacasa82	human
@charliecfm	human
@kate_t85	human
@Vonny_17	human
@Edinburgh4Lunch	org
@elleffsee	human
@ChineduAnarah	human
@Sistiana	human
@chrisbuff999	human
@BiteMeBtn	human
@ilzinja	human
@JoeJeanDaou	human
@j_a_j___	unknown
@AccommodatingU	org
@viwuhaqadezacy	human
@vitalafoods	human
@badeinrichtung	human
@JustIsFashion	unknown
@Kenvil_lzw	human
@BaconChronicle	org
@deejayjmoney	org
@mzlololo	human
@fitryfee3	human
@EatSmartScales	human
@HaloVeg	human
@YelpOC	org
@widyabestari	unknown
@HenryXavierJr	human
@padariabairro	human
@KitchenOnGeorge	org
@Tatumsmall	human
@SwedenFashion	org
@thiayufada	human
@PaddoFreshFoods	human
@jameskmaur859	org
@chinga2mother	human
@RedCarterSwim	human
@yadiroman06	org
@DaviosManhattan	human
@SANRAL_za	human
@berthityou0915	human
@Mplaehner	human
@ivyqistina	human
@primapastamiami	org
@NeopolSmokery	org
@HomerBushJr	org
@_Pellimore_	human
@MissANNiiEAnne	human
@FodderandPlonk	human
@emmalouiselayla	human
@BoyBelieber_Leo	unknown
@gedhe_seant	human
@apolisms	human
@Fashionexchang3	human
@coralmonster8	human
@sonipiano	human
@CaliforniaPrune	org
@sergiocorvacho	human
@selflogy	unknown
@TanyaPangalele	human
@millaananova	human
@BrenjCaballero	human
@BeaniesYogart	human
@iLOLARENAE	org
@NuarUmai	human
@alexkurban88	human
@CARLAJNC	human
@IMLAUNCHY	human
@valvacante	human
@fresh_fit_food	org
@awiscz	human
@Mitch_John573	human
@SweetSimpleMag	human
@lroxxl	human
@noriko_yo	org
@PerukePeriwig	org
@lifiaTubeHD	human
@PapasTacoHouse	org
@sarahs_recipe	human
@tintuin	human
@DeOrd23	unknown
@InstaKemerovo	human
@aphenix	human
@TheOakLoughton	human
@gingerandwhite	org
@CassieChanWK	human
@Sara_Monteverde	human
@SageCafeNY	org
@razzmann_v6	human
@FishHousePcola	org
@tinaxrf	human
@Aditi_DamonS	human
@akiryan_Nakao	unknown
@ShannaIsIn	org
@julia388	human
@Luchacartel	human
@hubrestaurant	human
@JoshiBieber6	human
@SebPerrinParis	human
@whitecamelia1	human
@ROCKSLV	org
@gilbertalfred91	human
@petitmerveilles	human
@angelaaagomez	human
@mrstailista	human
@lsdesignfirm	human
@dinnerbirds	org
@JerryKandouw	human
@heatherclaire69	unknown
@CharlesMcCool	human
@DoubleJ55321479	org
@BarimaPages	human
@manfred_gindu	human
@Cindjatheninja	unknown
@maebenot	org
@KimParkAan	human
@MSantiago146	unknown
@FarmKitchenBlog	org
@junkofukunaga	human
@SilverCreekCafe	org
@SheffieldLover	org
@Mireia_sv	human
@FreddieGator	human
@alohajuju	human
@2legs	org
@MummytoRawd	org
@yagreatreads	org
@hhky18429	human
@AUrbanik2	human
@TRy_tamora	human
@ChoiceCookbook	human
@ryantotspeaks	human
@maochinchin	human
@Maria62059631	human
@FishaJohari	human
@thereallordsosa	unknown
@Milkeean	human
@aamdadar	org
@Woman_Word	org
@dublinerpubdc	human
@degoez_darma	human
@Sharalee_Field	human
@MoogMeBooks	org
@BestofPortland	org
@timthomas_1	human
@feathermaye	human
@BlueAndBerries	human
@sellfish24	org
@umarkemilainen	unknown
@pypontocom	human
@ElektraButler	human
@VillaO_Dallas	org
@MiriumLo	human
@laurencejmb19	human
@foodierunnergrl	human
@Ons_Huisie	org
@labodegadetony	human
@KenDomik	human
@sharplystyled	human
@lillyandil	human
@100milemark	human
@tangibiliemoz	human
@WFMTamarac	human
@CaterinMnd	unknown
@savourthisktchn	org
@misa5114	unknown
@Shwetuni1	org
@SarahECarmona	human
@DraItzyPerez	human
@minadora10	human
@LitArtMagazine	human
@CervetecaLa	org
@carol_jana	human
@BecomingHome	org
@claudialuehrs	human
@kamishade	org
@lina_petkova	human
@atfoodnik	org
@burgercocktails	org
@Iamfitlass	human
@Chef_Amit	human
@CityHallMiami	human
@praktikhotels	org
@YaLLeY9	human
@mellsya84	human
@EarlsSandwiches	org
@bymeeni	human
@StephanieTucci	org
@CarrilleraP	human
@MMHASANOVEE	human
@talestrellis	org
@rika_kao	human
@Limor	human
@kazbahgroup	org
@Venisse06	human
@SARA_1128	human
@damnboredgirl	human
@ZulfiKamal	human
@Agoprime	human
@JumeirahBH	org
@waterlilyluna	human
@WeightLossATPA	unknown
@mylittlebrunch	unknown
@TheBenedictDiar	org
@DHealthyMama	org
@mistsandibrahim	unknown
@Miike510	unknown
@sivernetika	human
@SuzetteMumbai	org
@morgan_jody	human
@rorikop	human
@KitchnWhisperer	org
@louely696stupid	human
@lilmissnaga	org
@ttoshio	human
@coke405	human
@BrowneyeQte	human
@miizan	org
@marcelaugaz	human
@M__Abdulhadi	unknown
@SomEnStrand	human
@sowa_Boston	org
@KaeTharn	org
@asterisk66	human
@PerfumesCira	org
@gourmeturbano	human
@MJC1091	human
@I_am_Hoff	human
@Premier_Classe1	org
@RendezvousBN1	org
@elbuhomezcal	org
@83Rina	human
@your_ebbot	human
@4wholenessnet	org
@ReelFoodBytes	human
@grapetrotter	human
@danielle_cooks	human
@618mom23boys	human
@drinksatjoes	human
@Davidstreetgurl	human
@LadyDSM	human
@Ahu_Senturk	human
@SizeHealthy	human
@ErikaDLindsey	unknown
@ChowderSingh	human
@KokLiik	human
@CooleyKimble	human
@veronica_jean08	human
@xmart5	human
@bot04466388	unknown
@ohbuoyclub	org
@AlberghiMktg	org
@DoUKnowMandela	human
@CafeSqOne	org
@AllThingsRejet	human
@kaaeleem	human
@MagdalenasParty	human
@katie_cypher	org
@WEIYINGKAO	human
@timdelivery	human
@y7lifestyle	unknown
@nicolaxn	human
@theRealBethAnn	human
@DASHEDdelivery	org
@MacoQuebueno	human
@tomaikens	human
@california_hill	human
@NerdyMammaD	human
@dd_scotty	org
@DJOMEGAREDNY	human
@8AMAMA8	human
@primaswari	human
@melisadewi1303	human
@IndieRetailUSA	org
@MahirTheALLIGAT	org
@body_envy	org
@omoro_tubu	unknown
@Heather00211	human
@gaultmillauAU	org
@RealFoodDublin	org
@HollyBarber_	human
@tammington	human
@RLdulay	human
@MarcoTesta1	human
@ChristinaCaccia	human
@TyckledPhancy	org
@OrganicoBox	human
@E_Dub_a_licious	human
@DellavalleJoan	human
@gogenevieve	human
@RouxPtown	org
@QueenofSanity1	human
@JodyBrise	human
@OlivingstonTV	human
@Hattieflorey	human
@RestaurantRowFW	org
@mommyrunfaster	org
@TheRealC_Mar	human
@NickyofNUBIAMAG	human
@urbanfargo	org
@DennizEray	human
@PureGlamTV	human
@foodbyjonister	human
@HiSariiSlash	unknown
@ADupreeHealthy	human
@ElvinBernard	human
@The_Style_Era	human
@MikaelDemenge	human
@PunjabiRooh	human
@ambie	human
@5Dollartravel	org
@SafitriJa	human
@Shiivannii	human
@best_diet_tips	org
@C1015	unknown
@JustineAgnew	human
@elena_perotti	human
@mbhb64	human
@grazebristol	org
@w_nelishia	human
@KimberlyDepalma	human
@dk1210	human
@Xperten1	unknown
@BlueSky_Jkt	human
@junjuntivanny	human
@HotblackN1	unknown
@FredKiesche	human
@LeFrank12	human
@LiveShopLocal	human
@Badgurlrachiee	unknown
@RosieCuppaTea	human
@Kiewkoykan	human
@ksceviour	human
@TheLostPelican	org
@syuka0328	human
@NushNashar	human
@starheartly	human
@SaraCurti2	unknown
@jetpanes	human
@Ikhsan_Eysan	human
@BakesnBites	org
@MommyNoire	human
@doglover18256	org
@Sakura_Kuwait	unknown
@Shloobi	human
@hamptoncoffee	human
@GertrudeCBeggs	unknown
@azli_hussain	human
@livebmorelife	human
@emsrealfood	human
@patc_ee	human
@ldeguzmanpintor	org
@SNJToday	human
@bibliophile1211	human
@VegeriaTX	org
@memettaskiran	human
@JamiesItalianUK	human
@mingo_1	human
@Sinuhette	unknown
@dntPT	human
@TheAmala	human
@futurelifeza	org
@Dr_PeterMorgan	human
@mayerT13	unknown
@LordNeddard	human
@wonkywonderful	human
@DuoLook	org
@eMazingRoscoeVi	human
@nyororosketch	human
@laU_uUuU	org
@lpslzzl	human
@puretuts	human
@DornaGail	human
@TimEmir08	human
@janicelee_88	human
@WidyaMellowNver	human
@miss_k_roe	human
@tinakaos	human
@FeastExpress	org
@CurryCravings	org
@amodeisantoro	human
@djlilrye	human
@YogaSpiritCT	human
@TeddyBullyDC	human
@angelene3ac	human
@Parsnip_Pete	human
@CraftedOrlando	org
@CincyRefined	org
@KofyKat	unknown
@MercCounter	unknown
@muenue	human
@MsChanteMonique	human
@Kali_Butler	human
@Tracy_Iglesias	human
@fridachueca	human
@Spotburgers	org
@nyonyacooking	org
@Aquietplace4mom	human
@sloanethoughts	org
@nacchi0808	human
@QielaShukri	human
@bulthaupMayfair	human
@kaorihousearoma	unknown
@1029uuu	human
@karmahoop	human
@uriuh_	unknown
@karlita467	human
@istanbulCT1	org
@BOTStartup	org
@dedevily	human
@MrJonathanRudge	human
@FoodArtProject	org
@omorfi83	unknown
@ck_ward	human
@AkKi284	human
@a8co718	org
@FridayAustinLA	human
@Blackacrefarm	org
@HighStPhilly	human
@MattVaile	org
@Krankiescoffee	org
@avocaireland	org
@SchoolFamily	org
@Howardsfoodsadv	human
@ichacilik	human
@rellic21	human
@Yi_Yuanying	unknown
@leodimpo	human
@MelChisnall	human
@elNegroSantin	org
@LaurenHoldenx	human
@BriePYT	human
@Smexy_boy	human
@KMM1130	human
@Greenpagesng	human
@Namaku_Risa	human
@viriksondubai	human
@tentables	org
@Pedro_Jr	unknown
@ahkie_eze	human
@murph984	human
@alaxmeyers	human
@HealthyLiving20	human
@Sara22Mk	unknown
@nayuta_k	human
@CharityRowell	unknown
@missrtdaily	human
@maryetbailey	org
@MayasJams	human
@Moogles14	human
@SiNxxx36	unknown
@Naruren	human
@Fabietto2005	human
@bigbootyhero	human
@Cannonball1104	human
@B_CDS	human
@Arafauzi	human
@kenzylee18	human
@eatnativeuk	org
@ShrimpyMarkets	human
@ElAlma_ATX	org
@daice0716	human
@ChefRichSweed	human
@pieceof_cait	human
@FuckE1808633	human
@DisplacedTaiTai	human
@vintageabbie	human
@skinnyonemiko	human
@Francesca_Ceci	human
@Pele_Tang	org
@eonhiei	human
@ichbinmatthew	human
@teroangeria	human
@alexxrenee22	human
@chezsiva	human
@CaseyBrynes	human
@JustinEats	org
@ameliaraffa	human
@Its_Kashxx	human
@anjaliagarwal05	human
@CKPEP10	human
@Paradiesmaedchn	org
@WORLDSofFANTASY	human
@PaleoFoundation	human
@strawberikitkat	human
@SarahBlack21	human
@orbitalraver	org
@Denajulias	human
@Aborx	human
@callmejoelph	human
@eatveganfood	human
@liverightremedy	human
@CookerySchool	org
@pavlovaandcream	org
@vega_w	human
@Bub_Ble_	human
@liferoomstyle	human
@LeoTaTT1	human
@EaNnAs_heart	unknown
@mommemeals	org
@NatalieJFawkes	human
@MilesTable	org
@masterbuildUK	org
@windridgeyachts	org
@CubicBar	org
@Docpip0	human
@JoeyBaseballsNY	human
@natashy_nicole	org
@gReeNMagIC72189	human
@doughmydear	human
@amirafeelmatba5	human
@JevanE33	org
@br_team	unknown
@Bonton_Palace	human
@AIREST	unknown
@apogor71	human
@OurKnightLife	human
@mmarksshih	unknown
@FullBustPerspec	unknown
@th3hungrycat	org
@Priyaal08	human
@Stella_JiaXin	human
@RADDCard	org
@ba_marshall	human
@Vintuitive	org
@west_losangeles	human
@JanTweetTweets	org
@reviewsbypink	org
@kbrly	human
@pastrykingz	human
@astaicer	human
@ActivityWorks	human
@Wikideals_SA	org
@crazygingerlady	human
@CaraM45	org
@SurreyvsLondon	human
@jonesUAE	org
@hollymoebus	human
@bambinaoko	human
@Linewinder	human
@MasalaboxInc	org
@sassyjudy04	human
@Pangpunkster	human
@Lace_up_Lottie	unknown
@kathes	human
@goldfishpka	human
@agilsonvalle	human
@UrbanListBNE	org
@KeVnGroup	human
@andrecarvalhoo	human
@loveethewayy	human
@kybecca	org
@EntrePuesFusion	org
@missoandfriends	human
@MadamCharlott	unknown
@Gullithedoc	unknown
@TheLocalPuzzle	human
@0702cheeks	unknown
@littlegoldbook_	human
@BonnieBoox	human
@lilo2387_lianne	human
@macymagpayo	human
@TechCrowdfund	human
@gracefullady01	unknown
@POCDining	org
@Justmurrayed	human
@SmoothieKingAU	org
@parc19	human
@loconsoho	org
@okinawanladyyy	unknown
@MimiBakerMN	human
@ligayan	org
@pinkistarfish74	human
@rolysbistro	org
@Adaveable	human
@QueensBarPE	org
@AlejandroMery	human
@cancerpadilla	human
@kruszynkaaa91	human
@Nansupranata	human
@Sushi_BoardsNet	org
@bennthie	human
@RUEats	org
@BurgerBBQ	org
@eatatchow	org
@Blendtec	org
@ilovechizzz	human
@Wedgwood_UK	org
@EnekaMarini	human
@xiaoopocarii	human
@CeCeesBoutique	org
@Puggy_Wuggy	org
@sixmilechick	human
@JeffreyBezore	human
@queen_schultz97	org
@exjsb91s	unknown
@bsii	human
@WuLaN182	human
@pumza_m	human
@drinknyc	org
@Keith_J_James	human
@mikkunbsk101897	human
@bluestarfoodie	org
@erikapels	human
@ikrammuzammil	human
@Silas0894	human
@DIFC	human
@Thenewsagent	human
@BarArgos	human
@TweetieKaz	human
@bustagp	human
@ThierryLasVegas	human
@Idodidid	human
@killeveryth1ng	human
@pastryismybf	human
@MiamiBakehouse	org
@stylishot	org
@societefair	org
@BarCavallino	human
@JodyAllen_SAHM	human
@FourSeasonsPR	org
@aawhitehead	human
@haeismylife	org
@NonnasCucina	org
@KokoDidie_	human
@sugarandgarlic	org
@LancierEvo007	human
@TonyGist	human
@BioFares	human
@sitisabri	human
@duffitness	human
@kumebryant	human
@rossaSinTabu	org
@blogginggals	org
@sourceDsAlvaged	human
@ShaymaFawwaz	org
@ralphguzman	human
@makingmewonder	human
@RubyRedApron	human
@choirhuda	org
@CastonChris	human
@RobertRoseBooks	org
@DonnybrookD4	org
@HellyLN	unknown
@anaalicia99	human
@WADAARISA	human
@BetsyJoye	human
@kwtalent1	human
@Lee_dvd	human
@JewelrySeaside1	human
@LoliLiebana	human
@MyFancyPantry	org
@Laavasmom	unknown
@Poojipants	human
@Espada7x	human
@BACDA104	human
@fiona_schubert	human
@Lunaphrea	unknown
@Eurosuites	org
@yoanflodemencia	human
@rachelcottone80	org
@angelocampione	human
@dbBrasserie	org
@renai_hj3Sk	unknown
@ClaireKlara3	human
@denatheexplorer	human
@KelleyFoulk	human
@angiemary65	human
@wholesomehunter	human
@oyenlourentz	human
@north_stargirl	unknown
@ytchie_cherille	human
@FancyClancy14	human
@CampUpstairs	org
@GoldilocksCie	human
@FoodMeParis	org
@kc_shoeQUEEN	unknown
@Ofelien	human
@SONOMADR	human
@a_kaoru21	human
@crumbycupcake	org
@MCRcars	org
@thorpus	org
@AKitchenHoor	human
@CamTourGuide	human
@asugarycloud	human
@MizAly89	unknown
@HaugeKarina	human
@ilonaspassion	human
@ThePieGirl956	org
@modelsocietyint	human
@tanyaybanez	human
@uyanua	human
@beaNerbuG4	human
@forkb0mb0t	unknown
@Denise_Wint	human
@CharmagneRamos	human
@LansonLoyalty	org
@markallanhoppus	human
@frecklequeen45	human
@Memelys	unknown
@M_A_Haley	human
@xPoshFittie_96	human
@Maya_Today	human
@sonicdjc	human
@tellmeybnormal	human
@KelvinSim93	human
@NaturalGrocers	org
@josperchef	human
@aliyc	human
@ReySukma	unknown
@dikLa_V	human
@DVC_of_SCV	org
@farzan81	human
@MagaLiiiiB	human
@HYPEmonstar	human
@betbetxuhuiling	human
@20Somethingrl	human
@JohnBrentCawil	unknown
@marcellvaswegen	human
@TosynBucknor	human
@KevinJohansNYC	human
@JoanneLReynolds	unknown
@toricorona	unknown
@KjManami	human
@Homestead4Honey	human
@GlenmoreInn	org
@HeeLsInABubBle	human
@adits06	org
@HaltomHoffbrau	org
@umbertagentile	human
@SultanFaresMF	unknown
@tweetFCL	org
@AshliLynette	human
@EviiiieB	org
@ABeautyMoment	human
@CamiFraschini	org
@XTREEMTRAINING	human
@romynakach	human
@ma_adventures	org
@OfficialYasminO	human
@joelrgluck	human
@richardwalkers	org
@Xlines	human
@commissaryLA	human
@marialetizianal	human
@FoodLix	org
@Style_Chameleon	human
@ms_ling_69	human
@sebnem_kutlu	human
@bullets_bacon	human
@VeestroFood	org
@MyRoyalConfetti	human
@sixcherries	human
@Superminilau	unknown
@alicep311	human
@_Pirate_News	human
@larazeaiter	human
@podyumparkbursa	human
@Jijie13	human
@SarahSammut12	human
@HeatherDReese	human
@milandilicious	unknown
@ohmyjayonabike	human
@PluzDivaRenee	human
@cd_trigueros	unknown
@Cafe157Matthews	human
@stylishldliving	human
@CulDelBristol	org
@TheCurryGirls	org
@tinsnipscissors	human
@clontwo	human
@koraliedw	human
@BiPolarFitness	unknown
@epaulnet	human
@VeroniqueTT1	human
@tiogadowns	org
@porc_belli	human
@leochiro	human
@Justshootmefoto	human
@ClariceQii	human
@davidepuglisi_	org
@TapGenes	org
@Jewish24	human
@ONEBalHarbour	unknown
@Searrabby	org
@jbg77	human
@IrinaWardas	human
@OedoCollection	org
@StefanoTerrani	human
@thebagushadi	org
@Sabia786	human
@houseofstef	human
@tripsLA	unknown
@Diane3316666	human
@LiveSushi	human
@gloriachin	human
@blndgrlcravings	human
@BeataBea	human
@77Moms	org
@laudue	human
@cocoinkitchen	org
@HotelGranViaBCN	org
@the_moviegirl	human
@psalm911lisa	human
@SantiTts	human
@location415	human
@wina108	org
@MissusSpunge	human
@ReynoldSetiadi	human
@Mon7que	human
@SaraLulliaBudro	human
@JessicaMDowning	human
@MrJohanTorres	human
@tiara311hime	human
@NHollenbo	human
@MetroHooligan	human
@findfoodrecipes	org
@crave_news	human
@RoraBorieAlice	human
@lizventuresblog	human
@jkgilpin	human
@lilthingscorner	human
@atw80musicvideo	org
@Hoppalicious	org
@MilanoGourmet	human
@Maria_C_Redmond	human
@kabobcurry	human
@Finds2Share	human
@LimzSteven	human
@DosPerros200	human
@rebeccadru	human
@cassie_teshima	human
@fabulous_n18	unknown
@GMoingul	human
@BrandonMondido	human
@PrimoGiftCards	org
@TweetToTina	human
@Snigerals	human
@Casabe305Bistro	org
@RedBLB	human
@nothmngwysspain	human
@LoneStar_Camb	org
@lorileiwe	human
@irvan_talk	human
@Remodeling_Dude	human
@ErikaTamaura	human
@BagatellaCC	human
@rebeccahartz	human
@FeFeNicole1	human
@barebearz	org
@FrenchyGoLucky	human
@oliviarennylda	human
@viviontokki	human
@ericamarie3	human
@fabglance1	human
@theWesQuikshow	human
@Doctor_Deena	human
@ValeFacchinetti	org
@missionburritos	org
@glenys_allison	human
@monicasent	human
@CrunchyHotMama	human
@m_1_y	unknown
@LaCuinaGdl	human
@BenInMankato	unknown
@sekararumw	human
@SusannaValacchi	human
@SeriousSauce	human
@sweetsdiary	human
@kristatrotter	org
@Tomyname	org
@KaiQiiii	human
@MsLorenGeorge	human
@countryinns	org
@_aneb	human
@goalie1998	human
@jyothijagadish	human
@DrifterPlanet	human
@ChewonthisSTL	human
@PipasDay	unknown
@CAVUKitchenBar	org
@ManaTakai	human
@RestoCazau	org
@TheFoodClick	unknown
@TheSpiceClub	org
@AshlenBurns	org
@Aundrea_Lacy	human
@TATESCHOOLFIT	org
@nmarcano3	human
@stivCONNECTED	org
@TomWestcott	human
@YeongXing	unknown
@IndiaCIS	org
@Harry_Yuni	org
@TenaroR	unknown
@kahmanbossie	human
@ThemBonesMelb	org
@luluontherun	human
@sonyachodry	unknown
@810bianca	unknown
@HeltinhoLima1	org
@smcitydavao	org
@HyojinCH91	org
@abunviersaldjs	human
@kitchenpops	human
@Wilmer_45	unknown
@mypi_milo	human
@IQmomblogg	human
@AnonMusician	unknown
@lobsterkitchen	org
@victoria_rt	human
@sb3lucid	human
@MichaelFoods	org
@MissFitzNYC	human
@janat_official	human
@AhWeng93	org
@news_donatella	human
@PrestonMorganD	org
@euniyunjae	unknown
@AnnabellePerez0	human
@Tripngo	human
@brasilbykilo	human
@antdesigner78	human
@mellysocks	human
@LilblackdAKing	human
@labellapetite	unknown
@djmarkobie	human
@SNaffati	human
@BearyBren	unknown
@CaresaResa	human
@RespectTheView	human
@adeline94_tan	human
@Laurenb_France	human
@movingpro	org
@DyneRbles	human
@Lilue78	human
@lamichoacana301	human
@ulrikkelocke	human
@imago_mundi	human
@deanasaechang	human
@AaronLoveJude	org
@ElizabethMinett	human
@mvanec	org
@MixItandStixIt	org
@HorsinAroundDel	human
@BrandoBistrot	org
@yokaruu	human
@DFGrillePlano	org
@1chefdiva	human
@TrulyScrummy1	org
@FoodTastic	org
@rachist	unknown
@menaej	human
@cmhabits	human
@Jamezy33	human
@OWB_MMG	unknown
@madamegautier	human
@RowenaAngeles1	human
@Daniel7Medicine	human
@andyelliottpt	human
@bistro1682	org
@InCucinaConVale	unknown
@laViennaTM	human
@cookitpretty	human
@TheBonneville1	human
@ANNIE_viv	human
@kingthegwaping	org
@christinewilla_	human
@Illa827	human
@thewinepark	human
@FollowbackWhite	unknown
@Itona_jude	human
@__JaneOfficial	human
@BMCMartins	human
@SharmaRoger	unknown
@lynnlly	human
@Hybreeds_link	unknown
@YARD_CT	org
@leidicamp	human
@fashion1988t	human
@bbarnes3489	human
@AML_WorldWide	human
@fill14sketchbk	human
@mammac30	human
@maryam_1812	human
@albin4ic	human
@ira_jayline	human
@RedstoneGAH	human
@disisd	human
@ARTnHOOTERVILLE	human
@GiannaAguero	unknown
@nakd	org
@senorita_fresa	unknown
@dp_rahardjo	human
@JohannaTanno	human
@BoukjeSmit	human
@AdrianoMendes75	human
@dansanteman	human
@AmisTrattoria	human
@LadyProducHer	human
@caplerkim	human
@MaxJuhasz	human
@caitlynhill28	unknown
@FashionBlog_amm	unknown
@jbromwell	human
@jocynglim	human
@jacqueaeiouh	human
@hmscat13	human
@LaDescarriadaV	human
@haozhang188	unknown
@TootingMarket	human
@gheypartnerFTW	human
@KalocziJaclyn	human
@Banialnajjar	human
@itsjashnotjosh	human
@kayla_itsines	human
@SalvadorenoAZ	org
@_GOOLP_	human
@syedhazq	human
@C_Mar_TEEN	human
@femicorazon	human
@ToastCafeFans	unknown
@seanverchick	human
@WAFIMall	human
@Thelmablanco	human
@VlaamschBrood	human
@klynn928	human
@The_Fat_Belly	unknown
@Lost_Cafe	human
@AsmaKhanCooks	org
@GloriosoSLBApp	org
@naojkenshin	human
@Kriss_36	unknown
@reggiculous	human
@aledesiena	human
@Rossi82Ilaria	human
@cats13me	human
@KasKryst	human
@WVirginiaSent	human
@deladestiann	human
@TheVillageMM	human
@ArtisanFoods14	org
@marina_thomas26	human
@EdmondsonWin	human
@JDBalanay	human
@huiseetan	human
@dedy_sw	human
@CLylez	human
@CecesGoodStuff	human
@GA_Knight	org
@SimonSaysCook	human
@ALUCARD827	human
@beanbagfoodcart	human
@Tooh_Two	human
@CafeYnez	org
@BodyByMichaelG	human
@k_lau92	human
@himachi_cafe	unknown
@papirodrigo	human
@amundenovskiy	human
@bigtrinity_	unknown
@Jenna_RDN	human
@HealthyJFGirlie	unknown
@pj_sincebirth	human
@Meeschu_	human
@inPALEMBANGcity	org
@BalancedBrunett	unknown
@RAIDEN072	human
@la_agorera	human
@Mikyasuke	unknown
@travelfoodblog1	human
@Milestones_STC	org
@dutchplaces	org
@ATL_ClassAChic	human
@lionelrosso	human
@RedaElAouane	human
@AenimusFredrik	human
@pelin77	human
@Whiting_Hammond	human
@kittupari31	human
@stefanianascimb	human
@ChipsSW	human
@chefromeomc	human
@iomaemwa	human
@fatima_um3li	human
@burrp	org
@EatAustinMENU	org
@jlmckinney1982	human
@345CaffeItal	org
@cakebyc	human
@jasontroj	human
@kelsykao	human
@ewdzi	human
@douglasgoh	human
@JCumminsgroup	unknown
@itsheathaaah	unknown
@PriyaJaquline	unknown
@The_CakeLounge	org
@sarahberneche	human
@LasPalomasATX	org
@JenniferCadiz	human
@michaeldube74	human
@IamCiVil	human
@MaNsOoR1982	human
@nelsonjameson	org
@iAnAdevA07	human
@flexprogress	org
@FadhilahS	human
@be__styled	human
@ClauGutRod19	human
@LilyLopezR	human
@CherineAdelRizk	unknown
@BullatBenenden	org
@khaxestudios	human
@KNMEYERS11	human
@hippiebutter	org
@Harvest_PHL	human
@mealku	human
@isjdoro	org
@chikako121122	org
@MC7Donna	human
@DailyLeisures	org
@fabulousnana	human
@DaBlauw	human
@nwlywdscookbook	org
@bellyphunk	human
@punyarodeo	human
@AdamMohamad8	human
@MauritiusFoods	org
@Joel_A_Mitchell	human
@hmk0712	human
@BeluTMPR	unknown
@sherylcuchapin	human
@museprincess	human
@an63liQ	org
@KimLou_official	human
@ispaydiman	human
@weasellulu	human
@THESHOPNW10	human
@tastynsons	org
@J2meePok	org
@chocbunnyjs	human
@tsarinevanya	human
@orlandoguides	human
@shoegal_84	human
@LorilLucas	human
@CampusClipper	human
@wildfreshntasty	human
@MNPSChefRebecca	human
@cynthiaaaq	unknown
@maryjessicago	human
@isjustANDY	human
@overthemoonbc	org
@LethbridgeEvent	org
@Christo14280034	unknown
@drebmann	human
@KathleenIrena	human
@marian_cassin	human
@suppysuppy	human
@etiennejazz	human
@CircleKArabia	human
@lauriegannon	human
@M_Fashions_eBay	unknown
@McCutieLovesU	human
@benemariotti	human
@BATsLife	human
@PichetDublin	org
@SalumeriaW10	human
@TONEEHAMMER	human
@getbakedct	org
@Maipu_xoxo	human
@A2ZSocialDesign	org
@PetraCostandi	org
@eddiesplaceclt	org
@newoki	human
@jessagift	human
@BiagioRistorant	org
@sayitrahshay	human
@lulycastiglioni	human
@SalvaPradoVigo	human
@kizzykim	human
@talldoll_ohlala	human
@chipsnsoysauce	human
@CherlynAurora	human
@inaktatau	org
@Travel4Seniors	org
@leijudy	human
@ishysrubberduck	human
@freestylesteve	human
@chelsiepoo	human
@MomMostTraveled	human
@SammyOMatic	human
@sszoha	human
@aeolian817	human
@eatdrinktravels	org
@CG08	unknown
@bypladies	human
@MatthewKatakis	unknown
@yuukarijkpop	human
@sunwoh	human
@salivacommandos	human
@westartariot	human
@Pocahontas1106	human
@SophiaR06732348	human
@LaunchyMusic	human
@Tamara_Gibson	human
@BasheleDj	human
@eggsypony	human
@jacquelinehadel	human
@MissXoxolat	human
@djikon808	human
@thembafayisa	human
@ENovicio	human
@bombaystfoodto	org
@tupeloeventz	human
@BfastRecipes	human
@LauraFalin	human
@JBG_rosario	human
@marcomborromeo	human
@Australia_RT	unknown
@fordycefarm	org
@NaturesNurture	human
@TreySierra	human
@sinapples	human
@Reclametweetz	unknown
@Nunnsy	human
@JenZino13	human
@puikeong	human
@JLanderos80	human
@KarenImperial	human
@jayceemendoza	human
@T0nedandFit	unknown
@mEiTy_xLiPs	org
@katevillanera	unknown
@braylonwarr	human
@totsuka_bc_bot1	unknown
@FlawedSuz	human
@levinefoxevents	human
@PogFroyo	org
@iDesignMe_news	human
@ambrosioscater	org
@cluckyhen0	human
@Graphicrez	human
@fudatzkee	human
@byzame	human
@bobstiles1	org
@wicked_kayeen	human
@RockstarEmperor	human
@IthamarisRivera	human
@UrbanHopperz	org
@mansionsonfifth	org
@m_mauki	unknown
@debsumikolee	org
@key_genius	org
@SirPorkaLot	human
@Melinuschka	unknown
@snapdragon_paul	human
@PresleyStClaire	human
@Chris_Chaffin68	human
@VickyToriaLi	human
@TavernNashville	org
@pamelamaynard	human
@OccidentalGrill	org
@coupdetatmpls	org
@Deeanthony_GOES	human
@gygkarting	human
@RafflesFood	org
@ruINla	human
@thatsalsalady	org
@andreas_travel	human
@PhoenixVicSW1	org
@dineLA	org
@PaolaEM	human
@GellaiNael	unknown
@Snakku	org
@eileen_loo	human
@barbiesway	org
@abeke_echalier	unknown
@jessiemedina77	human
@infeedsblog	human
@JulysVeryOwnXO	human
@PaulFromFox5	human
@etcProspero	human
@MelHagg	human
@GayaArtCafe	human
@Felixchung628	human
@vickygibbens	human
@only1missdeana	human
@SohamShoney	human
@oxanamua	unknown
@basildon_hour	human
@dailyjoinupdots	org
@Anomaly617	org
@Talesfrombefore	human
@MISSINGMARMITE	human
@ice_embalsado	human
@IlianaProject	human
@wrapwithdebbie	org
@Chowki_co	org
@phatimasBox	human
@HealthFit_Boss	human
@MrsKarmy	unknown
@i_magnolia	human
@aliishen	human
@wigginstock	human
@sulema_best	human
@CallMeJegs	human
@WGTDCardiff	org
@seoulcialite	human
@heroidoasfalto	human
@sexyitaliana	human
@michnyaaniko	human
@Msdon	human
@StaceyBoccuzzio	org
@MyBeeArticles	human
@ConradNewYork	org
@kikaytrekkie	org
@sweetlyvip	human
@bumpandhustle	human
@RaYeBrAnDy	human
@josey_killah	human
@YourCoworkSpace	unknown
@faatiin89	human
@mzjerzey201	human
@CarsonSolution	org
@krlajurado	human
@FLFLS	human
@bobby_f28	human
@JuSoraia85	human
@sugiyama_benji	human
@KylaWinchester	human
@_Artistryfi_	unknown
@_thisisantwerp_	human
@Vikki3040	human
@14cruiff14	human
@_xiaohu_	human
@gonnaeatthat	org
@theveganduchess	human
@jjin__world	human
@FoodiesofIndia	human
@heyelza	human
@Kittencat519	human
@_angelica2S	human
@ChoosyEaters	org
@AriadnesThread_	human
@EVELYNepin	human
@thebunnychow	human
@dexterbalita	human
@inspiralled	org
@Mn9oorAlnoman	human
@memarkyb	org
@ElideOrtega	unknown
@MenorcaRetreat	human
@FelixPColon	human
@Eetgoed_Blog	human
@JezzieMandrake	unknown
@rouxtoronto	org
@greenbenchcafe	org
@chiarapifashion	human
@aireneecyaa	unknown
@FittieFighter1	human
@lordLDX	human
@donkearbour	human
@laurilory	human
@rene_ames	human
@rickya781	human
@OgeeEverett	human
@cjammet	human
@Chicano_McGyver	human
@AG_onecall	human
@surinofthailand	human
@ag_access	human
@fitchick428	human
@Kelvinphoto	human
@lanarimane	human
@JMorrisonLuv13	unknown
@CarlineRichmond	human
@JessJanksA	human
@persicafe	human
@ecocibiamo	human
@kuronyanko32	human
@GloseFr	org
@MWnaturelixir	human
@dek_noi_555	human
@meganebrooks	human
@LifalethuK	human
@fyrho	human
@johannyoon	human
@Melih_Soykan	unknown
@EunjeongXoo7	human
@NY_0019	human
@aliving	human
@ashleyjenna	human
@RonnieRMiller	human
@VJndel	human
@Tendeals	org
@jessic2903	human
@MiraWinery	org
@Nkazii	human
@chrisrosam	human
@CCindywu94	org
@ritaweets	human
@Une__Peche	org
@SimmoneSquires	human
@ArmeniQueen	human
@alancappelli	human
@ESLCarnival	org
@IMMaFREaKYaZMaN	human
@MindWealthRadio	human
@AyumiOde	unknown
@JessiMinchincon	human
@carlosarias82	human
@momwifefoodie	human
@FaraSaje	unknown
@CaraKeith17	unknown
@HanZhenEr	unknown
@saleh20091619	human
@callmedanibeth	human
@Christiewriting	org
@kenseto	human
@Careeenlong	human
@Brokenyolkoc	org
@skibootskitchen	human
@CarlosHTR21	human
@gakushinoda	human
@hattadolmatHDC	human
@TamseyT	human
@KEHIN_MODEL	org
@rochelleata	org
@MichiTorresC	human
@orangezestnc	human
@cesttoutbon2eat	org
@MennoTabbernal	human
@goodforkredhook	org
@karandevika	human
@BrunsKitchen	org
@mrairemout	human
@springorleans	org
@ACETHATNINJA	human
@ChefHope1	human
@TightenToneWrap	human
@marianatjoe	human
@boutique_rooms	org
@Tico_DC	org
@flower_snow	human
@Saeki_kun	human
@213kanapyon	unknown
@Rheinany	unknown
@Balkon3	org
@Kalicooking	org
@Sheraton_Sharm	human
@marsellina	human
@AllFashionBot	unknown
@Nikenho	human
@nhiea_sanjaya	human
@BrazilianBoston	human
@how_raymond	human
@ashley_dejong	human
@Gastronerdy	human
@GoldenCorralRoc	org
@GraceAshaye77	human
@LuckyLunaNY	human
@iamjoshalcaraz	human
@Fight_Owl	human
@ClubsGalore	org
@mikolai	org
@cellenna86	human
@bloglabarracuda	human
@VijiSadhana	unknown
@Vanessss4	unknown
@BespokeCurry	org
@Courtybear96	human
@birddogellie	human
@djlively55	human
@rindakoban	human
@618_btownrep	human
@dithjoyce	unknown
@SophiaThomas52	human
@eazydiner	org
@khusnatika	unknown
@jocejocelyn	human
@AmandaRean	human
@MrJesensky	org
@tatsumi68	human
@ivibz	human
@Duffus25	human
@cinetiKFit	human
@Pippy_la_rue	human
@Revive_Hope	org
@sylviann60	human
@BeerTourUSA	human
@SisSunshineTV	human
@anggaabigel	human
@DicksFoodCourt	human
@ChaletT5	unknown
@lisicious	human
@unitedcakedom	human
@Cooneyis	human
@fikakensington	org
@Lumilumss	org
@NLFireFighter	human
@janice851111	human
@planetbox	human
@DaniMaslandRD	human
@SlMPLYDANA	unknown
@Legally_Josh	human
@PaulinaMassone	human
@AviVazhenina	unknown
@yanagram139	unknown
@koipage_L	unknown
@SixxFeva	human
@CharmCityEdible	human
@themummyblogger	unknown
@irairoo	human
@NeilJeffree	org
@kateeslaban	human
@actsofsweetness	unknown
@CEngelgreen	human
@BabyAcapulco	human
@LDOTCDOT	human
@Afick_ERA	unknown
@Jaynie84	human
@HoltLodgeHotel	org
@StlPazzo	unknown
@81andSunny	human
@hennyseroeyen	human
@AlexisFloresE	org
@NancysBuckhead	human
@tsuru711	unknown
@gilbertvsgallo	human
@jlfoodie	unknown
@MarkLipinski	org
@BeeJustice	human
@DrAnneline	org
@TheCocoShow2011	human
@henniehigh	human
@GourvyHeffley	unknown
@ForPastaLovers	org
@high5bigbear	human
@lluis1966	human
@elmonara	human
@Dawg222Jamie	org
@CharlyScobar	org
@momopiyo333	human
@trekvero	human
@avalenz82	human
@TorMartina	human
@Rafagardus	human
@ronaldo1ro	human
@EvanFLIINation	human
@LittleNick23	human
@TheTeaRoomsN16	org
@dhernandeztv	human
@food_byte	unknown
@Cupcakes_Co	org
@xxcm_	human
@amylam117	human
@AlexPearl24	human
@GladysDeblois65	human
@MaritzaVanrooi	human
@Prisonworld	unknown
@AnniceGuilboard	org
@PayneTrainsIL	human
@lilbitty78	human
@marikokoloco	human
@luiANDlurix	human
@lukemelia01	human
@hotbeachspots	org
@sarahdanielleph	unknown
@Elda584	human
@Tom_Ford41	human
@HustleAndKale	human
@burrp_mumbai	unknown
@scenesfromcali	human
@DBA_Turkey	human
@nacotatata	human
@willsonhere	human
@joespizzait	human
@iSouthampton	human
@KwaaiBoyJ	unknown
@d1_flooring	human
@uselesssreptile	human
@Elvis_Orlove	human
@JediMuzik	human
@areocat	human
@xaveriuscello	human
@diomedes66	human
@18_HOT_18	human
@aninininini	human
@Hymbeer	human
@LansdownePlace	org
@DjBobbyQuest	human
@shokotaaan0709	unknown
@ForbesInspector	org
@danielbautista	human
@TheLushList	org
@beautytips1388	human
@HURWUNDEKI_LDN	org
@DancingYoghurt	org
@CSR_RT	org
@MissSueFlay	org
@Foodable	org
@andyconca	human
@keyingredients1	human
@utaminovia	human
@musicdiary	human
@erikhana	human
@Proudandmom	human
@GoodStuffNW	human
@CosyClubExeter	org
@JohncitoFPeraza	unknown
@DaaniM	human
@DinaMariaWeiler	human
@SUSHIGROOVE	org
@Amitguptaooh	human
@Flawlessvip	human
@enirothenclif	human
@adilsongimenes	org
@AdamFeroz	unknown
@LostFactoryGirl	unknown
@JaclynGitlin	org
@imyourjc	human
@ayyuquna	human
@ellouellou	human
@HawaiiLoverUSA	human
@AngelTope24	human
@LetMeEatCake	human
@monsieurzab	unknown
@stentless	unknown
@HeartArtsnCraft	human
@dannicastillo	human
@enaxkie	unknown
@ViognierChef	org
@ashleyrachellep	human
@Drkillson	human
@katshotcakes	human
@olymposcafebar	human
@hotvideode	human
@nomsnyuswa	human
@KayraVelez	unknown
@BrunchWTheBoys	org
@RealGreekTweet	org
@CorinthianClub	org
@nousrestaurant	human
@the_real_kat	human
@ShepherdGeorgie	human
@HMSHomeWarranty	org
@3DBillionaire	human
@L1ghtweight	org
@Lincantalk	human
@Table4MEUAE	org
@loavesanddishes	org
@Twoheys	org
@thebizlocal	human
@FarleyEdward2	unknown
@MalayVillage	org
@tiramisu8	human
@MimosaWayne	org
@maryadams20	human
@_kamchacha	human
@Anastasiya_R	human
@HostAndy	human
@tiff_gonzalez22	org
@SpiceHamilton	human
@HimHarshaw	human
@midnight_plue	human
@HealthEasier	org
@5hahh	human
@KouzinaChristos	org
@LAStory	human
@TroyOrem	human
@spanishhomemade	org
@Wisconsin_Dells	org
@LisaRCharles	human
@Crisderella	human
@Shahril_Wokay2	human
@claytonderby	human
@Iusetobeu	human
@NRJLebanon	org
@MsHfk	human
@permatacintaku	human
@emerson20798	human
@sveback	org
@DarylLea92	human
@ChrissyCastillo	unknown
@missk28	human
@ChristineLai604	human
@irracpsychee	human
@crabtavern	human
@McAlistersDeli	human
@DKolaches	human
@msirinagonzalez	org
@AliceTiezzi	human
@BrookstreetOtt	org
@ClicknChop	org
@lbrubens1	human
@rhyantaw	human
@ChampagneNYLA	org
@zieluvista	human
@WorcesterHour	human
@ReadToKnowHim	org
@TheButchersSon	org
@duanejealousy	human
@brisajserrano	unknown
@BocaEvents	human
@hello_olivia	human
@familyvacayus	org
@Manchego_Cheese	org
@latinamomdotme	org
@SarahEatsOmaha	human
@BoathouseBC	human
@LanceSnacks	org
@RileyBeers	human
@MorockinChef	org
@Ginge7x	human
@rganicaGuate	human
@akc1970	org
@kie_rizky22	unknown
@Da1Brownhornet	human
@nihonluver	human
@1chef1river	org
@Populayer	human
@Joel_K_Kramer	human
@WilliamHolding	org
@charisetu	human
@DaveVise	unknown
@belledale	human
@JohnnyDs	org
@ktacoocojp	human
@Jebbica	human
@Drummergal90	human
@arieparikesit	human
@teh_tarik	human
@laurasweet5	unknown
@Chiara_Laudani	human
@komenkansascity	org
@izagxx	human
@JennaPrice	org
@TMoughal	human
@2tk1z126	unknown
@MILIUS_M_S	human
@obnoxiousSMT	unknown
@norttigurl	org
@nomidesu	human
@ms_m87	human
@MyOregonLife	human
@Fuuu3xxx	unknown
@Artondra	human
@AlvinMoMo	human
@GimmieSumMo72	unknown
@IllegalBakery	human
@30droppingloads	human
@tiopwn	org
@officeyoga4u	human
@renZafarina	human
@MSM_Lynx	unknown
@cheftrevino	org
@Butterballfs	org
@Jason52974Jason	human
@Anchi46	human
@maikhun0208	human
@anjhotmama	human
@amandamaryperry	human
@py0nai	human
@SRGCREATIVE	org
@CleetTweet	human
@getfitwitjoanna	human
@broodjeFrank	human
@_fanchoco	human
@LBBDelhi	human
@CocinaCondesa	human
@Bethany_20	human
@COSCFO	org
@NoDietsAllowed	org
@Que_anna	unknown
@CocoMike27	human
@LisaSchokokitty	human
@ho_weekim	human
@BriarLevay	human
@sagespoonfuls	org
@mypurplespoon	human
@starrdazz	human
@InstaNskAkadem	human
@rachnayyar	human
@abemora1	human
@yanaforte	human
@GabbyPizzi	human
@ayie_dewi	unknown
@_CarmenHarrison	unknown
@lifehousespa	human
@Chef_Derek	human
@pdouble	human
@PoshtoGanache	human
@gracieopulanza	human
@Indiapreneuress	unknown
@shellyVpalmer	human
@iSennie	human
@Thebrainky	human
@RodrigoMartin28	human
@sugarlaura22	human
@itsxtiancapuyan	human
@AlgarHarry	unknown
@maaayuko	human
@JessieJess1986	human
@Sergay81	unknown
@PaolaStyleBlog	human
@IndriaMaria	human
@DownRoyalPark	org
@JIMDETHOMAS	human
@thisismonx	org
@kozyfreeman	human
@GalwayHour	org
@Chef_Jenn	human
@nuckingfuts_	unknown
@ymk72	org
@TheBurgerGuru	org
@SBuxChester	org
@MonteCarloDxb	org
@caionet24	unknown
@Foodspectations	human
@federalcafemad	human
@doylee02	human
@EPCofficial	human
@esenina_yulia	human
@autonomotive	org
@bluecollarmiami	org
@RussNJ	human
@bjmc7	human
@Carmen_Wraps	human
@FitFlyMamasEPL	unknown
@luvseaside	human
@BigJoe49us	human
@iambossofme	unknown
@LeBristolParis	org
@OjalaWine	org
@SlapFishME	unknown
@nonononchan1	human
@heirloombeaver	org
@bella7549	human
@iamtherealsonja	human
@nomadwifey	human
@LouisChong69	human
@triangleyue	human
@donnerrjay	unknown
@Zoey39KnT	human
@_master_lanut	human
@WeLoveBrighton	human
@Nutritionbites8	human
@roykelley	org
@YEAHBUDDY0329	org
@OrringtonFarms	org
@SorrentosWPG	org
@gitikasaikia	org
@TajLandsEnd	org
@shipmenus	human
@MIX997	human
@ReneValerie	human
@NorthernLites87	human
@LetsPlayOC	human
@AHealthyMom	human
@mad_santos	human
@QuiteAStir	human
@CPLauthor	human
@TutuChicByFP	human
@Monique_Borst	org
@EdenRocMB	org
@1989_alicja	human
@grace_dhey	human
@BYEOuMmY	human
@superayucool	human
@Insulite	human
@mattsparks88	human
@MadeByTheeAlamo	unknown
@AndrewT85	human
@LazyDaisysCafe	org
@PioneerChef	org
@CHEFtropeano	human
@FamilyTravelKid	org
@chaipohpoh	human
@PGouveia14	org
@MagnoliaMamas	human
@RecipesSquared	org
@HankStraw	unknown
@sueykchi	human
@EdibleSoFla	org
@GemsHealingHand	human
@WokToGoCardiff	org
@ratihred	human
@emerentianagill	human
@estefaniap44i	human
@renai_6NC5t	unknown
@BackstageBarbie	human
@Akcay_Mehmet	human
@natgaga	human
@WoodysTacos	org
@theTinaFan	human
@SelnerAnneRaine	human
@MrMarkFairhurst	org
@bellischicago	org
@Aspoonofsugar	unknown
@friscarasyid	human
@happyin13	human
@swagpartner	human
@SanJoseContract	org
@zaynaab	human
@TravelInsiderM	human
@SchanzensternHH	human
@JaiminRajani	human
@CanopyShishabar	org
@CasaTuaAruba	org
@WeichelDaniel	unknown
@JSB_bot__	unknown
@tiffanylgaston	human
@ChristopheLaer	human
@AbsOnizuka	human
@RWRestaurants	org
@michelaravera	human
@EspaiBoisa	org
@HerbGir1972	org
@SuckaFreeGang	org
@StampEnts	org
@sarahsreallife	human
@growwithlaura	human
@prettystems	human
@SunWorldFruit	org
@82gardenkitchen	human
@meals_soho	org
@Dinaegy	human
@LadyGryf	human
@vegfitarian	org
@ShredZoneFit	org
@HdiaJsus	org
@Yogaclubbers	org
@IAmHeartrecker	human
@CatchMeBC	org
@CharlysStyleOfL	human
@cmcapellini	human
@Krishacranberry	org
@carolinegarrad	human
@fitfabfoodie	human
@ishi_san	human
@rocio_carvajalc	org
@HairsmithsNR2	human
@TsunamiRest	human
@lovebrunchblog	human
@HopBunz	org
@chessaSA	org
@themattkim	human
@Georgelfcynwa	human
@KimLoLee	human
@MiyokoOnuma	org
@beyondfrosting	human
@PassingMY	human
@A_PinchOfSalt	human
@FrankieKuzmem	human
@tadafn	unknown
@alexandrawow101	human
@jayceefulgar	unknown
@WWLindsay	human
@halalfoodiaries	human
@felicia_s143	human
@GetCereal	org
@ChefMerry	org
@jayliey	unknown
@Alexxx_Collado	human
@NikkiKJo	human
@EssexPR	human
@KarlaJBrador	human
@GreenHeartPT	human
@Equagold	org
@no1dukestreet	org
@Crishee	human
@RyanxWrestling	unknown
@Nicko_Andrew	human
@kat04murphy	human
@rehnskie	human
@sophiagaleria	unknown
@jchang64	human
@YeahThatsGOTTi	unknown
@valoumodeuze	human
@wiOart	human
@themughouse	org
@MrsHomewood	human
@SFU_Dining	org
@tin9ish	human
@cHengyIk16	unknown
@arubian_cocoa	human
@casinocochin	human
@PaulFulford	human
@elissapr	human
@2fieldshk	human
@DJMellow0523	human
@perfectchef4u	org
@BECK_SCHNERR	org
@OhlalaQatar	unknown
@1JohnnyWood	org
@bcbssc	org
@RawPressery	org
@DeanRewOfficial	human
@AllArtBot	unknown
@RiaEviee	human
@Chilenita74	human
@liveatllife	org
@gvEventsNewYork	human
@GourmetPH	org
@Ch_Panas	human
@MalagaTapasBar	org
@JennCassetta	human
@yautsztsz	human
@JPRCafe	org
@Gisforgingers	human
@kaisersdiner	org
@lalaherysmar	human
@MarianaSaraceni	human
@itsellibabexo	unknown
@itsorangelim	unknown
@oceangirl6108	human
@n3chelle	human
@AliveAndKicknDD	human
@saporicanada	org
@jacipena	human
@yesterdayssc	org
@chempakamohddin	human
@alsheekisses	human
@Curliesclips	org
@LeslieVeg	human
@SSexyStorMM	human
@JeliIng	human
@adkt1976	human
@Exk33	human
@AzureSmile21	org
@LArtista_CBR	human
@tinakits	human
@marlawhite	human
@AiKameyama	human
@Cucinadelcuore	org
@Nessa058	human
@fluffedup	human
@ambre89	human
@soni_wagmee	human
@Dj_Amar_B	human
@_evonlim_	human
@YUI_III	org
@fitfabfunmeals	human
@kfa1217	human
@Staybridge_DTC	org
@lpugurl25	human
@EvgeshaKemi	org
@ericarey	human
@KnowVega	human
@mizbayou	unknown
@RemarkableJamie	human
@jewels0588	unknown
@Jdaboss_now	org
@FiendGrub	human
@KingsCafe2013	human
@dynaummuathira	human
@Helpful_Foodie	human
@jmedios89	human
@whatrn	human
@hollylikes2cook	human
@FresitaCanada	human
@divine_sevial	human
@OzziesPOV	human
@BizCentralSA	org
@tasha_feldman	human
@LaStellaMamma	org
@Loyalty360EU	human
@heyeian	human
@EmmyChristine	human
@ebanaandrea	human
@Kaptivating1	unknown
@Johnny_Storm4	human
@BirdInHand2011	org
@CantonSpiceCo	org
@CrowdfundSpirit	unknown
@isna_inesz	human
@satoshimyroom	human
@TavernaRovita	unknown
@LakeBurks	unknown
@TonyLe73	human
@sarablonstein	org
@VisitDublinGA	org
@Shoshi	human
@Iamkriskennedy	human
@sm221017	unknown
@NolaFoodGoddess	human
@ChrallanToo	human
@nerissexiness	unknown
@TDi1909	human
@BurceTatar	human
@Worldofmunchies	org
@gunning_nash	unknown
@Toyconnor	human
@annapello	human
@jUdE_MD	human
@pancakepow	human
@BrunchSessions	human
@APRAlliance	human
@gotomexicoUk	org
@EJ_MoM_23	human
@DearDiaryblog	human
@N_Milenna	human
@BBBLondon	org
@c_hab	human
@chanyatang2	human
@Jarvisydan	org
@MikeyThreeOaks	human
@Jennyobrien73	human
@Helena9789	human
@babbinom	human
@BhamFoodie	org
@Nicolette__X	unknown
@TheBuzzDoha	org
@fashionfoodi	unknown
@BlackAleCat	human
@ContactumLtd	human
@RuthFrechman	human
@ohsosavvymom	org
@2travelntaste	unknown
@Fromtcore	org
@CigarSauce	org
@energyripple	human
@fla_defilippis	human
@thespian_yiani	unknown
@1iloveladygaga	human
@Yvetteskitchen	human
@TheUnionVan	org
@thehautecookie	human
@bOOb_Solver	human
@witbrood	org
@rheavan	human
@shana4damon	org
@room4dessert_	human
@Carolina_Aanita	human
@SusanneT3	human
@kriz_23	human
@sm1bca	human
@tillagat	human
@FrostingQueen69	human
@AlistairDerek	human
@myrumblingtum	org
@moeyskitchen	org
@LiveUrLifeKaNa	unknown
@ChaumetteWinery	human
@KartikaDewi20	human
@mtdillon50	human
@happy2xjoy2x	human
@MovenpickKhobar	org
@petermiless	human
@chressgruiz	org
@Jamilerdzo	human
@RainyTuesday	org
@plushykatebir	unknown
@jababoy188	human
@fuckx_love	human
@one_2_three	human
@Tastingwellness	human
@V3MBRY	unknown
@GJosselsohn	human
@secrets_lady	human
@ohlaladianne	human
@corsley1947	org
@LilPixieMama	human
@PLAZADELTOROpdx	org
@intandeintan	human
@thefitmrs	human
@217naturals	human
@wulan_luvrossa	unknown
@wanim0927	human
@Foodie_Frolics	org
@ronaldmartinus	human
@kath1556	human
@TheRealPhatJoe	human
@BambangHerlandi	human
@guineapixs	human
@FlahavansIRL	human
@Harte_Sammy	human
@JonRobK	human
@zuzu36660387	human
@HeaViLybrOkN	human
@TimTweetsEats	org
@GoNzA_elp	human
@Jovialjoe_05	human
@karlalanexxx	human
@LiakadaTravel	human
@yoshie_san	human
@BNDQ8Bloggers	human
@NeuvooPTMis	org
@TheCheesemason	human
@MalachiteWulfga	human
@LaVidaDeliciosa	human
@ChefBarYYC	org
@Massielcheco	org
@StephanieLugue	human
@PaulieCooks	human
@BuCorrea	human
@AngelicRyoko	human
@Poohbear1030	org
@jessieb3lle	human
@HighNoonChicago	org
@rianneslenema	human
@Fatafeat	org
@lenduletmagazin	human
@Nath_and_you	human
@chxrene	human
@OakStreetCafeNQ	org
@HelloFresh	org
@SugoiWhat	human
@YoHobbyCH	org
@kakunie	human
@kingtaha95	unknown
@LisaHQCD	human
@Arezoo_	human
@cesar_nanez	human
@nursyazwaniZB	human
@GPgobbi	human
@ByVJL	human
@sakura3486	human
@jesarand	human
@KEVNIZ	human
@ancientsoul7	unknown
@chumi2	human
@doan_ly	org
@ourhousefortea	org
@SchwaigerLauren	human
@WildGooseTavern	org
@elfabuloso	human
@thehungrygents	org
@bluefrogpune_	org
@J_Monroexoxo	human
@FitnessOnToast	human
@Cantina1838	org
@MeetTheTaskFast	human
@UPPastryPlate	unknown
@VanVaVeu	org
@mikosison	human
@FordOverstreet	human
@leonardlyy	unknown
@traishamartin	human
@PlasticBowsBlog	human
@ddy_flammie	human
@GingerDogDish	org
@missazalea	unknown
@LivdeepYogini	human
@ua_madrid	human
@TheFoodAvenue	org
@SnakStash	org
@604_club	human
@ZenHedonist	human
@Follow_Sweden	human
@artofmusic85	human
@LisaSejima	human
@alalali_ME	human
@asbin_jordonne	human
@Kithrak_	human
@Modespektakel	human
@trabidri	human
@_daniellalo	human
@sandysasibella	human
@magicalvs	human
@shellyb1902	human
@ebisu_nurikabe	org
@RareRepublic_WR	org
@lucianayuwono33	human
@ytwolf	human
@NomNomNewYork	human
@theveggiefix	human
@ChristianGruene	human
@ChefHermes	human
@louisvillenoms	human
@AmyB_Essex	org
@Houssseine	org
@moon_sing	human
@charbray	human
@beerwell	org
@MLRPromoBabyKid	org
@Droid_Zero	unknown
@CBRODY09	human
@jennitahmassebi	unknown
@Lubna_AlLaham	human
@hendrafael	human
@DylanPrime	org
@Madaboutravel	human
@FlyingKitchen1	human
@RMIT_Village	human
@rockminori	human
@icearrojado	org
@torylynn_	human
@hamptonforge	human
@ariyantiee	human
@erickmorones	human
@SchirattoS	org
@gobalu_d40	human
@VillageKitchen2	org
@jhandylicious16	human
@CatchCayman	org
@reyanna13	human
@unpreparedkitch	human
@listeningroom	org
@Greenwitchlady	human
@brittt_dee	human
@houseoftaste	org
@alonsocuris	human
@chefdechill	org
@chappaquamarket	human
@edwinsander88	human
@PinkLoverzzz	human
@mddhani	human
@noordphilly	human
@ParkSham	human
@haroldrobinn	human
@challanthotel	human
@GloveBoxGlover	unknown
@iamanishsinha	org
@trawickimages	human
@bobwadd1	human
@sosana83	human
@ballandchain_LA	human
@PachangasHenley	org
@dedierianto	human
@unrfndsweetlife	org
@bacchusjennife1	human
@richcovey	human
@linifeisol	human
@ChungKiddo	human
@marisonisunique	human
@Silverringsshop	org
@ichi_JI4	human
@mqua	human
@JerkyG	human
@mamikoota	unknown
@EmiliaAhmad	human
@YowkBreak	org
@bargainbriana	human
@Mu_Ramen	human
@belveliero	org
@ProstoGwyneth	human
@Green_and_Baker	unknown
@LenahLang	human
@SophieBailey96	human
@SINNAGUBBEN	human
@DiscoDavid9	human
@HauteLivingMag	human
@Miss_Coco_Bijou	human
@MelbVillage	org
@Marissaabjones	human
@Idressitalian	human
@bongbongbandra	human
@aidilhareez	human
@ONeillsSoho	org
@IamSaikhar	human
@BrumBrekkieClub	org
@HulyaBaris	human
@bamayye	human
@mike_quinzon	human
@eclkdomestic	org
@AcmeNashville	human
@Karreno	human
@PRETTYGRLTAYLOR	human
@LindsayHess07	human
@Gr8dee	human
@DallasSocials	human
@MiyakoKai	human
@morganakaboo	human
@dhkproduction9	human
@djkckevin	human
@paleobods	human
@laurajamiept	unknown
@praveensayswhat	org
@WMGTearoom	org
@myapalmalvez	human
@foxanginger	org
@RemlyVzla	unknown
@redaktorr1	unknown
@aijanuarita	human
@medveg1	human
@Pizza_Dominium	unknown
@estefania1507	human
@Mozza_Risella	human
@PizzaManDans	human
@RonThornton	org
@Hussein36_MD	human
@Sontes	org
@Feroza_56446	human
@hkglady	unknown
@BIVY1600	org
@azianhasan	human
@iliyanyanev	human
@PoseManikin	human
@gfgoodneighbor	org
@dickermax1	human
@Leplacardanais	human
@OfficialRaechel	unknown
@sunshinisaac	human
@aMichellePhan	unknown
@GGFGourmet	human
@MT_Sonja_Eatman	human
@LauraBadie	human
@NPaluPi	human
@hotmamaskitchen	human
@I_am_New_Mexico	human
@ShamaeGia	human
@girl_who_cooks	org
@MayedAlHosani	human
@NocturnalPandie	org
@avtarius	human
@Fabulous698B	org
@rie_viera	human
@Erilea08	human
@1011scnz	human
@srftoy	org
@DareYouToBlog	human
@annalaurabrown	human
@lpconsultoria	org
@jeibleu	human
@ReaIHealthyFood	human
@badgirlrachiee	human
@Almeida_N1	org
@SassyGirlzBlog	human
@locandajakarta	human
@syawalwan	org
@Sharolayn	org
@EggsBenedictDay	org
@marcialealpt	human
@JessicaCargan	human
@dronoblog	org
@Ladygourmet	human
@Endobariatric	org
@raziakkhan	org
@HradcanySavoy	human
@JeffriesSunni	org
@GB_Barbie	human
@MarlenMarieM	human
@minierika	human
@plantstrongveg	human
@BoomHowsLG_Doin	human
@locandamarina	unknown
@srs743	human
@benz_montague	human
@yappisoracco26	human
@CaseyFryAuthor	human
@alexbklyn40	human
@KensingtonCafe	org
@HanaaDesigner	human
@ubeee	human
@Thee_Khaleesi	human
@a_dragon19	human
@ashgoody	org
@handanovicova	human
@VitosPizzaCLT	org
@nyonyatiara	human
@AnnekaCarley	human
@JLelandAussie	human
@greatdoughnut	human
@EnhanceTelecom	org
@style_picker	human
@Shinwoo87	human
@NYCTSubwayScoop	org
@yabmhyforever	human
@wilmer_fer	human
@janetsbar	org
@LuglioSerena	human
@kimtiu37	human
@MyThermomix	human
@ClassnFab	human
@HolidayMatch	org
@snackhappy	human
@chongsk818	human
@madbakertucson	human
@Kellydavis_12	human
@pcosdeaf	unknown
@lockstockphoto	human
@Raphaelle_Smith	human
@coffeeanthology	human
@dandyhuang	human
@ZocaloKC	org
@Ovenly	org
@TweetTre	org
@shiawasekim	human
@Some_Cities_Bot	org
@nadianananad	human
@AFPfoundation	org
@Nickisme44	human
@kjsarabi	org
@JorgeVMenendez	human
@cwenxi	human
@yod4yod	unknown
@lockwood_paris	human
@LesFalbalas	unknown
@katpol80	human
@HWPIns	org
@cookwithjoyce	unknown
@Rubinphotog	human
@Kat4Obama	human
@CMxoxo	unknown
@ramboand	org
@PopUpsters	org
@nicoo_var	human
@1ente	unknown
@NurfizrinPiyin	human
@LoadedCafe	human
@ameltoe	human
@justforcoupons	human
@FigStreetInn	org
@goutdfood	human
@EddSerrano	human
@marcyrichardson	human
@Davina_Morris	human
@augustisme	human
@mamachallenge	human
@marcmazauskas	unknown
@Omar_Gaza	org
@shinha_rider	human
@blondiebambie23	human
@AKOsiYHENY	human
@25nuage	human
@ImPoeticJustice	human
@pinkpoodle3	human
@scandelights	human
@MaijaPippuri	human
@MyCreoleKitchn	human
@JuliaLundinblog	human
@tu_anh	org
@sasoomcouture	human
@teuku_irshah	human
@chefali_acikgul	human
@Justina681	human
@richieibarra	human
@juliebakercr8v	human
@IkhwanMache	unknown
@belliscoop	human
@BistrotMaximo	org
@Oboraqueen	human
@Jenofa	human
@Carta_Carta	human
@lozachops1	unknown
@nerubia_	human
@CarlosCanlas	human
@bagelsandbrew	org
@itisjeffrey	unknown
@visualnewbie	human
@force_majeure	human
@zachary_legend	unknown
@THEORY_MOVE	human
@Drake_Tan	human
@PeasandCrayons	human
@lilsnow00	human
@hiphiphealthy	unknown
@FillYourPlate	org
@suppernut	org
@stayreadyevenif	human
@SharonGruman	human
@JSchlesserFOX	unknown
@foxeslovelemons	org
@isabellay10	human
@AlsCajunVillage	org
@JustDeac	human
@ih8jorge	human
@thepimmy	human
@Munkipawse	unknown
@frelandb	human
@victordrosario	human
@flygirl_steff	org
@sleepysummers	human
@ADucksOven	human
@princessdanah	human
@dengerd_patrick	human
@MadisonSocial	org
@darlenecavalier	human
@NatalieMcBee	human
@DesireToEat	human
@CouplesDealsUK	org
@ChizDee	human
@MrsNicoleLD	human
@mamachinkun	human
@JOSIEROM	human
@c_belleofficial	human
@LadyComplainer	unknown
@Mary_985	org
@Beautified__B	human
@JunieBabe02	unknown
@JackMagnifico	human
@sinefm	human
@Stradabella	human
@ClaudsCloud	human
@iamnicaferrer	human
@BambooCore	org
@georgeonibala	human
@Abby_Woo	human
@ilovefood01	org
@BarInfusion	org
@MarKAddicted	human
@monicasubintang	human
@missionfitchick	human
@AkberRizvi1	org
@nguping_Bwi	org
@seveny_77	human
@McQueensPub	org
@johnsontan30jt	human
@Eisha_89	unknown
@wintercriss	org
@Diolifestyle	human
@dezjara	human
@rubymusngi	human
@barracudabee	unknown
@Andrewstirling9	human
@reneebythec	org
@AmeriHealthNJ	human
@TheChefSeries	org
@wendywahito	org
@MoniquesKid	unknown
@NatashaJLow	unknown
@AW2SL	human
@nymphstyle_nere	unknown
@padz_jap	human
@forks_of_nature	human
@WishboneCowgirl	human
@foodityourself	org
@StyledbyReti	human
@colonymainst	org
@Rico_BlaQ	human
@Jutta421	human
@LouEatsGood	org
@NeuvooBloominUS	org
@NorwingRivas	org
@AListExpert	human
@Modasic	org
@gorringeparkpub	org
@BerlinFood	human
@LarryHoe	human
@BreakfastStorie	org
@itsjillybaby	human
@WasatchBagels	org
@AlexFChester	human
@nomadicomet	human
@bmattos18	human
@Chewsdays	org
@xgisellx	human
@estadoboricua	unknown
@bklynbrewshop	org
@AvenueCookery	org
@StateWeHo	human
@VTCottage	human
@therealspunky	org
@lilmsMae	org
@hacchizaurus	human
@starkermax	human
@SEvanTownsend	human
@party58898982	human
@chapidee	human
@AeryG	unknown
@eztomahawk	human
@foundations_fnw	org
@MarkAGlaister	human
@Smoking_marci	human
@jor_daluz	human
@BengalTigerLDN	org
@bikash061172	human
@TazlyTaz	human
@dimantha	human
@LEntrecoteMiami	org
@galaxyicecream	human
@neozhang	org
@Food__agent	org
@LeftyRonbo	human
@krysilove	human
@SSclare1	human
@WahMillie	human
@JBlacks_Houston	org
@MelvinPou	human
@AliVegaz	human
@Zamo_Amara	unknown
@barborkas	human
@MrCollymore	org
@dirt_r0ad_diva	human
@callme_maebel	human
@siddiqafifi	unknown
@carlos_depaiva	human
@P9MzNabi	human
@persianmamablog	human
@nana_tanimura	org
@supermoDELMAR	unknown
@M3M3_1	human
@JourneyintoDadd	org
@lowe_xo	human
@MarkDaviesJnr	human
@raymrnd	human
@PepeG_uardia	unknown
@GIVENUSA	unknown
@CatenaNetwork	human
@JessicaWNC	human
@PhilippDegen	human
@yutoon1227	human
@RevsBarCardiff	human
@Foodritionista	human
@Maydayforfood	org
@Digichocchic	human
@AskMeAnyThing18	org
@churchmki	human
@adelmojrmanaus	org
@MarlineOxley	human
@karlavadillo	org
@Johnleetao	human
@CopleyPlaceMA	org
@Sha_4	human
@kaori22love	human
@fuudey	org
@stradatweet	org
@DrMejiaMD	human
@TheGuestHouseV	org
@Shiiiningstaar	human
@MissD5	human
@ladyhomemade	human
@MinnieWann	unknown
@happysunny88	human
@LoquaciousLotus	human
@RippedVixen	org
@xhilarygirlx	human
@RoastedRootFood	human
@deliasuboni	human
@Adjitator	human
@tiadang	human
@afrozumba	human
@ManelKape	human
@siinarose	human
@TheMonochromes_	org
@achakosoon06	human
@BackPackerTalk	human
@joeagdeppa	human
@TankaBar_Linda	human
@michaelluciw	org
@casaveraRD	human
@taro_of	human
@jpaigeevans	human
@MadelinErazo	human
@wearemediarocks	org
@YnotItalian	org
@ka_rizz	human
@FountainAshurst	org
@GlobDesign	unknown
@MU_restocafe	unknown
@YoungNCurly	human
@NutritiousLife_	human
@maurice_canon	human
@FIThausandmove	human
@VoloshynaAnna	human
@Feer33	human
@HiImZech	human
@exit266	human
@RetrosGoodEats	human
@MenuTest	org
@Torbay_Hour	org
@StefanieVoge	org
@OzgurKesemen	human
@burrrSOLO1017	org
@anthonyfhoto	human
@MapleCheong	human
@SunnySpotVenice	human
@jorgeleong	human
@GalaxyGirlie	unknown
@LittleMissNutz	org
@vivalditan	human
@ElisaLouK	human
@HenryDaHawk	human
@houseorock	human
@aimmi0127	unknown
@thegov_mark	human
@ms_olinx	human
@longjohnslvrs	org
@iambravocharlie	human
@moffuuyy	human
@SouthMeetsEast	org
@petitemod	human
@sinagalib	human
@Fairoza	human
@itsmeJackyMFull	human
@sarah_hudl	human
@PMallagray	human
@TR88EDGE_TV	unknown
@Stirrups_Dining	org
@heena29784	human
@MrJoJoSilver	unknown
@lippuex	human
@Leiya_Pedrosa	human
@rashidelamin	human
@JustbeinwhoIam7	human
@LB_MakeupDesign	human
@justjouett_kace	human
@SDSmokers	human
@alexlauver	org
@soniasphoto	human
@lajkea	human
@Lee_Siegel	human
@SkyestoneDenver	human
@Just_Zoshin	human
@hotelsbooking1	human
@DeliciousSydney	human
@vienamorgan	human
@theHobNobShop	org
@dripworkscoffee	human
@btmomama	human
@tzachalon	human
@Shaggy_Sigit	human
@mrjpang	org
@ismailsinclair_	human
@rai901	org
@jordanbourk	human
@purpleview	human
@stupidrug	human
@cyn_ho	org
@RHETT_MASON3	human
@lifesport3	human
@SweetsAndShorts	human
@SueSetiawan	org
@bamskitchen	org
@justine8508	unknown
@KasumiKriss	human
@DKcentraal	org
@sharpegirl	human
@TMP_90	human
@KissMy_TweetAss	org
@foragersmarket	human
@MakCrystal	org
@caichanco	human
@jols569	human
@GrapesfromCA	org
@hepondort	human
@TruffleSocial	org
@RandyChirzziger	org
@iamDaveNitro	human
@EspinosaBaster	org
@AiennLatifi	human
@twittieying	human
@apogee711	human
@IndianFood4You	org
@the_gastrotruck	org
@hopegaffney	human
@oolingio	human
@MrFrenci	human
@kylieroger	human
@dayanalunk	human
@aki_ga_kita	human
@Edicsi	human
@lapdancingclubs	human
@Oreo1916	human
@danger_sandwich	human
@namizo0801	org
@WaninaJ	human
@Shadowolf19	human
@revolving360	org
@cowpunkmom	human
@broncosranch	human
@GarciaExspyinaz	human
@thecleandiary	org
@doNUTboyz	human
@abhiKRajput	human
@kenziepark	human
@villagecafeD6	org
@ShellyFlash	human
@YarraHouse	human
@eatsurftravel	human
@Missaenagy	human
@WowItsAndre	human
@iulia_andrei	human
@dewymandasarii	org
@ArelifAlephant	human
@H_ector_infante	human
@nanotok	unknown
@TOMOKING36	human
@pfiel	human
@JosephAFarrell	human
@canonflame	human
@David_Logan39	unknown
@NorthWalesDaily	org
@sisocameraman	human
@AlfredssonFi	human
@chorltontraders	org
@EJEbeauty	human
@LukeMangan	org
@GollyGosh84	unknown
@BronzeCenter	human
@SelfLoveAngel	org
@Garfieldnolink	human
@NujDeCastro	human
@PuraVidaLondon	org
@rawalon	human
@OpenTableUK	org
@OsoGlamerous	org
@RadioKC	org
@sweetspicymonky	human
@BrowninEntrtain	human
@RollingSushivan	human
@kieliann07	human
@fitnesswinss	unknown
@Nickolas603	unknown
@B_long2Me	unknown
@thegastrocard	human
@JhonRamos10	human
@HotelSchiphol	human
@gooner_del	unknown
@MGSidrus	human
@phylanthropic	org
@HanburyManor	org
@LightDLee	human
@4lowlikewater	unknown
@mervederya23	human
@Yuki_tty	human
@ianwrongkillyou	human
@peterzburg	human
@FuelPlusInc	org
@JoseTweeting	human
@dollybutch2	human
@GuinevereMV	human
@Rick_Chbt	unknown
@suchetajt	human
@FRentals_en	org
@blickieblick	human
@myrac	human
@ShidaNatural	human
@KERB_	human
@James_Slurrr	human
@iDari0	human
@RelaxInBarbados	org
@jungtastic	human
@catarinahurtig	org
@TFCullos	human
@alexheadchef	org
@mariacascone0	human
@lucysback	human
@OmarRod_riguez	human
@LuckeeTO	org
@only_heather	unknown
@BASILEJ1973	human
@SheSoExtra	human
@Iammrdover	human
@Ayesha961	human
@SpoonfulFoodies	org
@O3104pupu	human
@hulikavalbon	human
@Ky2sTantan	human
@couponchief	org
@TheOtherHepburn	human
@ryota_u	human
@SevenSocialDub	human
@Mrketinho	human
@HelenSmith61	human
@Lornz3081	human
@TuiteoMerida	human
@wilolu2k2	org
@FunkySteph	unknown
@Chris_Elister	human
@cathsharper	human
@garymccarty	human
@Jullia_Granger	unknown
@allenahdi	human
@emptyglasscity	unknown
@littlegreybox	org
@elybooG	human
@AakashRaut	human
@SUNDAYBARNSBURY	org
@EmeraldCityChoc	human
@WNTDMAN	human
@EmBisset	human
@GerryGeraldus	human
@mb13579bm	human
@BCNewsy	human
@SouthendHair	human
@RokaAkorAZ	org
@HappyBrownHouse	human
@mscheker	human
@tanvelina	human
@tgloria1213	human
@tinaitits	human
@weight_talk	human
@Sergej_Ivanov	human
@RathfarnhamV	org
@LauraSiui	human
@dianaayyu_	human
@suu_mahalo	unknown
@BlogOverThyme	unknown
@vampire_vera	unknown
@whitneybethesda	human
@CCarr247	org
@DBebookStore	unknown
@moriar_TY	org
@alexafretes	org
@croissantreview	human
@astruwe	human
@beauteousmax	org
@monikamanchanda	human
@miljnte	human
@So_Delicious	org
@onnistain	human
@ting_le	human
@gregcavo	unknown
@FermentedSoul	human
@Hen_kumaseop	human
@WirawanNews	human
@edo_au	human
@ClockworkBeerco	org
@PerpektoKitchen	org
@springsteens	human
@amylynn_TIU	unknown
@OpaPhiladelphia	org
@MissBeckyL	human
@jennjones86	human
@Chongsterink	human
@AmbikaKauL	human
@key_boo_net	human
@AdrianaPerser	human
@jbuddle1	human
@xsilverskyx	human
@kristineciard	human
@soohongsim	human
@garotadebhutan	human
@PresidentCoffee	org
@fll723ow	human
@kalvinize	human
@Kirkaaa	human
@KanoomCakez	org
@RaynniereM	human
@roligerardo	human
@BecJCannon	unknown
@zoievpy	human
@KissMiiPearlz_	human
@mintja55	human
@fransteryuki	human
@palmysmilemania	human
@yuyu_gemi	human
@Tephy_Figueroa	human
@bgeorge802	human
@BatangaHouston	human
@sewwhatstudio	human
@ishelnuvole	human
@anarmnet	human
@ShewJiaHao	unknown
@catnip_abu	human
@vina_deve	human
@PaulKulpinski	human
@Me_Jonathan	human
@justsalad	org
@CarminesNYC	human
@hugomamma	human
@EastYork_TO	org
@CravingsLunatic	human
@xImYourCurex	unknown
@TheMintGarden	org
@ccliffRDN13	human
@SloanRawlins	human
@westavenuecafe1	unknown
@SparkleyTwinkle	human
@TheFoodManiac	org
@drewjkoch	human
@LCHFDetective	org
@Leila1H	human
@StreetSpittas	org
@cdn_cannabis	human
@bridgettw69	human
@ppsfollower	human
@evesbk	human
@fundraisingmix	human
@iam_bora_	org
@VoiceOfShy	human
@chri_scerbo	human
@homechefjb	unknown
@ThunderAngel454	human
@MyFamilyTies1	human
@Melian84	human
@SeeMomClick	human
@mallerysdeals	org
@InfosUNI	org
@PeppeECardinale	org
@Gastronomyfood	org
@otona_ko	unknown
@BraddocksRenPgh	org
@FoodWineAndCo	human
@AliaSaiful	unknown
@Meikah	human
@daebakID	org
@calrikin	human
@Dionysus_	human
@anniecanada7	human
@UnityUnitarian	org
@luxury_escapes_	org
@Diddiandlulu	human
@miss_kern	unknown
@emutami	human
@surprisevegan	org
@Scarpones_YYC	org
@Masterslicer	human
@euzhanchan	human
@cannic70	human
@GiuliaBorroni	unknown
@akahitoamaya	org
@CultureTripSF	org
@philmar_lapura	unknown
@jonfellchef	human
@DyesebeI	human
@3CityGirlsNYC	human
@makoto69148186	human
@xkenbadx	human
@Angeling_	human
@aldrenortega	unknown
@LollyPop08	human
@budiprass	human
@petern1cholson	unknown
@Le_Comptoir4807	org
@TheComfortQueen	org
@AnneJensen01	human
@goodcakesfran	org
@takaosa_n	human
@foodvisors	org
@aokikate	org
@GFMealPlan	org
@izumin0109	human
@Teebrescia	human
@alexstyling	org
@Ierfaan	org
@Ro_berto_Rocha	unknown
@JustCombined	human
@iamshiela	human
@Missrosemawar	human
@vituz22	human
@AlegriaTruck	org
@aCreativeDC	org
@isa_brilla	human
@scottinfalls	human
@ProWestJetSki	org
@Bethals87	human
@SamJones563	human
@KatIceStarr	unknown
@Newfoodaisle	org
@ComiendoCon	unknown
@yesitsmeshella	unknown
@EvoluzioneLDN	org
@xtinecu	unknown
@bmstoltenkamp	org
@TheStagsHead	org
@Van_Marshall	human
@Riran_Kataoka	unknown
@LeeAnneTodd3	human
@mehmets47327380	human
@BallSquareCafe	org
@puppydogbianx	human
@ArabicaLondon	org
@itsmextiee	human
@my_foodstory	human
@GastronomyAust	org
@JulesDuffield	human
@Koyumism	human
@DublinFoodLover	human
@akane_3103	human
@CheltenhamLover	org
@Liddybear	human
@YoLisaYoDiva	unknown
@hmgleefulness	human
@yoshirisaaa	human
@jennielynn35	human
@FoodObsessedSam	human
@justJasemine	unknown
@RightOnMom	org
@MassielFeliz	unknown
@mami_ishioka	org
@sonoralampung	human
@urban_cupcakes	org
@raziAhmad17	human
@Zwone94	human
@micktriff	org
@joel_varela	human
@yardyarzlil	human
@ccthestar	human
@drewboox0	human
@bendog	human
@_dalejvb	human
@its_zaa	human
@NikeGuy303	human
@baconhound	human
@TTT6993_3	human
@NaturesHBox	org
@ideasmalave	human
@bhebheKarl	unknown
@WeddingGiftsCA	human
@raintes	human
@kat707	org
@lusilleann22	unknown
@inezzitah	human
@9bHomeBar	human
@CarlieKercheval	org
@MidnightRedBEL	org
@rhubarb2rhubarb	org
@Ohsoamelia_blog	human
@CitizenRVA	org
@MteBBB	human
@GastronomeATL	human
@DarrenWright26	human
@VKG_zoe	human
@clarebeartweets	human
@DarbyDo24	human
@HollywoodPies	human
@YaJagoff	human
@PaytemJane	human
@BarraNTeaJazz	org
@HeartofJess	human
@YellowTennessee	human
@HackneyPantry	org
@SeemaSubash	human
@Raf_aelMora	human
@OGRcafe	org
@RockyRoark	human
@RendiKun	human
@John0fTheDead	unknown
@parastar	org
@LoyOfficial	human
@kjorlingwine	human
@eksterland	human
@DribbleDots	org
@aglobalaffair	human
@Cassandrea	unknown
@TEFoodHall	org
@RabiaSoraya	unknown
@aodh11	human
@b2bakeshop	org
@yeseniah12	human
@KeepKCurtis	human
@GroundBased	org
@Andr_eaAzua	human
@TheRawChocCo	org
@naturalhazards	human
@ItsStephyBaby	human
@IceAdz	human
@0714sora	human
@CarlahSantos	human
@dogielus	org
@_EyE_OpenNer	human
@kathtadena	human
@Carlitosway559	human
@Banana_Chuck	human
@DannyG4141	unknown
@rcablun	human
@SureChef	org
@guslugo	human
@George0Hensley	human
@BACONBOYSTRUCK	org
@mnlalic	org
@DoEatBetterApp	human
@Ck15074	human
@BaillieClaire	human
@thafondello	unknown
@1CoachingLive	human
@CafeBlancEgypt	org
@mac9o	human
@O_birk	human
@mediamatic	org
@_MaRiNeTTe_	human
@ottosuke	human
@SophiesChicago	org
@gapn86	human
@coffeeINNAcup	org
@DJJeopardy	unknown
@victorianuguid	human
@akbartama12	human
@Leggeremania	human
@StacyLCharles	human
@inesgagliardi69	human
@DynethaRae	human
@FilippoBerio	org
@trentaineparis	human
@CHUK1ES	human
@julesmccann	human
@sa_artists	human
@HutchesonsGLA	org
@faithandfete	human
@BeOurGuestMike	org
@babyfacereggg	human
@phibakery	org
@HiltonPanama	human
@JWeventsca	human
@tastysnacking	human
@IwanOnline	human
@Ezy85	human
@lecolonialchi	org
@BarceloRaval	org
@LuckytheRescue	human
@wohnungsdesign	human
@pamela__tan	unknown
@my2littlebirds	org
@raychan	human
@kemmko	human
@SanterMsanter71	human
@shazminacap	unknown
@TylerTDHS	unknown
@iam_INVICTUS	human
@LewishamMarkets	human
@Auden_JV	unknown
@fitnessfrosting	human
@PotteryBarnKids	org
@MarietaLRM	human
@WFMCooking	unknown
@koorikoo	unknown
@splendidamy	human
@thornbiz	human
@MiracleMileLV	org
@srefanorossi	human
@Poes_Kitchen	human
@astitchinstyle	human
@checcobai	unknown
@ChristinaStumer	human
@uniquelygreek	org
@Stangman007	human
@Mymenudining	org
@my95210	org
@GeorgiaEliza20	unknown
@KiMwManyNames	human
@EllDouasshamza	human
@ShirleyHusar	human
@monsturrles	unknown
@stephanievoong	human
@beastandbottle	org
@Essentials_Blog	human
@bundoosanto	human
@marinesdiary	org
@LievitoMadre_	org
@Nicole__Brown	unknown
@simayjoelle	human
@clicksaloni	human
@cesarvaldivia87	org
@RolandoFrancoG	human
@Stungun_Shoji	human
@RomiiRuizDiaz	unknown
@makcuiwen	human
@JohnHendy	human
@ckhaslingfield	org
@rustandstone	org
@Dyra9Ndrh	unknown
@Foodwatch	human
@Caravellebcn	human
@lighthousetaiji	human
@ZuzanaJochman	unknown
@EATAPAS	org
@thevegantrix	human
@YummyCode	org
@420cams	unknown
@LadyAmaIthea	human
@robcsi	human
@cyberchefindia	org
@AAHotel	org
@SeppyforLove	org
@d7cam	human
@WhatHeSaidShow	human
@MindfulDiane	human
@tatinz03	unknown
@findmecoffee1	org
@_Myracle	human
@Jane_vip4ever	human
@azzafyzza	human
@CarissaJ26	human
@megjunky	human
@shawnmsoles	human
@kayshealthyeats	human
@E_ivashkov	human
@SpiritofBoston	org
@RulerLips	org
@KaylaMaryNizi	human
@StilettoAnna	human
@JanaParengkuan	human
@shococo	human
@WSB_Chiara	human
@Benzito_	human
@robinvmiller	org
@whatsiegesaid	human
@Tahmeena_	unknown
@LocalDinesMaine	org
@patriotsgrl2187	human
@ragdollia	human
@INDIOnapolis500	unknown
@LilianLils	human
@bhags227	human
@TheCockInn12	org
@evan_CD	human
@BrownsMansfield	org
@rdfreak	org
@csgazette	org
@siscaps_	org
@da_goodman	human
@TheBeachCafeNYC	org
@KZiniJones	human
@yoda1librarian	human
@bullyred	org
@joyhealthyeats	human
@iswanlims	human
@Threadznshreds	human
@trollson07	org
@allthewaydriven	human
@JusticeSadie	human
@myhealthydxb	org
@SaluteEspresso	human
@ParkPlazaMex	human
@ralphnuara	human
@LepachaZamalek	org
@totto4114	unknown
@stormie_sikb	human
@rosariojennifer	human
@AleatoireMtl	unknown
@ARawsomeVegan	human
@CzesawaNowakows	human
@L1a111	org
@QuirkyJo	human
@emzleth	unknown
@bernieshoot	org
@TheLabourofLove	org
@roastedbeanz	org
@inahor_itis	unknown
@Reuel_Williams	human
@Andrea_btw	human
@TavernCo	org
@SupNoodleBar	org
@vi_hotels	unknown
@AnujaSelvakumar	unknown
@blockbxhyo	human
@tableKY	org
@yummiaaus	org
@HFHealthyLiving	human
@TownHouseItaly	human
@ericahelmetag	human
@chopshopNH	org
@Chauncey5456	human
@TheTezzyFiles	org
@ReinventYourDay	human
@mrs_arkhipenko	unknown
@thecanuckcook	org
@inDEPOKcity	org
@CafeCantataSD	human
@jillianmack	human
@SVisitas	human
@scrummyclub	org
@gluttonsplate	human
@Wedding201405	human
@glushakovaaa	human
@chastie11	unknown
@chidefprgirl	human
@lena_iksar	human
@tavernonjane	human
@mcmorgSoNiA	human
@kobeyaki	org
@jsantana203	human
@VickNagra	human
@bogartsdoughnut	human
@chocolateonemse	human
@CatalinaInLA	human
@CMCuntisModa	human
@BBJAZZEVENTS	human
@NateNepo	org
@georgianacsl72	human
@Vranzaa_BB	unknown
@Kallia_Belieber	human
@puro_sigoto	unknown
@shes_got_soul	human
@ElvanaNovandy	human
@MelianaLesmana	human
@ulisesortizb	human
@ThBagelEmporium	unknown
@RustlersOnline	human
@stilize	human
@LakotaLeo	human
@MaggiosCafe	org
@ShaniseCompany	org
@LaLaMelodic	human
@weFATBIKE	human
@urisheedy	org
@HeartMindAction	human
@ElmiraSF	org
@ExisM	human
@TasteThatHealth	human
@jjayfive	human
@knowyourproduce	human
@gleamssunshine	human
@Farah_Sorayaa	human
@tagoyumi	human
@LuckyMe2k	human
@da1don	human
@arturotappin	human
@Peady	human
@amandaeatspaleo	unknown
@Kandi_KayXXX	human
@Dee_bestEVER	human
@quicktripto	org
@SmTAdbS	human
@PamelaVarelas	human
@ClaDagostino87	human
@perrif48	unknown
@gabb241	org
@cutejappina	human
@NelAllan	unknown
@ImMzKennedy	human
@douyetheartist	human
@kellykhy	human
@fabriziospizza	human
@Miss_Busssy	human
@matteodutto	human
@yvevon	human
@MartysMarketPGH	human
@hiro_iri	human
@samanthadjb	human
@Kempature	org
@RodBarros999	human
@LuiseWoldt	org
@laraslaras	human
@fly276	human
@RitzAnnSantiago	human
@sushitimecz	org
@Q_CarteBlanche	unknown
@tangosl1	unknown
@BRXBondStreet	human
@RebelBoca	org
@SJLove2Wrap	human
@fitz_92d	unknown
@RochelClemans	human
@thescreentv	unknown
@streeteatsptown	org
@SmokinJim52	org
@AwwJoAww	human
@OVillakop	human
@AbeerAlmaazmi	human
@WholeHealthDork	human
@yunezaa	human
@ShaikhahMghrabi	unknown
@Locosxlamoda	human
@jzaskorski	human
@FayLiz1214	org
@victorjung	human
@hepburnandgrace	org
@amelladee	human
@HICKSONHOTNESS	human
@SabaToGo	human
@AmeliaYaron	human
@RADFoodTrucks	unknown
@SuperBeaner	human
@pacosaustin	org
@AMtravenous	human
@becomingpopi	unknown
@FoodBlogDBN	org
@BabieCutely	human
@TheHammeredLamb	human
@TwitRome	human
@GinaMungiovi	human
@aimanmelon	human
@YogaNFitness	human
@PNPJazz	org
@Tehreemm412	unknown
@NextMMORPG	org
@DCRBB	human
@Debbey_Deb	human
@Zhaklin	human
@ShaniaSuperlove	unknown
@marvinrm	human
@RamyAbouRjeily	human
@tobydaily13	human
@adorkablii	human
@toptierpastry	org
@BibigoUK	org
@Wheildons	org
@1985luckygal	human
@cinemascapes08	unknown
@axxessdenied	human
@Winner_TF	org
@pnj777	human
@MichaelDaniel_	human
@UltimateLife01	human
@6TricKER9	human
@megat1186	human
@shayat17	human
@serraunay	human
@CharPower	human
@MELVINAIVANA	human
@RRPartyBites	human
@VitaLivesFree	human
@kimbyoungwoo	human
@hunahunatuna21	human
@WeightLoss_LA	unknown
@kujatelkutat	human
@E811	human
@yoursassyself	human
@NotJustBagelsNJ	org
@PoeticStarChild	human
@enzomondejar	human
@chrisraposo13	org
@ankiii_Hoshiaki	human
@xoclate	human
@georgia_flower	human
@Amlia26Maria	unknown
@boxesandjars	human
@hilaldokuyucu	human
@luvdabeach33	human
@TasteMarin	org
@chitjuan	human
@DogsSing	org
@JustinCasipit	human
@yakochi67	human
@shahida_bakri	unknown
@MsWorldNV	human
@happyzeta	human
@djTEN_JP	human
@AmyUys	human
@Labonnetablesd	unknown
@Thalappakatti	org
@sarahpetchell	human
@Jennii_1997	human
@TatInspiration	org
@byGinaBeckford	org
@clotheshorse90	human
@FreeMindz	human
@BosiDiego	org
@bklynboy8810	unknown
@BABEMAGAZINE	org
@AmyraMalik	human
@orange2cv	human
@digitalgali	human
@ComunidadAvion	human
@SweetNosh_	org
@FM4URestaurants	org
@theandreasays	human
@judicorriveau72	human
@CrzyBeeautiful	human
@libbunnie	unknown
@cellz100	unknown
@code_no5	human
@RitchStyles	human
@Ap823_	human
@PKNUCKLEMUSIC	human
@monikwu	human
@boredg1rl	human
@merchantboston	org
@janicet001	human
@HipHopBrunch	org
@foodbysssourabh	human
@0wyn0	human
@AdyBoy65	human
@GRUBMCR	org
@GordonRamsay007	human
@enflammee	human
@CarlosEchanove	human
@marthamora58	human
@thelifewardrobe	unknown
@dhanix	human
@GenieGore	human
@somepigseattle	org
@11sb17bb	human
@DistilledNY	org
@yovani_nene	human
@jane050290	human
@JessieSophia_S	human
@RCafeBernabeu	human
@LiangChiaYu	human
@PlayHardGetFit	human
@robertreginald	human
@TasteGhana	org
@AMBaker11	human
@bams_1606	human
@ZestoRestoMTL	human
@NeuvooMarCha	unknown
@wingFrog	human
@ronniespirit	human
@ITSYAHBOYVERSE	human
@FashionFlakes	human
@Katieeeeeeb	human
@Commercial1859	org
@kim_yulia	human
@LittleRedAMRO	human
@tiurtobing	org
@ZodiacJo	org
@happenstancebar	org
@Miss_AlieMakeUp	org
@lazy_reiji	human
@FootballersWine	human
@NurulAffiza23	human
@QueenaWan	human
@ELL_DeviLL	unknown
@ronhulst	human
@goLadlePhoenix	human
@ELGuenther11	unknown
@rlewisphilly	org
@CrispCooking	org
@LillianEdmiston	human
@TheBlissfulChef	unknown
@ehmstrikesback	human
@forbidden_rice	human
@BobbyByrnesLimk	org
@SuperNoodleRach	human
@TheHusbandInTow	human
@KBonarrigo	human
@OllyneApple	human
@dentphan	unknown
@KarenEManning	human
@Inalovesgeeway	unknown
@BucksHeadInn	unknown
@JohnstonJoanna	human
@dunjacvjet	org
@EATFITLONDON	org
@meltingpopote	org
@wyld_free	human
@11oct05	unknown
@tanya_nuchni	human
@STKWashDC	org
@daylesfordlad	human
@LuneTa_Lunatica	human
@RamonS17	org
@KitchenCaveman	human
@ChandaPlairBlog	human
@ArjesKitchen	human
@SAMBALKLASIK	human
@OmarM_oreno	org
@mrvietz	human
@FABMediaSF	org
@canadasbest100	org
@shirley_liem	human
@StevieBarbee	unknown
@EveMartineau	human
@QueenimoImaniah	human
@afdstudio46	human
@hwarr310	human
@JohnnyUgly72	human
@jennlacson	unknown
@xustyle_	human
@myvegfare	human
@the_twenty2	unknown
@BryanPezzone	human
@msddxx	human
@xprmntclothing	org
@cookwithchefs	org
@Tatt00edF00die	human
@ArunKlangMickey	human
@Cua_MuahNunley	org
@acts0936	unknown
@iyakamae	human
@nickiedegeorge4	human
@slimmingworldpg	unknown
@BrasilKiss	org
@iamRoxiie24	human
@dextrerium	human
@empadabrasil01	human
@GaiagdnessFood	org
@yeniraboca	human
@Trattoria_NYC	org
@joselop44	human
@sheyx	human
@CederbergTea	org
@Jenmack88	human
@yimt15	unknown
@himariella	unknown
@AltarDeOracion	human
@malicom58	human
@yuechan0629	human
@Gayot_Chicago	org
@makkulaus	human
@BerlinSoriano	human
@NoraRoslan	human
@DesrineLove	human
@TheDelishLife	unknown
@hulaangel21	human
@Gydood	unknown
@TLJ238	unknown
@NeuvooIndianapo	unknown
@SVWineList	human
@honey_ninik	org
@satoimotoimo	human
@rif_786	human
@chilkathaiku	human
@lulut0xx1c	human
@fabiananicora	human
@ThisGirlCanEat	human
@alanskyo	human
@SharjahRotana	unknown
@LadiesDC	org
@thecosmeticmag	human
@nousernameidea	org
@JavonHilaire	unknown
@equisele	human
@SupperLondon	org
@mikedopanda	human
@FineLivingA	human
@Amarelo_Hotels	unknown
@GinnaCastillo	human
@charisadee	org
@lolitashowbiz	unknown
@Xandra_Carcas	human
@akisada0717	human
@jeewanthihe	human
@nycdukemarcial	human
@whimsypixy	human
@mommyknowszbest	human
@AnnaGlasspearl	human
@omarjmc	org
@OLDABBEYINN	org
@FreshiiUP	human
@cassandrafayh	human
@trufflesfoods	human
@Karolineloca26	org
@mikclassic	unknown
@Nevathend	human
@MissMunaIsmail	human
@RadaCutlery	org
@GossipGawk	unknown
@39RakuRaku	human
@qweboobusiness	org
@AlayMet	unknown
@NadineAmmari	org
@yanababy1201	human
@armanplacido	human
@KaisaKaisaKaisa	human
@crazyadventures	human
@winnywan	human
@CestleVie1987	human
@Ashghalouna	human
@MarzBendol	org
@dishuplove	human
@HerbyMendes	human
@afizionau	org
@ShopWest4th	org
@saraWIMM	human
@MoonGardnStitch	org
@MissCruzzz	human
@MarketingRxCa	human
@ggwinstead	human
@preppyschool	unknown
@Milele_FM	human
@a_imel	unknown
@bellavivere3761	human
@epicentrenews	org
@packgreg	org
@xxemilyxxm	unknown
@AhmadAlAreef	human
@alfonsocuellarb	human
@JoeyHndz	human
@KinKinKel	human
@alessiosanzogni	human
@vsdresscode	human
@sessanta_nyc	org
@NewportBeach	org
@ladywolffcom	human
@Annekaji	human
@Yellowknife_RT	human
@thewh0lestory	human
@NeuvooElPaso	org
@Badbadkitty75	human
@YuShengHuang	human
@LoveliestFood	org
@nima66kathmandu	human
@Nixon_Randy21	human
@TheCakeAround	org
@alexsign	human
@natuuduarte	human
@niaokada	human
@andrewdoak	human
@Munzin	human
@HealthyCdns	org
@DineAspen	human
@FrolickFoodista	human
@middlesexchiro	org
@TheParlour_W4	unknown
@penthousephilly	org
@AlwaysTheRiver	human
@antiarthritis	org
@Quinsy88	human
@Munch_Ado	human
@ecourtne	human
@Jamiesanssuchan	human
@Mizzcacerez	unknown
@VickieIronStone	human
@emmalbrown1	human
@BistrotBruno	unknown
@credenzagastro	org
@OC_Photographer	human
@JesCaMZ	human
@GreshamMadhan	human
@TheMikeEllis	human
@ChefMichaelNyc	human
@MikaelLindfors	unknown
@00upskitty	unknown
@PrettyPoshOMG	human
@SRVelez19	org
@Mapolatoo	org
@europeansoul	human
@WhyWholegrain	org
@autosgames	human
@kobelcong	unknown
@FireflyRaine	human
@yellofly	human
@pamjaochico	human
@BrentBryleBrian	human
@Q43_Dubai	unknown
@tracykontos	human
@IsmieZabitha	human
@DanielC0rdoba	human
@jonasomandam	human
@nik_pascal	human
@ripper91176	human
@numidiet	unknown
@ofarahzakio	human
@DelcietT	human
@kj_gastronomic	human
@brightonstation	human
@RamenLoveApp	human
@putrichriss	human
@TheStylelicious	human
@Kevin_byDesign	human
@Crispy_Crepe	org
@gooq	human
@pomegranate202	org
@DonnaONeil	org
@kristineyunny	human
@LaDolcerie	org
@AnnaFelkins	human
@CelinJuan	human
@TalkRadioChick	unknown
@ulan_RP	human
@LeslieLauretta	human
@marinako1103	unknown
@Sheyla1124	human
@EjaWillP	human
@AuBonPainIndia	org
@LilCED50	org
@TrisheeOx	human
@TheLifeOfLuxury	human
@modernmami	human
@SpencerKarter	org
@BingeAudio	org
@VeganJoanna	human
@dustinduchoang	human
@robynyoukilis	org
@kibum_1515	human
@Singers_Girl	human
@funfitlife	unknown
@icome_undone	human
@Fabio73523462	human
@Irina_a_Bogdan	human
@serevanNY	human
@DanforthEonline	org
@HotelBotanico	org
@YnavAvlis	human
@IannysEyes	human
@CikHaf	human
@belmontparksd	human
@ozhyquenz	human
@kaswaraibnabid	human
@eisenhowel	human
@ronmad82	human
@Empellon	org
@labellarosebaby	unknown
@TulumCantina	org
@LuciaTassan	org
@Pazzo_Mia	org
@LinwoodsFoods	org
@Annemae03Mae	human
@LaBlues	human
@PurvisRobinson	human
@Elias_Hallaj	human
@s_sadoughi	unknown
@AmmoyesMusic	human
@CircusStars	human
@RegentsCatering	org
@inBOGORcity	org
@MsSandyRivera	human
@SusanPainter	human
@baluarte	human
@gulenaysuer	human
@PanosBelgium	human
@b_ccf	human
@RangeChicago	org
@pwincezzolive	human
@TheCityGuide	org
@SkinnySouth	org
@badboybutimnice	human
@clrhuth	human
@beinglittle	human
@bcece2	org
@IAMWASHONE	human
@lilyjoy44	human
@shah_himanshu	org
@HeritagePlaceSC	org
@RedOwlTavern	org
@yourbeergirl	human
@KitchenQueer	human
@LarrySchwandt	human
@jewen73	org
@jilliwillixox	human
@justbeatrizfox	human
@DJSom955	human
@Galvin_brothers	human
@inthequeencity	human
@Gingy91	org
@aztecdinero	human
@Teamtoronto_	unknown
@teriteriany	human
@iDonjeez	human
@marianam0nteir0	human
@09JamesDavid	unknown
@NotDaSubwayGuy	human
@Bunnipunch	human
@phadke_abhishek	human
@ninongs	org
@cooklikeamac	human
@Goutdfood	human
@ponpeeraya	unknown
@DeeBarretto	human
@TTLayne1	human
@OrderEnvy	human
@4closure2frugal	unknown
@PrettyInInk_79	unknown
@MMCKnoxville	org
@AdrianMrowczyk	unknown
@Kilner_UK	org
@oliolatenight	org
@JamieJonesPure	human
@missmayawolff	human
@StepHaig	human
@MissSarahHardie	human
@Atlantic__Hotel	human
@Elialopez	human
@AustinDorman	org
@DerekKaye	human
@beebuy_0723	unknown
@oscarbrioso	human
@SohoGrandKelley	human
@Alina9465	human
@yigittekin	human
@JOEtb57	org
@alan9304	unknown
@jashmiine	human
@DekontiJewelry	human
@NeuvooWaco	org
@PROMOCHICS	human
@JulieBlanner	human
@Oksana_UDCH	org
@UrbanThai	org
@Kimttk	human
@MrsStares	human
@iamscottscott	human
@singletraveller	human
@corallista	human
@SnackIndustry	org
@Lialeutik	human
@morphettmoo	human
@abbyluy	human
@flowersfablifex	org
@CHENGBarney	human
@charismatones	human
@aleksandra_3	human
@CPennParent	org
@SusanSalzman	human
@RWKwong	unknown
@AllisonCGomez	human
@AhmedElyas_	human
@Jayproman	human
@karaburns	human
@MisforMarcy	human
@perfect_zxyn	human
@EddOCC	human
@leeticia1992	human
@BarSoapBrooklyn	human
@ilovefloridavn	unknown
@mike_mellish	human
@griseldachaoz	human
@ldbeme	human
@dj_volYUme	human
@AJP_Nyandere	human
@KLoveontheway	unknown
@FitMittenKitch	org
@elekta_gulf	org
@miraldinho10	human
@fashiongap11	human
@Yuki0824s	human
@nuybeauty	unknown
@RekomendasiMe	human
@_AniHaq_	human
@ohveryspecial	human
@Le_Casey23	human
@Witney_WestOxon	org
@mannafoodwirral	org
@BridgendForum	org
@jamietwl	human
@TonyKayouka	human
@Masa3879	human
@Cambo_Luv	human
@PositivelyManda	human
@mafephoto	human
@FoodAndDrink14	org
@laniecraig	human
@IHEARTVEGAN	human
@sassyfashions	human
@HenNightNews	org
@TakeABreathR	org
@DamsonAndCo	org
@aweSAMnes	human
@LubomirSokoowsk	human
@YesMomCanDoIt	human
@DJIntence	org
@Alexz406	human
@dorsburn	org
@lisastarrstyle	human
@jordular	human
@Madame_Asha	human
@SyazwanBrown	human
@orlyxkatzroy	human
@Guntur_12	human
@fotozbranek	human
@Modaysh	human
@MidNyTe_TeeN	human
@pinongrill	human
@mojojomarie	human
@39M1h0	unknown
@NewksCLT	org
@alicomps	human
@NatasyaNadyaa	human
@potter87	human
@skinnedcartree	human
@suciverlaan	human
@Workout_Hunny	human
@HideakiNii	human
@Chef_Sharon	human
@RiadDaricharq	human
@lik5n	human
@tinkerbell_g	human
@AllTangled	human
@thetruckingmav	unknown
@PhillipAmstel	unknown
@CocineriaMX	human
@starivers1980	human
@247ModernMom	human
@GabsCR8	human
@dopechick215	unknown
@niclisnextdoor	org
@BubuCrichton	human
@WAMgirl	human
@Vir69Arg	human
@xoDarlingReidxo	org
@lukegarnz	org
@Nutrisimo	org
@samgrayson3	human
@Sadie_Sweats	human
@missmissa85	human
@Stormy_Perez	human
@FeedMeDougie	org
@vasim777	human
@thisissanty	human
@ShahzroyAkim	human
@Arthur_B2schwar	human
@lurvelemontea	human
@fullupcious	org
@AhYan_Superman	human
@KixTraining	unknown
@JessicaM_PR	human
@BelLee9	human
@LudoBitches	org
@REXTEC2014	human
@mao_gonzales	human
@ppg1974	human
@benjahcasper	human
@Kru_Gong	human
@TheHippieHut	human
@julia_fontaine	org
@Media4Podcast	human
@just_david17	human
@minsd	human
@norhalid	unknown
@bimsibolang	unknown
@djpain	org
@LOVEmesaysFOOD	org
@400moms	human
@expoldmontreal	human
@tomatofooddrink	org
@SushiBoyUSA	org
@LaBellainGhent	human
@jensshizzle	human
@MLMelectroman	unknown
@SammyShummo1	unknown
@cactusclubcafe	org
@NatalielnsL	human
@BorderGrill	human
@JosefaTT1	human
@NeuUnger	human
@BigTreeFarmsUK	org
@9thWardLondon	human
@thecookingblog	unknown
@GoodFoodNewJers	org
@nin8me	human
@gauravgjain	human
@kirstyba	human
@CiroCaldieri	human
@tapastakeaway	org
@Nans12J	human
@Rebecca34850081	unknown
@jninewhat	unknown
@ms__msz	human
@9HarryEstrada	human
@cinebistrot	human
@MitraBeautyYoga	org
@krokodilbursa	human
@the_panzerottis	human
@hooray4boobies	human
@wolfestavern	org
@AnnaBelleBuyse	human
@slabster13	human
@usgingerCA	human
@FlyingJai	human
@MeudaDamia	human
@hernandezandre	human
@Pfsaienni	unknown
@girlinaff	human
@ROSYLEETEAROOMS	unknown
@nabbyha	human
@ricky4025	human
@DwainLeland	org
@SterlingBizNet	unknown
@angep1969	human
@tjamaicapogue	human
@FitCrazyTV	human
@GussBBQ	org
@welovepedring	human
@madebysweetheat	human
@FaridKader	human
@TeamUpcups	org
@MIFUNEdumaguete	human
@ItsUnnieBella	human
@SearcyStPancras	org
@1MeditationTime	human
@jinquimpo	human
@_ArAcks	org
@SeriousWog	org
@DanDaliy	human
@ellieguitarstar	unknown
@WiseGuyFit	human
@travelgogirl	org
@traderjoesinsid	org
@BenNCarrier	org
@NolasMarket	human
@sally_1228	human
@YummSnap	org
@BaconBikerSam	human
@abdallahchef	human
@sendysands	human
@susangcl	human
@shivashafaghi	human
@LynnSZ28	unknown
@BeautynBumpNYC	human
@CLAFOUTITORONTO	human
@eddyliao2	human
@PrincipledHCS	human
@cleggy23	human
@RahmadiPT	human
@goLadlePortland	human
@CarrieHill	human
@NataliePalombi	human
@dilaariff	unknown
@luismphotograph	human
@EurosparMilford	org
@tedward131	unknown
@lulubrownskin	human
@BeerlancerUnion	org
@JustJingle	human
@apozzack	unknown
@smart_bn	org
@FragataUK	org
@JohnColaJr	human
@mindieadamos	human
@onesweetmess	org
@KevinLengerich	human
@ritefitness	human
@RLRealEats	org
@hindelhassan	human
@JaylanaBryan	human
@EverythingEvie	human
@romanospizzeria	org
@manleycom	human
@arv_ma	human
@karentham_hbl	human
@BettyChristina8	human
@TheGothicMaine	unknown
@McDonaldsCyprus	human
@JuicySecret_	unknown
@MadeMyselfDizzy	human
@mrgeorgechan	human
@GarrettTurta	human
@hssainGh	unknown
@meeshybelle0205	human
@KeeslingMary	human
@RavenswoodQ	human
@NYCPremClasse	unknown
@DijeShintaRusli	human
@mey_chen0904	org
@giomorimilano	human
@ChaChaMilkTea	human
@StyleSheenie	human
@ezratepania	human
@zicococonut	org
@evelinecandra	human
@dinalucille	human
@TheRitaGarcia	human
@Aannie_W	unknown
@charne_marwick	human
@themommyfiles	human
@BrownandWhite1	unknown
@BecL6	human
@WhatTheL	unknown
@WTFab1	human
@composio1	human
@MrJanAllInOne	org
@Pepamint83	human
@GuiiCabrera	human
@ARMHC	org
@aimeedavis89	human
@ShopeuZenCavale	org
@thebestfoodblog	org
@AprylElectra	org
@ChefMireille	human
@Amanoonaise	human
@apfelmus5	human
@MissBoomarang	human
@liquiteria	org
@jarrenm	human
@jaytronzero	human
@RensonCL	human
@w_lotte	org
@carolinacevada	human
@JeriLowrance	human
@feuille_dechoux	human
@HeatherSchultz	human
@Amaribe_bmd	human
@rindAnriani	human
@JadeQKJones	human
@SilkeandCoLtd	org
@KimBlossom	human
@TheIndoreRocks	org
@zocalotoronto	human
@BevVysaidx	human
@Sweet_Liqueur	human
@missgreedypig	human
@KokioRepublic	org
@808fix	human
@mixmasterb	human
@mintfitdelray	human
@erikacantor	human
@Grangerandco	human
@medibank	human
@PigsCanDance	human
@moomoof	human
@rajtamang	org
@aidanvalin	human
@ChefXChangeCXC	org
@NHATPUKMITH	human
@Dhanarajtweet	human
@N_LuvWithAvamp	human
@AlDonte	org
@yunita_bong	unknown
@artisanparlour	org
@Terminalinc	org
@bella_pinker	human
@Orangeville_ON	human
@MisturaCA	org
@benugo	org
@BrittanyAMonroe	human
@marystamales	org
@wnicjames	unknown
@nuvofoodies	org
@theindustrybar	org
@jwd4272	human
@nleeder	human
@desiredone72	human
@sweetieblade	human
@CANDICE_COSFIN	human
@mginnett	human
@GoogleGlassGram	unknown
@materiousbig	human
@LaceyNashay	unknown
@xjentotx	unknown
@KulinaryKeri	human
@Berkybear	human
@GlympsesOfMe	human
@amutomo	human
@grayskies_	unknown
@JaMaLisKING	human
@dith_bam	human
@GoGoFreshFood	org
@djlissamonet	human
@StriveFItnessNJ	human
@caitsbeautyblog	human
@AzardeenRameez	human
@Tonsrescue	human
@BelDragon_C	org
@sarawakbot	human
@moco__o	org
@doririn55	human
@ShipInnBristol	org
@eiffeltowerpix	human
@JustinaDaDiva	human
@JoseNiceDreams	human
@chieyotachibana	human
@Jamester119	human
@AkilaPetite	unknown
@RalphTheDefier	unknown
@Harvest_GM	human
@fixmyweight_org	human
@nyanta_dao	unknown
@oldstrathcona	org
@BarillaAUS	org
@MirrorLakesElem	human
@StressFreeKids	human
@TheGristMill_	human
@tessaknaeps	human
@HealsUK3	unknown
@siShingalinG	human
@PrettyHomeOff	org
@Strangefruite	human
@BlueOsaYoga	human
@YasViceroy	human
@twittoroscopo	human
@PsychoRyuu	human
@Riza_G	human
@theprince23	human
@HawkMenard	unknown
@emi3nem47	human
@itsyourkryz	unknown
@Blimbu	org
@Davidsteyn	human
@iivylau	human
@gra_246	human
@mendozajpm	unknown
@Leatherssss	human
@saaaaala1	unknown
@dwight_crazy8s	unknown
@EBONY112003	human
@ConnachtHotel	org
@stonefiregrill	org
@dawn_emans	human
@Snack_in_Box	human
@WeightlossAdven	org
@EyelinerGinger	human
@chezKimJoelle	human
@qeepgiveaway	unknown
@LaQVrai	human
@ChottoUkGM	unknown
@sg_promotions	org
@FoodTravelist	org
@coffeers	human
@malcolmeggs	human
@cahowell1956	unknown
@Writerboss	human
@zazoomblog	human
@neilfergie	org
@FoodDaddy1	human
@EiytaYed	human
@WhiteWaterlilly	human
@Nadinasfitclub	human
@elpoll0loc0	human
@pieology	org
@SrJCLORENZO	org
@Thekifchicksami	human
@PEIFlavours	org
@RosettaRozay100	human
@TerraceEatery	org
@kuroobisan	human
@chef0211	human
@thenashyyc	org
@cornbbg	human
@andray93	human
@toddlersurvival	unknown
@thenumbernyc	org
@Clif_FoodTruck	unknown
@Mazenat106	org
@darlingmakeup	human
@KassiusKlutch	unknown
@boborestaurant	org
@bodywrapsbymike	unknown
@menelluin	human
@LunchePointe	org
@studiomasruae	org
@anh_thule	human
@bhatdixy	org
@dj_showta1212	human
@Ao_aunaun	human
@StephVeeGee	human
@ActionGMusic	org
@bourneexplorer	human
@kingjepoy	human
@ValeriaLennon	human
@NKubanMinton	human
@karlyhoney	human
@jegr24	unknown
@agonzalesvigil	human
@grandtrunkusa	org
@capitanmo143	human
@caitycaitcake	human
@katie_joanna	human
@SavorySimple	human
@RainbowInn1	org
@EdRamoso	human
@eramirez0412	unknown
@Shuomii_Life	human
@SheilaLeaSoha	unknown
@AliSue	human
@locali	human
@AlyssaJones624	human
@BlackMamaStudio	human
@Haferlgucker	human
@itsberyllicious	human
@p_riaella	human
@FreshThymes	org
@VickyJohnston	human
@JojoMua	human
@mack_zerniak	human
@abancommercials	org
@Mrs_Monalisa941	human
@Jacobs_Finest	human
@Conecepts	human
@OzzieOzcan84	unknown
@Hyukderp	unknown
@DlishEats	human
@NeuvooHosUS	unknown
@monalisafrechet	human
@iBilians	human
@cattomazstyle	org
@driftlessfood	human
@PeytonandByrne	org
@Emilie_Ros	human
@LauraLaverty	human
@bwlrjim	human
@i_am_ferny	human
@DivasKW	unknown
@BrokeAssGourmet	human
@sapphyness	human
@Jothetartqueen	human
@BBBCLT	human
@clusterqueen	org
@mezzobg	org
@Lyfzbeautifulll	human
@miss_ng_	human
@justinmelgarejo	human
@steff_anderson	human
@Gaurai1984	human
@chichialamode	org
@FLeXxX_	human
@BlueMamba24	human
@PeggyLeeLoves	unknown
@AsmaKhan06	human
@TalkingMomcents	human
@LondonSocialeat	human
@OpenTable_DC	org
@sadiqsamani	human
@giul91	human
@Mshamadi	org
@StephanieFestin	human
@ThatIndieWriter	human
@Terrydaviss	human
@luitadorhotmail	human
@GoCookng	human
@jacquejacchong	human
@GiantTeddy	org
@Miami2Boston	human
@erinusme	human
@psuarezlacayo	human
@RichardDalton99	human
@LisaGaluna	human
@StyledbyLucy	human
@Anabel_Atkinson	unknown
@mimiBtran	human
@heilaSA	unknown
@MissDowlen	unknown
@SavvyCitiZen	unknown
@NeohErin	human
@BWaltDotCom	human
@Zealth_Life	unknown
@itsmunchbetter	org
@SyscoCTX	org
@ShieraElena	human
@JulizaSusana	human
@bertoandkwala	human
@CreaturesStore	org
@corsinonyc	org
@walles_spain	human
@allynz_rapz	org
@wireuldongdong	unknown
@LeToiny	org
@metalgod41	org
@carla_birnberg	human
@OntarioCulinary	human
@FratelloCoffee2	org
@MannasNathan	human
@annieeezz	org
@onespotcare	org
@TeamVernonJ	org
@JustBeFamousUK	unknown
@Pricklypigco	human
@Pisimel	human
@trendaporter	unknown
@EmpressBleu	human
@manage_it_right	org
@CoDIRECT_BIZ	human
@mrsmagovern	human
@ChantzSchoonbee	human
@AshieshShah	human
@bigmel	human
@king_msu	human
@PompanoCC	org
@HeyDuRock	human
@alannurhadi_	human
@EndaBettis	human
@RhondaHenninger	human
@EsFactory	human
@annasanx	human
@Vintageclash	human
@albertowhernan	human
@Homeodriqbal	human
@SuperCouponLady	org
@dessy_nugraheni	human
@mimsaysok	unknown
@BespokeBites	org
@IvorGoodbody	human
@ThriveFit	human
@Dianeee2544	human
@fennelandiris	org
@WINESofWA	human
@f1kr	human
@ldsfiles	human
@MontaluceWinery	org
@Joediatko	human
@AshlynCaylen	human
@MakedaGrandPub	human
@TLsFourSeasons	org
@TheHotelStory	human
@nishreenali	unknown
@iDineDC	human
@BadtotheBoneBBQ	org
@nonibelanda	human
@CapeCodGarden	human
@bezetoz	human
@m_a_bg	org
@foodigoesprimal	org
@MajaMax2	human
@kleinerkerl2	human
@nauyuchi	human
@RachelsCuisine	org
@CherriBock	unknown
@SisterSax	org
@fratellaalfredo	human
@renai_ZmFKj	unknown
@MeleFalala	human
@unaenirati	human
@loolkaew	human
@Blaiwell	human
@Foodieshut	human
@AndazLondon	human
@mizuha_0207	human
@sarahforan1	human
@melu_bruno	human
@okadascape	human
@TheSweetCream	unknown
@VerdeCoalOvenBK	org
@AdventurousFit	human
@kcijoel	human
@latinAbroad	human
@personallyglo	human
@theplumpinay	unknown
@TabithaBudiman	human
@CorralesSylvia	human
@cteqqa	human
@SudhansuSharma4	unknown
@Vader_Drummer	human
@calimeromio	human
@markeith86	human
@itzmeeELAINE	human
@LichfieldLover	org
@sproutsnsquats	unknown
@simplyquinoa	human
@TheLongestTable	org
@Mabuhaysitayam	human
@Le_Richemond	org
@phatjasonle	human
@Aschoenthal	human
@inamendoza	human
@paradoxicalstar	unknown
@JessicaMarchia	human
@iLikeitCreamy	human
@BarraFion	org
@TheGatewayHotel	org
@LazyLowCarbNet	org
@hobokenman	human
@HealthyMumsAus	human
@adrian_bacon	human
@zidanuri	org
@HermosaInn	org
@Omni_Nutrition	human
@K_Forde93	unknown
@Marie_Dtrl	human
@noshinoshi2793	human
@CynnamonS	human
@jujuvieira	human
@nostalgia_doll	human
@kcsparkles	human
@BlaireBear89	human
@CentralSH	org
@oliviasartisan	org
@kenziethedoll	human
@DjPeleBoogie	human
@liu_yiyi	human
@toxicbaker	human
@windowinthesky	human
@KayleeMallory	unknown
@RobertoHermida	human
@SkinFitnessAU	unknown
@FabricTwinz	human
@waggycampers	org
@Yanina555	human
@GoldenKinta	human
@DejavuSake	org
@carnival24	human
@So_fiaPretto	human
@eatell	org
@DevilleRomano	human
@TimothyMundenPR	human
@mfbane	human
@lepetitjeff	human
@SpeedyRomeoNY	org
@FreshrEVOLt	org
@Jeffboyaredee	human
@David92707	unknown
@getparadox	human
@balanceflex	org
@DiaMoNdZ_4_EvA	human
@CharmarFamily	unknown
@aizhiwangying	human
@alcontecavour	human
@Piccolino_	human
@Untited_Crush	org
@raceing_car_god	unknown
@ChurrascoTruck	human
@GeelynIlustre	human
@SaveCanadaMoney	human
@LuxiLady	human
@bandbblogging	org
@youdee_	human
@dine365buffalo	org
@NoviL_ajadeh	human
@breadricepasta	human
@winerabble	org
@MR_cj_FLOW	org
@jffrygmzsld	human
@diahdheey	human
@AuVintage	human
@TopoftheMarket	org
@ErikPavezzi	human
@milknhoney85	human
@QurtobaResandCa	org
@connor_p_obrien	human
@mvtweets	org
@Chikawarouw	human
@Kymmie	human
@DOARAT_Shu_Bass	unknown
@Konell	human
@smostasz	org
@SenoritaUlhusna	unknown
@erinamykristin	human
@GNHotel	org
@valelanducci	human
@YashirosJournal	human
@wildestdesires	human
@TheBlindBurro	org
@fiftyjewels	human
@USACP2016	unknown
@NuelizR	human
@dhruboneal	human
@Restobarbeapapa	human
@CreatureNYC	human
@michellehsiao10	human
@janesbond009	human
@MrsBigBooty13	human
@LanshopGirl	human
@darlingsvintage	human
@atastythought	org
@Napoletanaleb	org
@MarcoBenavidesF	unknown
@TerrSiw	human
@islessordinary	org
@tonee78	human
@berylli10	human
@NYGirlCanEat	human
@incubus_doubled	human
@samjoeynobili	human
@lisatrimboli424	human
@PeiWenLim	human
@BridalShare	human
@pandadomonyc	human
@meganyuen	human
@IamSeanDustin	human
@kzell	human
@Henry18m1	human
@ohguysthisisbad	human
@0304_i	org
@ms1an	org
@GetawayGirlsInc	org
@ISTANBUL_NOTES	org
@derekhui	human
@ZabAngelo	human
@HannekeVerstegn	human
@flygirlkpie	human
@SUPER_ESPN	unknown
@AARONS_WORLD	unknown
@HarlowMarin	human
@josefotoxico	unknown
@JudySteenman	human
@EagleW40	human
@FEELFREEATL	org
@beautifullycrld	human
@jackiebastidas	human
@ThatFooEli	unknown
@TanselAli	human
@ef060372	unknown
@yoginiwong	human
@ivanerk	human
@bereza1278	human
@basketmanjames	human
@AM13ROSE	human
@jeniv11	human
@IvyChelsGarden	org
@PeckishPig	org
@ana_rhoda	org
@Superkakinung	org
@tkdkghn	unknown
@hitomin_icexx	unknown
@DancingPoca	unknown
@jforjackieblog	human
@justine_faeth	human
@bvigt_bz	human
@jelovesyou	human
@ni2nk05apri	unknown
@emily2u	human
@AmandaKing2386	human
@fashionwhittman	org
@OMGBethiica	human
@Bigsmokeburger	org
@truckfoodnyc	org
@JohnRSFerrer20	unknown
@94Teruking	human
@iamjelane	human
@donnamrandell	human
@kkmanzoor	human
@SankalpOnline	org
@GetMe_Delivery	human
@ALICIAGOLDD	unknown
@YaraEstrada	human
@GabrielaVerge_l	org
@davidbowieee	unknown
@BUSYBEECAFE	human
@EPassyunkAve	org
@Kuchiiiii	unknown
@FatinLiyana22	human
@karYn_ladiee	human
@JDTRoad	human
@NeuvooDenver	org
@oldmonk_says	human
@GuardianGDP	human
@GooseClybourn	human
@malexan1	human
@Bulbella	unknown
@mainakaseko	human
@VisitHudson	unknown
@FeastMagazine1	human
@GoonerYoda	human
@Bossy_KC	human
@kristinnw	org
@Lucas69060114	human
@Salomons_Venue	org
@AlexRSaenz	human
@turkkonamomi	human
@gateaugoddess	human
@FitBits_	human
@myUGH	human
@YvonneYongIM	human
@nervositee	org
@DWBistro	org
@Photographinya	org
@LazyOwl125	unknown
@BmoreCupofJoe	human
@TheRusticCoffee	org
@GigiLovesDaisys	human
@azianazz	human
@Alza_Liza	human
@meemsnyc	human
@KireStankovski1	human
@dannidanzzz	unknown
@LilianaFernands	human
@gymcas85	human
@Lexi_Fierce	human
@dianneisphancy	unknown
@JessicaErin19	human
@_LOUIStjh	human
@firedog729	human
@jarendubois	human
@parkvine	org
@FREDom2dream	human
@chinnyj22	human
@tyeshantrell	human
@clea_alisara	human
@Juli_Wu	human
@_EvanJC	human
@reyn_baile	human
@AsteronLife	human
@ginosrestaurant	human
@ayuman_tm	human
@yoshi	human
@Mad_Hatter_Tea	org
@DaDa_Burung	human
@iamrockgonzales	human
@ParaliaTO	human
@Izhevsk_life	human
@scorpiopride	human
@dimasfahmirmdhn	unknown
@ChefismQ	org
@88eckham	org
@felisPasseridae	human
@KateAlexandraMc	human
@MegganHill	unknown
@MeghanSaraK	human
@andjelkaducic	human
@DaRealChrisZorn	human
@TFL23	human
@veg_box	human
@kurtreyman	human
@rubyourselfie	org
@ALBee115	human
@arthur8009	human
@ElayneTT	human
@JosephCapponi	human
@bamt21	human
@BrianBrownPhD	human
@itsyhelsanjuan	human
@Elsewhere17	unknown
@Mysukmana	human
@foxyinflipflops	human
@YukaMuraiMiller	unknown
@chefpino	org
@HelenGuyMUA	human
@gr8shout	org
@DanniaMae	human
@Giovanna0325	unknown
@HansonWendell	human
@phoebe_CJV	unknown
@TaisIllan	human
@ITnewsTN	human
@dhedheyhona	human
@fabfitsquad	human
@Heather_2007	human
@chuweeeen	unknown
@RambleSAHM	org
@theserani	human
@revetoledo	human
@SolchaSoria	human
@Rogerandfood	org
@theluxegen	human
@DrGrasshopper	human
@kramerhendricks	org
@BOT78027673	unknown
@zeroisme	human
@cordova72mary	human
@WeeliciousMenus	org
@SkySUBLIME	human
@kckatykc	org
@melikylikeme	human
@MYWISHHUBLTD	human
@gianlucaviola	human
@supermaiix	human
@TAKOZMODMEX	org
@bungalowbarny	org
@mike_neylan	human
@marc_solis	human
@newleafsmile	human
@MarkoMislov	human
@AshaSummer	human
@Cafe_Hide_Away	org
@_caramellove	human
@MundoMCBO	org
@peasandpeonies	human
@n4tly	human
@SeasonlyBlog	org
@MuchMostDarling	human
@JustParis_	human
@masakizura	unknown
@HealthyTips2015	human
@forkdeli	org
@Busymomshelper	human
@Kanni_Kan	human
@CCafenegro	org
@1337_Jay_Mak	human
@PakuHer	org
@kimberlyweiwang	human
@VinePair	human
@SchrecengostKa1	human
@ppkernel	org
@ItsJust_Rebby	human
@thisischloekim	human
@WanderFit	human
@Shamil_Suleiman	unknown
@PrettyGyrlJaz	org
@stefanoparrella	human
@AndreaBenavides	human
@PretaporteaSE	human
@NotaBeneToronto	org
@Cashmir23	human
@OrganizedIsland	org
@JaneEHRoberts	human
@SamKapoi	human
@EggstaticTruck	org
@hall_loo	human
@Chef_Migs201	human
@MayouMayu	human
@AquaStoneThrone	human
@SalmaAR12	unknown
@hideyukisaito	human
@AdelinaMatinca	human
@thekitchenpaper	human
@Sherridacherry	human
@MaggieAttoe	human
@kiansavero	human
@curious_case	human
@lovebabydoll91	human
@TheAbFabPlan	human
@Natalie_Schu	unknown
@mkkngt	human
@casandralopez68	human
@everydayCafeLeb	human
@huei1128	human
@sophiebrothertn	human
@amanda830804	human
@thesuitforme	org
@Liveaholic_de	human
@OldNerdReviews	human
@Soniatyl	unknown
@ViViHuang1990	human
@rjornd	human
@BrightonWOT	org
@CorpusLorraine	human
@oohjulesblog	human
@AndreaRSmith	human
@chinitachubby	unknown
@food8ndtrips	org
@LittleCinde	org
@momma91l	human
@miramanek	org
@bacon_adrian	human
@NavitasNaturals	human
@voiceovergal	unknown
@LousterXpwn21	human
@EnzaLovecooking	human
@BiggFootDeals03	human
@ComtrexSystems	org
@beecreel	human
@waseemshafi	human
@erikoharuby	human
@_SunitaPatel	human
@WhisperAmber	human
@Viaprade8	human
@Alisant_	human
@humbertemuerte	human
@jhon_kazy	human
@miniNeKomtl	human
@MamaCheaps	human
@London__Fashion	org
@docshaui	human
@kreinholz80	human
@ERICA_41_13	unknown
@BlackTieFF	human
@bondappetit01	org
@flavourofbrazil	org
@WorkingHomeKpr	human
@AdeIex	human
@King_Linn	human
@jaythevicious	human
@AureliavL	human
@beneficialbento	org
@CoastProduce	org
@ANNASFRIENDS	org
@McLeodRob	human
@roxypserrano	human
@Luviyan	human
@EspressoYLeche	org
@BristolLifeAds	human
@Rubye1445	org
@Bleu_Restaurant	org
@DineinCT	human
@hacho55	human
@OttawaSt_BIA	org
@Beach_body_Dee	unknown
@Taniapzar	human
@SarahZareen	human
@YouthAwakening3	human
@floriscatering	human
@ambergib	human
@ItsMeDaeHyun	human
@schoenermax2	human
@Vlomography	human
@ShadiMB	human
@AisoBoat	org
@fumikichi2525	human
@IanMemorabilia	human
@Foreverlelo	org
@kikukaken	human
@drinkaanbieden	org
@RadissonAustin	human
@NNourishedKid	org
@Annas_Tube	human
@IamDmaze	human
@renzidoodles	human
@Jimegzz	org
@sandyBmonde	unknown
@claire_jace	unknown
@kuechenflug	human
@NoJokeLifestyle	human
@InfoNobodyNeeds	human
@fennn	human
@DallasSingleMom	human
@LA_OM_Chef	human
@MountPleasantBC	org
@pierivera	human
@BicesterShoppin	org
@Chipilina84	human
@notjustfood	human
@RoarCio	human
@ButterflysAttic	org
@everybodyfav401	org
@rennsi3	human
@crankyyanky1	human
@tetha_ajah	human
@EightSign2014	human
@BravoFrann	unknown
@luishperezv	human
@christieeebearr	unknown
@InstaDevyatka	human
@nimaladasa	human
@daytonmomspot	human
@rkroepke	human
@simplyelenafood	human
@pepefoodtruck	org
@mimimiles	human
@zanCHY88	unknown
@Nanami_togarasi	human
@cmariele	human
@JordanAytch	human
@sdbrewreview	human
@GuylianMummy	human
@EDVPhil	human
@jrm426	human
@lykke_tak	human
@_VincentJames	org
@besto000	human
@HCLondon	unknown
@xXJohnDonXx	unknown
@batchigtwitt	org
@Fattymctubbins	unknown
@SaraGaffurini	human
@ann10mike	human
@Stobzy	human
@pbrfingers	human
@iAmHic	unknown
@SarmanMarlo	human
@Quarmia	human
@aking201	human
@NasxLim	human
@CurlyPeachy	human
@Heatherabbit123	human
@Hola_Chef	org
@meredithgene	human
@ChefDamianW	human
@richNEXO4	org
@RockdrigoFrodo	org
@WhyIsLenguage	org
@LorraineWitte	human
@back2happymom	human
@ILikeUTheBestDJ	human
@NDpropertyM	org
@SantoSecrets	org
@NYCgal8	human
@cafehaven	human
@DJ1period	human
@xtianpanggih	human
@Anna_Shteinfeld	unknown
@mapihermida	human
@mhaine_exoxoxo	human
@BeautyTweets10	human
@PandPFlamingos	human
@MuyLocoTacos	org
@Pearlridge	human
@CBTL_Jordan	human
@Imakeithappen04	human
@canker2	human
@mayutj17	human
@S3xyblue	human
@ManuEla62594311	human
@radicadinoce	org
@marcjsievers	human
@SofiaPali8	human
@AnneIsDyesebel	human
@thebrunchgirls	human
@annabelpesant	human
@atrueloveofmine	human
@thelamuelpinto	org
@peaches8790	human
@RonnethPLC	human
@AnankeQuesos	org
@MauraHernandez	human
@JulBrite	human
@nappy0n3	human
@zukkermeBlog	human
@danielitu1989	human
@elle_singapore	org
@EricaBachelor	human
@bellaMUMMA	human
@noniFairuz	human
@AbdulazizMoe	human
@BrighterDayzEnt	human
@chinablue2600	human
@itsmargarida	human
@marketcafedelhi	human
@VoyaflexVorim	unknown
@dutyfreeshopsgr	org
@ruisy_M	human
@JordanJamesENT	human
@Rexychia	unknown
@MrSukiSandhu	human
@dc_theo	org
@EmInSeattle	human
@charitycery	human
@ZoZoOfficial	human
@Win4LifeWUN	unknown
@conceptmatt	org
@donnafaye1014	unknown
@GORGEOUS_SHAE	human
@JustTuscany	org
@MediaOneHotel	human
@MarisaCAlmeida4	human
@AprilE83	human
@nataliadotw	human
@joannemacstyles	human
@katramirez4	unknown
@Jerrysbarphilly	org
@Jewels_Cupcakes	org
@galsmolar	human
@ika_yessika	human
@mopidav	human
@izzysmiami	human
@royalsaxon	org
@mattyebriega	unknown
@Designworld12	human
@Thara_Wood	human
@bremarie_wesley	human
@pas_de_pot	unknown
@rwodecki	human
@nurkhasira	human
@IneshPutri	human
@MrBrandonField	unknown
@Urosario95	human
@pjferg6	org
@InterConMD	human
@spirocks	org
@martinadandrea	human
@EuJulianaPrado	unknown
@ginzaunley	org
@GlutenFreeG	human
@SanDiegoHRMom	human
@ChickfilaMo	org
@karalinaluna	human
@Esensei	human
@FelicitySpector	org
@cobaltmale	human
@RecipesBySara	human
@Chuan678	human
@pheyriantiLouis	human
@AbbieOsborn2	human
@La_Ley_Lover	human
@Tempspournous	human
@xtintina	human
@mssukeyna	human
@HburgDowntown	org
@jerav89	human
@DamagedCup	human
@DennisTebbs	human
@pickyfork	human
@Jojoblossom1	human
@yenyen1213	human
@BetterBodyFoods	org
@XReflection	human
@MindiEden	human
@AlexisMeads	human
@yennynovitawang	human
@VirtuousTonline	unknown
@SavannahAlalia	human
@KhoroshiyUzhin	human
@MariikaLee	human
@LIJLNetwork	human
@2prcghg_edls	human
@beccisharkey	human
@VKCLUBSHRED	human
@ChefTimMa	human
@NeuvooHosMis	org
@EmilyKleppesto	human
@AgaveNYC	human
@vamosta	human
@markoholic	human
@nhlanhlaMchunu0	human
@PastelSecret	human
@HollandSt	org
@beyondtoastblog	org
@hyveeosceola	human
@LaFarolaLondon	org
@GGoodtaste	org
@SRSGROCERY	org
@LukavilleTw	human
@LeeLambchop	human
@DispatchNY	org
@xbsoonx	human
@UhligIrene	human
@TheRealAivanett	human
@BOZTDave	human
@yukikawai__	human
@vfun69	human
@macariomacoi	human
@CucinadeNonna	org
@utyuu_hhimitu	unknown
@DinaSarai	human
@MDaShaunJackson	human
@muftidakota	human
@chilloutlounge2	org
@treyyy_t	human
@NeuvooHosSD	org
@CeliciosoBakery	org
@30kids	human
@aloysius89	human
@ZombieSorcerer	human
@TheHarriedMom	human
@cricketsourabh	human
@TheCoffeeNazi	human
@SUGARPILLSCLTH	human
@epicureanjess	unknown
@szda	human
@lovelazo	human
@hanaieka	human
@TheYummyBunny	human
@OshunRaNaturals	org
@PMCakaPrimeMC	human
@takuya6B6	human
@renai_M6GAI	unknown
@TrainMate	human
@joycemarco	human
@CapeTownFairy	human
@veike	human
@HoustonTM_Homes	org
@LynnBillett	human
@Primaadani	human
@ItssJimena	org
@CulinaryCapers6	human
@leo_nie_82	human
@MaxBurgerArabia	org
@itsKevMosby	org
@victhorxavier	human
@msmindfulmoveme	org
@phuise	org
@ehmjhay_bello	human
@EvieRock	human
@glamourliving	human
@3lamodaksa	org
@RellBurks	human
@minamiai_dayo	human
@Jayna26Patel	human
@nautica1mermaid	human
@m_faqih	human
@MsVybe	human
@ZitaPita13	human
@SpencerCapelli	human
@gelevy13	human
@TAPshipyards	human
@cleverleys	org
@SBANKS_116	human
@funfundanica	org
@dan1985morris	human
@pizzapluscurry	org
@melissamaples	human
@fancyzahra	human
@hermitho	unknown
@GFNationUK	org
@UncleRhea	human
@mo_na19	org
@ria_gene	human
@KGH2831	unknown
@chyLem	human
@itsaharleyylife	unknown
@Los_TightPants	org
@homedecorhouse	human
@Dbomb252	human
@munequitarocks	org
@hettiegwatson	org
@luxobasiquinho	org
@LondonNorthWOT	org
@Laureline	human
@JulieC13	human
@HustleVision	human
@nidhi_raghav	org
@ProGenSupps	human
@cuttiesteph	org
@sureambeautiful	org
@jmrockz_99	human
@SummersForsyth	human
@RI_Nutrition	org
@PauloWanda	human
@TerillisDallas	human
@LewisOliverFarm	org
@TresHombresUtah	org
@CreateCaters	org
@GreenRoom_Bar	org
@bettylovell	human
@rayskitchensa	org
@LizziieRosario	unknown
@EggsmartCAN	org
@SeatechProducts	org
@fit2014_me	human
@LydiaJaneH	unknown
@GiselleSchroer	unknown
@irachdotcom	unknown
@iprojectinvest	human
@HSUJUDY	human
@iban_lopez	human
@Meridians_SCLH	org
@BreakingBrad__	human
@1117Lachs	human
@WANTEDlMODELS	human
@leiane1	human
@HAtawneh	unknown
@WIDplaymates	org
@BlackBartV8	human
@AyamiKouno	human
@LetiziaFederico	human
@_chasuchan_	unknown
@sarahgal	human
@emma_cannon	human
@ferrum_lady	human
@shinnasuka19	human
@MrDunmore	human
@MANDJELA	human
@AileenJen	human
@yannickmartens	human
@ashenim	human
@CookingGiulia	org
@IEatAdelaide	org
@Kamiya_Toru	human
@Lucresia_Sitz	human
@omowaleadewale	human
@piggywentto	human
@BelleHeleneNL	human
@ergylicious_	human
@LeonReyesOk	human
@EthelsLounge	org
@MillerPhoto	human
@LeMondeLIttah	human
@muuID	human
@blabvla2002	human
@Sweetinbloom	human
@charlottearnoux	human
@HarizRasip	human
@MilaCamnasio	human
@nuckleb	human
@fuoriditaste	org
@Mrs_Leeteuk	human
@djane_neeby	human
@PoomaBby	unknown
@Leandro_Obrie	human
@taschw	org
@AntonyKE	human
@CrazyKidd991	human
@kankodoris	human
@BeautifulyBlesd	human
@ahGrace	human
@AusLoafer	human
@TropicFreeze	org
@5cshell3	human
@gspmumbai	human
@AliceBites	org
@LMHBlog	org
@pamoed_chan	human
@ChinnyD2nd	human
@WelcomeToKC	org
@zynpzep	human
@BeignetBabes	org
@alloftwinpeaks	human
@chiwatolove	human
@JoanneSemaan	human
@cacio_vino	human
@ExploreRaw	human
@WholeFoodsTUL	org
@Fri_Barbara	human
@gorgeousbiatch	human
@karen_lushious	human
@MeiMeiFox	human
@HenriksenErik	human
@Pam_BK82	human
@GeorgeBakhos	human
@adrid111	human
@carlamackenzie7	human
@StephCraveiro	human
@JaclynLondonRD	org
@Cheffwallis	org
@ChefKajsa	human
@bbpdaha	human
@ChellyL131	org
@culhanes	org
@jasond_thomas	human
@alextbueno	human
@Pitopianyc	org
@MissJacquieO	human
@Abby__Kim	org
@vincenzogrenci	human
@_MOMtrepreneur	human
@ispeak2u	human
@ainasyafiqah747	org
@mariobasiliofj	human
@yogaforgirls	unknown
@lifeenjoyer	unknown
@brunch_ec	human
@DosaDeli	human
@clumsydopegirl	human
@The_Melt	human
@SuperSmoph	human
@dolunayerboyaci	human
@sarry30xoxo	human
@MsLunaVictoria	human
@LovePx1	human
@TablehoppingNY	unknown
@1113d0	human
@kpopdbzgirl	unknown
@lizzlemynizzle	human
@FlowerFairy1991	human
@dlimkp	human
@MariposaFit	org
@particularites	human
@suzanna9soccer	unknown
@the_AndrewFang	human
@SandBitchArtist	human
@NAbiLGoOdBoY	human
@Estilozas_	human
@vivekaterin	human
@pickleandjam	human
@NikaKabatova	human
@WFMhawaii	org
@libbyhams	human
@Naturalista_Eve	human
@basexperience	human
@kyshieme	unknown
@PiIipinas	human
@SushiandThai	org
@cminthemoment	human
@IZZAMINT	org
@missy_b	human
@DeliBagelCafe	org
@DiamondSkyDiva	org
@UdosChoiceUK	org
@deagirlfriend	human
@BallsandCompany	org
@SofiaVardaro	human
@openandclothes	human
@slawandorder	org
@nanako919	org
@merrymiaa	unknown
@joyfulsoprano	human
@MandySeymour68	human
@purokareklamo	human
@_noyolita	human
@MrMikesLangley	org
@guelden4	human
@XploreSydney	org
@FoodattheCrowne	org
@tetoversiglia	human
@JamesOrsatti	human
@Peter_Som	org
@WhiskyGirlSport	org
@FabianoGcorreA_	human
@Laurette750	human
@ladysagebg	human
@goLadleSeattle	human
@paopaoAJ	human
@theNaosWorld	human
@ViewWannii	unknown
@PJChambers6	human
@bum0184	human
@FashionQc	human
@blue_chocolate7	human
@KalamiCebu	org
@cesyhateshobos5	human
@cookingwithgis	human
@PJR1223	org
@KiwiInSG	org
@MissKWilliams87	human
@SmokedStreet	unknown
@firkinonbloor	org
@LinderNichole	unknown
@jusunhui	unknown
@WATUPRATTLER	human
@Rae9600	unknown
@BeautySatisfaxn	human
@xiruki	unknown
@sweetsaak	org
@swlottermoser	human
@crazykoji	human
@MzNoWay	human
@Reductionista	unknown
@SbZlee	unknown
@UPGym_Jeddah	human
@changweii	human
@Must_Hammad	human
@iSa_Spain	human
@jolenespatter	human
@MakanDiantar	org
@PaulaEdgar	human
@daisydayz25	human
@MellGadizgula	human
@littledeliapp	human
@annbahri	human
@Up_BKK	human
@sookyu2505	human
@Lisachansok	human
@krayner22	human
@BookingKitten22	human
@YoandraNAK	human
@VicPubMark	org
@khoalitytweets	human
@xShineOrDeath	unknown
@clavicle_po	human
@BridgetOBrienPR	org
@beabethlehem	org
@sonnyb4u	human
@ilbuconyc	org
@ajouni001	human
@peaanutbutterr	human
@aoiKawanishi	org
@madonionslicer	human
@rikkysamsurya	human
@wudi_beijing	human
@NoStoryNoBizz	human
@urbanlejen	human
@hlthyfoodsnmore	org
@UbonsBBQ	org
@iamkimkravitz	human
@julianhosp	human
@dianajasmi	human
@VAlegend93	human
@mayarinrin	human
@CynthiaShelby1	human
@saGEMom	human
@BeaauuuParis	human
@Madisonlondon1	org
@Batistanancy	human
@loutini	human
@fuelledbynature	org
@BestFoodRetweet	org
@teguhzaenoeri	human
@SchaeferNeu	human
@thetamalecart	human
@FatmaZiya	human
@GemmaThomas03	human
@Kavin_Jay	human
@BarcelosIndia	unknown
@BalkissockLodge	org
@MyAFWifeLife	human
@UptownTeeg	unknown
@LincolnSouthBos	human
@EzraTadeo	human
@SkylerHaze	human
@viviensun0520	human
@MsVera_C	human
@maloubet	human
@officialdjmel	unknown
@SHUEDA	human
@colemodel	org
@RMTSweeps	human
@Estebaan93	human
@DJtwiZZysoLo	unknown
@wareiyachouji	human
@happyla333	org
@NickMrnhook	human
@JanetGibson13	human
@mmcokc76	human
@tammybuggs	human
@Getnobetter17	human
@mayurosemaya	unknown
@isiskamaruddin	human
@emmakessler	human
@kamalkant81	org
@korea_info1	human
@adiadriaji	unknown
@sakakikisai	human
@DJ_Blaxi	human
@Lily_mdsalleh	human
@FooducationIrel	org
@franeux	human
@ladyk1921	human
@Ayk_830	human
@philip_tt	human
@_minah24	human
@DEANDHF	human
@marco_ianna	human
@ntawali	human
@DeliaCazzato	human
@LesDamesDC	org
@blakedamon	human
@MrShri	human
@Clamityjan	human
@Laura_Driha	human
@mirandayork_	human
@AlisonBough	human
@NadiraZulkifri	human
@TheAinsworth_	org
@jessica_conrad	human
@MyBeachStore	human
@Deanes_Eipic	org
@gunslingerkeren	org
@estarLA	org
@mariana_tay	human
@MarkDeskin	human
@kayewhiskaye	human
@BrainBalanceUT	human
@DailyBrian	human
@mamitake28	human
@SnackEOS	org
@picjumbo	org
@xautumno	human
@RosaBlancaPHL	org
@theamericanmama	unknown
@spoonfulatatime	human
@023Culinair	unknown
@IdasCafe	human
@oleynykova	unknown
@MariaMosonova	human
@cumisainz	human
@Rolly74	human
@MelissaMarieLy	human
@Roznolita	unknown
@radiogagan	human
@Forever_Val_	human
@EliteCityEscort	human
@GroggyMonday	org
@FlowervineMom	human
@W_Angels_Wings	human
@TheDiningTable	org
@kowyongxian	human
@lucyirv	human
@DarraghZaidan	human
@danny_perdana	human
@Yubal	human
@theColeenPerez	human
@ImmigrantsTable	org
@AttyTating	org
@thechefinthehat	unknown
@naddjane	unknown
@marcellaSheiby	unknown
@onezeb	human
@MonkeyHeardYou	unknown
@ScottStewart92	human
@Nikkiyapyc	human
@SorayaMoraes	human
@enjoyBite	org
@IchaSweetz	human
@AveryDa91305197	human
@DaSaMz	human
@threewishes4me	org
@MissAsiaAmerica	human
@lourileylive	human
@maghrebyat	human
@elmercatglories	human
@Thomas_Ellie1	org
@AldrinDDolosa	human
@Lisa_Marie42	human
@TakingItOneBook	human
@BlondieBlueBlog	human
@STYLEMOM	human
@whereghanaeats	org
@Kimbyloo	human
@RickyRozay3OO	human
@WorthATip	human
@bonnevivante	human
@V103	human
@champ_ion76	unknown
@yukino1230	human
@Laileen	human
@mrRoy2706	human
@MusicWheel	human
@mumobelly	org
@MangoTreeLondon	org
@jjunoah	human
@bronze4u	org
@FultonFish	human
@Raff_Elric	human
@gabs949	human
@FKxoxo	unknown
@ziuremorej02	human
@HENRtYx	unknown
@ShellyBsCafe	org
@limaeduh	human
@AmirulSyafieq	human
@chihi69	human
@annmarieLmt	unknown
@HaseenaRummun	human
@randomanything	unknown
@Arletta_PH	unknown
@gigglejuicepty	unknown
@thedandylionel	human
@lamSanjayGupta	human
@MunchPakSnacks	org
@shakaburrito	org
@grzegorz89	org
@vodox	human
@bishuzenkanpo	human
@broadwayJleVar	org
@LadyLikeDC	unknown
@HaliborangeUK	human
@gab_casagrande	human
@rmiran2	org
@PalladinosEPX	org
@Markos_photo	human
@RobynRozeAuthor	human
@AleMissHooligan	human
@PhilthyRay925	human
@InAPickleRest	org
@hrtsnlaserbeams	org
@priyankamitrac	human
@dailyfitblog	human
@EatGuideBoise	human
@Thiaraa24	human
@LavishtoLite	human
@BayouBeauty_06	org
@MoroccoWest	unknown
@thisotherdude	human
@rikab8d	unknown
@HawaiiMomBlog	human
@ANJ3L1CA	human
@beet_sweety	human
@bluebird427	human
@fashionofmysoul	unknown
@CourtHausSocial	human
@superfoodica	human
@DrewFabolous	human
@FoodPhotogrphr	org
@jasiashley	org
@NenaCastroMtz	human
@msn00100msms	human
@AnneChan2012	unknown
@TeckMeWithYou	human
@CleverEd	human
@scottkingg	unknown
@Frequent2Food	org
@StilesCooking	human
@Balletsteph	org
@TabishaD	human
@PamelaAvery_	human
@fjramali	human
@Gforgelato	org
@monchan0504	human
@kearama	human
@BurgerDogBoy	human
@keatz87	human
@basblonde	unknown
@Musingmutley	human
@spacystacy5	unknown
@LFlexKitchen	human
@James_Mapaye	human
@LaurenMikler	human
@SpiritualHomies	human
@Scottsdale	human
@shiokoholic	human
@yanaabellar	human
@jezzygirl1	unknown
@azuinirna	human
@anaysapusomo	human
@VictorMaisano	human
@feebeeblog	human
@suzannejdean	unknown
@loldoyle21	human
@nao3oh2	human
@RachelYeomans	human
@PixelOld	org
@Muhhtayyuhh_09	human
@vanessamsayson	human
@marsaikegami	human
@KristaK2	human
@clah_j	human
@Randy_Haas	human
@help_pe0ple	human
@Bev25001	unknown
@sarenraj	unknown
@EverythingIEver	org
@gabyohz	human
@TamRagazzi	human
@yuccakusadasi	org
@KamikazeQ1	human
@sherashoib	human
@TonedToWin	human
@emack1790	human
@DottPaolaCais	human
@88thplanet	org
@ItsATotsLife	human
@CatchAnaheim	org
@JaCaBrun31	human
@poupeire	human
@brightstarling	human
@D_BelaSetia	human
@Profango	human
@HonestMummy	human
@Danettesoasis	org
@flynaveed	human
@mutingka	human
@mhdfrzn	unknown
@WYEATV	org
@tpbrown64	human
@AzukitaSweets	unknown
@Boong_Bee	human
@ThiaNugroho	human
@eggitude_daily	human
@AudreyReiff	human
@Seyasanchez	org
@royalmansour	human
@Nigel4750	human
@smaandags	org
@cullen_awitan	human
@realfoodrealfam	org
@silvia_scuotto	human
@Rizzis1	org
@donnyelvina	org
@Its_my_lunch	human
@LebAllWorld	org
@DAlessandrophr	human
@Gilbert8787	human
@xoLuexo	human
@HedgeHogi	human
@RachaelRegan	unknown
@hungrymusician	human
@AsBestRecipes	human
@BoxedWholesale	human
@daydreamfoodie	human
@LyannaConrad	human
@Zenocracy	human
@BillyRayon	org
@TheLaughingCow	human
@artandgifts	human
@AmyGorin	human
@dinnerwfriendny	human
@healthfoodpage1	org
@dsoerodongso	unknown
@LadyLynham	human
@JoshuaBarreras	human
@KatherineAmbu	human
@sisters_secrets	unknown
@deltamoxie	human
@thenudestylist	human
@brekkie_club	human
@ANDRELONI	human
@p61222	human
@veryberrybhr	org
@wehaemeat	org
@LemonandSoul	org
@BuilderofBoats	unknown
@ingenierovalle	human
@MissBirdieJA	org
@allnewshawaii	human
@puspitarani94	human
@denton_04	human
@G2EVera	human
@paintermain	human
@tresjolie2015	human
@setyanindhita	org
@kenakoint	org
@systellak	human
@jony2008	human
@YoungsRestrnt	human
@HoteLuxeThomas	human
@thejackietan	human
@McGregorKatie	org
@KhalidAlrazooqi	human
@Crysta_bell_e	human
@FitArTEE	human
@Rogerio_Kupfer	org
@Ifonka74	human
@Oligiano	human
@SmoothTrapSt	human
@tonyhomme	human
@TranSake	human
@coachnoris	human
@elbornnyc	org
@StorySculptor	human
@lexiquin	org
@syafieqshaari	human
@RustamHuseynov	human
@Reffa	human
@_DRB_Stadium	human
@SiriaPiga	human
@cuka_1D	org
@ChocolateSuca	org
@vinlamperouge	unknown
@evrythngboutzen	org
@dekdakaafee	human
@HubertMayer	human
@LailaSharani	human
@burrp_bangalore	unknown
@kiimberk	human
@LuciaRock4	unknown
@budi_hr	human
@xAleDrugFreex	human
@sutton_and_sons	org
@Spicy_Squee	human
@STAGgerINSgrill	org
@AdrianoVisagie	human
@NAT4THEMEDIA	human
@alvinlowe	human
@k_meaghan	human
@EdgarRivGarrido	human
@RSANOMI	human
@KirstieKae	human
@citybaking	org
@gordonstcoffee	org
@IlarioSemeraro	org
@GraffitiJ3	org
@tara05angelee	unknown
@secondblonde	human
@eattheworld	human
@sofrezia	human
@AnnasHouseUS	org
@ThreeSixtyGee	human
@akb48up	human
@Kolie_Yola	human
@Beardo__Weirdo	human
@beaglepizza	unknown
@Cafe538	org
@CoccaroMaizza	org
@SaddleDrunk	org
@KariDavies	human
@Melinda_Brunell	human
@linnbhamre	human
@AureliaApple	human
@jeafz02	human
@SillySarahHilly	unknown
@Ali20586	human
@fitbandits	org
@TheMarcDavid	human
@qtab	unknown
@miijidaa	org
@viggigreen	human
@Pony_eee	human
@BrittneyLeigh00	human
@TallyShulas347	org
@crates4life	human
@TheLittleBites	human
@DrArshAzim	unknown
@PsZafra	org
@pete_fusco	human
@VaanarMukhi	human
@chanthabirch	human
@princessrachelk	human
@GumDropBunnyBee	human
@mathsongs	org
@Sallyeobo	human
@TheOberoiMumbai	org
@Oliviaagunawan	human
@jamesfloower	human
@FloorFlawless	human
@ruizcarlav	human
@DittasGifts	unknown
@Shorty12075	human
@angelingko	human
@ClickForNudes	human
@imnemi	unknown
@misstipsforyou	human
@april4metoo	human
@Ss_MrTrillzz	human
@_marcdavies	human
@goodstart11	human
@Ayuni_Rashid	human
@chrissakabamma	human
@dheanyuhu	human
@GourmetWest	org
@syed_nikon	human
@TONYTBAYBAY	human
@johannycasillas	human
@KellenTiendita	human
@az_1218	unknown
@foodmandu	org
@__Margarete	human
@Pieroguys	org
@gabrielaquek	unknown
@curlychibi	human
@MrGenerillo	human
@raccoonsclub	org
@JenniferBible1	human
@IHS4U	human
@kirbybuxton5641	unknown
@chinadealhunt	human
@fittingitallin	human
@matthewjohndaly	human
@maebaylove	org
@AdamKamani	human
@DecotosBigBen	unknown
@TLorina	human
@MissEJP	org
@tugce_tb	human
@vice_menu	org
@mi820906mi	org
@jojo_jacks	human
@GansevoortPark	org
@JuniperEdin	org
@FlawlessFitUK	human
@collifornia	human
@gideonnovlin	human
@CTGirlAboutTown	human
@ThatDivaJ	human
@NatsumiWatanab1	unknown
@nendz	unknown
@JRINKjuicery	org
@Visenyc	unknown
@italianbrunch	unknown
@speraydan	human
@jumalian	human
@chefpolice	org
@DaveSoNoob	human
@TheGamechanger	org
@meloly4	human
@SLskillsfactory	human
@AdaiYing	unknown
@jimnyd	human
@Venenutrifit	human
@1o1reasons	human
@kashiifoto	human
@beijingbean	unknown
@Adrien2955	human
@Sham16294	human
@Love2Laugh1977	unknown
@VonnyCorner	org
@maria_irham	human
@EKconcerts	org
@JolandaChan	org
@kathleenlqx	human
@1followbillion	org
@BottegaDolce	org
@marksandmemos	human
@GraftedIdentity	human
@Cj3KODOM	org
@Lacenruffles	human
@rikaringjiji	human
@Heather_Hammel	human
@La_buena_vida__	human
@KenzDutton	human
@SPINSouthWest	human
@chiro410	human
@awesoMONICAAA	human
@dscntgaragedoor	org
@Gloria_Marie_	human
@leighluscious1	human
@kedamamamachan	human
@dpmzk	human
@ILuvJKnDDub	unknown
@KandyPaint1	org
@Hotrwordhouse	org
@mishasvobodova	human
@TasteMagazine	org
@decibellevel	human
@1FattyGurl	human
@BriannaNoelleW	human
@2gigle_com	unknown
@RidgeGrill	org
@elisangelica95	human
@follyandbloom	unknown
@babywhite3111	human
@Tlove2022	unknown
@616McGregory	human
@NYCFitnessXpert	org
@TaniaJoyFJane	human
@fermedinae	human
@yvrblogger	human
@Dietmarmango	human
@jhomAlmighty	human
@Omar26m	human
@RoseyRebecca	human
@Abdulla_jaidah	org
@NewLeafMarketTL	human
@yuRiRinN_k	human
@BrandonVelasco_	human
@iamkcndptn	unknown
@lindsaykearns	human
@HPFY	human
@lst_cooking	org
@Cami_Newman	human
@DunkinPanama	human
@jhockey2	human
@DreamRecodo	unknown
@realwoj85	human
@Shafer4867	human
@AroundAboutApp	human
@shaynayoga	org
@zazandrea	org
@TamaraEmir	human
@Chrisjairo	human
@Farisha_Raihan	human
@shakirarodrigo	human
@45Evilmurderer	org
@O_indy	human
@AdrienneDLR	human
@Tyga_Austin	human
@philvickerytv	human
@marinastvan	human
@vanillapodhove	org
@Kida_BeenBadd	org
@mrs_Indrajaya91	human
@ChanelTT1	human
@crestfalldos	human
@chewsandbrewsca	human
@HaffizAziz	human
@Eric_Ahmed	human
@archiegrapa	human
@awowsales	unknown
@Bengiamino	human
@anasshino	human
@kibboutz99	unknown
@kasexton	human
@chriskong	human
@TonyMantuano	human
@heyhodaddyojoe	human
@dominickcosta	human
@SchoolFellDown	human
@Sei_chan_	human
@dnegayosa	human
@BSKHongKong	human
@renzo_santos	human
@SJWhipp	human
@LifeCareAllianc	org
@biakaz	org
@orangechickhen	human
@FootballBinge	human
@411video	human
@Bellincio	human
@CubatasGlasgow	human
@Magic100FMUG	org
@visitparos	org
@Debomarru	human
@irinasandu8	human
@XveganxTashaX	human
@meg_deo	org
@AustinGreesg	human
@Shmoowin	human
@SundownUnited	org
@stanleyvendy3	human
@KeepitinKent	org
@gdbmayu	human
@FoxPublicHouse	org
@InstaFeodosia	human
@sastrogozali	org
@liana3586	human
@annasolafs	human
@ZBAR_NYC	unknown
@Natty_Style	human
@Maryale14	human
@natalie_deane	human
@Hasami_Chan	human
@AbbottegaNY	human
@hazukiworld	org
@BelleBolle	org
@AtikaZamimi	human
@aridhzuan	human
@Iamthobeka	human
@TeamSaveFerris	org
@KickinSales	org
@HaydeePayer	human
@LaurenLomsdalen	human
@measterson	human
@mondtagskind	human
@MarcVegan	human
@TheLoungeTVTE	org
@icharisadewi	human
@babystackscafe	org
@Gediel_	human
@SexaySamxo	human
@YaBoy_Win	human
@CoffeeAndKahlu1	human
@Mronehundred	human
@BonnieRakhit	human
@Sibanas	human
@ronsley	human
@ChasTheeBaddass	human
@HalwaniBrosKsa	human
@DMVNIGHTSPOTS	human
@mGeeg	human
@DiNorthall	human
@eddiesnyderNOLA	human
@StarKistCharlie	human
@Prista407	org
@hiimangelina	human
@KakaChoong	human
@33_brent	human
@TheACEPrincess	human
@NicoleTinkham	human
@nwms_angel	unknown
@ClarionChennai	org
@KianboonSpurs	human
@riceandbread1	org
@_NfOrCeR	human
@lynd5969	org
@EgaDali	human
@ChristinaPOV	human
@XINkitchen	org
@3373fm	unknown
@AmyLaitinen	human
@BadGirlBabyJ	human
@the_artistitron	human
@milestonesxrds	org
@nellie_579	human
@L_m_brizza	human
@jennifertablada	human
@Nex1TV	unknown
@fwcampos	human
@autoSpotrd	org
@UTCommonsConf	org
@chummyboholst	human
@TabloidBeauty	human
@zandraflores7	human
@BeatriceJFCheng	human
@AMBROSIAEtuf	human
@SardineMadison	org
@pmjgomes	human
@wompcat	human
@Retweeterstein	org
@sherri_anderson	human
@james_reb	human
@itsaboutpretty	human
@beejung8080	human
@OnlyWhatICan	human
@dEcLee	human
@rusliowlcity	human
@hazelnaya	human
@nutriiofficial	org
@TKOAKG	human
@NienaTsuchiya	human
@LauraRibeiro91	human
@p_kassie	org
@poojavjk	human
@a_g_u_s_s	human
@Whisknladle	org
@aravelle	human
@RecetaJaponesas	human
@Comocaffe	org
@hummyb2603	human
@lilpsycostar	org
@1NOnlyMsKimie	human
@WhiteRabbitEAT	org
@CaminoLondon	org
@asrijulianty	unknown
@charleshtweet	human
@alenaxoxdoll	human
@LeGourmetTV	org
@a_SeraPh	human
@LanceRayPT	human
@VFarassino	human
@HanneloreHenne	human
@christinesimko	human
@ladygeorgette	human
@jrecarro	human
@Chef_Somm	org
@Lindina80	human
@DJShuloMixx	human
@fossilfarms	org
@Laura_Nice	unknown
@AppetiteAttitud	human
@itsmejojie	human
@grub_geek	org
@amanda_emilia	human
@KandiceTing	human
@USNewsHealth	org
@jaspiedad	human
@capitaldhealth	unknown
@lauralovesart	org
@gourmetDonna	human
@Meidy0805	unknown
@trovaricetta	human
@luandrecpt	human
@HenkeMacon	unknown
@riccardosciutto	human
@PeddlerCreekBBQ	org
@No67attheSLG	human
@NatashaKolombo	human
@Maz1100	unknown
@RMahilda	human
@Armageddon_Run	human
@woolleyssteak	org
@hendraab	human
@sississisi	org
@romeosantiago	unknown
@FizziKolla	human
@charlesallen15	human
@jessacass	human
@thereef	org
@Sunkist	org
@ShopFearlessFix	human
@AttiAnonymous	human
@lunchexhibition	human
@Queenie_Juju	human
@adamgarland1983	human
@appleu	human
@kasiakatie	human
@sueprman03	human
@VillageTvrnPGH	human
@Richsgoodfood	human
@UpCloseEdible	org
@BerryBloomXO	unknown
@Em_Malik	unknown
@JETSETextra	org
@SolentHotel	org
@goersville	org
@RumplesRedRose	unknown
@SamrahShahid	human
@ambergshore	human
@fashionfest1	org
@JacReneeFitness	human
@FerozaEngineer	org
@stacymoya	human
@ellilouve	human
@Sasa2C	unknown
@DEADeyeKTD	human
@lindseyjessicat	unknown
@LobodaKsenya	human
@cityurb	human
@yellowsconeblog	unknown
@jktatsu	unknown
@WidiNaoki	human
@Raingrz	human
@rodelpizarro	human
@framino	human
@KiaraR_	org
@TaysGourmet	org
@SmithTls1538	human
@MarcoArtesani	human
@Gavinscafe	org
@theblondedaria	human
@MangoFitness	human
@JeSuisJaneen	human
@elpowerbel	human
@juliadedev	unknown
@paperbutterflyo	org
@Unique78Andrade	human
@zabackj	human
@Ka3bo0ola23	human
@BREWSKYONLINE	org
@dxnfans	human
@ValeriaFrigerio	org
@JamesWarwick797	human
@LisaNamuriMgmt	human
@1995nx	human
@OKKUDubai	org
@ilaria_bedin	org
@AUcieklak	human
@Eloracork	org
@RutchOrdiz	org
@alamaroakland	org
@estrellataco	human
@Glimmercreation	org
@lydialgf	org
@Tweets4Yoga	human
@BCProductsNI	org
@AJbeCRAY	human
@tsecontemporary	human
@Twit0rTweet	human
@byMonPetitFour	org
@maxi_mieux	human
@FromDetoxtoDiva	human
@TuttiFruttiDR	human
@dewimag	org
@MiraAbedRabbo	org
@LotharQuarz	human
@styleupgirl	org
@finleypoppet	org
@siscabaxpao	human
@purnayuda	human
@FBSFitness	human
@Liinnie_	human
@Jinksy1080	human
@Mentari_addinda	human
@bambiii26	human
@zephnelaine	human
@JeremyGAngus	human
@aceprttylicious	human
@guilelessJAM	human
@raddie_cz	human
@ivansaputrapics	human
@LeighGembus	human
@uglybobswife	human
@BOLDmagazine	human
@EmceeSLIM	human
@sophie_MHP	unknown
@BiancaBernat	human
@soratj	human
@jmecale72	human
@mrgmintexas	human
@james96626110	unknown
@BurgooBistro	org
@djRelAt7	human
@SUPERMALT_	unknown
@AryMancinelli	human
@Susinnon	human
@Smarties	human
@theglobalparty	human
@tomsfoodieblog	org
@OlivaresMarcelo	human
@MiyabiKawai	org
@ma0410rie	unknown
@LilVicMorgan	human
@TheLivinTruth	human
@kimagenta	human
@EatCleanLLC_com	org
@tramruoi	org
@Yamiku	org
@ShareYourOffer	org
@JambonRT	human
@KimmyCruze	human
@AuxVivres	org
@starryeyedvicki	human
@wittich	org
@SosoMeftah	human
@dtheophanides	unknown
@toorealfortv	human
@BarlowsBoston	org
@lina3alami1	human
@DomenicoNesci	human
@iggysaysno	human
@Chloehall1993	unknown
@HarrawaysOats	human
@sokaelgato	human
@jvill__	human
@sae500	human
@Gilly_Farrel	human
@people4theTRUTH	human
@Graceareed	human
@moneow	unknown
@nellenuestro	human
@ImAdamWoodley	human
@eleniengels	human
@chefmafe	unknown
@MillieGanado	human
@hassan2341	human
@weeliem	human
@China_Yoo	org
@HCChicken	human
@YuliEnjoyLife	org
@IndiaTropicana	org
@PrinceAffz907	human
@notetoiris	human
@peopleofYYC	human
@overbakedbread	human
@hungrytommy	org
@MollySchoo	human
@tha__pakron	human
@Piglet1112	human
@ladysweet0318	human
@msvenus885	human
@Hueymcr	human
@Mana_Penguin	unknown
@crystal_qing	human
@ImstillaQid	human
@RelaxInCayman	org
@InstaKamchatka	human
@zetyadiela_fzA	human
@BistrotMonza	unknown
@TraveltoTaste	human
@EAHotelDanbury	org
@MandySuess	human
@davide_errani	human
@Clarbo18	org
@hanaisensehi	human
@IShopinWales	org
@alexbelew	human
@CurvyNPetite	human
@J_Sneed	human
@alwaysmakethyme	human
@Lopojo	org
@MangisiMangisi	human
@AlBustanRotana	human
@DBellMumbai	org
@teapigs	org
@Roxie588	human
@funnyeeee	human
@valerianecchio	org
@EmmaForward25	human
@thepaleoprize	human
@DarnellNewsMan	org
@KimKess	human
@Niki_The_queen	human
@JessKenny21	human
@NaseemNahid	human
@oooh_LALA	human
@RenovationWell	human
@didba	human
@oirekfdsogdfs	human
@shaikha_lawyer	unknown
@SkippyNYC	human
@ElodieLegale	unknown
@Pheh_Imal65	org
@yn_0429	unknown
@FoodieInLA	human
@Fadielghandour	human
@Waheeda77	human
@RateMyPudding	human
@hugmeashton_	human
@teenscancooktoo	human
@lazybeautiful	human
@omoshiro_jKs3y	unknown
@yakei_saikou	unknown
@igraine2610	human
@LoBuggers	human
@ahngek	unknown
@noticiasdovinho	human
@Donnaukx	human
@alejojohnson	human
@opart31	human
@MinistryofBrown	unknown
@mkramjee	unknown
@myinstantCOACH	human
@HasibeEbraheem	human
@HELLOBDAY	human
@ClaudiaMVarela	human
@alistairpike	human
@ChateyR	human
@Menaceabq	human
@Heger77	human
@kaorucha	human
@DsSoulFullCafe	org
@mjsmith4700	human
@stevenlkc	human
@handbagmafia_1	human
@jenmassolo	org
@MissTeresaMoore	human
@TheKingsHeadN21	org
@CharVinMolaco	human
@Ricky_Webster	org
@rekked_is	org
@agent_jhayjey	org
@monyunn	unknown
@kirosan_1	human
