@KristaFFN	human
@jpweather	org
@alliefitfoodie	org
@Romeo__art	human
@ellerahman	human
@Kali_Ghata	human
@FoodieWineLover	human
@WestonDaphne	human
@CalleDaoNYC	org
@Candypo	human
@EieiMomo	human
@Spanish215	org
@wokandgonoodles	human
@Piyokkomama_san	human
@Gula_Madu	human
@tjs_queen	human
@casadelbaroloto	human
@DaaMarco	human
@RyeMorines	human
@Hayleydaviez	human
@limrobbyyanto	human
@eQuiviaBooks	human
@DanforthTweets	org
@natsuminazuki	human
@matsujen	human
@yukiko96	human
@deltaforzz	human
@serenavaldez_	human
@MartaNav	human
@Fjartino	human
@Ang84G	human
@findingmyfancy	human
@CoCo_Pine	human
@Georgevonliger	human
@LifestyleC_Fab	org
@Ssincerelyy	human
@Restofourlives8	org
@chelseacolette	unknown
@mkomikoharu77	human
@NaaraAbigail	human
@LetsBeFrankTO	human
@KhayeEmBee	human
@nutrition_lc	org
@C3agri	human
@NicMelchrist	human
@BBCFood	org
@BranchandBirdie	human
@LesHallesDT	org
@Denise_Nicolet	human
@SaraBin8	human
@VMMAG	org
@SaraLucyi	unknown
@hell0Wonderful	org
@ciuzza88	human
@PitstopCafeSoho	human
@saffron_bay	unknown
@wholesomelybry	human
@TheGarforthTown	org
@noa_akhsani	human
@annabella_hilal	human
@Turismolittle	human
@CombrinkD	human
@emiemi666104	human
@Country_Deli	org
@Chillnsvg	human
@chrono13_	unknown
@djmanfro1	human
@kiunaka	human
@MelodiousBirdie	unknown
@PlayaProvisions	org
@PastelGourmetTX	human
@Del_Time	org
@MemoriaVitae	human
@Cheres_Cousines	org
@jerseygirl137	human
@iradyrara	human
@Elliejubin	human
@rikayushige	human
@TheAinsworth	org
@belcris57	human
@awellfedlife	human
@Margherita59012	unknown
@NadiaTjro	unknown
@thepaintedheron	org
@YettyD	human
@nikhil_merchant	org
@bgirl_eri_kir	human
@terhituomela	human
@disco2man	human
@wedgepizza	human
@Pash_dS	human
@mohammadhazri	unknown
@KarlaScarpiera	human
@DIRTY__MONEY	org
@Flywheel	human
@TheNikkiJones	org
@KevinMCI3	human
@ish2weet	human
@KAZUYA1121102	human
@TownFish_London	org
@WiltsArtisans	human
@bunkrich	human
@knead_baking	org
@BobbyCouncil	unknown
@DiCaribbean	human
@ilespresso_au	human
@PotsCarine	unknown
@cestlavierest	human
@pixie_rees	human
@flanderherrera	unknown
@vixypix	human
@jo2thegreat	unknown
@FantasyTamy	human
@LemonadeArabia	org
@MICHAEL_J_LA	human
@Chai_Veronica	human
@foreversmsm	human
@SansWheatess	org
@moneysvgparent	org
@IamMegJole	human
@hfslimmingworld	human
@Lainey08	human
@charliehere_	human
@nycmloc	human
@DjBankie	human
@LolaGrapefruit	human
@wellashopaholic	human
@BODYCRAFTFITNES	org
@Ashely_Bee	unknown
@72Forbes	human
@NicolitaMuniz	human
@DarkWestFilms	human
@26grados	org
@YEGTweetup	org
@wagonhorsesLA1	org
@ThisIsEllaz	human
@ah_madsufi	human
@lukskamamuri	unknown
@loisetmoore	org
@AngelRamrz_	unknown
@micchan_0706	human
@cookoutchef	org
@mohd_zarin	human
@eileenschuch	human
@KimIndar	human
@faridcc	org
@dishgram	unknown
@ardyvoladora	human
@ruka_fukamachi	unknown
@donguri7	human
@ChubbyGisus	human
@ParliamenthotCT	org
@TheCubicleChick	human
@lebootcamp	human
@kulinarymafia	org
@CleaverCalgary	human
@rage566244	human
@luvfoodluvdrink	unknown
@hikkii	human
@Dream1ncolour	human
@ModernEnsemble	human
@TinyNYKitchen	human
@HWNBTY	human
@sunnydaysRlove	unknown
@SaletaAzalea	human
@PBRRockBar	org
@emosorrygurl	unknown
@Burn_This_	human
@coolness__	human
@Lucrecia1660	org
@SheratonBlore	org
@agentcikay	org
@chef_in_heels	org
@glamourmuse	human
@TheDrama876	org
@mumma_c_ta	human
@welcometoneko	org
@SpringStBarLA	org
@AkiKeskitalo	human
@AiramToribio	human
@biancatecchiati	human
@EmmaIntrobiz	org
@ADPosey_	human
@KathyBirkettRDN	human
@SlimGoodieBiz	human
@soakden	human
@ChloeJayUK	human
@sanialove_	unknown
@ArbaaB	human
@HealthyFitNY	org
@iBREAKFASTi	human
@any2ndnow	human
@oneindiaHindi	org
@HoboHappyHours	org
@ponyrockphoto	unknown
@mimmocake	human
@keatsky	human
@ExponentEnt	human
@Joe_Skull	human
@Felt1ssc	unknown
@PacoArteregali	human
@Miami_CM1	org
@bazpup27	human
@MonAmiBethesda	human
@perchik_club	human
@Faris_Banjir	unknown
@chefs_desk	org
@ubaldo_p	human
@tititlimson822	unknown
@cuzario	human
@easyprintitja	human
@bbieprincess	human
@takuroyoshikane	human
@kimonoken1	human
@SugarShane8_	human
@LaughingEsrida	org
@skyvan	org
@NeuvooHRPho	unknown
@SEXCLADIBUG	human
@thinkinginwords	human
@muktasdiaries	human
@moniquecechic	human
@RobertFulton6fV	human
@syuibismail	human
@IncurablyRude	human
@TheBijouCafe	org
@figandquince	human
@NikCLew	org
@GotchaMorelos	human
@Nobread_nyc	human
@1wgd_lucifer	unknown
@IndraKayeS	human
@HeggieFVK	human
@litzwu	human
@stylishboots	human
@Rich_Sommers	human
@IrachanNeneng	human
@PachecoDani	human
@lydiatrj	unknown
@esmonaco1	human
@GoodieGodmother	org
@TotallyTrEating	org
@DaniDaniPat	human
@PPCork	org
@vicsnewyork	org
@TownsendHouse1	human
@giacomourtis	org
@mannheimgirls	org
@BINGBINGFASHION	human
@Cynthia_BowMont	human
@BibikGourmand	org
@NGarance	human
@DIANNE_KIMBROUG	human
@salsa_fiesta	org
@djmenace	human
@roxxi1993	human
@HansRattlexnake	human
@JuhaPalosaari1	human
@DanMorrisPT	human
@Merica_Bali	org
@MultiplicityMag	human
@LipstickCake	human
@Barbarapiana	human
@KenyaRidgell	human
@Papa_Scot	human
@somatizater	human
@iwakspeed	unknown
@GoBarleytweets	org
@kirsty112233	human
@theadvofliving	human
@strietje	human
@damien132	human
@STONYDANZA	org
@TopLaserSpaMag	org
@klubhead76	human
@ConnieRoybal	unknown
@TimeSavorStacey	org
@GaleosDressing	org
@ThePortlyChef	org
@MrsSupri	human
@phrincezzah	human
@Boop_benavides	unknown
@19MEGU91	org
@Wimseys	human
@Alejando115	human
@Nevena_Buljan	org
@MsLauraLeaMarie	unknown
@Go2Triangle	org
@jamesdpaton	human
@bitesofbullcity	org
@ftwashproudmary	human
@momsfitnessheav	human
@lightboltjoe	org
@K_AnnM	human
@akeja	org
@240_AyJay	human
@gnambox	org
@FMDF_App_	org
@PerezMawyin	org
@SandyMVaccaro	human
@simonnicholson	human
@bruceetgray	org
@HopkinsRivBeef	org
@VisitCobb	human
@jvdefcgr	unknown
@BlogdaCarols	human
@Teniele	human
@savoringeachday	org
@slickyomie	human
@alessiabruni89	human
@xavierclift	unknown
@Joie_de_vive	human
@Cherche_	human
@NicoloYuri	human
@NiskaNapoleon	human
@DUGUNDOGUM	human
@ukhtyvera	human
@HotPinkHouston	human
@KJGuzzardi	human
@SueStubbs4	human
@Vostrikova_Ksu	human
@unegersoise	human
@Lacy901258	human
@Miranda_Casiano	human
@foodieyu	human
@Edmiguel2	human
@girlzgourmet	unknown
@bettykit	org
@Timmeh71	human
@FoodToRemember	human
@razelldazzles	human
@Najamuddin	human
@ProudArchivist	org
@rainleihmark	human
@DogFathertulsa	org
@SedraHassan	human
@_NoBitchAssNess	human
@Johaa07	org
@nicboney	human
@_PabloRomero	human
@OhEmJiwoo	human
@swan_tarporley	org
@SeattleTalkRad	org
@nidkit	org
@magfox77	unknown
@wmoysters	human
@kimberlyymc	human
@Fishland_Pune	org
@ciaochowbambina	human
@usausa0213	org
@MeldaFiratoglu	human
@thereggaegrill	org
@MisterRedWine	human
@_Carols_	human
@stockbundles	org
@ForWORKERS_aya	org
@veronicaprager	human
@CriticalLabz	human
@hazel_esmeralda	human
@YellowBlissRoad	human
@I3ettyb00p	human
@mschanel5	human
@KayAdeola	human
@iloveleonony	human
@bart_schmidt	human
@TasteYYC	org
@ShoppingSpotter	org
@Elenakele	human
@Devona963	human
@EricksoErick	unknown
@London_Food_Gal	org
@Melo95792935	human
@Vlady_HRM	human
@nektar_naturals	org
@foodonaplate	human
@hello_nanda	org
@DLouinskizzle	unknown
@Jardinami_Diane	human
@CarmelTaylor2	human
@PuleosMboro	org
@overwritinghist	human
@OsborneVillager	org
@DairyGood	org
@Gyrowoof	human
@monzanitas	human
@hannahsbretzel	org
@VivaLaKota	human
@RaypowerAbuja	human
@reneille	human
@nitabk	human
@DohaMarriott	org
@SpiceSugarSoda	human
@TGIFNewCastle	org
@bfaithfullyfit	org
@lindslove115	human
@seeyouinitaly	org
@yokooong	human
@fernandoalfo911	human
@hectorandnoble	org
@TheSweetDefeat	human
@fifi_reid	human
@ashhhhhpoop	unknown
@WakeMeUpDesigns	human
@livefoodbar	org
@GravyRaleigh	human
@Julie18230	human
@HowToReceive	human
@OliverBeeck	human
@taketwotapas	human
@MelissaBehCW	unknown
@bunnykitchen	org
@ArgyleCCFY	org
@Hangouts	org
@TerryLee95	unknown
@MiyabiChan4	human
@tau1991	unknown
@serenatess	human
@crys1788	human
@Joyhumin	human
@aliconklin	human
@A_Drazkowski	org
@sofybutterfly	human
@lols2girls	human
@TogetherBahrain	human
@bargainbri	human
@Konfucius18	human
@HHBakeryCafe	org
@GreenInsuranc	org
@BNadyn	human
@jennierinnn	human
@reigndelacruz	human
@Cherrysweetie	org
@kensafabyola	human
@joancat1982	human
@AcornVancouver	org
@21_3_14TEAMO	unknown
@MKOliver66	human
@CarmenMCG	human
@CinqueportsRye	human
@cookingwchrissy	org
@KitsunePhantom	human
@MyMI_Milano	human
@nendi_shu	human
@Donyell_Mercer	human
@ChristineMM_TTM	unknown
@SusanLeighNoble	human
@ShahilJeet	human
@mamankmuck	human
@dailystews	org
@Sophinakhan	human
@pressfreedom1	unknown
@Backstreet_Cafe	org
@Stefanihisdi	human
@foodguruchannel	human
@GastroGays	org
@KareemChurchboy	human
@UAVenice	org
@RsZmud	human
@noynoyavery	human
@lateraleating	human
@Jadeisalive2day	human
@corde_Bero	unknown
@reebrook	unknown
@mashiitahmzh	human
@tyrrontan	unknown
@Getreallux	org
@Torarica	org
@gouravnayyar	human
@Destini1992	human
@TheAlmondEater	org
@shakespeareuae	org
@Koki_Doo	human
@Smrekarjev	human
@KelseyObsession	human
@andeewandee	org
@GinosRonkonkoma	human
@Joybeewhatsfor	human
@Resti_sakuntala	unknown
@clarideeasis	human
@WieKusnanto	org
@Joy_Villa	human
@Adelinajohnson_	human
@HFU_CHILLCAT	human
@SaraAnderson233	human
@KennyHoward12	human
@VisitSeattle	org
@RoseDunn11	human
@GoodNews_Shared	org
@Nailartforever1	human
@ThomsonsCalgary	org
@GrandKredens	human
@clarenceetpowel	human
@DHoard76	org
@VeganChefLenka	org
@kitty_trix	human
@EricaDee88	human
@csandsblog	human
@sarahsanchez516	human
@HAYLEYJPARFITT	human
@GreenTruck	org
@Cherraexoxo	human
@saRasglame	human
@picturesnailart	human
@FortPointChan	org
@Joyeuse_EE	human
@sidthirteen	human
@hollys__kitchen	human
@TavernintheSq	org
@FeatherPixels	human
@Fashion_Queen_B	unknown
@ilivewell	org
@SyahmiMohdIsa	human
@ChrisRUK	human
@kellacee	human
@Pinoy_me_too	unknown
@MiamiTalkRadio	org
@2101stLady	org
@keepitupdavid	human
@LarysaKalyta	human
@SilviaBaracchi	org
@trishanaicker	human
@MsSherriP	human
@ElenaAnna	human
@fabbricanyc	org
@emily_4444	human
@BigRedGuardian	unknown
@TGIFChesapeake	org
@twntysmthngLDN	unknown
@lexz973	human
@thugkiddz	human
@carlito_burito	unknown
@bar_turi	human
@PynkbookAmy	human
@ROSYLEEMCR	human
@highlandradio	org
@BlakeBerry	human
@TajciG	human
@emreozdemir87	human
@Pesch_Mattiucci	human
@YlndMssnbrg	human
@chocaffinitea	org
@blancamiroscr	human
@BullaMiami	unknown
@Russel66678	human
@SAEKOHAMADA	human
@NNofficial_	org
@wadewire	human
@javierchock	human
@wevvin	human
@AsSeenInPGH	human
@HeronsNC	org
@itterukotoga_	unknown
@LaizaCarvalhoB	human
@LamagnaMara	human
@laislacuisine	org
@RachelSoleilNYC	human
@SJBlahBlahBlog	human
@JimenaVakuza	human
@crusio	human
@ReneeMHamilton	human
@ShukaNYC	org
@aaronwestera	human
@onafideo	org
@LegendKAL	human
@jubbenjubben	human
@deespyder	human
@JYLeader	human
@bot52006590	unknown
@Kuffdam	human
@fancygrlnancy	human
@LAnimacafe	org
@AnalisaMohammad	human
@AlisonJaneReid	human
@b000ka	human
@StAlbansNetwork	unknown
@maira1114	unknown
@ABCretivLearnin	human
@Ballowen	human
@ttyyler	human
@cassiefoo1	org
@sachadetti	human
@PuertaAmerica	org
@Knoxville4Lunch	org
@AtelierArgentin	org
@agustineshary	human
@Badi_vivian	unknown
@MdemoiselleLala	human
@Jake_Hunter	human
@hash4tags	human
@PRandEI	human
@LadyHerbal	org
@alljustchoice	org
@that_benjamin	human
@kephrenayanari	unknown
@TrajekBeats	unknown
@TheKettleMB	human
@serendipity4luv	human
@Whitluf	human
@TheGrassSkirt	human
@babyyjennie	unknown
@chercoholics	human
@AffligemMexico	human
@campbell2468	human
@simplistcliving	human
@OzairWeb	human
@CinnyBBS	human
@ChefJGamboa	human
@bayerpr	org
@bellyofthepig	org
@sheerAMBITIONZZ	unknown
@HotchaUK	org
@FatalService	human
@mad_mex	org
@ShebbyChic	human
@k_zabawka	human
@bruswiffle	org
@Ambelline	unknown
@KARINABUDIMAN	unknown
@djwillcalder	human
@pattword	human
@talabistro	org
@Cliffhse_hotel	org
@BigFishBrand	org
@ClaudiaZompa	human
@foodcious	org
@GotchaSonora	human
@FlowLovely	org
@Me_Cook_Me_Eat	human
@Azaremba16	human
@PaleoByParris	human
@tastekhazana	org
@MrPringlez	human
@nyonyasepatu	human
@Farhana_LuvzJS	unknown
@PremierInnIndia	org
@puvanan	human
@jeanreno1227	human
@Shell_B87	human
@MissKhushiSen	human
@derfettebulle	org
@MsEndres	human
@ttgeminigoddess	unknown
@penkykocik	human
@MODEmagazines	org
@ollieamelia	human
@feedmedearly	human
@natalietangty	human
@ElleTheBaker	human
@thunchanok_aor	human
@Diddyshaow	human
@ActonInstitute	human
@MehmanNawazi	org
@Keneth_G	human
@pinchnutrition	org
@worldhalalquest	human
@moe_lan	human
@PartyJetsetGO	human
@ChefJB1	org
@cuquidolls	org
@Fumi0_2	human
@AlexCarolOates	human
@StephAWhiteley	human
@sandhik	human
@NadiiaAgeyeva	human
@mayoilagan	human
@JessMarie_321	human
@HIExpress	org
@snack_gudang	human
@GarlandRaleigh	org
@headzilla84	human
@firhasbizar	human
@3_y33	human
@aristanet	human
@Abdullah_Osman	human
@ZELuism	human
@equatorpasadena	org
@Chuka34Chuka	human
@Anto1888	org
@NikyLevy	human
@QueenMill343	human
@markberglas01	unknown
@jilow0318	human
@CharlotteCoco	human
@greggerzack	human
@guliz_ay	unknown
@yogitriathlete	org
@cavallarowest	human
@yimjsj	org
@3Buoys1Brunch	unknown
@GotchaBC	human
@cirkineleman	unknown
@plushism	human
@_GillianLittle_	human
@TJTheDJWFOS	human
@samkanter	human
@NalleyFresh	org
@AprilReynolds44	unknown
@kniveschang	org
@amirul_asraf	human
@eat_ditchplains	org
@gourmettogodenv	org
@DenverArmugga	human
@alyroux	human
@sakanbo	human
@AussieCantina	human
@eastchef	org
@eileencuisine	unknown
@MissMichelley	human
@EngagedInCanada	human
@Lrasal	human
@DNAbars	org
@emel_sagoglu	human
@CerebralOMG	human
@JoshTMCR	unknown
@FKampenberg	human
@COMPASSH	org
@BannersN8	human
@ZGtbc	human
@LuvlezzLuv	human
@App_iTize	org
@mandovila	human
@cnewsome9	human
@hashtagstarwars	org
@MoloQc	unknown
@hldcblog	human
@denden418	human
@EmeraldStreet	human
@YMBBastepaway	human
@iamflordeluna	human
@Bybarton	human
@Brianlkl28	human
@Emilythesecret	unknown
@nonno_BlogRSS	human
@smileyjoann	human
@helen_1088	human
@upit_dp	human
@aaguelo16	human
@RealMainEvent	human
@Tiffany1NOnly	human
@FrancoGaipa	human
@basketdelight	org
@eatatmunnings	org
@Catchster	human
@Ashuma786	human
@KunMiPan	human
@CorbeauxBake	unknown
@PanPacificSGP	org
@Hanilala	human
@LMommywood	human
@halopattys	human
@il_piccolo_deli	org
@LondonWestWOT	org
@DenisseSmrhldr	unknown
@BCottrellDesign	org
@Do_ItLike_Jojo	human
@JohnRosePutnam	human
@LynseyWard	human
@ukuleleds	unknown
@BeerBellySports	human
@KantinKendal	human
@redk3tchup	human
@hhhinagggiqqqu	human
@polliani	human
@_amint	human
@missdealicious	human
@legalentaco12	human
@Unanim0uslyUniQ	human
@receptitenamama	human
@pumabianco	human
@LunchBoxGirls	unknown
@PeezChin	human
@ichaaagustini	org
@ArisKonstanto	human
@christele_d	org
@TeeteeintheCity	human
@msinfoblog	org
@DaviosToGo	org
@Tapas24SnackBar	org
@robert2claudio	human
@GloriasDFW	org
@DayanaContr	unknown
@falseultron	human
@Major_Hutch	human
@TLPlantation	human
@Caracaramex	org
@hellojsbass	unknown
@TotalSalads	org
@KBKickboxing	org
@lopezedna070	org
@HighlandTapDen	unknown
@GrandHotelAlkm	human
@iambrian7	human
@AGKitchen	human
@Gibbo_son	human
@rinotarosu1	human
@Stuff2doHalifax	unknown
@XSLasvegas_Ken	org
@ClerksBar	org
@Darien_Semog	human
@mooh_HKS	human
@CharleneMixFm	human
@GalleriaKeidas	org
@MARY1L_MERRY	human
@hiroshitsujino	human
@AnEmptyBarStool	human
@BigSlender	human
@RoostBistro	org
@JohnnyVCaffine	human
@MeieSe	human
@GetSavviHealth	human
@saucybynature	org
@keals1974	human
@shawnetmurphy	org
@TorontoTalkRad	human
@i8and8	org
@MimiToday	org
@hobokenmenus	org
@stardaneke45	unknown
@justmyselfmarie	human
@SenseDating	unknown
@EleshaAlbert	human
@FitFamWorld	human
@kommilan	human
@melondegeneres	human
@xMissTaTax	unknown
@CleanEatingKate	human
@shushan0311	human
@SeeMonterey	human
@ChurchAperitivo	org
@ImKateMc	human
@DANA2S_HUMMEL	human
@LePainFrancais	human
@OzItalian3764	unknown
@aspiritbornhere	org
@ykaitot	human
@MusashiFoods	org
@CoverDiana	human
@Veeeeke	org
@Chica_Caramel	org
@DenkiPang	human
@nicolee26	human
@anneliepop	human
@viinavasikka	unknown
@ronin1983mg	org
@FuelShack	org
@sueshan_sue	human
@AProverbs31Wife	human
@MatthaiosRJ	human
@ernestosmexfood	org
@jenniferanderso	human
@RstylRLife	human
@debspots	human
@misz_nadya23	human
@daisuKEY_	human
@BeetnikFoods	org
@LatriceUnique	human
@papamasa2010	human
@MyLifestyleCard	org
@R_____omy	human
@MaraTrujillo9	human
@billyharris	human
@BrixtonButty	org
@gazadaily	org
@imarlandbulang	human
@FaganMcKagan	human
@teresaetbailey	human
@Annaamok	human
@WedgeLee	human
@BryantWarren	human
@hasnizahisma	org
@GloryholeClubDC	unknown
@christatravels	human
@sLax_	human
@justtinker1	human
@mschefkitchen	human
@kayokiki	human
@mbizzzzzle	human
@london_a	human
@dc_man19xx	human
@Trufflesicious	org
@jeanii	human
@TheMissNguyen	human
@DarlingHomesHou	org
@PamelaGrieco	unknown
@AnnG8	human
@sylvainnola	human
@StilettoBeatss	human
@ReprezentRadio	human
@oliviasharon	human
@RedsPorch	org
@teri_francisco	human
@tonyward19	org
@karingunnarson	unknown
@AnaaCDias	human
@GoLightlyIn	human
@wInGz	org
@acplanells	human
@djhansmiami	human
@Cherish2310	org
@toy_stories	human
@seccowinebar	human
@PwincezzG	human
@MalangTwitt	human
@IDREAMofSagan	unknown
@nicolarichman	human
@Tritya	org
@chuckaxp75	human
@tagstr	human
@emmascoffeewine	org
@BarbaraSergi	human
@MillinerFay	human
@heyitstaji	org
@WFMFortCollins	org
@GotchaDurango	human
@takeichi_	org
@CookingLisbon	org
@EdibleManhattan	human
@GreekCharm	human
@yadhie09	human
@ABrito002	human
@ASStyleDesign	org
@octavioparini	org
@JAPak	org
@mytravelinglife	human
@wiwinnopiansah	human
@jinko335	human
@SchmaltzsShop	org
@chef_hadamitzky	human
@deborahlchen_l	unknown
@DollarEnts	org
@itz_aileen	unknown
@terziogluemel	human
@HolyChicFB	unknown
@Sanmiguelprod	human
@Lx_de_Luxe	human
@GTFoodTravel	human
@123guitartuner	human
@linda_vo	human
@PropaGrub	human
@GiovannaHoang	human
@cokeanthony	human
@Bulla_Adriano	human
@ArryLee_	human
@aechjay	human
@ydldindalestari	unknown
@StellaBarraHW	human
@Gaylord_London	org
@Dear_Anil	human
@ElenaMouttet	human
@cabzWORDS	human
@JapaneseFood	org
@hassaalnuaimi	human
@achik_ezam	human
@peanutbutter813	human
@iamterreze	human
@Captain_Cindy	human
@ashaelkins	human
@StGeorgesMarket	human
@BlindTastingCo	unknown
@RadissonBluZRH	org
@KiaStavrossUK	unknown
@Sanityklzu	human
@Changing_News14	human
@GotchaOaxaca	human
@LoneStarAllston	human
@ThanePrince	human
@vhienmonika	human
@ithnkicandance	human
@hiromiumeki	human
@MAMIX033	human
@indiegamesdevel	org
@Motandkrid	org
@vee1924	human
@500critters	human
@PitstopKentish	human
@GiuseppeTurrisi	human
@dreenaburton	human
@PotRoastPinot	org
@gfinecatering	human
@Opcaotattoo	org
@seto_yuki75	human
@apaajaIKLAN	org
@LondonPicks	org
@Sucha_Fkn_Lady	unknown
@mattthebird	human
@SonestaBoston	org
@EmmaSallyH	human
@paladealo	human
@BVBANA	human
@jeff46101	human
@redhouseuptown	org
@Gynji	human
@Zina_Zina	human
@DinnerWithNerds	org
@adaishungry	human
@FamousOasis	org
@ShoresMarket	human
@TrevorSHarper	human
@DavidFullilove	unknown
@boldcursive	org
@hypsy_gypsy	human
@Hotel_Elysee	human
@moviestartalent	org
@Aprilsunkansze	human
@loz09	human
@vickie622	human
@sensesinspired	human
@littlechaosblog	human
@optimusconvoy	human
@kuyastevie_de	human
@OMC956	human
@bunbuncuisine	org
@__kuriko	org
@yodogawa0625	human
@EdibleArticles	human
@KathySiegelRDN	human
@akmal_zabidi	human
@VilleroyandBoch	human
@danielle_morgan	human
@LolasKitchenTO	human
@hulkim14	human
@DominoBlackwood	org
@998KCFM	org
@angel_tasha67	human
@farrisbukhari	org
@Stonefirenaan	human
@cheaphostingoff	human
@OneMommaSavingM	org
@SusieQMix1051	human
@SirBlodyI	org
@simoguidarelli	human
@RHONDA_M_BLEVIN	human
@TeaEnvyWBlack	org
@melaniesn15	human
@NeuvooHosMelbo	unknown
@iamawalruz	human
@adryan_heng	human
@minesushi_	human
@KCCateringLLC	org
@yunseonpark	human
@CoveBarJamaica	org
@HMWLC	org
@Maris1013	human
@angel_leopard	human
@ckkristiansen	human
@chiara_scalzo	human
@CBBhattacharya	human
@Vatkinary	org
@1ANONLYKISHAD	unknown
@LifeNChopstix	human
@JMRindskopf	org
@ElwoodEdler53	human
@Saritavjo	human
@MapleLeafFoods	human
@GastroVin	org
@realfashionista	human
@Alderleygusto	org
@cassandraborela	human
@TizianaAnna	human
@spellitwitak	human
@laurenbeley	human
@jerryoyster	human
@tvpuz	human
@CoachMichelleMN	human
@SHIGEMANrepTM	human
@Dube45Thomas	unknown
@Steph4ky	unknown
@carolinexsun	human
@goldbergsbagel	org
@isekai_	unknown
@sander975	human
@HuevickyAunty	org
@jessalynheckel	unknown
@oozinteh	org
@9Bar_Official	org
@SheSupps	org
@picnicfoods	org
@ina_Audigirl	human
@JimmyGreens	human
@brigidakaren	human
@EtenInDeKlub	org
@TRUEFAKEMILANO	human
@old_chequers	org
@Soulfull4u	human
@creativekay_	unknown
@goryoinsam	human
@myconciergeUAE	org
@KincaidBanteNXT	unknown
@Chantale	human
@anoemd	human
@givingtreesnack	org
@dalebkk	human
@erness_shafitri	human
@FoodieGems	org
@sarapanny	human
@Cream_of_Wheat	org
@SEMENONER	human
@JONATHANHREZA	human
@Bombclancy	human
@SweetTMakes3	human
@gypsy_agsy	human
@jhulyusM	human
@WomensAC	unknown
@CocoandMeBlog	human
@5minutesformom	org
@Jessicaalock	human
@itskimoi	unknown
@DefineBeautyxx	unknown
@Gabriela97154	human
@HelmiSulaiman	unknown
@RanchHouseGrlle	org
@Sushinoenuk	org
@Danieljacobdali	human
@jengoesafar	unknown
@KayaJamaica	human
@Get_GlutenFree	human
@alice_eats	unknown
@Ticklingpalates	human
@sarahdean10188	human
@abangshah_yoi	unknown
@ohsocrumbtious	org
@JbishopAlice	human
@TheFriendMag	human
@ruubz76	org
@GettingFitFab	human
@bittersweetcolo	human
@abed_wehbi	human
@TransformerZ	org
@cannon_darc	human
@UClassics	org
@AdenBREATHING	human
@cubixhk	org
@nutiva	human
@0902mepo	human
@RONILOGO	unknown
@raulymarko	unknown
@MissKCzslutgalo	unknown
@nancycruzin	human
@JazzyJuJuBee	human
@Wesley_Dell	human
@sasarakovec	human
@yuszhy	human
@Gab_Nikolaidis	human
@fanatiqueof	human
@Lowell4110	human
@ArgelDionio	org
@KRlSTV	org
@EllaLouPow	human
@SoGirlyBlog	human
@Petjah1996	unknown
@MisakiReika	human
@DiningPGH	human
@beerandracing	human
@rebecca_coppa	human
@Adrian_Crichlow	unknown
@TheTeatoxShop	org
@TheBlattreport	human
@beckiejoon	human
@iamsofriendLEE	human
@elencuentropty	human
@corasephora	org
@Bistro28Cluj	human
@Clouds_R_Misty	human
@kayashino	human
@ByMoxley	human
@DexterAlijono	human
@Gale516	unknown
@ZareieeCo	org
@RazaShafi	human
@fm_and_co	org
@ROBERTONEVES	human
@FrancesLRothRD	human
@fujiiumzaa	human
@JustFoodNoWords	human
@generalfoodco	org
@alexandramcm	human
@bar_tartine	human
@GemmaRice89	human
@RochesterInfo	human
@ArikaTao	human
@AleAscencio_	human
@JecquelineLim	human
@Mfuentesanz	human
@maisongourmande	human
@chermanyinks	org
@GoddardSchool	org
@Praew_SS	human
@KimWardMSRD	human
@Shinecafeinc	org
@tanvierpeart	human
@WeightMattersUK	org
@LMcreation	human
@Shoumyx	org
@GunslingerPimp	unknown
@meals_cvntgrden	org
@beingLj	human
@kyels_	unknown
@TheFashionTwice	unknown
@MercerKitchenNY	org
@alon_jibli	org
@kayladnls	human
@CeceMeg	unknown
@imanthebrand	human
@hemasri19	human
@AlexaFlame	human
@dheena13	human
@star1049	human
@Mil1ena	human
@OBTino23	human
@apctalking	human
@moinca1990	human
@NaturesPath	org
@PancakeBREKfast	human
@FlushDrawing	human
@Homebaked4love	unknown
@theheydayshop	human
@yearroundgiving	unknown
@3eishwemal7	human
@GotchaSinaloa	human
@GeorgesAtSunset	unknown
@georgygrajales	human
@kenjikyoto	human
@Valrie302	org
@alleyne_allison	human
@sloluckyruns	human
@chriisstinne	human
@656sports	org
@Trinas_No1_Fan	human
@LiftOff80	human
@ask_koopersmith	human
@BigTitsLoverXXX	unknown
@Ben_Florentine	org
@moonstar0204	org
@Genkiatl	org
@Nubia931	human
@Chef_Lotinza	human
@Glutenfreeda	org
@totsuka_bc_bot	human
@fit_betty	org
@mynameisDawid	org
@traceymeharg	org
@rvchef84	human
@mbred71	human
@luella_hooper	human
@souvlaemp	org
@1nOnlyBmounger	human
@Roxxy819	human
@twrstgo	org
@abuniversaldjs	human
@Tryfindme	org
@Lerryn_G	unknown
@GoodSonsIA	org
@BIG_HUD	human
@8rend	human
@FrameBrasserie	human
@harriottp	human
@diffier	human
@echo_tai	unknown
@bigballsonchin	human
@pickleshenry	human
@jules_stonesoup	human
@HYBODY	human
@hrcrome	org
@foodiespr	org
@DMdujour	human
@LittlePiggyLdn	org
@hallienoves	human
@Chef_Mimzy	human
@thelikelylady	human
@HarveyMilkDiner	unknown
@modernemama	human
@anaisabelrincon	human
@LIN_A_SHEN	human
@HSK0229	human
@romichugh	human
@NikkiBeachMiami	org
@iamhayzel01	human
@IMnotHIGHimDOPE	human
@actlivemusic	human
@katfran	human
@GalandSebastien	human
@NorthernBelleCT	human
@ilovemyalthea	human
@Farm_Trainer	human
@_SavagePT	human
@tolki3n	org
@DenizTamer	human
@Lootlopk	human
@PresChoice	org
@OregonDeli	human
@digitalfitchic	unknown
@davase23	human
@Tomfooleryat34	org
@smokywokjen	org
@jamesJTtyrer	human
@triwivesclub	human
@soficle	unknown
@GemmaLucyPress	human
@Alica73	human
@Duncan9460	human
@BBrecipe	human
@thegoodmoody	human
@mazzonebrenda	human
@cafeolaitcbrt	human
@heyitsRichMason	human
@steve_silent	human
@anissaannalise	human
@josiahnyc	human
@TheInnerWolfdog	org
@OsteriaJersey	unknown
@kurikopookie	human
@YogActive	human
@DortchYvonne	human
@ChefJohnsLLC	org
@willyharrison	human
@anitaleibert	human
@McBunnygal	human
@jenniferymli	org
@shawna_forse	human
@DJCATRINADAVIES	human
@Rachael_Mary	human
@_LUSIN_	human
@Dolphin4176	human
@IronHillMS	org
@JelanisTOGCHEST	human
@constancefic	org
@LenaChudasama	org
@76jewell	human
@52morieri	human
@NaturesDrive	org
@laniwulff	human
@DaphYin	human
@AnziPizzeria	org
@ShelluvE	human
@HotMomRadio	org
@zawszecyniczny	unknown
@Citylicious_	unknown
@maryjwelch_j	human
@satosing	human
@LazyGlutenFree	human
@cajunonwheels	org
@Nuevomedio	human
@WineCrasher	org
@IMpressedHealth	human
@123Joinsung	human
@BFoltzz	human
@jax_d	human
@Changing_News18	human
@noah_phyllis	human
@RudeToStare	org
@DianeCapri	human
@levanskidubai	human
@LvaroGonza	human
@KeishaZogbaum	human
@LinasLeb	org
@darlingberna	human
@victoriabuzzes	human
@Changing_News3	human
@Jontasman	human
@JeremyMallin	human
@DanishBlonde17	human
@Burodondon	human
@Mushroomcatty	human
@Ajacent2U	human
@danceonflour	human
@PatelBrosLondon	human
@caressedy	human
@KitchenOnCary	org
@BasketCaseEat	human
@soot1978	org
@ArchofFashion	human
@avecSerenite	human
@roticanecanesia	org
@StrangeofLondon	human
@shresthaemi	human
@cookitfit	human
@LMLDFood	org
@BeautifulJulieC	human
@diadyadiah	org
@alhanda	human
@juanpamerino	human
@angelofallico	human
@KoukieMonsterr	unknown
@Ms_Shirley_E	human
@45aminie	human
@RegiePubWeb	org
@Pierisaenz	human
@jessiesiauw	human
@richeallai	org
@actionmedval	human
@MindfulMomma	human
@Koreafoods	org
@brklynhousewife	org
@johnsimuduallo	org
@UncleBillys	human
@Demedicimarbs	org
@chisa_peace	org
@peachesjenkins	human
@xxROCKxNxROLLxx	unknown
@chigodlike	human
@thcleanelegance	human
@GracielaMont7	unknown
@DeboraL85	org
@angel140281	human
@lotrumpetweet	human
@Tea_HouseCo	unknown
@estherkse	human
@Primordya4ever	human
@MaureenjgilesJ	unknown
@MikeG327	org
@jalsonray	human
@RudeBoyPhotog	human
@csorreta	human
@aichanUoxoU	unknown
@guzmannelson5	human
@CAFEBARPASTA	org
@foodmanitoba	unknown
@Shanno22	human
@GreenwichHour	org
@madlikelovel	unknown
@RetweetPornstar	human
@acidsunny	human
@sudibio_su	human
@SP_Foodie	human
@MaryMaerMer	human
@ChefJeNaeKSilas	human
@Louie_daCosta	human
@ashleybttgr	human
@kazase	human
@EarlsKingsway	org
@WILLIAM2B_GROOM	human
@JuiceHugger	unknown
@_DHCatering	human
@hilifeballard	org
@nonaclaudi	human
@L0ve_Enigma	human
@me0wmixalot	human
@Andam_endhel	human
@ILuvPorkButt	human
@DominosPonty	org
@FrancescaVanzo	human
@hanaikeshi	human
@CikMimiiii	human
@BackBaySocial	org
@raymondwhy	human
@EXKiNYC	org
@mittenpawsduh	human
@3Xtraders	human
@KaCHimself	human
@destinationvegn	human
@DeepFoods	org
@EDITHMCCLURE	human
@RestoLemeac	org
@meals_chelsea	org
@LolitaRW	human
@ujalaalikhan	org
@smallapple	human
@ladymarsela	human
@benpanglima	unknown
@Le_Marais	org
@EatThisNotThat	org
@DJPastiche	human
@FakejoyClothing	org
@qiang0903	unknown
@savvysojournsPH	human
@TobeTheerawat_T	human
@wenitta1	human
@ApropoCrepes	org
@vangrath	human
@marxtermind	human
@MapySuarez	human
@TraveleatloveMM	human
@theideaburo	org
@Irfaath	human
@IamHarichandana	human
@kchin5000	human
@kareemsabbagh	unknown
@HLEFCU	org
@Hugs4Chris	human
@a34body	human
@Nsantos3108	human
@hanarokka	human
@BRCheffrey	org
@CoolKidBKK	human
@SAL1404	unknown
@thedamntree	human
@MulligansBeach	org
@Dony_Yoon	unknown
@discoveryparks	human
@EtsyFabulous	org
@MelissaMercier	human
@itsmerenzviray	human
@TicoRestaurant	org
@USAfricaBF	human
@danasnookbiz	human
@GotchaHidalgo	human
@BridalSouthend	human
@bjac68	human
@Lolitasbistro	human
@galatea	org
@InEmpWeightLoss	org
@goxyhetiqizus	human
@rosemci26	human
@egsotig	human
@bigbodykarate	human
@ladymysteria	human
@DealOfTheDay56	human
@SMichaelDesigns	human
@ItsJayStyles	human
@ilyasuzun	human
@calabashbistro	org
@jsperati	human
@yu5uuf	human
@ChevyMarlin	human
@janiebfernande1	human
@Totally_Ruby	human
@ketodietapp	human
@DJNorie	org
@SamDavis66	human
@arts_band	human
@shrewsmorris	human
@BRGRCOUK	org
@MonicChicSeet	human
@raceywander	unknown
@nensil	human
@ParkEastNJ	org
@cookiejusto	human
@thatslifecoffee	org
@DariaLonginotti	human
@oespinosa69	org
@MissHMT	human
@OrtaniqueCayman	org
@mltminc	human
@SidToTheRescue	human
@CanerDaywood	human
@DiningTraveler	human
@GraciaGunawan	human
@_BabySteps_	human
@Andmusfan603	human
@darelectric	human
@Nchaupe	human
@baraondany	org
@hamsterRelish	human
@UDM13	human
@miukai1	human
@P1k3	human
@kaewkandagenie	human
@WeLoveRishiModi	org
@trinitymalcholm	human
@babygracy	human
@GreatTastesMB	org
@catalinhladi	human
@j_nanalogue	unknown
@Harvest_18	org
@sidney_truth	human
@LavazzaUSA	org
@vanilla_libra	human
@kmaichapu	unknown
@WhichWichUAE	org
@Chefs_Choice_	org
@Damsiao	unknown
@Politprivet	org
@sweetesthng	unknown
@GoldenTriDC	org
@BigBonedBARBIE	human
@ChazzRistorante	human
@RoxanaFuent6	unknown
@litorysnit	human
@MichiGo094	unknown
@sezerkurt	human
@thegoodkettle	org
@acleanbake	human
@terry_chong	human
@pippuzza	unknown
@Mary_Carmona777	human
@kazumi_63090123	human
@n0tofthisw0rld	org
@RedBarnMarkets	org
@marouane_chak	human
@uzaypastaneleri	human
@CopperheadAtown	human
@Danny_Willy_CC	human
@EmpowHER	human
@CarolPune	human
@am_ayumi	human
@jerry_melendez	human
@TedsMostBest	org
@socialmonkey_uk	human
@naturalvitamn	human
@Vetta22	human
@ayebrooke	human
@reenbean14	human
@taufiqhusainca	unknown
@EaloraClaudio	org
@McDKentuckiana	human
@dishsociety	org
@dudubitavel	unknown
@ViktoriaShushan	human
@JenLooi	human
@hanautatomochan	human
@KWSW83	org
@EBDecanter	human
@lesterplatt	human
@TheFishChipShop	unknown
@iam_bergzhou	human
@nancybell906	human
@zeppy_france	human
@SamHagensick	human
@powered_by_pork	org
@TribSteakhouse	org
@TheMattMorgan	human
@galove0209	human
@wilson4ever	human
@Madcutie	human
@mooon_noor	human
@mariaflames	human
@Boris80678	human
@CJAllDressedUp	org
@mk73g	human
@DrdaveAnddee	org
@MirzaMalik	human
@MISSBOSSY1211	human
@kourintanpopo55	human
@AAENRIQUEZ	human
@josipovicaleks	human
@TruffleJamReco	unknown
@TheMooseFactory	org
@Lady_Chir	human
@thefoodswinger	human
@LaraLutfis	human
@FairmontMAC	org
@AndreaVlds_	unknown
@GotchaNayarit	human
@mikailamcg	org
@Burmis1	human
@pAaTsHaLa	org
@naga_jolokai	human
@guam_stafari	unknown
@Reemz358	human
@seo4e	human
@Ryan_____Lee	human
@B_1290	human
@zoraida_wiehrdt	human
@gaspershut	human
@DTBurlingtonON	human
@jamielynn1027	unknown
@_MalibuKen	unknown
@LocaleFulham	org
@PATRICKDANCEING	human
@RachelChang	human
@BirdoSmithfield	org
@cherry_LA	human
@DominosBridgend	org
@rosario_stokes	human
@EuniceYinSen	human
@MagnoliaLebanon	human
@LISA_MANDALA	human
@AmerigoMemphis	org
@MediterraneoWL	org
@the_flowercrown	unknown
@KarenWaller86	human
@francois23b	human
@hayapim	human
@FatimaAmay7	unknown
@CARLA23MALYAKAS	human
@kwongfeihong	human
@ivylie546	human
@SuperMat	human
@Lyulyu	human
@ayacharu817	human
@MyLiverpoolLife	human
@kitchenlangport	org
@thiio	human
@RecipeLion	org
@FluxiOnTour	human
@WeLoveFoodTweet	human
@cynthiaeladner	human
@datortoise	org
@DFoodinista	human
@yuta802	human
@boodlesmom	human
@AlvinValley	human
@Melony4689	human
@Georgiann3990	human
@kfj055	human
@CardiffBizTweet	human
@BxBossLady	human
@cylondj	human
@LemonSqueezyUK	org
@TGIFNewportNews	org
@MarloweRWB	org
@HelenRodriq	unknown
@meals_angel	org
@FinagleaBagel	human
@YummlyDinnerBot	unknown
@MarguaritaMend	unknown
@MelanieVanabel	human
@K9ismyhero	human
@PierosLasVegas	org
@ceislin	human
@BANDUNG_24JAM	human
@BumpyJohnson81	human
@AngeloMangibin	human
@DiiDaDiiva	human
@NataliaStasenko	human
@SofitelMontreal	human
@HouseholdChina	org
@hmrcarlson	human
@JoelleJanuary	unknown
@loverofflavours	org
@MarxKhoo	human
@TheLondonDolls	human
@SteakArtCardiff	org
@chizmay	unknown
@Chunchi	human
@Joan_1969	human
@Tiffytoo2	human
@nari0126	org
@murami_716	human
@AbominationDMK	human
@IHaveLanded	human
@irienaoki	human
@Qualityoflove	human
@SheeshaRetweet	human
@dj_maymey	human
@InstagramBham	org
@Kaarrreen	human
@Madelineh28	human
@TukkieNattaya	human
@chatrinethink	org
@Gotcha_SLP	human
@BARBARA_BARNE	human
@EdwardsMellisa	human
@BigRubeHarley	human
@ViemerJhosnil	human
@BistroPetit	human
@WILLIAM_LISTON_	human
@Marcus_Kwan_	human
@WeathervaneCH	org
@ChefMarvz	human
@BeetMoon	org
@TheBigMansWorld	human
@MFashionJournal	unknown
@Kitchnbutterfly	human
@TheRub14	human
@sausalitocoffee	org
@HwifeOnAMission	human
@superhegl	org
@Mdcha	org
@clarechiara	human
@Everydayaaron	human
@KyoBarJaponais	human
@ViolaChalmers	human
@BonBonRoseGirls	human
@dvdclinch	human
@winnie_chang	human
@donnartorres	human
@truestar05	unknown
@mikevogler	human
@Babyd0ll14	human
@marlene_cable	org
@turaks_15	human
@BigLion1967	human
@andrelevine	human
@issei87	unknown
@euniceindah	unknown
@rawveganme00	org
@ashimashenoy	human
@cute_traveler	human
@MinaVonDhoom	human
@karlkenichi	human
@BfastAndBurgers	human
@wani_zainol	human
@jaquespearce_m	unknown
@PittsboroRdHse	org
@KryOrKill	org
@dustbunniesblog	human
@DeePhillip	unknown
@EggNutrition	org
@drsusanmitchell	org
@franciscooks	human
@JocelynFromNYC	unknown
@TheMAHster	org
@dholder3	human
@opalrobles	human
@bCaHnIaCnKa	human
@iAmKay414	human
@Dessie796	human
@erodennin	human
@sciila	human
@EatSavage	org
@JustJadeBlog	human
@Nattnazz	human
@thevineleaves	org
@DilliwalaFoodie	human
@yuka_kasukawa	human
@LimerickHour	human
@Cupcake_Junkie_	org
@ivonnearmant1	human
@FekzAaron	human
@TheBetjemanArms	org
@carissathilgen	human
@hellosam	human
@katebollard	human
@takagamiya	human
@girlygirl007	human
@damron_sharon	unknown
@MJBautistaCPA	human
@abetcortez	human
@Nouradrenalin	human
@NorhazatulAnis	org
@IsabeldmooreD	unknown
@MDash707	human
@sunset_ibiza	human
@JA_Yoga_Vegan	human
@EnjoyFitzrovia	org
@Muhammad_Ozman	human
@bruno_eli	unknown
@LonLovette824	human
@ImWhspr	human
@PetraCupcake	human
@grill_market	org
@Sarah_Shahin93	unknown
@iamjay_pee01	human
@TommasoUlivi	human
@Boardners	org
@MsLake1	human
@Rinkoffbakery	org
@GotchaZacatecas	human
@JustinLambchop	human
@VincciT	org
@MissFigolu	human
@DendyCharlotte	unknown
@Curryhousema	org
@CafePatachou	human
@ParadiseBAR	human
@zainabkhawaja92	human
@EvryDayChampgne	unknown
@brythisway	org
@desayunodiamond	org
@cabosurfhotel	human
@GAONNURINYC	org
@jinarsaskara	human
@datgoldiegirl	human
@Nanniedy	human
@this_ian_garcia	org
@Hanihborhan	human
@mayu040732	human
@Ljinglebelle11	human
@HimawariPoison	human
@kenpaulmendoza	human
@hannahinchesham	human
@devisss87	org
@dwhite0002	human
@hesaidmag	org
@kazumisan_418	human
@wayneetcarter	human
@Battyyyy	org
@Savannataylos	human
@fernandosamk	human
@Luismdfernandes	human
@DynamixFitness1	human
@winkler_maureen	human
@toniamd	human
@kelseybaxter96	human
@TurkyUAE	human
@claireverneil	human
@PaulDeCampo	org
@Vitapath	org
@ShoreFit_Hannah	human
@wwday3	human
@juliette96risto	human
@Evangelevag	human
@rahilaanuar	unknown
@Shinigami2405	human
@ALTITUDE_ID	org
@appleby_edith	human
@burningtoys	human
@rubysnoopy1101	human
@bisdakbabbles	human
@AnitaZuniga	human
@Valkiria0910	unknown
@zmbjj	org
@wagamamapastry	org
@Jascsh1	human
@SierraRosa_gr	unknown
@iLoveLS__	unknown
@jonleehk	human
@ValentinaMdeR	org
@DUCKxxxKA	unknown
@BrainBalanceTUL	unknown
@RobertSykora	human
@nuani_pl	human
@Amandaryan	human
@DOUGLAS_4BROWN	human
@treyedj	human
@yusofyaacob	org
@AriadnaAnton	org
@Aernaja	unknown
@edinagrill	human
@FirstLadiesLndn	org
@garybaseman	human
@ReddRio	human
@russelwongphoto	org
@wholesomedish	human
@grandcentraldc	human
@Renaissance9Man	human
@ItsGabrielSima	human
@thefoodiekc	human
@Simply_Canada	human
@rossa_lina	human
@TarynAlexisLim	human
@m_anthony_pics	human
@pie_martina	human
@Kan_Gurular	human
@PrinceNutto	unknown
@AbdellatifErraj	human
@v_aun	unknown
@MelissaHom	human
@Mahezabeen	human
@joshsramblings	org
@VivaBrazilTweet	org
@Mzeyyemertrk	human
@HNBCow	org
@courtni_so	human
@Arminder1970	human
@ivaniasmode	human
@azizul_MY	human
@pikaachuu0316	human
@5alidMM	human
@girlsdoeat	human
@100eats100days	human
@adriasaracino	human
@TheWomenTalk	org
@wingedgoat	human
@pink_salt	org
@Trib39	human
@AmazingTruffles	human
@Naomitse	human
@ElChinoou	unknown
@IbericaLondon	org
@burgess_verda	human
@TheLoopYYC	unknown
@foodwanderings	human
@designcomplex	human
@BrbrHbrt	human
@AngelSefer	human
@muradevean	human
@toko_8810	human
@littenknapp	human
@highfatdiet4u	human
@getittoasted	human
@sampathdesilva1	human
@LeamanFitness	org
@DWNutrition	org
@BillieJeanHQ	unknown
@Bernardokomodo	human
@TonyaStaab	org
@amandakgrosso	human
@bluemt_11	human
@so_gracesco	org
@Delores630	human
@EatWellTravel	human
@iestatiptra	human
@Cargo_Pal	org
@superherojammie	unknown
@AnitaRobbinsRE	org
@Niesha3330	human
@pegasus_nanazo	human
@poumlamode	human
@mandyking_HEAL	human
@ximiTREJO_	unknown
@Aaugritaa	org
@buryblackpudco	org
@AkoSiKaystee	human
@hajihaoade	human
@AmeliaHanslow	human
@foodiept	human
@great_egashira	unknown
@TittyLipService	human
@bryan514my	human
@ayachoro_22	human
@OrsayRestaurant	org
@ilaikcake	human
@ImCyfOng	unknown
@janeyap97	unknown
@globeho	org
@igaelgm	human
@SpaBnb	org
@KingJoJoPolo	human
@MaxP77	human
@pete_ferrara	human
@DTLAL	org
@SunflowerOtt	human
@herybert85	human
@UrHealthyDiet	human
@DBrattyKat	human
@moyo_w1	human
@TBiggity	human
@pennywisemama	human
@EliteGrandeHot	org
@Low_ShaSha	human
@lesleyLA	human
@Catherin03	human
@EarthWindFlour	org
@mvpark63	human
@ALLEGORYofHOPE	org
@ElixirDowntown	human
@BoBPetersfield	human
@MilkItGB	human
@Evan_Robertson	human
@farruks	human
@VivianaItaly	human
@kitteyandkat	human
@momurico	human
@StefaniJia	human
@faewings	human
@ishimarutakumi	human
@salpr	human
@TheRealTinara	human
@bellarozdoll	human
@Omni4Health	human
@kat0417	human
@sirnomalot_	org
@lakersmind	unknown
@coupon8guru	unknown
@yongyongkuran	human
@DucAndrew	human
@Paakwesi2012	org
@LindaF0nseca	human
@usthreebythesea	human
@UrthBox	human
@A3Napoli	human
@FidelisCow	human
@ChefCamD	org
@Masakl	human
@MO_JAKARTA	org
@SpicyPickleQ	org
@RandomAnaCarol	human
@TeddyOutReady	human
@SinanBora_IST	unknown
@NewbianQueen_RA	human
@ClvrGirlReviews	human
@hostelmamashome	org
@RonCelestino	human
@MysteriousDiner	human
@CalCantaloupes	org
@CTRestaurantWk	org
@imlawrencew	human
@blackpigpub	org
@tys_june	human
@riniandriarifin	human
@TaiSuprecha	human
@Taiman0626	human
@RungCreative	org
@will_tzen	org
@CharlD22	human
@ZoomOnlyon	org
@LatteMatcha	org
@jesi_rotella	human
@OopsImAVegan	human
@kurupssss	human
@LauraLif	human
@TheFoodSauceUK	org
@gregmancel	human
@FiFi_Lewis	human
@accessam	org
@Glitter4Ever17	human
@zamanological	org
@motownsound_	org
@CremaRestaurant	human
@EmmaLander2	human
@designdroids	human
@AshtonandOld	org
@lijia1107	unknown
@simplycat76	human
@ASSid23	unknown
@ParisReally	unknown
@RPMoran	human
@AZUMISATO	human
@SunPiko	human
@SlimJimBABA	human
@OngMeiKim	human
@SeelpheeaW	human
@BDSMCumSluts	unknown
@lunchpactYYJ	org
@me_missnina	human
@TheLocalVegan	org
@MotherAndBaby	human
@animalbodyearth	org
@Emilio_Fabrizi	unknown
@Roscoes_CH	org
@carinkilbyclark	org
@Hani_Idahni	human
@Angel_blur	human
@annmarie4649	unknown
@esahmblog	human
@ChelseaBoy007	human
@GuTTinKun	human
@thelautens0625	human
@RUNHEALTHLIFE	human
@real_fat	org
@Dineinout	unknown
@1207Xw	human
@FoodTruckCrazy_	org
@AmeriAus	unknown
@peeyuka	org
@joannelopez	human
@MeanGirlMILF	org
@chestnutpub	org
@ThePlazaCafeSF	org
@spicethymeinc	unknown
@SEOExpertVegas	org
@GutenMorgenBot	human
@paintingmouse	human
@HotelNevada	human
@Willxia1	org
@styl_enthusiast	human
@jewelrykei0410	human
@May_Parla	org
@TootingPRSS	org
@IrishFoodGuide	human
@theendjc	human
@bricktownonline	org
@3Potato4Potato	human
@GailPR	org
@nazliuzunoglu	human
@sexyjoker17	org
@yaziedhassan	human
@ChezChose	org
@PaulFDavis	human
@byjensangalang	human
@surkhb	human
@jocelyngorge141	human
@Shakewellbar	org
@whitewolfcafe	org
@UNCLEJACKS	human
@LindaNotelovitz	human
@e11evenToronto	org
@TangerineJam	human
@_sportmate	human
@AvivVodka	org
@mynakedsnacks	org
@kjaegerfalk	org
@BeccaMorgs	human
@HermanosHerrera	human
@eatlafayette	org
@Gumbo_Music	human
@thehoodkitchen	org
@GiovanniGBar	org
@FortBlissGAH	human
@Fareeba2011	human
@NahkitaLashae	human
@diningwdipalo	human
@FionanaC	human
@DominosMerthyr	org
@Shinewellness	human
@shezeenanwer	human
@alexvinly	human
@RelyReley	unknown
@yurivazzola	human
@Prusovka	human
@stonemed	org
@SoundGirl0508	human
@MommyBanter	human
@_AmbitiousLeA	human
@enygma1314	org
@chalklanehotel	org
@maanzulaybar	human
@k3nt_low	human
@TriciasList	org
@CafeORTUS	org
@Kec_Tebet	org
@365ishPins	human
@MattSoleyn	human
@JC_author	org
@BeyondBreakfast	org
@samw19981003	org
@TheWowFactorUS	org
@citizennauld	human
@TefaaRenteria	human
@hannah_jermyn	human
@johnny_tai85	human
@LabocaGrillCafe	human
@thomsonchris	human
@shiela_benjamin	human
@FridasBakeryNY	org
@Kilian93LSM	unknown
@jujuwinaldy	human
@douly1977	human
@MshKrnd	human
@ditchio1	human
@vansa733	human
@dearestkaterina	human
@eatwithjess	human
@ResidentPR	org
@ProphetMicah778	unknown
@Simon____Smith	human
@endoverendo	org
@SlymHeat	human
@desginarama	human
@Seymour1250	human
@Xsanthemum	human
@aLisZiee	human
@EmileeShi	unknown
@MewsofMayfair	org
@chinita_jAxx	human
@luzaidan	human
@theshrivelling	human
@JulieLeClercNZ	human
@cristalc03	org
@hironozu	human
@Bagrrys	org
@nickizaka	human
@hhbookclub	org
@foodpandaPH	org
@hollywoodlaff	human
@highxdosage	human
@patryazagra	human
@luis98fer15	unknown
@HerniVader	human
@TGIFMyrtleBeach	org
@ahmedh202	human
@We_ServeYou	org
@DaVisClark	human
@BOLD_isMYbeauty	human
@lethalleslie	human
@bargainez	org
@JasonDangerDiaz	human
@CGrizanteGMezzo	org
@jackeiner1	human
@jets00006474261	unknown
@Gabrielles_Dine	unknown
@triasmardi	human
@Changing_News5	human
@DFGrilleNBeth	human
@Vito_Minaudo	human
@communiteacic	org
@FarheenAqueel	human
@SJaybadell	human
@marinzkie25	human
@blondieburdge	org
@FreshTakeAway	org
@LiveLoveLearnHC	unknown
@furtadosbazaar	human
@karla_kaman	org
@itsmerafael14	human
@marycage25	human
@SarahAdams095	human
@Funthyme	org
@FoodStudents	org
@StphnChttn	org
@Doli_Indra	human
@dioknopamela	human
@melody_violine	human
@TheWowAnthology	human
@saraetbutler	org
@t_piggy	human
@grupoazormexico	org
@MWill1980	human
@Jii_bear	human
@TheHormoneDiva	human
@KarinBarnhoorn	human
@BenditaLocuraCD	human
@SourceLifestyle	org
@_JulesReed	human
@Leistunghund	human
@ms_sosa714	human
@jkpreyes	human
@CandiWerx	org
@netnutricom	org
@ilovemitchbarce	unknown
@monstergalpri	human
@zamlos	human
@IkeKurnia	human
@Chinorocks	human
@gege_dyb	human
@Timberlaky	human
@filizozgur	human
@chfjenna	org
@beachbody_leads	human
@thatfooddood	human
@_FitnessFreaks_	human
@kaypee_az	human
@eatrecklessly	org
@productospaqui	human
@COG_fitness_	human
@jufcarreira	human
@hiroxkuri	human
@AldoZilli	org
@realjoe	human
@DinorahFloresdf	human
@iamNaaraa	org
@MiguelsCocinaSD	org
@queen_wil	human
@stacyELTblog	unknown
@NicoleCulver	human
@sophie_dee16	unknown
@NicePersonNia	unknown
@RachelBies	human
@DakotaBalkwill	unknown
@kegan_nivedita	unknown
@YAMILY_ALONSO	human
@nied_seno	unknown
@Bbii_Chun_Chun	human
@MichellebbTan	human
@Mar_CSanchez	unknown
@mattypeks	human
@yummychami2	human
@djacemusic	unknown
@LiyaNini	org
@RAPMAGKAARIS	human
@DailyAppetite_	org
@natalieglover1	human
@ArdentiaArs	org
@totisantiago	human
@MathildeMeteye	human
@Thesanjoy	human
@RapMagTV	org
@LabriolaRistora	unknown
@beclewis	human
@Angelayang	human
@syahmadh4n	human
@abekouichi0427	human
@ComfortBaking	unknown
@nantida_tim	human
@F4Female	human
@BrehoiMihaela	human
@ozlemurioglu	human
@s_cosgrove	org
@SashasPorn	human
@kung_ramingwong	human
@chin_yau	org
@lovematteokhan	human
@jchhabria	human
@TYOGOLITE	human
@LadyBirdMollyz	human
@NYSnacks	human
@NYFoodgasm	org
@Mikey_NoWorries	human
@glabarm	human
@Changing_News2	human
@Clark_fit_Kent	unknown
@MavMan68	human
@TGIFRaleigh	org
@MudpiesandTiara	org
@juliaetbaker	human
@FitWayOfLivin	human
@juliobarrera612	human
@Lynn_Marie45	human
@ChefAJJackson	human
@keimy0324	org
@KimHobanRD	human
@Southend0nSea	org
@realagent96	human
@theradicalB	human
@smithbites	human
@theParodaVet	human
@SBLChris	human
@Danushkacooks	human
@TheDinerSB	org
@shaun_japsay	unknown
@freak_spotter	human
@MattiaDiBono	human
@CrowdMappedPR	org
@shinanandana	org
@JamesRestarick	human
@catcheycafe	human
@super6r1	human
@kappi1122	unknown
@PuertoCabo	org
@CarreraHouse	human
@hotvideoca	human
@ScrollsNInk	org
@somehowsophie	human
@sweetlifeforcha	unknown
@C_A_M_A_R_O	human
@apfle416	human
@MPaulaRamosS	human
@vynnymm	human
@resalediva	human
@BoundCumsluts	human
@Coach2TalkRadio	unknown
@LHOCreations	org
@nunie_j	human
@AgustinaAssi	human
@Audry188	human
@Mulancita7	human
@SenseiWhitfield	human
@GatorSpotting	human
@quiniepie	human
@mkaHQ	unknown
@aa_hari_	unknown
@leelalicious	human
@zDy83	unknown
@Tremont647	human
@SaltCreekCasino	human
@StaceyLub	human
@TanyaPipich	human
@akstout18	human
@SpritzBurger	org
@PhilipPerre	human
@brigittammy	human
@KarenKing_07	human
@TheyCallMeCCV	human
@Monaco228	human
@MudBayCafe	human
@walkerareanews	human
@retairena96	human
@MartaTovaglieri	human
@jlz_1280	org
@Stephanie_Yaffe	human
@Jade_Stanger	human
@vennvenn17	human
@CollegeCeliacs	human
@FM1061	org
@MayNuti	human
@KarineFitMtl	org
@KetiMazzi	human
@CoachGuidotti	human
@bangerzwth	unknown
@elsapastelera	unknown
@filomenalake	org
@amalBastian	human
@terrysaporitram	human
@SnoozeAMEatery	org
@OluochKennito	human
@RomeeGroothuis	human
@ChalNikalOye	human
@PatriciaCeru	org
@David_K_91	human
@KishTweetsDaily	human
@emiliesobels	org
@voetbalpoul	unknown
@Yumiko_jojo96	human
@DFGrilleBurl	human
@wkcafe231	org
@TGIFrichmondLab	org
@DOUGLAS_s_skib	human
@jemurdough	human
@JOHN_LORENZI_	human
@thebeagles0707	human
@LittlePastels	human
@LaraMurray11	human
@eatandcook	org
@IndustryBeans	org
@lifeofelle	human
@_Mwrites_	human
@mummy2to0h	human
@SaytheVword	human
@MsFrancesca_r	human
@Inessmorais	unknown
@nickilee33	human
@BCTaco	org
@fechnerk	human
@_candiizz	unknown
@CookCleanCraft	org
@Fabletics_DE	org
@bethfitzpatrick	human
@NeuvooTeiVienn	human
@JamesTFletcher	human
@chiftf_uchicago	org
@GFMaven	org
@D_TheShadyPorch	org
@BoseApurva	human
@igersCadiz	human
@DominosCwmbran	org
@zcampbellphoto	human
@ICHISUSHI	org
@LambethWOT	org
@Flabbypanda	human
@TGIFrecipe	human
@AioKona	human
@myles111us	human
@fizsfs	unknown
@DrDawnOTR	human
@cutiehotMOM	human
@YogaCocktail	human
@oscampuscafe	org
@BeautyfromItaly	org
@vegabajagoddess	human
@AndyMdeLeon	human
@foodventurist	human
@carnalfedfrenzy	human
@DominosChepstow	org
@dezusvanmnbroer	human
@sora_usagi_	org
@KyleTheKatalyst	human
@LizzieBland	human
@GossipDetector	org
@Amandathecook	human
@asm_0428	human
@LiciaFlorio	human
@FortBelvoirGAH	human
@LeParfaitParis	org
@Lunch_Cucina	org
@Athiplai	unknown
@VicSlim1	human
@strau_brey	human
@friangganu	human
@rachelonpointe	org
@SafeEggs	org
@happenstancesl	org
@liao_min	human
@fetzhang	human
@zara_yasuna	human
@geloooohh	unknown
@swelephant_cafe	org
@DisneyGals	org
@UNCKJ	human
@VictoriaBCToday	org
@CatsLoveCooking	org
@teresamorone	human
@bobbimarie24	human
@Eddie_Ortiz	human
@the_twittzor	human
@ClubMonacoMotor	human
@inzillospizza	org
@lousohongray	human
@sunkisstiffy	human
@rajster86	org
@AyamBrand8	human
@thirdletterc	human
@gl0412	org
@bloglauraoupas	human
@Kaddiontherocks	human
@xiiaomei	org
@sammie_rez	unknown
@Trini_Taurus	human
@BRIAN__RANDLE	human
@jazpertiongson	human
@JessAM87	human
@anujadeora	human
@SelinaLewis7	human
@LeeBryanOnel	human
@SanteriaMilano	org
@elangit_niza	human
@aien_purple	human
@stickyfingersdc	org
@OliverDunne	human
@bparkingnyc	human
@Starlalever	human
@LuluPalmSprings	org
@KristineOhkubo	org
@PittiUomo_ig	org
@rhodymomrunner	human
@TullAin	human
@MilanoDine	human
@RubyLway	human
@MiaowMie	human
@jhelobaby16	org
@faithfulmomblog	human
@womenruleonly	human
@eban_alba	human
@jackburton1979	human
@chiarasfoodwine	human
@rocioconesa	human
@MonikaTanas	human
@s_411_t	human
@ChefBernardDC	human
@Ngie_22	human
@iluvtweety18	human
@ItsHanoy	human
@PulpMyFiction	human
@777Dublin	org
@lascherillo	human
@Ladymelody007	human
@cj_LAD	human
@SageBistro_CNMR	org
@sunchyne79	org
@CityWaiters	org
@airchristophe	human
@lucyinabow	human
@elygio95	unknown
@DominosCaerphil	org
@Giggles561	human
@Fitnessmom1	human
@SkyPien	unknown
@ABCGlutenfree	org
@peipeiWang1	org
@neuroticbaker	human
@edwinvergara	human
@beer_benefits	human
@TeachAmandaFish	unknown
@tadcaya	unknown
@BabyLovingMama	human
@MubarekaMakeUp	human
@sistermaryjames	human
@blew1	human
@mylittlemadrid	human
@Chandra_Pao	human
@OliveologyUK	org
@AlexTaramona	human
@siewlee1811	human
@wholefoodjunkie	human
@Landmeedchen	human
@selvyDes	human
@Bemocked_Cypher	human
@GirlHeartFood	human
@AbsolutCraizyRy	unknown
@teweuk	human
@thedee143	unknown
@Rawan_Ali_M	unknown
@gluten_group	unknown
@MIAGIZANE	unknown
@rthompson33602	human
@JargaPix	human
@Yelle_Darling	human
@FaconHouston	org
@cultivatorofLB	unknown
@searchexactli	human
@William_enz	unknown
@rayRsan	org
@rice_and_noodle	org
@kateplus_	human
@s_ericasandor	human
@ksuave	human
@kiutees2y2	org
@FSLosAngeles	org
@grahamegger	human
@AManoPizza	org
@susanaid41	human
@claudiafaranda	human
@monkeynutstweet	org
@JJ_Sully	human
@happiour	org
@sshigekix	org
@NuchasNYC	org
@TheTruffleHouse	org
@CeresParreno	org
@RoseVillaTavern	org
@why930907	human
@ygq718	org
@weowetwetweo	human
@casadiabla	org
@Xclusives_Card	org
@TAMGPR	human
@QualityArt	org
@masee0052yh	human
@TheSunsetStrip	human
@JanRomes	human
@ferdinandbs28	human
@ClevelandClinic	org
@Almond_Fresh	org
@thecrowbarcdm	human
@KettnersLondon	org
@FwdHealth	human
@JasonMcDermen	human
@ShannayaBreezy	human
@kokikiyo	human
@CHarveyBiz	human
@ohimamikeke	human
@winnie8829	human
@koyaeri828	unknown
@hundaga	human
@BPSaanich	org
@bzlivegym0	unknown
@BeccaTredeau	org
@HanishaLalwani	human
@anapaulalima	human
@belleaukitchen	human
@DitaTime	human
@Ennaest1986	org
@khunshyice	unknown
@WhatUCouldDo	human
@ken803s	human
@deyonjohnson	human
@anamargaridalr	unknown
@SmyyeKubraDAGLI	human
@sushi_junki	org
@Zahlerestaurant	human
@WildOrchid985	human
@kantaphong	human
@JamieFavazza	org
@Dessert_kitchen	human
@GianniSepe3	human
@alemeksykeu	org
@mariarosadg	human
@Ken_JPOP_fans	human
@a5rie	human
@FortBraggGAH	human
@ThickLoud_Kyia	unknown
@YungYoungbrg717	org
@MICHAEL_HART2	human
@K8TYBoo	human
@YachtClubDubai	org
@gabynocanada	human
@Lisda_AT21	org
@frankbicocca	human
@PhotosbyGabri	human
@spica_mode	human
@kite_fishing	org
@bacolodchknbbq	human
@aner76	human
@CrazyKittten	human
@meellsj	human
@Gennacher71	human
@Riley28917	human
@tina_dollface	org
@omoshiro_PDWVE	unknown
@helpmamaremote	org
@SirThomasHotel	org
@fulmetalartimis	human
@welike2cook	org
@melEmel86	human
@BubbleBezee	human
@HarlemGuide	org
@almostapricot	human
@QSFLancaster	org
@healthyseasonal	org
@veganfeast	human
@Pantry_Cafe	human
@TaldeJC	org
@_karenzetina	human
@bot02349977	unknown
@E_R_G_WHY	human
@miho_meeodam	org
@carolyncariaga	human
@ProudLatinaTX	unknown
@FleurDietitian	human
@RozzisCatering	human
@mrvictorluciano	human
@elleeeeelle	human
@Conanhong	unknown
@maggiemae34	human
@BeautiflTragedi	human
@RyanSMichael	human
@Fashion_Flavors	human
@henryezkandar	human
@kaeselin	human
@amom2fight4u	human
@heiji326	human
@PrettyN_inkk	human
@OutbackPuntaCan	human
@hiVanny	human
@sugayline	human
@FavelaCubanaNY	org
@peoplemag	human
@100trains	human
@ayakayamaguchi_	human
@Amber_Keshire	human
@Havanacasadcafe	org
@albrighterday	human
@TasteTheNature	human
@CandiiPaige	human
@ITSCHEFBABY	human
@EdwardKaihatsu	human
@GFORCE_Michael	human
@ibunAyou	human
@MoyeMiami	org
@yppilot	human
@hellonoonoo	human
@didsburylife	org
@lenor1799	human
@AzureReadingIt	human
@vinvillan	unknown
@ajggentozala	human
@Debers0605	human
@explorebluedoor	org
@FairulRamli	human
@FlavCity	human
@fazakprimary	org
@FTdeZign	unknown
@jzivy93	human
@foosye	org
@holliej87	unknown
@chefwaiterhater	human
@LukeElin	human
@redvelvetnation	human
@ObikaUK	unknown
@thehungryrells	human
@elkesockeel	org
@foodwellbuilt	org
@RRRR_LLL	unknown
@ChrissiGlamour	human
@FoodieBuddha	human
@MFHappyFork	org
@DabnorBibiane	human
@MommyImHungry	human
@CopasyBares	org
@LookUpNDaSky	human
@AishwaryaAjit	org
@dorisetclark	org
@PizzaHutOrmeau	org
@Natalie41783835	human
@Maykabcn1	human
@nnphenomenal	human
@Littl3MissD0lla	human
@Mayi13141988	human
@bench_ave	human
@beggars1973	org
@AgentRie	unknown
@hdana74	human
@EveDonkin	human
@CafeNonnas	org
@CurtisSChin	human
@risa_risa0823	human
@sassycat38	human
@KelleyVargo	human
@tcchronicles	human
@tapsytapas	human
@hanane_cuisine	org
@Michelle_Oliva1	human
@NeedSexyRt	human
@ComfortMkt	human
@candtalan	human
@EdinburghLover	human
@BeatrixChicago	human
@meals_kntbridge	org
@ChabrotBistrot	human
@DuckInnChicago	org
@Travel_Sharer	unknown
@unmatchafrappe	human
@wonbida	human
@rova305	human
@babaduck71	human
@BeaAgoncillo	human
@OdysseyChicago	human
@cbusadventures	org
@kimilogy	human
@BlueberryNutrit	org
@NadaB98	human
@elegantlyeco	human
@wtfmrpooks	human
@HostIndiaOttawa	org
@staceysetoki	human
@MichelleB_The1	human
@WendiiiE	human
@AleMau5	human
@drainedbeauty	human
@drhynard	human
@Funkychickensth	human
@MegawatiSu	unknown
@wanmiz	human
@TiberinoRoma	org
@crusinchristina	human
@Changing_News39	human
@PFCMIKEJONES	unknown
@itzssp	unknown
@Lilphillip	human
@SofitelLyon	org
@kathleenetdavis	human
@Music4HimNow	human
@richbennny	human
@K22nj	human
@mrspugiotto	unknown
@recesseatery	human
@nagomi_mi	human
@Johnb0y85	human
@BeverlyChee	human
@pMr1337	human
@bokiecookie	human
@mayie_may	org
@YerBolognese	human
@RaymondPasadena	org
@tweet_ingHAPPY	human
@IrisCafeNYC	org
@OrganicSunshine	human
@MondayBlogs	org
@iamaljangeles	human
@quenchnation	org
@jeremy2929	human
@akosipv	human
@BJermaine	human
@MajdALalami	human
@MJoy_Oldfield	human
@WeedBinge	org
@bolet53	human
@Saladicious	org
@slimmingworldSH	org
@Tessie116	human
@lweichiang	human
@EnricoCallino	human
@SilviaPersini	human
@NeuvooHalifaxNS	org
@8Arjay8	human
@loveleov	human
@WrapsByKeshia	human
@allstarpdee	human
@FPaulRevere	human
@the_memory	human
@LiLaruan	human
@sunnilala	human
@Carlos_Naimeg	human
@nella22	unknown
@thedigitalbird	human
@H_Alenezi_	unknown
@tarrowe	human
@she_WIL	human
@ThisIsOFH	human
@MissMaaike85	human
@randelrosales	human
@Jordanzitop_933	org
@pecel_	unknown
@ReniRespondek	human
@TanyaCabrera17	human
@quinzhang	human
@awanderlustyogi	unknown
@NYCsidewalker	org
@cheesecoffeeabq	org
@bot40691611	unknown
@Amaliedamkjaer	human
@n0ggy	human
@unklzaki	human
@AbdulSongui	human
@glmh101	human
@pietropaschino	human
@PlaneFood	org
@eggsmartshores	org
@BimmersportAuto	human
@niccomania	unknown
@ndoparaolado	human
@jaredvxd	human
@iStReEtWaLkeR	human
@unnakednails	human
@DazzlingDeal	org
@Tamaradomingz	unknown
@DebrinaWright	human
@HepworthKitchen	human
@PardioFitness	human
@BibisRestaurant	org
@iamYUKIITO	human
@KGlatt	human
@DanielaFrewa	human
@WakeYaMindUpEJ	human
@FashionPeopleMa	human
@qatarflights	human
@sutweet87	human
@OtakuKenz	human
@ilaria_muller	human
@charlie0353	human
@slicehouserp	org
@OrlandoPicks	org
@WillsatOne	org
@spicyrish03	unknown
@RossForcione	human
@ikayuaq	human
@martharrazi	human
@DanielDeppe	human
@TigerLeadership	human
@JoeMuerSeafood	org
@marauder760	org
@LoveBlacangel	human
@AloooyMohammed	human
@iamYemilouSR	human
@pwbayonne	human
@kiki_guri	human
@ajhess05	human
@nyameen86	human
@PauloFurtado	human
@hiphoplifemusic	org
@hotvideo	human
@Coleen421	human
@edf_89	unknown
@Pretty_And_Fit	human
@wwgklyz	human
@AnthnyDProducer	unknown
@janebeep	unknown
@JWDesertRidge	human
@kjfsix9	human
@MayfairClub_	org
@supado0522	human
@EduAyala_	human
@balue78	human
@Vialecg	unknown
@CurryDaysApp	human
@brokenhana	human
@WeirdMikeRocks	human
@burcintolga	human
@aerialdancerumi	human
@recipedotcom	org
@nssmith46	human
@zumba1301	human
@VisitLankaBot	org
@PappaRotiUAE	org
@dulciesbeautybl	human
@dc777id	human
@mochalatte09	human
@cheryletpeter	human
@saraochoapalau	human
@QuinoaRest	human
@ORBC	human
@zamisd82	human
@JocelynNicole15	human
@dsok06	org
@ItaRiveraMelin	human
@damevan20	human
@upidyB	human
@themeddish	human
@babycakessd	org
@BirdhouseUK	human
@DominosAberdare	org
@elia_noviana	human
@mijames82	human
@noinaive	human
@thankyoumydeer	org
@Submarinaok	org
@manandcat	org
@ernestick	human
@letseatfirst	human
@ChowDownSeattle	org
@Alejaibra	human
@minsy329	human
@TOMOMI_DIAMOND	human
@AdrieannaSaxoni	human
@mariamabdillahi	human
@thezoful	human
@TINKER12X	human
@greedybackpack	human
@2ndActHealth	human
@seafox81	human
@csfernandez1977	human
@EatHealthierwMe	human
@nickkrk	human
@bonappmalahide	org
@BastilleVa	org
@OliverBonacini	org
@Liljendal	human
@eddiesky	human
@DunnBrosUptown	org
@ver_vin88	human
@Leniii2211	human
@Miki_Koizumi	human
@zeppy_startrek	human
@AlbanyBistro	org
@chesterDmolestr	human
@davidhhwang	human
@Grendle210	human
@Wataru_Kun	human
@Time4mommy	human
@existential_xo	human
@WeekendWinter	human
@ManuVidalRivas	human
@RomeInDepth	org
@hazelsolon	human
@HookedonPaleo	human
@Yani_Scozziero	org
@GibsonsSteak	org
@ame_music_dubai	org
@WahyuRahman	human
@1DaniStevens	human
@_FredG13	human
@Riceflour	human
@charlenezhuo	human
@gabrieloto	human
@capee99	human
@Hayleywoowoos	human
@DjLuMan	human
@JulianRibinik	human
@JackieOurman	human
@candacepayne	human
@aclove2077	human
@algoparaponerme	human
@TheGadgetFlow	org
@vipe_bk	human
@Yeedfarrel	unknown
@Dadigirl	human
@MARGARET_MOSHIN	human
@novhymanurung	human
@izatAS	human
@Tunivisions	org
@innhouseuseonly	unknown
@EastSussexTalk	org
@ClassyChristy09	human
@GabFLouis	human
@HdpFitness	human
@NatalyPant	human
@adamsgrubtruck	human
@OntCraftBrewers	org
@limoncello_food	org
@DESIGN_STORE_T	human
@JLynnGirl1	unknown
@MenuSapiens	org
@siewpeiwen	human
@IntroCooking	human
@zun0709	unknown
@Krishna8470	human
@poconyapoco	org
@LinasQatar	org
@Changing_News10	human
@yyc500cucina	human
@wyattwichman	human
@DwarfHammyMum	human
@klarahemlin	human
@alisoncnapier	human
@magalicuevas	human
@ThePowerPen	org
@cowbellnola	org
@ARYZauqOfficial	org
@dtorr33	human
@HectorCarmonaS	human
@EBP8284	human
@bellaella7	human
@199472100	human
@tomoe_07	human
@anne_la_lim	human
@abcWitness1	human
@VeramoniC	human
@enngigi	human
@La_FeriaHG1	org
@PaRn_Papaya	org
@MariamAssaf3	human
@Pb_80	human
@madisonshotel	org
@Mackay_Coffee	org
@northbeach26	human
@misspebblesss	human
@NutsNMoreUSA	org
@ikuan	org
@BangPopMelb	human
@BlackWhite_Porn	human
@Redlizzy1	human
@curryoba	human
@MichelleTayloMM	human
@gersonmora	human
@DarnahMorgan	human
@tzarlz	org
@TrillmaticRT	org
@athenaskeeper_	human
@CarMenYong	human
@meemai82	org
@John_JC_Caruso	human
@DominosBarry	org
@InsidiousCesar	human
@reni_89	human
@Lina_Alarcon	human
@Starz_Aminn	human
@e_Masatoshi	human
@Gressoneyfb	human
@DawnYang1	human
@jewmob	org
@huckleberrysplc	org
@simona_reca	human
@dreamclosetfor	human
@Asellina	org
@ElmhirstResort	org
@FabiTermidor	human
@pigandbutcher	org
@saltygirl7	human
@marina_cerra	human
@totallykeen	human
@OhhSocialMedia	human
@Hannoouu	human
@OrganicallyMo	human
@DominoNewportCR	org
@DiningPerks	org
@PrettyP_MakeUp	human
@tmaws	human
@BrokenMeatball	human
@dila_za	human
@KidsNSleds	human
@LorisDeluxe	human
@yellowstonemike	human
@myshapers	org
@haassun	human
@craftdictator	org
@djsoundstylist	human
@ddz6006	unknown
@JamCookApp	human
@CAMELDOG_YU	human
@RutsiCM	human
@ZeinaTlaiss	human
@c8r0lyn3	human
@TruffleGod	human
@0098smad	human
@Giselaputri9	human
@MercaditoHosp	org
@Michael_Dismuke	human
@TwoPickyFoodies	org
@iamnityapriya	org
@UCTRadio	org
@MamaHolistica	human
@OscarMezaR	human
@buttondigital	human
@Grazia_NL	human
@star100x	human
@rhondalayton	human
@TwoSummers	org
@RScheir01	unknown
@micoh87	human
@itsmekatie1220	human
@AldacosDominion	human
@ladywimbledon	human
@KristySamone	human
@MettD	human
@BreakfastClsrm	org
@ZanderBrant	human
@Eleannet77	human
@MDOlympia	human
@DanseiKun	human
@JoeyTripHopper	human
@SicilianaBeauty	human
@bubblybeba	unknown
@sueraya	org
@annedubndidu	human
@MagWojCop	human
@donCmontgomery	human
@BigMuscleDad	org
@BelleNaturelleS	human
@DominoRisca	org
@Sannysample	human
@UbuntuPromsLtd	human
@ladymarielle	human
@Changing_News16	human
@MaharlikaNYC	org
@7maikeru777	human
@MediGo	org
@DJ_DARO	human
@village_gym	unknown
@FannyFlowerss	human
@LastmansBadBoy	human
@CoachesTavern	human
@javierr69	human
@zatulkay	human
@AngieStephanie_	human
@iLoveFunOFF	unknown
@RachelLow14	unknown
@SimplyDesigning	human
@CalumCurry	human
@JamrockFood	org
@anadom75	human
@LBistreaux	human
@itsmenemiea	unknown
@SweetButterflyV	human
@komarjohari	human
@susan_az	human
@albert_ozzy	human
@MAPIcom	unknown
@thexia012	human
@atticgirl76	human
@MedorDu27	org
@vanessa_824	human
@LeaGutierrez1	human
@JPLocalFirst	human
@quinnfarah	human
@nic_uy	human
@mikeyfdez	human
@MyDubaiMyCity	human
@KatyCoffield	human
@WannaBGourmande	human
@ESPRESSOLOUNGE	org
@TrevorJDaly	human
@DoctorNvrmore	human
@wonderg1	human
@Molly_Ramone	human
@mandfhers	human
@thentherewasIA	human
@Moalhashimi1	human
@apwapurpose	org
@comellasfood	human
@BARSTRAF	human
@TheNoviceChef	human
@GervasiVineyard	org
@Without_AMC	human
@FowlPlayTruck	org
@Changing_News7	human
@BestBetOnTheWeb	human
@redfighadd	human
@realdbosbi	org
@Real_Lee_Min_Ho	human
@MommaMediaNetwo	org
@tinawoo21	human
@PekkaPuhakka	org
@screamDiNA	unknown
@Ajax_Of_Telamon	human
@janneyyan	human
@TammyLaLaLand	human
@carmelartdesign	org
@AgnesBellamy	human
@KayFaizal	human
@WellingtonBrew	org
@DominosMalpasRd	org
@asextonrobert	unknown
@artwhkg	human
@JOLTJAVA	org
@j_bienvenue84	human
@dianeetwilson	human
@Sweets2day	org
@deliciousandgf	human
@Jas_Tas_Tic	human
@chrisjtrujillo	unknown
@SpitandRoast	human
@Michey_licious	human
@MelissaDToler	human
@vanedeveyra	human
@VisitSavannah	org
@misseileensoo	human
@v_akili	unknown
@Pitarria	human
@sethtravis	human
@weazoid	human
@HyattMadeleine	org
@KiaSebastian	unknown
@Life_Is_Sweet20	human
@CaPuCiNa	human
@maimeronpaaan	human
@MochaBev	human
@Chefkaransuri	human
@thum_belina	human
@WyneStainedLips	human
@VanKaramanos	human
@ParenthoodCom	org
@hasanx71	human
@ttnesan	org
@maisonsibon	org
@katence25	human
@elpalmaronline	org
@CAROL_CAMP_	human
@aero88bic	human
@BrightonLoverUK	org
@GemmaTrevillion	human
@PappacicciaSW6	org
@tenesommer	human
@SophiesDublin	org
@D_V_7	human
@fitcupcaker	human
@ajburuca	human
@luyaozers	human
@patricketbaker	org
@eyeheartit	human
@sheratondubai	org
@PeppadewFresh	human
@mayuko0428	human
@55daddygirl	human
@df_condesa	human
@layla_400	human
@CAROL_CHMIEL	human
@IamStarline	human
@RJKANEAO	human
@Thejay1	human
@mitchiekins21	human
@SanetBaking1202	human
@Bernetta382	human
@BungaBungaLDN	human
@HelenaTeodora	human
@ryuta1028	unknown
@Roselee8140	human
@Puliauk	human
@IG_Tiff4ya	human
@lafayettekanard	human
@SigningToddler	org
@TattooedJuggalo	human
@teoqianhui	unknown
@MyCoffeeStopUK	human
@KristinSAHM	human
@aiueoayu	human
@WorkoutRadar	human
@Yung_poitier	human
@LESLIE_OCASS	human
@ReeBennett	human
@N_Hassaballa	org
@Syafiee_Ali	human
@Chrystlebee21	human
@Nonik2912	human
@tersern07	human
@hal7474	human
@Pingplalee	org
@miskanal	org
@FFairies	human
@HaloCafe	org
@fbrtw	human
@LexingtonCandy	org
@EpicHouseWife	human
@jetnatuelgo	org
@CapCrush	human
@veyalicious	human
@LivEveryPlate	org
@UomoSenzaTonno	human
@toth1981	org
@JaneofAustralia	human
@carlita20002000	human
@NuBeginnings	org
@TheWalk	org
@lilajust	human
@debracar7	org
@LadureeUS	human
@ume1o25	human
@bond_louise	human
@UNAHotels	org
@FreeDramas	human
@boo_thedarkstud	human
@SixLittleHearts	org
@RBKCMarkets	human
@GearedOut	unknown
@TrStyleCooking	human
@craigcockburn	human
@iloveyourainbow	human
@ViviiYeo	human
@nom_nom_nom_nom	human
@coolchillmom	human
@lifemorenaked	unknown
@NinYOWisMYname	human
@keykwangisb2st	human
@JulieAnnPoll	human
@socialmediamond	human
@PriskaTalia	org
@ReedsDiner	org
@TwerkFR	unknown
@WhatCoolMomsWan	human
@TracyRepsMusic	human
@dad_cooking	unknown
@shaaqT	human
@bhavikbhoot	org
@IonaturalWorld	human
@Byn	human
@MonicStevani	human
@_FamilyFriendly	org
@stephy905	human
@JaimeCule3	human
@Sita_S_D	human
@chareene_1981	human
@m_teshi	human
@middlebrowmadam	human
@TradersHotelKL	human
@MamaKupcakes	human
@FuyandyGTjhin	org
@marylolagouge	human
@ferlynfeliciano	human
@edzborromeo	unknown
@xedout23	human
@mummynmecooking	human
@ViviIka	human
@UmurColak	human
@ZapatosdetuBoda	human
@AnnelOnline	human
@theRealScrazzle	human
@JerrysPRM	human
@CultureTripLA	org
@queencitysaint	human
@mybeautyboxblog	human
@BXFern	human
@MissKayleigh_H	human
@MotorBike_TV	human
@TWlTTER_SPORTS	unknown
@OhLuke_	human
@Maeva_B_	human
@KiyoeI	org
@madpizzaebar	human
@chowandchatter	human
@deskynowsky	human
@LolitaPortland	human
@JohnMackEats	human
@LS25WebHosting	org
@EmilyDiaz83	human
@PornStar_40	human
@MonoComeBanana	human
@Sasta_Show	human
@FitandFoodieC	unknown
@CameHereToParty	human
@ysha	org
@BBlondieBaby	human
@JoeyBevan	human
@CestoCoaching	org
@SimplyGoldBlog	human
@GrillfishWDC	org
@ameliacherrypie	human
@CityTable	org
@cajp10	human
@angahparty88	human
@proteinbakery	org
@tiffinigonzalez	human
@mariaetyoung	org
@hecate0118	human
@DanMorgantini	human
@AButchersSon	human
@snottysomm	human
@FoxyFalafel	org
@Halifood	human
@steveireson	org
@TheTivoli	org
@workoutgirl321	unknown
@iffisangi	human
@choicefm1043	human
@ShopWithAdam	human
@IKEA_LongIsland	org
@iQrecipes	org
@skybe	human
@Stannsfct	unknown
@ID2Tcrew	org
@phiephieex	human
@maririku	human
@G2BGummyBear	unknown
@PlazaatPreston	human
@Beautyisraw_DE	human
@RPSekon1	org
@BrianJosephOHar	human
@soraandrie	human
@yarusaru	human
@CeesStokman	human
@kelbugsmom	unknown
@vbiscotti	human
@MICHELLE_VOSS_	human
@ahmad_alkharraz	human
@MadhavaSweet	org
@CTCarra	human
@emraguso	org
@McMomentsBlog	human
@CaviarChronicls	org
@CocoGirlButter	human
@EbeeMD	human
@kalurah	human
@chef69	human
@HueyMagoos	org
@carlyphilpot	human
@Abyuka	human
@zduvenci	human
@princericosuave	human
@jenniferetperry	human
@CoachJohnKz	human
@MODEmagazineDN	unknown
@joshualevy50	human
@placesiveeaten	org
@HealthyGirlLive	human
@TabishYousuf	human
@LaughsBot	unknown
@smeang	unknown
@s_fyle	human
@oskey	human
@HelloJenniferYu	org
@jalafoodcourt	org
@Zullybelly	human
@PletzeDeutschla	human
@PHILLIP_CRANE2	human
@fabulous_emily	human
@ThatCwg	human
@LivingHerbs	org
@Chrisessence	human
@LongWait4Bella	human
@FvmeAndLuxury	human
@corradovigo	human
@Randa9278	human
@keinakat	human
@mits_i	human
@newyearforannie	human
@oneinabilli	human
@Joan_Schneider_	human
@Changing_News29	human
@iammariahxo	human
@itsthesherf	human
@zoe_gooo	unknown
@ChopNblog	org
@iKentLao	unknown
@TekilaHollywood	org
@someonescorner	human
@Ariana24Dancing	unknown
@ljenator	human
@oonti3	human
@invigor8teaaus	human
@Delicious_NY	human
@Elissarstar	human
@Justa357	human
@SockeyeCity	human
@kkkkkanna	human
@BjoernBio	org
@HotMami2EW	human
@Srinath_Fan	unknown
@LVillafranca84	human
@SouthEndKitchen	unknown
@ooconoooo	human
@SteakoutWoking	org
@Tavernita	unknown
@Changing_News32	human
@richardwahl	human
@POON2220	human
@yorkshireknits	org
@senorIZAT	human
@alorcafesocial	human
@nawalyah2011	human
@shyeyes	human
@KariSmid	human
@ElisabethBFriis	human
@iamralphsutton	human
@Lady_Wen	human
@AcquachetaMI	human
@UntitledChicago	org
@Consuela995	human
@WilliamClifton	human
@claricellp	human
@Holiday_XP	org
@TefiCalo	unknown
@KulinerSolo_	human
@bluejayw	org
@VicktoriaM	human
@Kulturkueche_MG	human
@misskalak	human
@littleworld03	unknown
@domesticspeak	human
@justinmw316	unknown
@JGjerdrum	human
@EverythingDawn	human
@happyhippyshack	human
@LuvCultura	human
@MakuBarbie	human
@oakleygrange	org
@akikisp	human
@CarlDirty	human
@mollysinsoulard	human
@gjsibio	human
@jujubee71	human
@OaxacaTaste	org
@Sapphiirexx	human
@10Srp	org
@ziajojo	org
@SOPHIETREM	org
@clothes_4_men	org
@Samsul_Hairi	human
@BillsRestaurant	org
@dil7li	human
@ZestFonthill	org
@mirjamjonker	human
@CheekyPV	human
@MilliesPancakes	org
@bluesegg	org
@GreenTipGuy	human
@dawnclouse	human
@heypuppet12	human
@amacchiavelloTV	org
@TOAC119	human
@kitchen_play	org
@garridosbistro	human
@ChooseHealthKel	human
@PlantationSing	human
@HoodStreatham	org
@punkycanoy	unknown
@iHomeschoolNet	human
@Alize_Lily	human
@LaPastArrosto	human
@DessertAtHome	human
@muebleselvolcan	human
@emma_g_riddell	human
@4foodistas	org
@lozoodisimona	human
@tiffanydelights	human
@dinade	human
@DiazCharles	org
@RBKCRoadFood	org
@almar407	human
@ronniidesu	human
@janelawsonfood	human
@jelytacannisius	human
@ProskinsLtd	org
@BottegaNY	human
@chs93dlj	org
@TheTriTipGuy	human
@CommerceClubATL	human
@portmanpub	org
@SCoolHunter	human
@demenuenmenu	org
@chinmayogale	unknown
@ElephanteauBleu	org
@foodiemikec	human
@caelyohann	human
@Janel908	human
@quite_am	human
@lex_francis	human
@valchong	human
@MHparisCE	human
@AvellaCornella	human
@Because_Im_X	human
@Bistrorolf	human
@ReemKhalaileh	human
@serabucknall	human
@RedMangoFFLD	org
@GlynsRnsm	human
@VeganRapNerd	human
@TrineHahnemann	org
@Cherrie_Cherie	human
@alterstar13	human
@_jennifertay	human
@penn6philly	org
@harleywonderpug	human
@PierogiWagon	unknown
@ColdtunaTinaBee	human
@magickart	org
@dobbss1910	human
@eatdrinkkent	human
@DumbbellsAndDL	org
@Leipzig_Hotel	human
@Winchcombe_St	org
@SammyZRodri	human
@MariC1527	human
@ArfiBee	human
@yinglau1993	human
@Penny794	human
@rawfoodlove	unknown
@KatheGreen	human
@Rose8191	human
@DocsDOVER	human
@RAPMAGLAFOUINE	unknown
@042814970	unknown
@FineFoodies	org
@Mrsnaranjo87	human
@pamm	org
@ZeiglerHouseInn	human
@lucianamagis	human
@Moneybarbie78	human
@cyn_k011	human
@sweetsammiejane	human
@IJannaw	unknown
@jccolyer	human
@BiebZonic	human
@LunnSllck	human
@PAPAJOHNSPA	unknown
@Mimms72	human
@mwfrost	human
@MeingBaby	human
@AdebowaleOduwa	human
@jhealthcoach	unknown
@AllThingsP828	human
@N_G_Le12	human
@Cptrashid	org
@spotsoc	unknown
@dzhimzohn	human
@godspromoteme	human
@bikinimodelcook	human
@CristinaSurdu	human
@hizaga	human
@Ftkm_BB	human
@DanJoeC	unknown
@Luna_Ho	human
@MozartST3	unknown
@Troiboi	human
@Liftbarandgrill	org
@UIEventsLtd	human
@mesohungrytoo	human
@TheLesSocialite	human
@ChelsaMillers	human
@ohalchemygirl	org
@twoyou2	unknown
@MissADS1981	human
@miurayvr	org
@whipin	org
@ko_mz	human
@MarieCelineBBH	human
@blogdajess	human
@AlexGonzalez321	human
@iAmZakkkkk	human
@kleptic	human
@Refugio711	human
@aeygth	human
@LostPlateTours	org
@bruceetwhite	human
@heavenmalone	human
@Panaros	human
@suikar	human
@TalalHafez1	human
@Donna9376	human
@hollyann9816	human
@dineindublin	org
@stereotelecast	org
@krprmedia	org
@LittleUsBlog	human
@bobbasingstoke	org
@zaidahili	human
@DawnCordeiro	human
@shervine	human
@glaizaporneso	human
@paufeliciano	human
@PeterLoh	human
@Seasons52	org
@Modi_Virodhi	human
@AggNickagg	human
@jordanwinery	org
@zeroplus1991	human
@bceggs	human
@DelaCruzGlen	org
@mervebozer	human
@koheiakiyama3	human
@Gideon64Smith	human
@EcoWarrior1980	org
@MYeventLA	human
@mountain_dyow	human
@lebaronzeist	human
@goSawaTeam	org
@VINNYBLAKE	human
@Cigar_Charlie	human
@dsantos2307	human
@franzeandevans	org
@judicreighton	human
@DinnerIsDone	org
@edw_gto	human
@powerhousetam	org
@mammetacchiaspi	human
@MizzYodyOD	org
@mamasmoment	human
@papastevesbars	human
@BennigansFutura	org
@Freerkina	unknown
@nadinebelle88	human
@16mazaraeti	human
@karenkristie	human
@chellebelluk	org
@loverkagoshima	human
@wtfshouldieat	unknown
@thecraving4more	human
@jamie_momof2	human
@itskristal	human
@remarkableREV	human
@PetitBills	org
@ruttgard	unknown
@mungmeepon	human
@Giulia_Z	human
@waza868	human
@alectronic0	org
@davemcginn_ie	human
@akanekidd	human
@intanratnaj	human
@SnackingKitchen	human
@TDMindSeeeet	human
@sisiliawidjaja	human
@stevenhallas	human
@MASSIMILIANOENG	human
@AZestyBite	human
@ActonPhilip	human
@LaurenVeronaD	human
@PakistaniPTI2	org
@samantha_mariko	human
@manholeti	human
@terumidor	unknown
@Kirsten_Emily	unknown
@pauline1145	human
@Strawbrry75	human
@ItsDylicious	human
@SilverSpoonUK	unknown
@MoeAyoubi	human
@CarolVickiFan	org
@KakaakDedee	unknown
@LocalListingAU	human
@SashasTube	org
@TiuDropar	human
@SeventhSphinx	human
@WYKayleigh	human
@MsDessertJunkie	human
@natthekatz	org
@Afamishedfoodie	org
@NedDevines	org
@JamiePanziera	human
@BayAreaDating	human
@JarsandCo	human
@AdamsExtract	human
@C_Paisley	human
@mamitasu915	human
@akaMathChick	human
@Renteril	human
@SHEEVA_LONDON	human
@CabinetQueen	org
@Rising_SunHotel	org
@binno18	org
@kendraspencer	human
@Mehrabhupendra	unknown
@rikokn	human
@HolyDoughnut	org
@FannyRooseboom	human
@Getone81	human
@ManchesterLoves	human
@tupacd	human
@LivingSMoments	human
@i4r	human
@rosarium7183	human
@williamrichar	human
@acdbdb1	human
@LouiseCampbel13	human
@ElanaSolomon1	org
@WesterlyMarket	org
@RedSandwichShop	org
@chrisinec	human
@CharlieFulluck	org
@jeftan	org
@Migcarcamo	human
@kitchentested	org
@lawrencethoma	human
@scratchandpick	human
@terezahui	human
@AlyaIS	human
@YeahBunnyStore	org
@nikkifrancisc12	human
@nurul_303	human
@Shrewsbury_Arms	org
@BestFoodFacts	org
@ApplesArteries	unknown
@ShineEyeShay	org
@missA_del	org
@EisaJunaid	human
@clkibrahim_clk	human
@sixtodate	human
@campfireforyou	org
@p0undthegr0und	human
@DaedrianM	human
@JinnieT	human
@FifiSanlie	org
@DeccanTiffin	human
@EllzBetch	unknown
@chia2top	human
@Worldbierhaus	human
@MorgenhofWines	org
@PEHACHE1418	org
@Tomtorron	human
@mumairmasood	human
@CoffeeCork	human
@PacificDiner1	org
@shu08ksjd931015	human
@TGIFMidlothian	org
@MyMediaSupport	human
@dressingroom247	human
@ISWDYS	unknown
@hsm_rockz_21	human
@mysecondhelping	human
@mai921mai	org
@Meliaccs	human
@banamonxbanamon	human
@Yosiara	human
@N3_Nutritionist	human
@fasheria	human
@TopChangeAgents	human
@LINDA2_RANDALL	human
@Dharshoe	human
@LoneStarEggs	human
@raunellis	human
@laranuque	human
@LocalSCambridge	org
@Borges_India	org
@LovablyDumb	human
@Miz_Maliciouz	human
@iRezawr	org
@OscarsDinerLux	org
@michischaaf	human
@LifeAndThymez	org
@FrockingAwesome	human
@theDanforthBIA	human
@indirareynaert	human
@Yancheto	human
@Ol_Ananyeva	human
@TulipPenney	org
@teenageworld628	unknown
@AbigailCr87	unknown
@DinnerexchangeE	human
@mymelody0804	unknown
@irocc527	human
@chezrobbo	org
@MignonPlano	org
@jnthnrsa29	human
@CherryGoh1	human
@inspiredtaste	org
@robertawhitney	human
@jdscandy	human
@iamnatantonio	human
@Rinsdark	human
@midtownaldesco	human
@Changing_News36	human
@welovewoking1	org
@ayahanachibi	human
@NutriNuptials	org
@waywardhum	human
@yapboonyew_	org
@Rae_RaeLanay	human
@Strawberry_Wolf	human
@gabriellaira	human
@halfwaydcent	human
@AsianTune	human
@nutrahat	human
@FeelingszRocky	unknown
@GGSparkes	human
@iskandar_wan	human
@sweetpsBBQ	human
@stevel327	human
@secretlygold	human
@bostonlivingsoc	human
@jimedhardaway	human
@firezzapizza	org
@crazejane143	human
@lettuceRDs	org
@italkmotherhood	unknown
@littleamberfate	human
@jeanine08	human
@SizzlingSuzai	unknown
@SusiAttia	human
@BoomBapBurger	org
@DarleneBurris	human
@mrmarioquezada	human
@VEROCHICKY	human
@_Love_Fitness	org
@tinalee814	unknown
@SanDiegoPicks	org
@freshgrillit	org
@SeleSunshine	human
@ftblsk26	human
@kattanita	human
@AsyaVb	org
@SuperetteStore	org
@samosashackny	human
@LivingInBsShoes	human
@harrytriggs	human
@yani_iman	unknown
@aratofit4run	human
@Vegan_Prague	human
@fraangeleri	human
@albertizrah	human
@Markus_Mattila	human
@Leland537	human
@JuliaTabore	human
@Changing_News15	human
@tiniphuong	human
@JenJbBoutique	human
@Elisewin__	human
@WOGABAR	unknown
@bigkjin	human
@88food	org
@SaadiiSpunk	human
@TalkerNewYorker	human
@Christen4045	human
@PandoraSkies	human
@elysebekins	human
@guijarro_carol	human
@bsm139	org
@LiciniaRafael	org
@friday1508	human
@TrenzaloreTomb	human
@Bree_Morey	human
@TrofosCom	org
@stagesofbb	human
@GirardOnGirard	human
@TheSussmans	human
@duchesswasabi	human
@yuu_nalu	human
@SixDollarFamily	org
@DarioQuez	unknown
@ATavolaMagazine	org
@perke	org
@JacquesShu	human
@TiffanyandC0	human
@CaramelCrisp	org
@Azn_CyberSleuth	org
@YamaninGlobal	human
@CornerstoneNapa	org
@GroveIsleStyle	human
@VeronicaMartian	human
@PlatedwithStyle	human
@ConradKohSamui	org
@DollyDionne217	human
@Changing_News12	human
@hair_ann	human
@Legends_Grill	org
@postingreseller	unknown
@TheGayVegans	org
@_wuntu	unknown
@elna75it	human
@spoonandsaucer	human
@cliffalbert	human
@Peter_Sundberg	human
@kasandralachina	human
@SheSoBrooklyn	human
@chezmamanusa	human
@lyra_quinn	human
@Tillthen_Smile	human
@LaurasBakery	human
@Healthyfamilybc	org
@jgug_13	human
@surihoney	human
@KEYMagazine	org
@RedTapeLass	human
@Pseric	human
@tiffyp9	human
@Seanlpattison	human
@Pesto_Princess	org
@irvfabor	human
@peternelson11	human
@WhiteRabbitx13	human
@kimhua78	human
@filippaee	human
@YourLifeAfter25	human
@MimisMiracle	human
@BreezeCapeYamu	org
@PandorasDeals	human
@mereteikata	human
@TheSlocan	org
@LesiaBi	human
@JasyJessie	human
@LuisLumalulu	human
@manojkumarv0201	human
@TashaInaChurch	human
@mmmarkjohn	human
@IlContoxFavore	org
@straighthealth	org
@OberoiNewDelhi	human
@NerdMom_Deals	human
@madamnEM	unknown
@NannaLR	human
@AyakoIshigaki	human
@deviwhs	human
@foodiequine	human
@myappeteat	org
@EatThreeSquares	org
@manuel_c	human
@soul_vegetarian	human
@LenaAuger4	unknown
@MarcusCooks	human
@StyleBlazer	human
@BetyAndriany	unknown
@5Townsley_DM	human
@FRANCESCORESTAU	human
@iamDanieHuertas	human
@EGATokyo	human
@incognitobistro	org
@derekyap	human
@coach_juliane55	human
@tattedmom21	human
@Herupaabotto	org
@gwapitoGab	org
@curvygonefit	human
@MaineGirl2Runs	human
@La_Pentola	org
@staromanadaniel	human
@itgrrrlofsfbay	human
@LaCucinaPovera	human
@JadeHorobin	human
@TheNewLanding	org
@Laura11880	human
@__mylittelworld	unknown
@SimonLeong	human
@DetoxYou	human
@rainydayinmay	human
@HinokiBird	org
@SweetWoodruffSF	org
@MaggieKnox	human
@AZPhotoChika	human
@SkynnyKitchen	org
@joecool89	human
@bebelovegirl	human
@JaneMC	human
@MishalEv	human
@FarraDiandra	human
@texstacos	org
@Sammy_Nguyen	human
@AubreyRobinson6	human
@dirtykettleone	human
@TheBrookfield	human
@quaglinos	org
@jinyoung1804	human
@JOHNMILLS72	human
@susannah21	human
@LaDiiZ_LuV_TaN	org
@DisasterReborn	human
@ShoT_Tr3s	human
@mika_rice	human
@ladywardrobe	human
@Albano_Lina	human
@davidatsg	human
@beenish	human
@obrienc2	human
@kinonao6	human
@honeyblanche	human
@VoriRestaurant	org
@jojo2gorgeous	human
@fernemccann	human
@isaac_ahmed	human
@ForagersNYC	org
@soradeghgmailco	unknown
@geometriques	unknown
@DianaCoiscou	unknown
@cands_xo	human
@SungStarDolly	org
@JugoAzul	human
@CoachGift	human
@howardetwilson	org
@omair_a_khan	human
@breakingstlnews	org
@ChloeMckellar	human
@aznable_char	human
@shisillya	human
@crespobarbara	human
@KemPayne_	unknown
@dongwood12	human
@KoppermansSTL	human
@WokAndGoCardiff	unknown
@iamjober	human
@anandandy91	human
@didincer	human
@OutbackJacks	org
@thegreenhouse	org
@StoliTheFoodie	org
@realhotelreview	human
@Elaine_McGee10	human
@milestoneswhist	human
@wonrocks	human
@94_arwa	human
@Itchyfeet8	human
@eeemunmontoro	human
@BMXtafarian	human
@LindaJacobi	unknown
@1994_mays	unknown
@reneeburland	human
@klarahx	human
@763Zeman	human
@Asian_CumDumps	unknown
@GetawayGirlLiza	human
@SpoonRocket	human
@CRUNCHtables	org
@PokeBowl	human
@KarenCra77	human
@natasyasaid	org
@AncientHarvest	org
@catwomen_meow	human
@Gillian_aaa	human
@FaceEleven	org
@myweeklydish	human
@MissKateGB	human
@djd800billion	human
@happyjom821	human
@stevanusfran	human
@retrosesos	human
@KaiEgg	human
@jugomucho	org
@jasminjoy	human
@davidgale81	human
@roccodispirito	org
@SuzetteLDN	human
@WrestlingBinge	org
@Bryan_Osbert	human
@4expo	org
@paleowithmrsp	human
@BethanyKhan	human
@MissPersChopped	human
@thetokenwogle	human
@boxtera	org
@HolmewoodHall	human
@Nordic_Baltic	org
@RojoCXW	human
@Thetruth507	human
@Xiaohuier	human
@Cher1977Sherri	human
@BrianthonyB	human
@MichelEnLaRed	human
@deoudehuize	org
@lalaurelax	unknown
@DJCubanPete	human
@gladbach_rt	human
@ammyyyzhuu	human
@adehansler	org
@Huixins	human
@tuadict0	org
@claremaxfield	human
@WayWayApp	org
@thefoxandshe	human
@yupaaan	org
@Johnny_wong	human
@pandamoz	unknown
@theGOODScafe	org
@chris_cauthen	org
@Marionlietout	unknown
@nini_msceo	org
@lastbiteanalysi	org
@fiqah_ross	unknown
@nateskater17	human
@bakery_corner	org
@howlinglupus	human
@QuartersBR	org
@fadzainuddin	human
@TriumphHotels	human
@FoodCrafters	org
@siskaaudii	human
@ALCBayRidge	org
@Athlete_52	unknown
@zest_mist	org
@mmmtastethis	org
@SavouryIndian	org
@djmaestro1	human
@Graffiato	org
@JessicaMe33	unknown
@manofsteel_510	org
@Talk_Trucking	unknown
@eu_paulasouza	unknown
@Rossyt33	human
@PiperHarrisChef	human
@GarryChoo	human
@thatwallace	human
@eli_angelina	human
@MimbsPhotograph	human
@lilcoconovo	human
@Randym0913	human
@bosh3584	human
@1gastronomy	human
@ChachiRiot	human
@kevinlynchnj	human
@chiyochan81	human
@kathrynciara	human
@fafatsui	human
@PhebesNYC	org
@GreenPalmInn	org
@AclandVillage	org
@redrandal	human
@benderbutt_	human
@EpochHealth	unknown
@Kris6945	human
@Weston_Lucy	human
@stoinx	human
@TankaBar	human
@alkey29	human
@ScotFoodReview	human
@t__ai	unknown
@leverlen	human
@jay2313	human
@supermicheemich	human
@Mkrgf	human
@larrykbretz	human
@madelenefarin	human
@ururun_32	unknown
@E_Dayana	human
@GraceBarLondon	human
@RICHARD_BEACH_	human
@Stimpdawg	human
@SyamMujtabar	human
@KeenanBlake	human
@ChurrascoGrill1	org
@TerrenceMeow	human
@meals_fitzrovia	org
@whereisbenli	org
@Skippy9474	org
@Marklar1968	human
@NickyNoNaps	human
@themaidastouch	human
@LpeaceChris	human
@flipimode	human
@Vivian_Reiss	human
@kurtTleclair	human
@SakuraJaeRi	human
@krissong3	human
@MogfordColl	org
@HealthwaysFIT	human
@hayuhabibi	human
@EdnaGraer	human
@sha_instagram	human
@NilhanAras	human
@Tru_DreamChaser	human
@Chewingfogstyle	human
@esprezzocafe	org
@bernadettetungk	human
@SemSidorkin	org
@fit_4fun	human
@aPRedNosed	human
@VMaxGal	unknown
@Aceso84	human
@RosemontFarmMkt	org
@WeAreUAE	org
@alhabshimunirah	human
@Stingray_Cafe	org
@Hoanglyon1	human
@c_garen	unknown
@NataliOropeza9	unknown
@nadiasofialopes	human
@PikaChakula	human
@ANDREW_3WINSHIP	human
@LockeandRemedy	org
@CoachYari	org
@LizaAndAllan	human
@LuenThompson	human
@DNM_LA_Travel	org
@aika19870715	human
@MunchQuick	org
@barbie_girl_xox	human
@Lovemanaroom	human
@Changing_News13	human
@terroirNY	human
@susmaryotepp	human
@JulieAnneRhodes	human
@NZPounamu	human
@SteBiaggio	human
@nicolecwong	human
@niwdejie	human
@InOutBCN	org
@henleyswhfoods	org
@InterConMadrid	org
@PINARGUSAR	human
@Academy911	human
@dcalvord	human
@rosadolcedesign	human
@docgelo	org
@SanCarlo_Fumo	org
@annieetrodrig	org
@Cesca512	unknown
@PoutineandPrada	human
@baddiebae	human
@beingtazim	human
@Gaurav1926	human
@realfoodsfreddy	unknown
@VeganMelis	human
@WeeMcgee510	human
@KialaCamper	human
@CheekyJesse	human
@jaguiilarr	human
@TrentFood	org
@RTorrejos	human
@BrandonTakesOn	unknown
@TGIFShortPump	org
@kdesigns10	human
@tsehant	unknown
@lostinf00d	org
@lovelyme03	human
@hyunsoogenshu	human
@PiripiMiami	human
@ziijanie	org
@nuraqidahmbz	human
@Kirkyyyyyyyyy	unknown
@MonkeySee	org
@maorisquall0601	human
@GraceIgnaciaSee	human
@RobFun	unknown
@ileocadio	human
@bebeksofrasi	human
@myCnergy	org
@SheilaRodri77	unknown
@VeronicaVezzani	human
@WholeFoodsNWL	unknown
@mcardlesfpt	org
@errecepe	human
@ZagatAtlanta	human
@githavalentine	human
@malibuquilts	human
@TamaraSchelleke	human
@BnBFinder	org
@anorganisedlife	unknown
@adelinezz	human
@PuzzleFlip	org
@HyattRegencyMex	human
@_joshuapotter	unknown
@PlacesAndFoods	org
@centralmr	org
@De_Ondernemer	human
@ronchaan	human
@TheRedheadRiter	org
@trysavory	org
@Changing_News19	human
@Lautnyc	org
@zeal_cc	human
@GianniSarracino	human
@RuwanJay	unknown
@heyyaya90	human
@BellasTube	human
@SBsnacks	org
@mimihollowday	human
@clintmamerto	human
@Aldrique25	human
@Linkjrc13	human
@muhammad_bilal	human
@larateh	human
@rucola0123	human
@CheckDirector	human
@HolbornDining	org
@sandwichsupreme	org
@xXxJBiebz1DxXx	human
@JBSchef	human
@Waikiki_Parc	org
@pawwlow0150	human
@CityWineryNSH	org
@TagineGlobal	org
@tannawings	human
@RVACard	org
@embr4d	human
@ameriporean	org
@ShiEnnx	human
@kayamalay	org
@Martinallen72	human
@BubblyNature	human
@BlogFoieGras	org
@BathCoUK	human
@SSidpara	human
@bianca_maria	human
@DibaHera	human
@DoughCaterer	org
@thescenedubai	org
@CommercialD	org
@WeatherAnchorMa	org
@Changing_News31	human
@IveyIsabel460	human
@iamsprung	human
@hui_alice	human
@jenna95212	human
@superfitandfood	unknown
@Labeveone	org
@snapsandrye	org
@buddygalaxy	human
@QueenOnTop1	human
@AmbitiousEats	org
@wpblogsch	unknown
@shabireena	human
@EmilyElyse	org
@auroramckean	unknown
@ChocolatRoyal	org
@gaby_natasha	human
@margorj	org
@TalkRadioPrime	human
@thepointfeedsme	org
@UberRainicorn	human
@jasdiane	human
@CentriBen	human
@frederick_doug_	human
@PurmalaPurmala	unknown
@LevelTwo_Hyatt	org
@mc2454	human
@TridentBKC	human
@DJAlBoogzZ	human
@FoodTruckPHL	org
@WCTheGrillRoom	org
@richpangalila	unknown
@hafizhood	human
@bigboyjakes	human
@restolabulle	human
@magnifyk	org
@syuhu87	human
@HaapsandBarley	org
@claira_c	human
@Acre121	human
@CazWillmer	human
@peteretmitchell	org
@McMonsterr	human
@MadeinCheshire	org
@Legless01	human
@PHXBistro	human
@6degreesorcutt	human
@HersheyDrop	unknown
@LittleCropCircl	human
@kristenmee	human
@bongloaded	org
@PointGraceTCI	org
@moncochon	human
@ramlopez_	human
@EdytaAndCo	human
@JewelWood	human
@annabel_ljh	unknown
@violetandrose11	human
@NricaPaez	human
@zebraprintsky	human
@TasteNW	org
@CleDubai	org
@Tribakery_Cav	human
@loren0216	human
@G0DL1K3D3V1L	human
@SH_SocialClub	org
@defraoui	human
@WellmarkBCBS	human
@clublove	human
@MissNerdi	unknown
@okamitotsuki	human
@Saporie	human
@gheelizious	org
@SerenitygardenT	human
@Gracey_Mills	human
@captainxid	human
@aVaLoN_Tm	human
@imbluewhoyou	human
@meat_merchants	org
@NewYorkLoverUSA	human
@KamalaniLulu	human
@Gigazavr	human
@astylelnz	human
@hubcityboi	human
@stefaniacormio	human
@howdymaggie	human
@bryanwempen	human
@Negar1987	human
@_FUCKYourTWATCH	org
@_callmerachel	human
@sehseh	human
@Kristin_Sargent	org
@SengAik	human
@WoShiLinda	human
@Felissahadas	human
@DivaStateMind	unknown
@12Tho16	org
@bakuhatu	human
@denvertalkradio	org
@basilandchook	human
@exploretravel1	human
@NEAHealthy	org
@DSoven	human
@simonwilliamsim	human
@LEOSFINEST801	human
@Will_PowerFit	human
@BreannManyatz	unknown
@ralph_richie	human
@talithahijab	human
@EATBALKAN	org
@DJDIAMOND	human
@bhumika_t	human
@mickeythrust	human
@IamUnt0uchable	human
@flossiecrossie	unknown
@lindhardt83	unknown
@Marjoriestar	human
@mmpk59	unknown
@BigBoysClub	human
@eveirecarolina	human
@BraLadyJapan	org
@Oned214	human
@Ayanna_Dixon	human
@isnink	org
@biiiiiTCH_WHAT	unknown
@diningrooms	org
@hmaybliss3	human
@giahnna	human
@amr_events	human
@MICHAEL_JJACK	human
@grupoelcolmao	org
@lua_branca	human
@Nizarfauzie	unknown
@babysavira	org
@lottasnbwc	human
@HeroesRiverside	org
@CoachMMG	human
@adalef	human
@nataliesperling	human
@ManoharMankani	human
@damlabayko	human
@SharonZelayaOK	human
@Summershines90	human
@DEMETSDONUTS	human
@CapponesNYC	org
@Unebonnefemme	human
@lytebright3000	human
@gataiinoii	human
@Sherylya	human
@debbiejulians	human
@do3photo	human
@EmunLow	human
@ColossalCat	human
@rccwine	org
@NorthernQuest	org
@JukeboxCLE	human
@vamps360	human
@im_jiayitan	unknown
@nicopunongbayan	unknown
@Dzul_M	human
@kaitiy2001	human
@AkashaCC	org
@malcdsouza	unknown
@Media2Author	human
@Reese0815	human
@lorrainecladish	human
@beflirt	human
@oversixty60	org
@TheMamaRuns	human
@kimbreid	human
@P3LIGR0	human
@YourFriendInCT	org
@RaisaOne	human
@ChelleB36	human
@AdUmbraLumen	human
@lucianositaly	human
@ThisIsGray	human
@Jasonammie	human
@Who_Is_Michael	unknown
@snappysalads	org
@barneysbeanery	org
@Maria_Alexa	human
@TastyChomps	human
@tttiffany_li	human
@GastronomicLife	human
@FitBombshell99	human
@katfish_mnl	human
@tigerfish	org
@NicksKitchenHU	org
@Stephyoyo	human
@TessHohman	human
@MyWorldMyLife87	human
@LaPetiteTarteCT	human
@NamsFia	human
@lafarmcary	human
@GotChiz	human
@StynaRenae	org
@lordheavenearth	human
@BentForkGrill	human
@lickerishtrini	org
@CraveLocal	org
@rhmandy	human
@MelfortHouse	org
@Claritymusic	human
@revgotswag	human
@AlessaSoriano	unknown
@miemonster	human
@HettydeVogel	org
@jamesps469	human
@cutthroatkitche	org
@WineHotelsColl	human
@StreetDMusic	unknown
@ClaraVeliana	human
@slol59	human
@TweetsMate	human
@eyal_keren	human
@G_Blessed21	human
@CurtisMann1989	human
@jirka_22_	human
@BigJon722	human
@Natural__Remedy	unknown
@HegeOwa	human
@perrinean	human
@GetDailyRecipes	org
@ItsAlreadyPoop	human
@liyana90kay	human
@DogDoseDotCom	human
@squeeze0914	human
@emjeywee	human
@TheDDinerValby	human
@Katyjuneful	human
@SayWordForReal	unknown
@mikebenson82	human
@PhuckOff	org
@sashimiso	human
@gt5323b	human
@mdforkos	human
@vegan_hausfrau	org
@mickeymingz	org
@britishberliner	human
@Fer_Cabral_	unknown
@Massivehawtness	human
@jacican	org
@iamglenpot	human
@pauljenningsfit	human
@ShayneWilliams	unknown
@WorcesterBID	human
@marcushaggstrom	human
@STEPHEN_LYNCH__	human
@ajhuffine	human
@BlackMastermind	unknown
@alineeats	human
@Salvador9323	human
@GMAsianovelas	human
@photolbm	unknown
@DYCMILLIONS	human
@HindPalmer	human
@TitosVodka	org
@aboutdotcom	human
@LEGO_CRAYON	human
@tinrooforlando	org
@TimDisaster	org
@USCBDining	org
@UteUrbaniak483	human
@chefroofiej	human
@Eyeballsio	org
@laurieGABBY	human
@SofiaDelpiano	human
@_20somethin	org
@synysterazizJR	org
@ZebraLuxLounge	org
@alexameale	human
@TheJeffersonDC	org
@SutahOnTheBeach	human
@setoharu1030	human
@GemRubyEmm	unknown
@BerniceLiu	human
@GuardianiBelen	human
@cdbibay	human
@Toni2Fine	human
@chrisdulux	human
@civerinos_slice	org
@linny_pinnyx	human
@Nataftrujillo	human
@NgaamC	human
@cuddlypanda71	human
@ewoo66	human
@pauldavidescu	human
@Ets000079	unknown
@kjcross0171	human
@GraftonInn	org
@philipmilton	human
@N_Smith7	org
@JeSuisNicey	human
@jackluism	human
@BaursRestaurant	org
@JozedeGoes	org
@BowAndTruss	human
@muzikfreakah	human
@RrAdelysina	human
@elzachster	human
@maisasaki2	human
@PikeCafe	org
@HerrHaus	org
@rachelgillon	org
@butko123	human
@ChocolatSD	org
@Kidd_est1994	human
@StratfordHall	org
@CornerstoneDet	human
@Melliemel122	human
@DanerysG	human
@SarahMBender	unknown
@iisjong	org
@HealthNutRachel	human
@azryjaafar	human
@antoni_widjaya	human
@pomodoro4747477	human
@dyneosaurs	human
@Darleen_Amelia	unknown
@KoyBoston	org
@BooksAndSpoons	org
@g3r11	human
@SonyDSLRa350	human
@aretfoodandwine	org
@wawrus	human
@Nightmare_Jisu	human
@365OpenHouse	org
@manhattanphotos	org
@SonbobAmillion	org
@CameraCHEYTV	human
@SilFoschi	org
@stick_mukumuku	human
@kokojuce	human
@bakeriemcr	org
@jenrosendahl	human
@daniel_farel	human
@ROKAaldwych	org
@WhitneyANTM	org
@KurdisMedGrill	human
@LeanneMaskell	human
@Abhishek1106	org
@MrsChalkz	human
@yurie524_spg	human
@Spokeable	org
@misscavallier	human
@evangilbort	human
@sofii_060795	human
@neng_iyma	unknown
@Gigalum	org
@nowinberlin	human
@GPerdikaris	human
@Mattsantos91	human
@TGIFRehoboth	org
@ManTripping	human
@imoetz_mia	human
@CookandPour	org
@KentFarmers	org
@DJNELZ	org
@AlaHamdann	human
@cucinareitalia	human
@RebootWithJoe	human
@HotelStrijpS	human
@kakaiichan	human
@GQstatus	human
@SheldonLifee	human
@ElCentroDF	org
@MMJSecaucusNJ	org
@containscumin	human
@Musicinjp	human
@jetblaqelite	org
@FooDivaWorld	org
@LoveRazila	human
@bonmarche_yoko	human
@cypressdoll	human
@antonioethill	human
@jamielloyd	human
@YourInnerStrong	unknown
@FabJdenPrestonB	unknown
@maximaximum	human
@VickyChan6160	org
@ziiisan	human
@lambaholik	human
@norbalm	human
@graeyze	human
@LanaSmiling	org
@pogisipoy	human
@Mixedbeauty090	unknown
@TentacionesMx	org
@genofsavings	human
@zeroHybrid	human
@themommybunch	human
@DrEKirkeOstm	human
@myvancity	org
@HooHaBar	human
@date_concierge	org
@jeffiejeff88	human
@panquefashion	org
@thereptilezoo	org
@codeidesign	human
@ZagLeft	human
@GreysMonchichi	unknown
@rohansonalkar	human
@LsSqUeeNz	human
@LTAllisonTG	human
@KrisvaAng	human
@Evergreen_RD	human
@manhattanselfi	human
@CipelicaJB	human
@domi_li	org
@nals04	human
@ohlookitsSteven	human
@EatGreatBEGreat	unknown
@NAP0LE0NA	unknown
@manuLrios	human
@themoonsixpence	org
@SpiritNavyPier	org
@SaintCathBK	org
@londongirltales	human
@leearna14	human
@anahitairani1	human
@Antionette817	human
@Bodydefining	org
@cornexchangeMAN	org
@mummycooks	org
@foodieinwv	org
@BrazenBBQ	org
@PervezMarriam	human
@Sawyer923	human
@joemed3	human
@TurkishVillage	org
@mamaskitchen813	human
@evenutz6	unknown
@xxxjenxnxx	unknown
@garethsingham	human
@helloLisaNg	human
@sanctuaryaz	org
@momo_vp_11	human
@Serena37	human
@mpdesignerwear	org
@arecoleh	human
@kebunbistro	org
@thimstblog	org
@VictoriaMomca	human
@YukikaJennyS	unknown
@AlyWebsterr	human
@emybutton	human
@AreaCondeDuque	unknown
@Prillh33	human
@MintonsHarlem	org
@nourishnyc	org
@singingpeonies	human
@debbzs	human
@kurohoshi218	human
@BelgianCafeRDU	org
@pink_parfait	unknown
@AltaPrado	org
@SportsRevTV	unknown
@vouchercloud_mt	org
@AFewShortCuts	human
@ayuindrii	human
@lykaangon	human
@AceeyShaw	human
@LegendofBobKane	human
@LuvtoDream86	human
@rachkrupa	human
@ColoradoRetweet	human
@Honeyandco	org
@Caliboy805	org
@Kazzer55	human
@kikosanz32	human
@_Heather_Brooke	human
@gngbukid	human
@LummeTerhi	org
@earthfalcon33	unknown
@queencooking_q8	human
@ICarrasqueira	human
@kickgrid	human
@melissasbargain	human
@Mista_MarleyMar	human
@chubbyveg	org
@sakurapandatea	org
@RoseyFit	unknown
@AlTabkha	org
@BamaBeach	human
@SizeZeroKitchen	human
@KatieJamaludin	human
@DavidWoolpy	org
@Dorethea450	human
@ManhattanTwist	human
@Hmuay_Jung	org
@Alveararthotel	human
@TyeAtha	human
@LeosBeanery	org
@angmiAKAanmitsu	human
@prncezj	human
@susan_saulnier	human
@prsloo	human
@izzycopley	human
@PeraNYC	org
@naughtyBhealthy	org
@07Pengz07	human
@AnneleenNaidoo	human
@Purrrfect_NOT	unknown
@Demiros_Cardiff	org
@LaLatinaMiami	org
@306phoenixhouse	org
@FefaVips	org
@One_Jerection	human
@robertoor	human
@peartreediaries	human
@FranzVivoli	human
@chenieng	human
@Nin4119	human
@ErisMaximo	org
@TheDeadCanWrite	human
@TheRacyRedhead	human
@nathan5321	human
@shashaALqadry	unknown
@minicloudie	org
@boc_photo	org
@sakuraaaaaaako	unknown
@TheTastyTenner	org
@xnailbunnyx	human
@all4REDy	human
@Anurag10k	human
@FranchiseBeats	human
@WiLLoWs_INDIGO	unknown
@LaRomaDF	human
@SoByTheWay_	human
@juliewunder	human
@JFRestaurants	org
@HungrySwans	org
@frieta10	human
@SereneLoh_	human
@pinkuru	human
@sillyazzgirl	unknown
@Fariba77	human
@joanna_anthi	human
@sapto_anggoro	human
@healthy_tings	org
@diettoolscom	org
@desiree_merlina	human
@YingYangLiving	human
@VinotecaGT	human
@TomBurnPhotog	human
@LittleRhein	org
@Sentia_UK	human
@thatsabang	human
@TFFcafe	human
@junpena11176	human
@chuyakasim	unknown
@BhartiPuri	human
@djraeworldwide	unknown
@SreeSince91	human
@this_is_cecilia	human
@mayafellerRD	org
@cherryblossomV	human
@serena_cheong	human
@meditation1988	human
@Djane_Myzo	human
@forisephori	human
@juliennefries_	human
@FSAmman	org
@Fashion_Jungle	human
@MastiffSausage	org
@Pest15	org
@vanyahsiao	unknown
@TableNo10	unknown
@guptajikifamily	unknown
@NathanKersaint	human
@healthfoodtips1	org
@monalisaamidar	human
@gwenrightnutri	org
@SweetLifeYYC	human
@luiscontrerasm	human
@COALITIONBOY_K	human
@Tanaka_Yuki_san	human
@MMags_14	org
@BiltongBoxUK	unknown
@IndianHouse_	human
@CarolAuCourant	human
@DeliverMyGrub	org
@Thealmuic	unknown
@GloomyJulie	unknown
@duncanchew	human
@MarikaBougere	human
@DreatheeQUEEN	human
@23khim16	human
@Binali_Eycan	human
@elisabethwithns	unknown
@Cutepigblog	human
@herechalam_	unknown
@OsakaBsAs	human
@Takako5940	human
@chefsclubhouse	org
@FlavoursandFros	human
@p_h_a_r_a_o_h	human
@Simobb_	org
@PalaceHotelSF	human
@FridayBrunchDXB	human
@Ngamtomyum	human
@enyermARTe	human
@Seal_GC	human
@quoidenoeuf_mtl	human
@PrivilegeProm	org
@Francexca_style	unknown
@JennyMiuTweets	human
@marquiswc1	org
@twiinklemint	unknown
@Leilah_Loo	human
@dajavamon	org
@TweetMeABite	org
@the_magic_mon	human
@IKEAOrlando	org
@saytine	org
@SumzzKhan	human
@NoirEnBlanca	human
@meals_shoreditc	org
@vrnk1908	human
@EMC_ondaMIC	unknown
@wholesomebos	org
@VinoFinoNYC	human
@qiqyakidah	org
@ColneyQing	org
@UrbanListMELB	org
@EstiasAmerican	unknown
@ChadwickBoyd	human
@Cheeky_Cherries	org
@LyndseyAriel	human
@Imprevist	human
@Miss_TA5L	org
@princeszalirey	org
@eFoodPyramid	org
@LaUrbanaAtl	org
@ErrandAbuja	org
@BestFoodiePorn	unknown
@FitSwissChick	human
@ShoppesPalmilla	human
@kittiecarrie	unknown
@chjamescafe	org
@TravelersLuxury	human
@TravelersCouch	human
@coty5mel	human
@LarryAsPizza	unknown
@lunchboxworld	org
@willyjoee	human
@TruVisionz	unknown
@FRED_2ZEIGLER	human
@SienaWellness	org
@YukikoTan	human
@SCWinery	org
@wongjayrick	org
@RoastingParty	human
@espionage_diva	human
@Likeomgitskaila	human
@Coopscoffeebar	org
@lillyljubov	human
@AmandaRayFitz	unknown
@Rednekked_	human
@VedgedOut	human
@ChrisHughesy	human
@Nuttie_Nuchy	human
@epicuresglasgow	org
@CreativeSonline	human
@erikarlebang	human
@dobbernation	human
@Adolfseven5	human
@HansSpee	human
@DanyJMoreno	unknown
@thebingham	human
@DarumaView	human
@KempinskiJKT	org
@thehenryroot	org
@youngsolotravel	unknown
@AuroraeYoga	org
@whygowithout	org
@sgrogiuseppe2	human
@77SherBear	unknown
@ChefStephenCoe	org
@gemmalush	human
@Paulsharifa	org
@itshacketd	human
@BellaForcella	human
@sclubfregene	human
@HsiehJunJune	human
@xsally90	human
@twoonlychildren	human
@Dredfly	org
@saoyMiNAJ	human
@reypuentenegra	human
@RoSalsTaylor	org
@yourveryownrd	human
@KitchenShed	human
@travelwithsugi	human
@Arab_A1	unknown
@macky_moji	human
@emmav6	human
@Didone_EM	unknown
@TiffinTales	human
@tinepun	org
@arimi_skywalker	human
@Skorpeo77	human
@aurorae_S	unknown
@Slurp_Rina	unknown
@TalkAboutLOMBOK	org
@Lake_Fun	human
@InstaRedSquare	human
@ZombieBeck	unknown
@ACompofelice	human
@j3noi	org
@MMaxOne	human
@hinako_0115	human
@euqinu07nique	human
@SpeakerMedia5	human
@EatOutKenya	human
@klausner0304	human
@mjlifestyle	human
@mikaoyay	human
@CMWL_Natl	org
@mariy_kitanova	unknown
@TheLightbox	human
@GreatLifeFitBev	human
@LardyBunz	human
@DashofLes	human
@swissbelhotels	unknown
@rctwilkinson	human
@camr_tina	human
@thegirlinme	unknown
@iamMaot	human
@sushisakemiami	org
@barbouludlondon	org
@EmiSklar	human
@jolin704	unknown
@TheSkaPirate	human
@AstonBalikpapan	org
@Raul_Orta_mtz	human
@gman_in_gville	human
@chelleyschoe	unknown
@Cataavsaez	human
@hugoshae	human
@PalarioFrazier	human
@Kellai36	human
@stevebazzano	human
@SelinaHotwani	human
@bonnie_blog	human
@anteaterpr	unknown
@sharaice	human
@workwithsheena	org
@cigar150	human
@ade_virelya	unknown
@chiecal9	human
@djghettod	org
@babydollLOUANN	human
@Litbit7772	human
@garyjberry	human
@imjhoms	org
@Gim_Jan_Di	org
@tsukanoma_lunch	human
@satoko0909	human
@stephenaaron05	human
@krupinajustyna	human
@bmoregreenbowl	org
@RachelsKitchen_	org
@chille4s	human
@scundithRD	human
@suntattoo66	human
@breakfast_view	org
@DanTheWoaMan	human
@erozman	human
@catsseason	org
@jaminwang	human
@hotelsandycove	org
@chfdhl	human
@Joflewin	human
@shazzain	unknown
@JimeCapozzolo	org
@TiFLiS_BiTLiS	human
@simplynutrinyc	org
@Flaviioemanuel	human
@misanyam	human
@DanceEatRepeat	human
@MeLchTaLaBis	human
@iammryumyboyyy	human
@calibere	org
@ROcCO6888	human
@tracymnho	human
@MrCookMusic	human
@snab1986	human
@drewinning	human
@rini1303	human
@Spoons_Cafe	human
@YAPxy	human
@Foreverbarcelon	org
@deandavid	human
@Hindsight03	org
@kgreenier	human
@lar2l1	human
@greggmcdeigan	unknown
@Darcus90	human
@_TwistedRedhead	human
@lespros_kako	human
@jodenathan	human
@inesrsantos_16	human
@BelAirBarGrill	human
@OsoMarketBar	unknown
@teacupsandmore	human
@WilmingtonEc1	org
@m83216625	unknown
@Pommeofvie	human
@arraaayy	human
@restaurangvilla	human
@CarroCouture	human
@mrestaurants_	org
@surenshete	org
@venyhair	org
@ireneliauw	human
@Cri_Salvo	org
@rmhomedecor	human
@locorela	human
@SataShultz	human
@owentjoeng	human
@Margret327	human
@ImekaSF	human
@KellyChia92ian	human
@ItsEricWJJ	unknown
@healthmeup	org
@TBeds_B2B	org
@ReverieChicago	org
@CreativeXwalk	human
@Bioesseri_Pa	human
@luannehopkinson	human
@oceans45	human
@Studygir_1	human
@gurmecakma	human
@QuinnsCafe	org
@InspireBeck	org
@ThymeCafeMarket	org
@_SENEQUA_	human
@BabyChefAC	org
@WwwJKsRockDiva	human
@Kickstartsucces	human
@EstatesByAmanda	human
@MrrSuperman	unknown
@chefmads	org
@joei888	human
@LasVegas_Picks	org
@EnmanuelGarciaV	human
@DivineDishesNS	org
@pashathedog	human
@furryroadblock	human
@LittleCookingT	org
@AndrinaCTisi	human
@myblessedhandz	human
@diegocentrico2	human
@paolanenciarini	human
@Peter_de_Chef	human
@Amadyoreth	unknown
@pebblesduque	human
@issyhealthylife	org
@LindenReekie	human
@pajai1	human
@MakeUpWorldit	human
@joniedaigle	human
@Lucia_Castaldo	human
@randyetbennett	org
@MadJamFitness	human
@LVNationalGolf	org
@thesavoury	org
@emztan	human
@MEHMM	human
@Babi3sbr3ath	human
@bayougifts10	org
@flowerdalefarm	org
@ManiceriaSJorge	org
@GeorginaBencsik	human
@sestelo76	org
@TinyItalianDeli	unknown
@FlippinDelish	human
@SantoliPatrick	human
@thehungrycow	human
@BrisDevoured	human
@alankllim	human
@CibareMagazine	org
@ayane0709gt	human
@Miss_Pups	human
@TonicTherapy	human
@nishjamvwal	human
@NOTORIOUST_NMC	human
@TannyWong	human
@OceanMarketATL	org
@FFandHappiness	human
@TalkRadioLive1	human
@PettirossoSEA	human
@hellorigbyblog	human
@tijuanera	human
@ValeriaAcin	human
@samnutchawhich	human
@portabooks	human
@E17village	org
@InNatsShoes	org
@ZingZingTree	human
@1986Webber	human
@mita_lin	org
@lastgamble	human
@GrandmasDdowry	human
@DaniloGabrielli	org
@thatjustinviber	human
@Ikue29317529	human
@TrishJamesPFK	human
@galang_golda	human
@TheBrew22	org
@Chichi_Lalla	org
@sucresso	human
@djtisit	org
@goodfoodtoronto	human
@lanalynneauthor	human
@CrazyGG429	human
@DMVdining	human
@NilanjaniP	human
@ryanetgarcia	org
@Cassykkc	human
@RTInsane	org
@seouloftaipei	human
@UnionofGenius	org
@MissVashon	human
@jibbyjewels	human
@bethemillones	human
@ponytailjournal	human
@alebrunel	unknown
@bethovenrazul	human
@MandarinaTOP	human
@CityWineryCHI	org
@emilipa	human
@cbarnesphoto	human
@BrownsLiverpool	org
@NAHphotography	human
@Starofthenight1	human
@TaniaCarie	human
@VaNoRy	human
@Nia_purple	human
@jadekhoo	human
@polianascaramal	human
@highsocietyhobo	human
@AryelLanes	human
@yassy0709	human
@jacqlovesred	org
@ghazzawia	human
@DGomezPearlberg	human
@NaughtyWethaGrl	human
@Todoleo	human
@OvvioOsteria	human
@lalabadadoo	human
@ezatyramly	human
@danztilya	human
@CanadianKitchen	human
@holiday24travel	unknown
@soeryocafejkt	org
@Raksanalee	org
@gudbuddy22	human
@Dr_3bdul3ziz	human
@Marie_Janelle	human
@APPeTWEET	unknown
@stylestamped	human
@RUBYSMURF	human
@MoonLight_30	human
@emmajudge100	human
@yuming_STAR1008	org
@MaevillaHere	unknown
@proteinologist	human
@_ErwinWijaya	human
@Stallions35	human
@Crewiser	human
@getinmymouf	human
@meals_knsington	org
@Tookie_27	human
@HortonPkakes42	human
@honokami	human
@DJChuZe	unknown
@EliKingFitness	human
@GGsDineORaMa	human
@DasoftIndonesia	unknown
@Selly_angkasa	org
@davideoxyribose	human
@chnilacan	human
@yattstrawberry	human
@KananiAustralia	human
@Cariocagirl2016	human
@tamatebakonet	human
@LennonMiklem	unknown
@victorkkz	org
@katelewisx	human
@inuj_music	human
@WakeupYMakeup	org
@haslina256	org
@jimenadpj	human
@Bee8383bee	human
@my3tartlets	human
@chazuchazu	human
@WillySixx	human
@JonnahNubla888	human
@VillaRomanaDxb	org
@happeningrinky	human
@GymPumpTime	human
@LauraFitLife	human
@BellaLuvDiamond	human
@cornflakedreams	human
@miya1975	human
@dewynns	org
@thebargables	human
@icecreamskull	human
@rowmyboat	human
@MagnoliaVT	org
@LindaRothPR	org
@Namza006	human
@LoblawsCarlton	org
@danielzhafran	human
@coolprogeny	org
@ywjrachel	human
@dendykalim	human
@ShaleeniR	human
@Lesss_Rdz	human
@OYERWUNDERBACH	human
@kanoxazu5	unknown
@CareerAddict	org
@TheBumbleBeeVI	org
@VoiceOfSussex	org
@jbrotherlove	human
@yuu_okm	human
@Sensation_Hotel	human
@PikasCafe	org
@Internal_Matter	org
@Heidi809	human
@KinleyLance	human
@R_Rausch	unknown
@sly_frank	human
@weartopshelf	org
@NeighborFoodie	human
@Batpaco	human
@TheIslesOIB	org
@winedirector	human
@Gailcanepe	human
@ChLa_	human
@live_laugh_lean	human
@allansmithuk83	human
@dajana_santic	unknown
@laceandglaze	unknown
@TheDudeAZ	human
@EstandoEnForma	org
@mikokoki	human
@piyoangel444	unknown
@yyjnow	org
@MarckeeJ	human
@foerort	human
@DENNIS_KIMBROUG	human
@NessaScreem	human
@CheshHens_Stags	org
@OCTA_licious	org
@Rebekahdg	human
@shochoUAE	org
@Larasalud27	unknown
@margaretimecs	human
@Changing_News27	human
@GillsOnions	org
@ShaynaArmstron7	human
@m_azad	human
@Nona_irene	human
@TruckToTable	human
@HelenElizaBee	human
@phillymetrohome	human
@adorolei	human
@InstaTambov	human
@sasha818021	human
@HarperMonroeSpa	unknown
@pitstop_diner	org
@cafexperiment	org
@PerNordhaug	human
@iamjohnlloyd13	human
@Banksy_E	human
@imedwinnathan	human
@_GiuliaJules	human
@lmaquillaje	human
@omniyatnet	org
@chelleyislife	human
@ShoreBirdGrill	org
@cijmarasigan	human
@MerrimackValley	human
@TheBlueBeret	human
@calligraham	human
@NostalgiaElctrx	org
@EinfachBens	human
@Changing_News6	human
@beaumarchaisny	unknown
@silverfranz	human
@JeffreyChiu0610	human
@MayInMiami	org
@AmeliaMagjik	org
@tashaDxoxo	unknown
@zulmary_nieves	human
@Ls_Way	human
@haroldsheights	human
@katehlyn1	human
@3LWTV	human
@simwalker	human
@NAVONILDAS12	human
@yogabrunchclub	org
@Javanese_Spoon	human
@riepy0n	human
@jessica_HS_	human
@AshleighBowyer1	human
@Irene6562	human
@eastern_in	org
@JamieAGriffin	human
@RoadhouseHG	human
@LisaGrows	human
@SOCIALITENYC	human
@samuraistripper	unknown
@decor4interior	human
@LaCamyG	human
@Revival_Coach	unknown
@TonySunjae	human
@Kayladottcom	human
@hende04	human
@caspower	human
@beautyisraw_ru	human
@NevaRDLD	human
@JamesLJ	human
@rebelathearts	human
@ScintillatingSZ	unknown
@ChristelleSJ	org
@tinebs	human
@4gens1roof	human
@Mfeebs23	unknown
@LaFincaBali	org
@jessicacratty	human
@TheGunnySack	org
@hjconthotel	human
@_DonnieStykes	human
@eriko61616	human
@SOUTHERNELEVEN	human
@qua11ife	human
@Letsgetwordy	org
@atomjack604	human
@Lucha5263	human
@TheDistillery	human
@BenGieCruz	unknown
@LesDemoizelles	human
@BearpitSocial	org
@5wa	human
@J4yno	human
@JoshWillTravel	human
@LibraDolce	human
@Kat_Loyola	human
@BB88G	unknown
@vitopuntocom	human
@robinetgriffin	human
@TrippTrippy	human
@nancyscravings	human
@blackcatrena	human
@Junction440	human
@carlymhussey	human
@MsFrugalMommy	org
@shanikayvette	human
@sugimarikaori	human
@thepearlhotel	human
@PhD_TENNIS	human
@ShazamOMG	human
@JynceDT	human
@roselauron	human
@LucasBezian	human
@ToddAlstrom	human
@unihomemaker	human
@Jokebucketfilms	org
@LdnOntTV	org
@APinchOf	unknown
@TheBobBecker	human
@starfish320	human
@AlexisLendechy	human
@MaxHrH	human
@EfaduaFaldy	human
@Brasseriebites	human
@thelittledelico	human
@mahaloayu	human
@RevHouse200	org
@SmutmanMDCXX	org
@ErrisSpeaks	human
@heddonstkitchen	org
@Andrewyap86	human
@IsaacKiat	human
@Coba_cobaCo	unknown
@dingobear2000	human
@39CardenStreet	org
@aledemerulis	human
@ROARSocialHouse	org
@freevees	human
@Petchary	human
@naz_ziha	human
@mikachiprin	unknown
@FionasFavourite	human
@hrk29hrk	human
@Amna_A_Alkuwari	unknown
@IZOFitness	unknown
@WaysideHealer	human
@MarcosSheffield	human
@KhaoPadPattaya	unknown
@margie6522	human
@CairaMUA	org
@beebeebee33	human
@Jeremy98790	human
@pastagoo	org
@L_Osborne1	human
@CafeCatula	org
@RKouros	human
@ayuan_	human
@ChenBenShoshan	human
@Alelunetta	org
@BeansN2Cream	human
@DerickVicente	human
@PlazaInnDoha	org
@FoodCloud1	human
@iloverain1201	org
@DrZaks	org
@LiseBrinkman	org
@jd_darenjoy	human
@simmernow	human
@WindermeresCafe	unknown
@ChoiRain	human
@rinjinTK	human
@Kale_Yeeah	org
@atthepg	human
@thebokehstudio	human
@LeBLackJesus	unknown
@Chiara_Guarneri	human
@500daysofJUNE	human
@forked	org
@agnesng09	unknown
@Becka_godden	human
@SistahInTheRaw	human
@eqinbelle	human
@chefsmelly	human
@AlenMlatisuma	org
@babsieburgers	human
@mgmilk0317	org
@DessertDrinks	human
@DayParentDad	org
@invipae	org
@Tictastic_Matt	human
@ms420smoke_	human
@AnnieLucyOakes	human
@PethertonMarket	human
@Wellybix	org
@VBagels	org
@yuNate	human
@Nickyrottens	org
@ricolribbon	human
@yyzgirl	org
@mealdiva	org
@imconforum	human
@MarcelleMacleay	org
@Al_Bayiokos15	unknown
@Sonia_Jahan	human
@taytayindawind	human
@HopperHeads	org
@ChrisAlgieri	human
@EmoyMerfina	human
@DflDiana	human
@tweet_ifttt	human
@HaeLupy98	human
@jbkristina03	human
@SUPERSTARMIX	org
@TheDani_O	human
@Astarte_Suites	org
@RevolutionFoods	org
@Ed_sarmanho	org
@peteypie46	org
@CouponCraving	org
@JSum27	human
@ranaomer	human
@Noujaim_Avila	unknown
@LipsLashesPaint	unknown
@momwhatscooking	human
@RockyLovesEmile	human
@boolan175	human
@missssasa	human
@inspektorgedat	human
@pandcfresh	org
@GraceyLu1309	human
@Omar48401	org
@bethesdabounce	human
@FofoMattozzi	human
@OliveOils_Spain	org
@TRACEY_REISS	human
@SelinOzcakir	human
@Blacksheepfood	org
@1Chinaman	human
@fitnaturall_y	org
@MEETtheRealMEAT	org
@ecaayesha	unknown
@MyFussyEater	org
@SayMglqui	unknown
@fazariraidi	org
@novyisni14	human
@Shehryer	human
@BigMamasNPapas	org
@jspr1102	unknown
@greenheartfoods	org
@Val_FitJourney	human
@BBCRadio3	org
@AnneJoleyn	human
@toufga	human
@dessertsreqrd	human
@jullieanne21	human
@AnferneeC	human
@greathire	org
@countryfreshmus	unknown
@ChefJasonPeru	human
@ArtistOgilby	human
@KennPalestroque	unknown
@LiciousTO	org
@roxeliitaa	human
@Gymmum	human
@ZtownsClarkKent	human
@Martos_nutos	human
@tziaaa47	human
@masao_19	human
@CormicanFitness	human
@ashferbiju	human
@adelebandera	human
@Faii_Tiggerhks	human
@StrangenessBlog	human
@CocoaVintage	human
@alluxia	org
@JaynePierson	human
@Dirtthesixth	human
@bistro33davis	org
@tierra0920	human
@DJAnthonyJ	human
@mymodenadiary	human
@theHealthology	org
@JajaJelly	human
@sslicis	human
@Monicaizer	human
@xylo_myloto	human
@JointOkawa	human
@andrea_barretto	human
@JessePeraza	human
@Kwin_Llayna	human
@itsthenewdc	org
@tacaistaca	human
@dorllymultiply	human
@ArbutusBread	org
@FoodFit4Real	unknown
@gajmirtic	human
@TheveebistroO	human
@Anggapndyanta	human
@FingerBeauty365	unknown
@caroolague	human
@ngocbeo196	human
@metabox	human
@GetFitWKrista	org
@mvargas_photo	human
@nursekierra2u	unknown
@DearCreatives	human
@Salty_Iguana	org
@beautybunnyxl	unknown
@Cellulaze	human
@1smileygirl	human
@AjMayoraj	human
@LiLsam972	human
@elviajedesofi	human
@CrownBrentwood	org
@urbancannibals	org
@nazwankamal	human
@melissashaver4	unknown
@Empire_Diner	unknown
@HawaiiSammy	human
@piedpiperliquor	human
@alexdmwong	org
@DaddyPineapples	human
@Neil_Saggese2	human
@invisibleloner	human
@SpoonUniversity	human
@iamSANhedrin	org
@Directory_Wales	human
@HoyEnMda	human
@omoshiro_05siW	unknown
@DZOOOMcom	unknown
@MadGreens	org
@FBloggerRT	org
@Nicky_Park_	org
@TwinPeaksSE	org
@izesteves	human
@McTorset	human
@AixaAllende	human
@DaniMarieSuarez	human
@mixmymuesli	org
@ywoono1	human
@eskhangover	human
@workwithmyhands	human
@sayapink_xoxo	human
@linawatyyodo	unknown
@BossyLadyEnt	unknown
@SvetiaWorld	org
@kimirhochelle	human
@stevedc27	human
@katzmanberry	human
@BilllNguyen	human
@Nicos_RD	human
@nutrition_check	human
@reynaskitchen	human
@mybigfathappyli	human
@YazuriSnts	unknown
@GrizzlyDiner	org
@ChocoRoStyle	human
@joymontinola	human
@LeeYChan	human
@Lanzxie	human
@LetoCaffe	org
@GatusJC	human
@HobbitMealTime	human
@SantanaWellness	unknown
@getDotClub	org
@joemamastoronto	human
@chrispzam	human
@YNATTIRB1980	human
@Meallat	human
@TheGraceKeh	human
@AlGosaibiSarah	human
@Shinzart	human
@RGHBF	org
@ThePinningMama	human
@Obninskall	human
@findhostinghere	unknown
@mekivifashion	human
@nazrieusoof	human
@dowatching	human
@SaltYQR	org
@PanamaHashtag	org
@tartansequins	human
@ship_styal	org
@JEYMAKK	human
@breraaydin	human
@sulenaartspace	org
@mashupsoldier	org
@luche72	human
@Baltzersens	org
@HopCatD	human
@ItssHenry	human
@K33_GOTTI	human
@busretuncok	human
@tausauthentic	org
@lightningwill	org
@shiraaida	unknown
@DJ_MIYU	org
@SAUCEmag	org
@Arnaud_Deb	human
@mutiaramadjid	unknown
@ludivineoff	human
@Tieffling	human
@newz_punchida	human
@litivasevyfy	human
@zarazavich	human
@sulistan	human
@BeFairBeFunky	org
@cobolink	human
@artmsilva	human
@princexxx56	human
@tashascafe	org
@xolindseywarren	human
@lindaetmartin	human
@wrapback2sexy	human
@angelawilson921	human
@JuIlParaitQue	human
@simoneartesani	human
@zeppy_manchcity	human
@TetyLUX	human
@Miss_V_Roberts	human
@UAEFoodGuide	human
@SASSY_ASS_STEPH	unknown
@istanbulfood	human
@MekkiMartin	human
@PennePreston	unknown
@kitchencoolstuf	human
@melmarie166	human
@SmartSanta	human
@jennyredmusic	human
@shokaite	human
@asli_cotala	human
@RenovaRugunH	human
@DuPoivreNoir	human
@xianmeister	human
@NanosGRL	human
@900aventura	human
@jezzaclarize	unknown
@Luuuu_C	human
@lynorasosteria	unknown
@regcoral	human
@suasanafestival	unknown
@94meihui	unknown
@sergeyrude	human
@PhillipaKelly	human
@4eversosa	unknown
@ljessie03	human
@robinTheputra	human
@Chopper_xx	org
@wickless_usa	human
@tristanlofting	human
@v_jaila	human
@MissRexy7	human
@TGIFSwiftCreek	org
@HackLords	unknown
@SportyChick5	human
@CarolineLzt	human
@DrealmisisC	org
@elbmadame	human
@ChickenBall	human
@ellitie	human
@Changing_News37	human
@Spencers_Retail	human
@giselleanjelica	human
@ADRTBot	human
@glronair	org
@abcollar	org
@painpoilane	human
@D00rKn0ckerz	human
@KatDaDeity	human
@Paula1cPaula	human
@ArcadioAbreu	org
@sinmnm	human
@TootingInsider	human
@uyu20	unknown
@Tavern_MFarms	org
@lilmissplanet	human
@deankts	human
@woeiwong	human
@DisneyJake	human
@GregoryGerad	human
@majenco	human
@DominicDizzle	human
@infhos	human
@Twirral1	human
@macosvideo	human
@JaikantP	human
@elpasony	human
@LiescaLaurent	human
@chowechow	human
@ftblsk75	human
@Farasue2	human
@pinkpunk83	org
@MyMamihood	org
@1220_cafe	org
@DeliciouslySavv	human
@mondo_meatball	org
@LiveYourJoyNow	human
@Ed_Celis	human
@UneParisienne_	org
@CazeyW	org
@olivierchatard	human
@sizzlefishfit	org
@ShehanPatrick	human
@lola198861377	human
@DCBibiana	org
@joanetrussell	human
@TatjanaBianchi	human
@barefoot_phila	human
@MizzMartha1990	human
@OfficialTikoy	human
@BreadtalkIndo	org
@SimoneMunari	human
@Cutiekanachin	human
@VanDiemens_nyc	org
@INSFYQA	unknown
@roozemary	human
@EaglesLady4ever	human
@tasterd	human
@laurenhowse	human
@kazumi510	human
@Darylxxx	unknown
@GRRROH	human
@Danilynn302	human
@mizzr0ck	human
@tigershowcases	human
@puremarabou	human
@CamiUntold	org
@SalitaNam	human
@lyndaprado	human
@jacquardflower	human
@DoriaYoga	org
@FB_Florida	human
@BillionaireMag	human
@NNP_W_Light	org
@Dlicesorganique	human
@cnfle	org
@mightyspice	org
@viksandd	human
@KHUstle	human
@KrskStrelka	human
@TexicaliCLT	unknown
@samstewartetc	human
@angloyankophile	org
@itslowie	human
@Yu92901	org
@Ludmilla_Aubrey	human
@SmoothiePress	org
@faith_walk5	unknown
@nunice_a	human
@MI_TimHortons	human
@EarlsMainStreet	org
@Breadnmorels	org
@SAMUEL_ZAGOREN	human
@patrickcook	org
@LeSSceneS	org
@rmunozIrving	human
@neha_uberoi	human
@armaniexchang3	human
@Dieke	org
@KarimBassatne	human
@RetweetToutFr	org
@dloccs88	human
@ALEXANDERNY1	human
@AlwaysActiveAth	org
@Ze_Fronk_3SG	human
@smartindc	human
@asiapoolhustler	unknown
@MLyeyi	human
@laportineria	human
@louisgaldeira	human
@cookieme9	human
@cacolourfullife	unknown
@safronprice	human
@NastaranL	human
@guamgirl721	human
@Changing_News34	human
@GreatHershey	org
@AnatoliSouvlaki	org
@omgluie	human
@myongie_myong	human
@marillionflower	human
@carytownrva	org
@bobbymagic	human
@gigiscafepdx	org
@AD_Renaissance	human
@voguefitblog	human
@kilakiller08	unknown
@bronxsandwichco	org
@klara_06	human
@BajaCafeTucson	org
@newclubbrighton	org
@linalecia	human
@Ferrocastor	human
@Dessertgo	human
@esdomp	human
@TheEndlessMeal	org
@BoBClubsHavant	org
@RitoKaiZen	org
@MountLoftyHouse	org
@DonnyLB	human
@shionii	unknown
@CaterToMyMan	org
@MariamNdour	human
@ginaandfriends	human
@renee_b_o	unknown
@charissawg	unknown
@Nemoyoyae	human
@kabes	unknown
@CheshireLadders	human
@bradwbuck	human
@jacq_tanoto	human
@bobounds	human
@bearjialing	human
@ClassySassy31	unknown
@WTTtheWONGmove	human
@just_the_walker	human
@DESSERTISTsam	human
@kekkomili	human
@GajenNad	human
@renzrotty	org
@AlWadiAlAkhdar	org
@suyintha	human
@ladyenigma	human
@EmmaLaplace	human
@RICK_MICHAELS2	human
@FSMMedia	human
@livehoustonlife	org
@Nazaria2002	human
@_k3rry_	human
@Nookvancouver	org
@mysticguardian	human
@JcoIndonesia	human
@fooyf1234	human
@VisitTampaBay	org
@jemomu	human
@LOVE_Park	human
@LeQueenofHearts	unknown
@quieroarepas	org
@LiveDerekChu	human
@ng9online	org
@theLEXlevel_	unknown
@mrgoodlifetr	human
@Cabotocentre	org
@kerlirosa	human
@MsUnderstoodToo	human
@alvaroRoldan_	human
@InstagramFromUH	unknown
@ERIKMEADOWSPVP	human
@booboochan0815	unknown
@makeitwithfifi	human
@BlackSwanBurl	org
@tinyfoodfarmer	human
@JilllChua	unknown
@christinaetgray	human
@TFDEaston	org
@FoxwJeffery	unknown
@anneejohnson9	human
@CocoaMommy	human
@benchan0718	human
@MiddleNameShaun	human
@bh_thai	human
@abitfestive	unknown
@santirun	human
@PaltiLugo	human
@krishnacouture	human
@Al_Murbati94	human
@pinksuperboink	human
@KevinMarlo26	human
@allsaints1987	human
@bistro_dtaste	human
@parenting	org
@Sheng07	human
@DonGotta	human
@KarenFluffys	human
@margaretsdish	org
@larisa_79	human
@LuxeTiffany	human
@yvanneteo	human
@andrewihobbs	human
@Giulka	org
@taitaifoodadven	human
@maylamont	human
@MichTLo	human
@JennaBlumenfeld	human
@meals_clerkenwe	org
@pennyteh	human
@apostlestjohn1	unknown
@PrepDish	org
@ZaFZhafri	human
@kristincrane	human
@Tasty727	human
@JessicaCMason	human
@foodifyurlife	org
@Crunchy_Craft	human
@Urban365ATL	unknown
@ArmeLTalabis	human
@biey_evans	human
@BakerBarista	unknown
@KaiserSumHungry	human
@sophsrobertson	unknown
@ketyreynoso	human
@PaulaMG27	human
@meals_fulham	org
@vhiitaaamalia	human
@SeaWorldMommy	human
@DemonicDomenic	human
@yurietashiro	human
@Amber_Tesia	human
@Gustavo6340	human
@NorwayInstagram	org
@Kitchen_Captain	org
@CathelijneVD	unknown
@maulasi	human
@paul2stevens	human
@MexicoWorldWide	org
@SamanthaLynchRD	human
@__jesuismoi	human
@ProducedinKent	org
@sefrizcha	human
@QuincyMaurice	human
@SoUnusualGirl	human
@mayara_alonso	human
@feliciaastrid	human
@ardiiano87	unknown
@tosseduk	org
@yumichan0214	human
@MQidan	human
@girlwithsometho	human
@SexyRena27	human
@ohheyjenna	human
@GinaMuscato	human
@CrnDrxlr	human
@CaposSF	human
@gogomariah	unknown
@Cate_DeFilippo	human
@OchieMochieChie	org
@SaeJosef	human
@Shark4ChipDrink	org
@redbankbistro	human
@MzJzah	human
@bathforumcoffee	org
@mensfitkitchen	human
@TheRealJmaxwell	human
@JMOryhon	human
@TheFareTrade	human
@SideBARnyc	org
@OysterBarPDX	human
@KimDyla	human
@verdecardamomo	org
@ErantheLoo	human
@realAraMina	org
@Val_Tol	human
@tk408	human
@CynthiaLemay31	human
@CjValenciano	human
@1_2CulinaryStew	org
@Eijiella19	unknown
@BestChoiceBrand	human
@MeedoJradi	human
@hellzee	human
@carb_low	unknown
@Iamloveandstuds	human
@MyCouportiera	unknown
@carolinuz	human
@EatingWhole	org
@thedustyknuckle	org
@HamalAriesY	org
@janecary123456	human
@MarysBar2	org
@lavanikit	human
@gofoodstreet	org
@BistroWineMan	human
@jennife27197400	human
@purplekushbud	human
@SurferGrl15	human
@Oughtred_Coffee	org
@lainiemess	human
@Mfnaughton	human
@natmmom	human
@Fashion_Dealz	org
@DrinkMeEatMe1	org
@jaydi_mac	human
@FSDoha	org
@LoafDeals	org
@sinfailan	human
@rina_mjmj8	unknown
@DiverseConnect	unknown
@BlondeCumSluts	human
@LyndaEnright	human
@araosiris	human
@nininininico	human
@runnowcrylater	human
@Yle88	org
@jessicajea	human
@InstaEatsCT	human
@jenniukk	org
@BoozyEpicure	human
@iamkhairuddin	human
@yumalanding	org
@KingaWronka91	unknown
@Rmeich	human
@DrenchedFur	human
@CABusinesslist	human
@LadylilaStern	human
@istalevtrainer	human
@mrdaps	org
@AlmaLnrs	human
@OfficialRainyen	unknown
@1703Roberta	human
@imeldaharris	human
@SwissliMuesli	org
@cpuvathingal	org
@WikeWijayaa	org
@Hsormunen	human
@shupin_	org
@sandrinesbistro	org
@aiuchicocoa	human
@RealFoodFest	org
@SusanFishback	human
@nhietampa	org
@SparkItUpToday	unknown
@CovenantOyetade	human
@nirwanaspabali	human
@isunvera	org
@DiningOutSF	org
@talitharebeccaa	unknown
@yuka_aha	human
@erickkaaah	unknown
@Ji99aMan	human
@knycky	human
@IzRijap	human
@VeganChatRoom	human
@HealthbyNapoli	human
@cocoocafe	org
@spaceman_sg	unknown
@BalansLondon	human
@ALICE_ROCKEY	human
@eriseamag	org
@ZaLe14	human
@LaceyMatherne	human
@roydellobo	human
@ironroosterfood	org
@WatRegionEats	human
@key2luxury	org
@VecinasEcoBar	org
@UrnotBowieSin	org
@CattlemensHG	human
@saraspicks	human
@HotPinkGrill	org
@VeganL1fe	org
@edible_photos	org
@TFuchscreative	human
@MacRtst	human
@J_Sliv	human
@stellardir	human
@MikiGonzalo	human
@BTyliskincare	org
@maeganh1	human
@Evan_Calisto	human
@KyushokuJP	human
@YuniDamarys	unknown
@LS_Travel	human
@jadefromparis	human
@RendyRustam	human
@cs55200330	human
@Tempest_Bijoux	human
@TifDiP	human
@OfficialMikeSoo	human
@nikkiyo7624	human
@blackswanxxx	human
@JuniorCouncil	org
@fathinazean	human
@marcgarraway	human
@elst126	org
@photogirlatte	human
@Doenja	human
@happyfoodlady1	org
@Searsons_Bar	org
@prancingpapio	human
@hoysoymasfuerte	human
@KaseKwift	human
@SocialResult	human
@yapling	human
@Taboonette	org
@KaftaMania	org
@JonathanBardzik	org
@emshealthykitch	org
@Francyyy_87	human
@Luchimil	human
@KevinWolver	human
@Skinnytaste	org
@MagsKoco	human
@viajante_A	human
@FariyaDoll21	human
@GloriousGGal	org
@JNP_Crew_Kaz	human
@OliviaHutton_	unknown
@stopcrazy	human
@sana_tentacion	org
@badyogidc	human
@DglckPauline	human
@QuakerArabia	org
@gLeNn622	human
@NorthwoodTO	org
@DenverPavilions	org
@AnjaKontrec	human
@HashimotoMai430	human
@LadyJFitness	unknown
@NutthaK	human
@JimmyYoe	human
@yoshinojp	unknown
@Fit_kristin	human
@adventurewmike	org
@iwebnel	org
@FaneuilHall	human
@mathieucadart	human
@zeppy_peppapig	human
@gwenhue1	human
@JessieAlaimo	human
@PattySFluvsJOEY	human
@SwitchingGranny	human
@ottaross	human
@_SallyannP	human
@31ranko31	unknown
@castillomeynard	human
@CinLyn62	human
@DevinNorma	human
@PescatoreNYC	human
@AmbrosiaPty	human
@patriciababylon	org
@Look_Its_Ben	human
@TOFromageDude	human
@ModernAgeless	human
@StephanieKaur	org
@JoshyBrah_	human
@boranaranch	org
@HarliQuyn	human
@LimeTonicAE	human
@LovinLife_Radio	org
@itsblim	human
@nicolesslaw	human
@FSDenver	org
@23Eya	human
@iam_vincentdee	human
@HeftyVanna	human
@SpottedHorseCT	org
@gelo123	org
@lilibebek	human
@KAZKAZ00	human
@BilyanPopov	org
@myfashdiary	human
@TyeBlue	human
@P3PastaLB	org
@Shrtbus	human
@LadyJ5569	human
@FRHcheko	human
@realnutritioncg	human
@EASJR1991	human
@hkr2205	unknown
@conmibolsoacues	human
@MattUy	human
@momsfocus	org
@stupidDOPE	org
@ImvelaphiSafari	human
@vincentsoncback	org
@papiramu	human
@CosyLeicester	org
@YENYENNAVALTA	human
@PrimaBar	human
@richardmelodi	human
@followiink	human
@owinCKs	human
@automo1046	human
@lydhiafeb	human
@nest3d	org
@Bruno_Matias_U	unknown
@ansiacl	human
@10e_Restaurant	unknown
@imarbellacom	human
@TheLocalChicago	org
@brunay_cloe	human
@LindsayRessler	unknown
@tacorocketbtown	human
@karlfoxley	human
@UnlockMcr	org
@CarersTrust	org
@manfredpan	human
@kojiharu_archiv	unknown
@hwup1396	unknown
@WhtevaLolaWants	unknown
@propriator	human
@OhNikka	org
@Ashley_Khoo	human
@CristianeTinari	human
@kaory_en	human
@Skibum4Eva	human
@AubergeSaintGab	org
@mariongrimes	human
@BT_Richmond	org
@SaLLeHunTeR	human
@zt_insta	human
@HeartShopping	org
@Joe_Kazzi	human
@8sgdeal	org
@tastykhana	human
@TalkZombieNow	unknown
@KureemG	human
@eatSheffield	org
@JenHerrero	human
@golfscoopyi	org
@beermusingskris	human
@gosampling	org
@HTSFF	org
@torviewtor	human
@GrandHyattDoha	org
@itsmerhanypoe	org
@EvrydayShortcut	human
@LDanielBertrand	human
@see_sushi	org
@dizguhdontplay	unknown
@dolessproject	human
@c_totoron	human
@MalkieFretz	human
@artofeatwell	org
@ebrubirinci103	org
@GrapenutGlitz	org
@UnicornHuset	human
@yudajacobs	human
@Zerogravitydxb	org
@USAHEROSALUTE	org
@iYanyanMoko	human
@GramoRestaurant	human
@BrimstoneGrill	org
@JJ_Events	human
@theUpperWest	human
@tracysuetyeng	human
@AmdGazzola	human
@mikybalzarotti	org
@farafara_	human
@ciyakciya	human
@Mexicali_VT	human
@Ldavis616	human
@JayEnvyUK	human
@1800BXCHRIS	human
@xxmanachalxx	human
@NoHeDaily	org
@ashleycfleming	human
@VarunVicky93	human
@SavingUpDisney	human
@no1lifter	human
@iam_mio_	human
@cafedelapresse	org
@mbthingsiknow	human
@_MizzShortStuff	unknown
@CldnSmnx	human
@Chefmathu	human
@josiegags	human
@BambinaAnna	human
@LorenzoKline	human
@FittBootcamp	human
@meleEpere	org
@naturalhome2015	human
@noor19haider	human
@FLORA65496463	unknown
@georgiayoga	org
@MagnoliaHtl	org
@spiceboxindy	human
@KENNETH182	human
@miracurupippi	human
@mshuizhen	human
@chocohol13	org
@ralphandlou	org
@SAKixxx001	unknown
@NecasAlmeida	org
@Greyhound_Hotel	org
@MichTD	human
@reenovation	human
@livewellbake	human
@Chef_RM	human
@ilmostromijooo	human
@About_Kidneys	org
@Pedrocaicedom	human
@maomaosalad	human
@krwatson	human
@TheParlorHW	org
@izeenat	org
@AnTheGoSF	org
@ppytl	unknown
@VagabondBar	org
@JulieNGiselle	unknown
@MakeupByKatO	org
@Ywka	unknown
@jkpuma	human
@NatureHelps	org
@BelleReveNYC	human
@magurl768	human
@k8y_k8	human
@philgatt	human
@jupiter010215	human
@thebearpawdeli	org
@enjoyeverybite	human
@postbellumrva	org
@BarkingMadGC	org
@NeuvooSantaAna	unknown
@boghis	human
@Jason_Choong	unknown
@Ka36800	human
@Zachariah4334	human
@arendgreat	human
@PointEphemere	human
@DanielaPazGomez	human
@slangcares	human
@jamendoza7484	human
@MordenAndLea	org
@GastroDeliBali	org
@AuntieLandra	human
@lek_official	human
@TheMintVictoria	org
@VlvaVndrgrif644	human
@Nathan_Andre82	org
@FoodNarc	org
@nels3	human
@ASecondChance	human
@dulcetta	human
@daniellecelmer	human
@CalvinLooi	human
@sanganfool	human
@meifan_xu	human
@HomaANDSotto	org
@Keittiokaveri	human
@food_atl	org
@jfmusy	human
@allergysafekitc	human
@theDCFoodChain	human
@BJsWholesale	org
@ChLovesyou	human
@meals_belgravia	org
@AlexisKornblum	unknown
@SaveOnMI	human
@WithLoveSRenee	human
@FloryJapan	human
@kseher77	org
@ng3online	org
@MarlenkaEnt	human
@airichan03	unknown
@EscobarBandra	org
@ChloeSarahWhite	human
@roarbabynz	human
@JoshieWashie	org
@kazukimori	human
@Mostly_hated	unknown
@mercedm67	human
@JulezRocks	org
@ahujayatin	human
@Just4Sybarites	human
@yachubwijaya	human
@ZeniaIrani	human
@TotalME13	human
@LifeDelicacy	org
@560Kitchen	human
@elkenyc	human
@BakerProperties	human
@cleardayz	human
@freshoncrawford	org
@DiniDelivers	human
@choppy_az	human
@alcolestudios	human
@danielhendrata	human
@TheAbbotPub	org
@ItsAlyaBebeh	org
@TheVictoria	org
@imjaebird	org
@dassanaamit	org
@UrbanFarmerCle	human
@Etiquette2day	org
@SoapinTrucker	human
@DjSixthSense	human
@Taehtitaivas	unknown
@_itspeachypink	human
@topgolfaustin	org
@dj_maaaayu	human
@mandown0420	human
@Bento_On	org
@anvvnan	human
@PeanutFarmers	org
@BennyBean75	org
@faerie_eriu	org
@inceirem	unknown
@yentlkeuppens	human
@duchiediaries	human
@TraceFace_1	human
@hbessonphoto	human
@fabiodimauro73	human
@LottieFitness	unknown
@BestofCA	org
@wctbymanon	human
@KavalonThatsMe	human
@OriginalLounge	org
@Djubilation	human
@nurul_izani	human
@megatfikri	human
@AhHaBoxReviews	org
@qtpinoy54	unknown
@liea_b	unknown
@ilovecrumbs	org
@FoodTee	human
@underground_vel	org
@UKWineMerchant	human
@Foodshionist	human
@JordaPaiva	org
@DoRidReam	human
@Atwoodchicago	human
@Stephani_kay	human
@Macucumber	org
@DspnVshn	human
@feliciaphoto	org
@LadyLakeMusic	human
@MissBlueShop	human
@Couponmamacita	org
@GubbaRum	human
@nitt04	human
@shravang	human
@BoozeKitchen	human
@Animalparty4U	human
@MissExoticMind	unknown
@ledibird	org
@cheffoale	human
@WonderCherryPie	human
@tobiren	human
@ItsFreeAtLast	human
@LibertaBella	human
@CampoRestaurant	org
@mjjeeje	human
@blaqkandii	human
@artsskillet	org
@leftbanked	human
@SkubyMedia	human
@lularuger	human
@TuloLaway	human
@ShopBuddyAnna	human
@Melissia933	human
@ng_effie	human
@amirshayegan	org
@dinner_tweets	human
@EchoesOfHorror	human
@SprintGroup1	org
@TheMcEwanGroup	org
@WayneHew1	human
@ElBudareMiami	human
@Fitness19MD	org
@cremond28	human
@Twittwoonic	org
@amyyylam	org
@itsgead	human
@Candyysy	human
@c_p_d_	human
@RachaelRayMag	org
@ElainaMWhitley	human
@NinoJakClubbers	org
@Lou52001	human
@freeads4u_uk	org
@DonnieDivo	org
@YuFujii0211	human
@birinci_kordon	human
@dailydiylife	human
@Winonacooking	org
@tracedominguez	org
@KnittingGeisha	human
@Kipparinmorsian	human
@PaulFrmTheNorth	org
@themilanomode	human
@Herine_Ang	human
@BackurBot	org
@BestRadioShows	human
@momo157579	human
@MrDroogle	human
@LizIsHere_	human
@eightmontemusic	unknown
@LuvnHeartDesign	human
@GregoryManley	org
@closkitchen	human
@TheAirportPub	human
@busboysandpoets	org
@Michuypromotion	human
@DuckEggCafe	org
@TheShila81	human
@nisharose	human
@richlai1	human
@PaiviSuhonen	human
@nanamiprincess	org
@LaParrillaKS	org
@SamisNutBakery	human
@BurreCollins	org
@Gmmvns	human
@zai68	human
@CiscaMarie	human
@joachimreinhold	human
@aprilgarcia08	human
@trixywh	human
@AllenZaki	human
@heythatsjack	human
@CheyenneNoriko	human
@JesielPleg	unknown
@SavvySurvivor	human
@matchbox369	org
@DavidBooker25	human
@volgastronomic	human
@impact5656	human
@littlemonstermn	org
@clubmexicana	org
@Bklynzizi	human
@kumasan019	human
@bmwright18	human
@mitsueki	human
@vincentator2	human
@kaigalway	org
@lopespulga	human
@simplemama2013	human
@diceman_uk	human
@ThaOriginalCJ	human
@ChristinaToGo	human
@CosyClubTaunton	org
@infashionlove	human
@heyitsEllaine	human
@vintageandbloom	unknown
@Aventura_Chic	human
@VisitHall	human
@caigerskitchen	human
@roberto7177	human
@deejase	human
@localzrule	human
@foodigatorJ	human
@ImThatLiar	human
@PatriciaPatPat	human
@kerijaehnig	org
@cheungs7	human
@katieoscarlet	human
@BerkeleyHella	human
@Joanny795	human
@fantasy_fids	org
@box_cake	human
@SeymoreSavings	unknown
@MallikaBasu_	org
@VenusIsNaive	human
@thoughtspresso	human
@Paris_Mind	human
@neatnnutritious	org
@dwikusumastuti	human
@stubbornalice	human
@CallMeKingMovie	org
@clothes_w	human
@bescobedo21	human
@how87	human
@igniteburgerbar	org
@tiaraisy	human
@latimesfood	org
@freakyUang	human
@Liuzaaa	human
@CheeSuang	human
@STsuperstore	org
@Asquared_dishes	org
@GastronautaDF	org
@SkySpideyPinoy	human
@Thurstee13	org
@tangtang666	human
@moizbil	human
@AmerigoJxn	unknown
@b2Scott	human
@justinclays	unknown
@BombasticPrata	unknown
@Grille29	org
@Biubiuy	human
@grazerdotorg	org
@MargieKorshak	human
@zhaxiabook	unknown
@disneyfan40	human
@leannechien	human
@fashiolista	org
@tv1imweb	unknown
@elizaflorence	human
@micibakes	org
@daonebreath	human
@BoundaryStoneDC	org
@aaronvampire	human
@getkingdon	org
@robberrod	human
@line831	unknown
@P0RTO	human
@CaitOConner	human
@sermetseveroz	human
@chipmuunkzz	human
@daymNEE	unknown
@Gallery1Artists	human
@ChefEricCrowley	human
@MarkKherDiao	human
@tapaswinery	org
@gourmetPH	org
@RinaEjon	human
@drkarenslee	human
@clovar	org
@mavitrapos	human
@parkroadkitchen	human
@milehighlupe	human
@ChopAndQuench	org
@pantrypacker	org
@thomaSchulz	human
@DamselAby	human
@JackieSg	human
@MiamiCurated	org
@mrod82	human
@DaNewMeh	human
@mylivenatural	human
@PearsonPatriAPP	human
@TheELMLife	human
@marleesteyn	org
@UndergroundIC	org
@akFOTI	human
@RonisKitchenYYC	unknown
@WongaCanada	org
@Hwa6650	human
@BakeTaste	human
@JanTK13	human
@BorsBilngsly321	human
@kpxKevin	human
@janinestyles	org
@WeAcceptPets	org
@Denver874022	human
@fithitman	human
@ryssiebee	org
@CoffeeCrack1	human
@UncleAlsCafe	human
@ParlayRVC	human
@CoonamessettInn	org
@KerryCanCook	human
@icecreamxpress	org
@AdeniyiOAdetoro	unknown
@mybabatweets	human
@JFJuhari	human
@bluedogskitchen	org
@miss_yxin	org
@kabemayor	human
@VICKIET_ENNIS	human
@allisonsulliv18	human
@Katarina99	human
@fishing_4_likes	human
@TormyJai	human
@Sorothavy	human
@josie_olivia	human
@mzjujulove	unknown
@Taariq_N	human
@sandywisdom	human
@bbcoachkasey	unknown
@Waske_Natashima	org
@goLadleDenver	human
@foodiegator	org
@editgirlnyc	human
@RedPepperAtl	human
@aboutamom	human
@DnL_w	human
@gunawansetiaji	human
@Lah_Shie	human
@ShamaSalmanKhan	human
@JSemaJJameS	human
@MaxeneSimon	human
@b0wGiee	human
@BellaVidaLetty	human
@NordicBar	org
@AffairesBelles	human
@Meals_notinghil	org
@DnnsMcfrln	org
@jillchenzy	unknown
@UNIQPERCEPTION	org
@DoverDowns	human
@KeithMooreULR	human
@themightyjimbo	human
@usk__	human
@SunnyStacks	unknown
@AznKage	human
@romanrobi	human
@CRAFTbeermarket	org
@AMANDAMARZOLINI	human
@Dub_El_R5	human
@Queen_of_stage	org
@Alli_n_AJ	human
@Cynthia_Hoang	human
@HeatherClot	human
@ChefJuvon	human
@Mellois	org
@Daisybeebee	unknown
@Timmy_Tanja	org
@Sprinkled_Sam	human
@kpop	human
@econciergeDD	human
@mistamanieymisu	human
@DeeDeeBlog	human
@JMart0785	human
@RIZLAU	human
@ronaldetbrown	human
@EmillioMesa	unknown
@CoffeeconMartha	human
@metal_fortress	human
@PrinceEdmund	human
@PLYMCR	org
@SwaggyJel	human
@techsupremo	human
@DebSmouse	human
@burro_alici	org
@kozyou_yakei	unknown
@jpizo	human
@3Scorpios	human
@dinnerfor2blog	human
@Lol_Amalthea	unknown
@gurhancicek	human
@elcaminante110	human
@goh_jyjy	human
@mrszerul	human
@CHAZisGOD	human
@FoxyFate	human
@bootyroll	human
@LaRosa4041NW7St	human
@IraMency	human
@ReanaBanana	human
@GRANDANTIQUE	human
@thelocal150	org
@jeremydboyd	human
@kathrynetcook	org
@KoiAbuDhabi	human
@OpiumDublin	org
@ZEITLOOS	org
@Alicklevy	unknown
@TFTPaniniCafe	org
@TheNorthbankBID	org
@betoinc	human
@SocialMyna	org
@YolyO	human
@jujudalmeida	human
@henchmanapp	org
@ZeeshanMasih01	org
@melaniietweets	human
@ZestBootcamp	org
@GDacorin	human
@kelly_chong	human
@nutritionmentor	human
@NutritionPanama	unknown
@PercysOrganic	org
@jAeYiN304	human
@biasintra	human
@JoeyThurmanFit	human
@YollaSan	human
@Himalayanbistro	org
@pelingsing	human
@mjr0414	unknown
@honeylsm	human
@Italian_Moments	human
@tracrbullet	human
@anthonyyc	human
@DeArdenosPhoto	human
@luzh81	org
@PlengpinELF1D	unknown
@DaraRakovcik	human
@akoeivle	human
@ehm444	human
@gzchef	human
@gen321blog	human
@PiolaDC	org
@Nayashae	human
@chloefarquart	human
@F5refreshyideas	human
@SuViche	org
@LABGInfo	org
@KarmenPiFitness	unknown
@cumbervamps	unknown
@ValeriesKitchn	human
@ediblenrg	org
@LyssFruit	human
@between_the_bun	org
@monchiemonchie	org
@rada_mohmad86	human
@sbabij	human
@MindfullyInJoy	human
@sarahjbowman	human
@GVRivieraMaya	org
@kohakosasiki	human
@ViegasGirl	human
@DaddyBookins	human
@baacco_com	human
@CajunsLR	org
@ChalkBarGrill	org
@findmyrice	org
@fridalorraine	human
@pocket_molly	human
@ohlalaqueenie	human
@JanTr2511	org
@TheFreshGrocer	org
@CurlyGrlBeauty	human
@nobuta59	unknown
@ModaserHandoush	unknown
@DocWellFeet	org
@caity_babyy	human
@stanleyowings	human
@IamJustinBabor	human
@Madhatterdc	org
@daniesutherland	human
@rula_z	human
@ADSinTexas	human
@Lee_Lee504	human
@vieMD	unknown
@giulianigi	human
@Chitra_65	human
@JulieShematz	human
@Maayalohawaii	human
@SandeeGlam	human
@ChefRobertKlemm	human
@mikemartinez50	human
@Adliany	human
@GOLDFISHh2sr	unknown
@AlexandriaVaun	human
@GhinaBratinella	human
@fanirejutoduxa	unknown
@meltothemax	human
@NokhuthulaNyoni	human
@CollardCowgirl	human
@EsmeRoseAndMe	unknown
@FoodeesIndia	org
@itsmeniamh	human
@green_zucchini	human
@jayvlad26	human
@RasberryBeret85	human
@diningbar_iruka	human
@DaYeJeong	org
@155_Bar_Kitchen	org
@KB18CTK	human
@itsqunni	human
@JILL_C_PETTY	human
@Saed_huss	human
@samp_c	human
@hapiicharlie	unknown
@strMz25555	human
@PassportsandPom	org
@blackdeminsider	human
@simplehack	human
@joweman	human
@glutenfreebt	human
@DD_Fitness	human
@abillboard	human
@cali_dreaming91	org
@Schoko_Junji	unknown
@MaryMorehouse2	human
@DianaLoriAnn	human
@robertwilson009	human
@khokhokrunchhh	human
@richard_pramana	human
@SammyAman	unknown
@RBLewis2295	human
@420y	human
@SellySanjaya	human
@uchi_leoni	human
@theargelhouse	human
@2Christina0	human
@iam_arty	human
@D3T0UR	human
@NutmegNanny	human
@SmashinBeauty	human
@MirandaBK	org
@Lorilor1979	human
@ShelfAddiction	human
@JoseMartinezTV	human
@philipwan123	unknown
@Randys_Kitchen	org
@KTCHNDTLA	human
@GaslampPopcorn	org
@djraeeverywhere	unknown
@lacklusterladyy	human
@AnnyBlue02	human
@ERiKAlmaz	human
@MartinBelan	human
@CookLikeNonna	org
@fang_jani	human
@DressMePrettie	human
@gingerbasement	human
@LilPortugalBIA	org
@sslifestyle	human
@PudgesSteaks	org
@rainyloveshappy	human
@DerbyFood	org
@toursinmypocket	human
@chitung_mak	human
@JAYMEBLACKWELL	human
@biiiiLABuuu	human
@MaitreyeeMAYHEM	human
@mryancey18	human
@mysamejica	human
@kristvav	human
@honeyandfizz	human
@_RazzleDazzle	human
@PozativProMo	human
@izu0924	human
@NuccisItalian	unknown
@olakkengal	human
@_Bacco_Bacco	human
@eatatstrattons	org
@Jrika007	human
@PaleoFoodsCo	human
@yasnakano	unknown
@TomClansy24	human
@Shopping_Ace	human
@iamshobz	human
@YouthfulHabits	org
@nadyarusly	org
@NashvilleRT	org
@LaCapaRouja	org
@Lunchboxdietph	org
@Claire_Eddie	human
@ielladeleon	human
@TravelCorkscrew	human
@KipperSnack	human
@BryanZwan2	unknown
@djraeboss	unknown
@MikedelaVega1	human
@CupshupCafe	org
@RealPoshMom	org
@whatevs_heath	human
@juli_piccoli	human
@americanfan12	unknown
@bbankyy	human
@NeuvooPTAtl	org
@ShirtyKumar	org
@JennyYNChin	org
@spetrakovitz	human
@Martine638	human
@victomlinson	human
@Hey46521491	org
@luxerubbish	human
@DeMoN8EyE	human
@TravelFood_Wine	human
@KellysBarLounge	org
@yokomosushi	org
@PocketVacations	org
@AnaIsabelS89	human
@thylin_s	human
@LawlerBarbara	org
@BushHallDining	org
@LttlChefBigApp	org
@burtonrdchippy	human
@Newson242	human
@XXXBinge	org
@TriniWithATwist	org
@RoiaRestaurant	org
@nsa4197	org
@elizabethrider	human
@TGIFWilmingtnDE	org
@CassieFiffy	human
@OTCRestaurant	org
@MikeyKodens	human
@nanimokamoiyad1	human
@beesihombing	human
@queeschyaa	human
@DaneshD_D	human
@astralmayhem	human
@spaziomovida	org
@jungjungmail	unknown
@geo_tc	human
@alpla888	human
@CYCLADIA	human
@linleshi	human
@wifeeclectic	human
@monStar1019	unknown
@Kildarespub	unknown
@jemangepdx	human
@marktan08	human
@firahanim	unknown
@Arneesa	org
@DevilsElbow_	org
@OrganicLifeTV	org
@CasperJizoux	human
@EricRoutenberg	human
@GingerSesame	human
@DistrictWino	human
@MyDowntownDubai	org
@Ifertari	org
@B_C_Island	human
@Irene3012D	human
@AmeliaAyerst	human
@DelMarcoBmth	org
@Julie_Alloggio	unknown
@IrzadAlRahman	org
@primmi3	human
@Naamyaacafe	unknown
@DiariodeumBatom	human
@IlMondodiIngrid	human
@MessHallKitchen	human
@vanrenzh	human
@ayaka_m0315	org
@AdairBachman	human
@KelMillionie	human
@CatyCatwalk	unknown
@CheerMap	org
@jeskaalee	human
@ItsCarmenBaby	human
@Teamarcia	human
@chefmarkell	human
@HooplaHa	human
@Beverley3918	human
@emilyyu120	human
@yumenoki830	human
@TheBayHorsePub	org
@clodaghmckenna	human
@OllyGuseva	human
@BumBumJones	org
@BrittanyMBarton	human
@jackasslut	human
@eazytraveler	human
@meals_padington	org
@D2Dezigns	human
@Nicoleherrema	human
@F4ZU	human
@yummitch05	human
@loveandsaltla	org
@silvernemesis	human
@Shane__Adams	unknown
@locallounge	org
@SahmReviews	org
@hungrySLIF	human
@sandbarsb	org
@FaithMonrooe	human
@akosiLG	unknown
@seelan1	human
@eiffelclover222	human
@GatorBearCA	human
@gstarluv	human
@Tan_RickyD	human
@RonjaHerranen	org
@Dar_rin	unknown
@NijarAjram	org
@successtohealth	human
@DBossdup	human
@InBrunch	org
@HelpMeGetHealth	unknown
@The_Feral_Lady	human
@RamiParamo	human
@c_barge	human
@Midtowndinerdr	org
@injustifiiable	org
@trendinaliaIE	human
@TheOldFrizzle	org
@proamhsd	human
@DrRoz_thefoodie	human
@apshylu	unknown
@designtodevelop	human
@eBubbleWrapped	unknown
@SophiaCollect	human
@meatdistrictco	org
@daniel_murphree	human
@boxpark	human
@H0peful_me	human
@HealingPlaceMed	org
@foxxyroci	human
@OldFountainAles	org
@Jnicol8888	unknown
@TeuyHom	human
@AboJoy	human
@originbakery	org
@Loredise	human
@Webadviceblog	human
@effiesiaini	human
@AbeerAli95	unknown
@Zeppy_marvel	human
@Gadacor	human
@mkz147	human
@zoeyh74	unknown
@Fab_Feline	human
@CafeBlancDubai	org
@ChopChicago	org
@cutja_ja	human
@ericktinez	org
@BDashika	unknown
@MelaniePerez867	human
@shannagebhard	org
@meals_london	org
@SKYBOKX109	org
@monvelin	unknown
@huisze3411	human
@thiscookindad	human
@kaoru_kumamoto	human
@sociallattesmm	human
@PontyBistro	org
@1goatroti	human
@Saraespejo96	human
@MarkTomic	human
@Kristune	human
@javislim_	human
@PrissyMrsParker	human
@iloveburnmdiki	human
@TheRimer250	human
@SteveMadan	human
@1Sunnyone2	human
@LaVilleDeMadrid	human
@Taylor_Gourmet	unknown
@MissJMean	human
@kittylingerista	human
@MICHAEL_J_CR	human
@aidmrocks_	unknown
@carito_lorca	human
@damgoodtrips	human
@mshealthesteem	human
@StartupLawSV	unknown
@Andrew_CMG	unknown
@Kimlin_h	human
@ettadin	org
@Jeanbaca22	human
@haniebunchiii	human
@Kristinavella_x	human
@GraceChi89	human
@Maelie_Bouchard	human
@SunnyStreetCafe	org
@JonKhanna	human
@tarosanikki	human
@annyludfi	human
@MidiExpressHT	human
@paradiddlepad	human
@MollyWright2921	human
@KeepAustinEatin	human
@adolfa_jancso	unknown
@aspoonfulofphot	human
@beckymortson	human
@GrndUpWellness	human
@KndcTrmp	human
@IrisestherFF	human
@ChelleintheBay	human
@genevolpe	human
@hukkin_turu	unknown
@EgmondDennis	human
@Town_House_Cafe	org
@OldEllicottCity	human
@luananaki	org
@jenifer7johnson	org
@TEdmiiston	human
@GreenDoorDAL	org
@RickSydney	human
@Defakeit	human
@princesskim014	human
@soulsisterscph	human
@yuup_66	unknown
@EveEveyy	human
@iamkimkeshley	human
@cody06340	human
@kupo_bim	human
@DCRestaurantGrp	human
@Fashion_mazikaw	unknown
@bq_cafe	org
@AbrilMend	unknown
@ivy___ivy	human
@tracina	human
@NYJournalAm	human
@ManhattanEats	human
@LaSandiaRSR	org
@_PrincessAng	org
@GaslightPhilly	org
@StarKnits	human
@TheRealMrBond	org
@Oweinch	human
@PsychBabbler	unknown
@trala2	human
@chrispics	org
@Mattapause	human
@fgr62	human
@Longzero	org
@JuOn_Azura	org
@creamcupcakes	unknown
@ChelsAnneBill	human
@racheldelle	human
@mcoppers	human
@ClareEPLS	org
@Chiquita	human
@freestuf4u	org
@OlcayBoybeyi	human
@NicliPizzeria	org
@Beach_Luxury	org
@HorisonBekasi_	unknown
@ANITA_letea6498	human
@shruzPa	org
@hiroticks	human
@TheNgrEconomist	unknown
@Nonesha96	human
@hellosstranger	human
@mymad_es	org
@ChechuLykaon	human
@BosphorusGrill	human
@According2Trish	org
@BabyChula318	human
@scopessor	human
@ElizParkCoop	human
@effa_fazierah	human
@Laura_cuddles	human
@farmsandforks	org
@MojoCardiff	org
@ErolOnMusic	human
@northbeachdeli	org
@RobbinsGioia	org
@marietamadrid44	human
@TaoXingCheng	human
@Wjghoul	human
@shinemonkun	org
@forumhouse88	org
@SugarDefined	org
@BakaGalleryCafe	org
@slicedbreadno2	human
@albarza_uae	human
@mimisp	human
@TravelDietitian	human
@urREconcierge	human
@the_spicery	human
@sallyannsbakery	human
@sfvmedianews	human
@asty_ananta	org
@realfitmama	human
@katrinaskitchen	human
@annalyn	human
@gwatson490	human
@Unicapinay	human
@BonnyVita	org
@Berneice566	human
@Sonia_Querido	human
@AyeItzJThon	human
@FASHIONGUITAR	human
@oramirez14	org
@byCarl	human
@spasieCT	org
@AvocadoGrillWPB	org
@elinatelove	unknown
@HarrisTeeter	org
@calligraphy11	human
@weerawatk	human
@maria_untar	human
@shanesta521	human
@TripReports_de	human
@kornela55	human
@GalleyBaltimore	org
@MusksSausages	org
@CARINE950920	unknown
@ukAfternoonTea	org
@BadaBingBuffalo	org
@DinnerPartyClub	org
@ScotchBonnetG	org
@JudithVanWeel	human
@Avery8590	human
@agnesevacanze	human
@BloggingUndies	human
@BurgundyVan	org
@GoEatandRepeat	org
@NewYorkUA	human
@eatdrinkloggia	org
@stephenbranham1	human
@MommyNamedApril	human
@lesagemark	org
@dr_evie_	human
@Naplestan	human
@monikademyer	human
@TheSlimSecret	org
@Lilz275	human
@bokumetu_innsyu	unknown
@commy	human
@CheerfulVanilla	unknown
@RiRaGeorgetown	human
@ScentedBychkov	org
@sduncan497	human
@BucatoLA	org
@cdecoratingidea	org
@JaePoet	human
@AlexShytsman	human
@oteihona	human
@jeanfrenzy	org
@DesyChi	human
@HungryPoohNYC	human
@MichaelLaRosaDC	human
@DominikZachar	human
@IdelisaMarte	human
@buntewollsocke	unknown
@LeroyDaGuru	human
@AmyMcClelland3	unknown
@MattCastagnoli	human
@jngorham	human
@melianachandra	human
@WhatDadCooked	org
@juwanlew	human
@jaaejaaja	human
@MsBrynW	human
@JumeirahZS	org
@JoeLipari	human
@BiceGrandCafe	org
@Sim_Louise	human
@csapickers	org
@checastillo28	unknown
@AmarantoLondon	org
@Briisco	human
@mattchow	human
@AbigailRz_	unknown
@huanchun	org
@cest1detailmais	org
@Lashawnda5610	human
@jem__jem	human
@TrishulVadi	human
@CueMC	org
@susmitchakrabo1	human
@OldTrianglePEI	human
@GaiaGoodHealth	org
@SweetChiliNYC	org
@zenandspice	human
@MariaLouise_09	human
@CarpaccioRyF	human
@najjmusic	human
@SHEdrinksHEeats	org
@kaylapetty13	human
@wellnesscoach1	human
@snowying622	org
@thecatswhisk	human
@GiuliaArdenghi	human
@Ding_Ding_Chi	human
@NegritoVip	org
@dennyroid	org
@davidfultner	human
@foodtrucksLEX	org
@BritMums	org
@vidalavonne	human
@DC_LuxuryHotels	org
@anitta_slv	org
@david_lky	human
@Beautystijl	human
@HEALingFoodie	org
@Knockout247	human
@DaraStyle	human
@gkrew	human
@chanpaco	human
@yariseth	human
@amblenorthland	org
@lollepampolle	human
@G2Swansea	human
@Jessy_Bentley	human
@myimagestudios	org
@paholnarak	human
@87_TwjC	org
@tokidokigohan	unknown
@PompChicago	org
@Soju_Sunrise	human
@MikeyGlovers	human
@SunnyBeLIEve	human
@JulzJoubert	human
@Magnumja	human
@HugosFrog	org
@jamieamendell	human
@LeedsWork	human
@CinderellaFL3	org
@Unbeelievable	human
@EkCupCoffee	unknown
@1HealingAndLove	human
@BDenum	human
@moniquemunoz87	unknown
@laurentmanrique	human
@MattyBBakes	org
@CDeegan_x	org
@JENNIFER_VANMID	human
@dumber_s	unknown
@Quweina	human
@ronaldhpark	unknown
@fofitourou	org
@MuffinFrenci	human
@rizwansikander	human
@UniqueHondaNena	org
@wiwieparis	human
@Davef163	human
@fdirgant	org
@ginagratiana	human
@Dawncracking	human
@healthyfitjo	human
@CountryWorkshp	human
@bojanaristic	human
@VinitaVarian433	human
@nechi_a	human
@KatiesCucina	human
@GloriaOutlet	org
@TheBfastLunatic	unknown
@FitnessForHer	human
@TenderPGH	org
@simplysated	human
@redwhitebride	org
@ayawellness	org
@DODGERMOE	human
@2littledollz	human
@RecetteNYC	org
@Mrsceeeceee	human
@laurabates5	human
@Mohammad__Scott	human
@StandardDinerNM	org
@char_mel	human
@moeteevs	human
@singer_miki	human
@greenxgorgeous	human
@GeomaraPia	human
@iamdksilva	human
@FreshShop4U	org
@Enaniemous	org
@susannalynnhart	human
@moethski	org
@ChefJasRoberts	human
@dogleash38390	human
@davidlkeck	unknown
@tantysaphire	human
@dowdy_dana	human
@Sherrill706	human
@EakkyCU	human
@ClaireHodges1	unknown
@djrae2012	unknown
@Skits_Esquites	human
@myralicioush	human
@bushcook	human
@530BUCKEYE	unknown
@ManUtdVancity	org
@cam_bum	human
@Cate_Cameron	human
@Lizannapm	human
@GDSCafe	org
@sunrise_sales	human
@TorontoNDs	org
@paramountroom	org
@GqStR	human
@chintalkakaya	human
@LISA_D_CARWYLE	human
@GridWideNews	human
@Siempster1	human
@MOMiSHStyle	human
@NaijaBarbieOA	human
@giovanniputzu	human
@SlugLeeds	org
@frederikayoland	unknown
@K_AliceC	human
@final_station	human
@ToribioKristine	unknown
@TOFoodPhotog	org
@TopChefMeals	org
@LindyHine	org
@BirdsNestBaking	org
@CSICincyChapter	org
@Zuzuz_Petalz	human
@coconom	org
@tira_blurb	human
@rokstarchocolat	org
@StormyWhisper	human
@KimAroundTown	human
@moniquefrances	human
@FranksItalianNY	human
@jodyjernigan	human
@Chewzy_CEO	org
@LornieK	human
@Radiant_Raven	human
@OLIVE_SHIBUYA	human
@Kareyasan	human
@Fashionbar_uz	unknown
@t_mellinda	human
@Ricardo_Metro	human
@LeGrand_Bistro	org
@bhenryteam	unknown
@coolmonacom	org
@linda1bella	human
@Mr_Awesome___	human
@leanna_yates	human
@nadiacerelli	human
@pearandginger	org
@iamjocelynsi	human
@fryfryfoodtruck	org
@stanleywishes	human
@kakwhy	human
@tbsazmasm	human
@famabeatz	human
@julesgough	org
@LaurinLitleto96	human
@Glamgerous	human
@katebestmakeup	human
@linychou_lnvr	human
@Melodyemolover	human
@Apolike	human
@C_MariaC	human
@TerroniLA	org
@bot31977615	unknown
@ellaeayyh	unknown
@BAMobile_net	human
@Sharpy_Lee	human
@DwnGthmllr	human
@queenlicy	human
@fooduzzi	org
@JusDru	human
@takaidohigashi	human
@haluoto914	human
@Noniswara	human
@TBakehouse	org
@AnujaDeSilva	human
@Chiorganicgirls	org
@EatPrayRunDC	human
@jessifit	human
@fatbadgerpub	human
@AvdonBahlmann	human
@food4umiami	org
@StevenTocher	human
@bebiecolin	human
@pinkshotdogs	org
@AShAdEOfINDIGO	unknown
@LaMaudeCafe	human
@Kiimmoy	human
@TalaveraCocina	org
@myauda	human
@khairulezee	human
@choloarellano	human
@cheladigranchio	human
@melirosenthal	human
@umamiburger	org
@gerre83	human
@UBToner	org
@shammy_tyn	human
@KarenMSoto	human
@WritingHealthy	unknown
@Coralie_Gagne	unknown
@ljordan_oficial	human
@rbcurly	human
@ray81162	human
@storytaleshop	human
@JonKosta	org
@Omiscoffeeshop	human
@xtinkkkta	human
@santimukti	human
@dinimadaryani	human
@85nnn_	unknown
@iam_JVP6382	human
@DP_heartablaze	human
@lailacoelhoo	human
@princessology	org
@WinchesterMansi	human
@js_digest	org
@SimplyJonez	org
@bunkycooks	org
@IncreaseFreedom	human
@NicheEscapes	human
@SoccerMomsBlog	human
@homestage20735	org
@Orion423	human
@LAGirlinTaipei	human
@theadkchick	human
@ellytier	human
@VelvetandVino	human
@ProteinBreadCo	org
@HLGrattan	human
@whatsonsyd	org
@theSHARPmethod	org
@jasngsays	human
@BrownsBellevue	human
@rizqruby	human
@mdesenna	human
@KIK_KIK3221	human
@pegs_cafe	org
@Afrolems	human
@veganmiam	org
@41111na	human
@vicmonfort	human
@Kort_Knee	human
@Afandy_Garcia	human
@MisterAgez	org
@supermiggy23	human
@thenosherievan	org
@brandonetyoung	human
@TomDrummond2	human
@gby_a	unknown
@Rezky_Ferdianx	human
@SohaKikano	human
@TRHadick	human
@taylorfckngang	unknown
@hayanoRailway98	human
@PoetaTurista	human
@capereycarlsbad	human
@theclaw956	org
@DrumAndMonkey	org
@nowod	human
@KirstenPlatto	human
@AdiLiciOus_Adi	human
@MICHAELJBOYLAN	human
@dianalimongi	human
@Chef_Ponderozae	org
@lysseeum	human
@MandiLizz	human
@24kt_	human
@kme243	org
@baison0103	human
@lenasupangkat	org
@angelac1313	human
@birdcagebelfast	org
@topmodels24	org
@Cyndy_Bush	human
@wurstsack	human
@PrinceMushashi	org
@dj_iWannaBeHer	human
@Hari_Qhuang	human
@xoxo11_asuka	human
@hearmylaughter	human
@lafashionicia	unknown
@YoonBeh	human
@groundsurround	human
@crishthin0708	human
@Romaine55	human
@mskrr1983	human
@thewaterway_	org
@ayk0828	human
@MaxFromKendall	human
@quadrophenia_4	human
@TygerArmy	human
@JoyYsf	unknown
@healthnuthannah	unknown
@figilav	org
@NatalieFegan	human
@_donnington	unknown
@mamuthainoodle	org
@nunibaby	human
@sendmeabc	human
@StrongroomBar	org
@galyettina	human
@aznsclboi	human
@MIZZ_IMPATIENT	human
@xoxoMrsMartinez	human
@TiffinsofCowes	org
@STEAKYY	human
@ariyaco	human
@PR_Palladium	org
@arief_exile	human
@Platefulofyum	human
@pedicablawyer	human
@TriposoSanFran	human
@Foster2Forever	human
@rgarrett333	human
@angeeliquesol	unknown
@SexySaintMike	unknown
@deniseperfect20	human
@UpAllNight157	human
@Cassandcamera	human
@stmarysinn	org
@CrunchyLatte	org
@MacaulaySq_SW4	org
@FireRunner2379	human
@AbrahamSoldier	org
@LouisSteven89	human
@Changing_News35	human
@AnchorDiglis	org
@fritesemp	org
@buhahogyjuqifi	unknown
@melissamai	human
@Cle_ann_	human
@BelindaChow	human
@PraveenSawh	human
@Hollie_Green	human
@Grace_Est	human
@Thats_Italian	human
@makeitbetterNS	org
@phnewfula	human
@thegibsonhotel	human
@HolyM2M1D	org
@chuckemorris	human
@bodBlast	human
@urbano32chester	org
@thebeatsalive	org
@Gibran_Studio	human
@tinascookings	human
@stephanienicole	human
@BXEnrique	human
@Pholocity	unknown
@GKCsSaladcc	human
@maricel_legaspi	unknown
@WeatherbyBill	org
@faasos	org
@AlinaKnoerzer	unknown
@fabulousWakako	human
@lauraalbouy	human
@iqmaljamil	human
@deegeemariegift	human
@hani_az	org
@LearnItalianWMe	human
@lasallehunk	human
@JRyan88	human
@frosted_fLAke	human
@CafeNarcissus	org
@ChefFiggs	human
@xxtin3	human
@Angeline1611	human
@wtonriddimz7	unknown
@TFIELDS013	human
@BernadetteGM	human
@Surich6Sj	unknown
@Haimin_00	human
@ling_lin86	org
@DonBrefo	human
@chrisstinew	human
@Pamis_Soy	human
@sewcreativeblog	human
@starfm101_5	org
@jkjuntaro	human
@kallimgmt	org
@GuidoGDamiani	human
@thewilmslovian	unknown
@gokokusushi	org
@WhatILikeAt	org
@_Shushy_	unknown
@chloecannon96	human
@KimberleeVDW	human
@angiisonfire	org
@ShrlyHtmn38	human
@PinkyBitchy	human
@TheFeverFever	human
@jarrettjennie	human
@paparazicirebon	unknown
@ccnamich	human
@Faraquel	human
@SalinetasHotDog	human
@womanmanyrole	human
@NoGarlicNoOnion	org
@lpe654	human
@POSTROADBISTRO	org
@Buticariu	human
@aecee151925	human
@DoItDallas	human
@MelhSokar	human
@My3LilKittens	human
@runloisrun	human
@dailybreakfast	human
@meikai_cl	human
@PremoGourmet	org
@joyly45	unknown
@WatershedATL	human
@Yvonne_Liaw96	human
@alicia_hq	human
@olimpiasoheve	human
@MICHAEL3JACOBSE	human
@SparkSunderland	org
@sandrascloset	human
@EmmaCHOUSSY	human
@HealthOrHighH2O	human
@hafsa_seddiqi	human
@dragonflyboo71	human
@PICKmeUPnapkins	org
@crazybdd	human
@morgiemayy	unknown
@W_Kaczmarek	human
@fathambur	human
@LivFragogo	unknown
@lauryndangelo	human
@vivianmacaron	human
@ChrisOlc	org
@funbites	org
@GR8socialmedia	org
@eltonhiew93	human
@mr_CHANdrue	unknown
@cocohealth_	unknown
@resmichelle	human
@danz_x	human
@La_Polenteria	org
@DevonshireSq	org
@jeprivalentino	human
@WorkoutPACT	human
@Fleetriver	human
@Bianca_LFT	human
@EnticinglyRich	human
@mbif	human
@Monmonlin	human
@KandaceHudspeth	human
@xingible	human
@1414stone	human
@chefausi	human
@BOT23791269	unknown
@teadoves	human
@FairchildElvia	org
@noorkim76	human
@HollowayNG	org
@MemoriesPink	human
@MrDeli	human
@newwestfoodie	human
@istvanv	human
@IndieGameDevBot	human
@Gen_Howard	human
@IAmMs_Bianca	unknown
@stykmn1	human
@PanambiStylist	org
@Jaw_Ari	human
@BishokuSushi	org
@rdib_kiko	human
@angelyanlai	human
@TheDarkGarden	human
@silvajaqueline	human
@Car__Dude	org
@ElMexicaliCafe	org
@TwistedMD	human
@sandyvball76	human
@TalkRadioTime	human
@ohnamaku	human
@Karri2688	human
@24hourbalance	human
@1Baina	unknown
@ComeToPapas	human
@WithLove_Sofia	human
@YummyHealthTips	org
@Changing_News38	human
@flower_model36	human
@syl0720	human
@go_jaxbeach	human
@Kbelleza	unknown
@AnnaAljuffrey	org
@yamachan360	org
@yuri_k144	human
@KrissKimberly	human
@Shop_Loop	unknown
@AlkalineDietUSA	human
@eatdrinkrally	human
@nikko_o1	human
@djRyC	human
@Adie_MathersIII	human
@AngelSeet	human
@Club31BaryResto	org
@RailtownCafe	org
@melahei67	human
@djsmooth212	human
@TheThriftanista	human
@MsWilliams1985	org
@ElisabettaS	human
@unclebhobs	human
@JTsGrilleBar	org
@GiftCardGranny	human
@KatchHQ	org
@MettleAustin	org
@CDGLeisure	human
@MsDessP	human
@JattuAnggraeni	human
@AOBMOB22	human
@CoachJMoore7	human
@MischaKaro	human
@Tandellaa_la	human
@MidlifeRoadTrip	org
@mllefutile	human
@JosephChan28	human
@RECOVERY_T	human
@IMeMay_SuriSum	human
@Janis11345	human
@SaintDenisHotel	org
@UpcountryBread	org
@iJasonYu	human
@CedraPharmacy	human
@BrittanyNestor2	unknown
@FastFooDeliverd	human
@vasprob	human
@CambsFineManPR	org
@FullGlitz	org
@Pastabarsicily	human
@HotInThisTrailr	human
@rookie_kitchen	org
@getfitwithmindy	human
@Manishka78	human
@cockentrice	org
@We_HaveItAll	human
@Manhattan76	org
@HisshoSushi	org
@nirwanabaligolf	org
@CarameloNYC	org
@drew_in_chicago	human
@fawssett_seldon	human
@cheftinaleigh	human
@mhrmzi	human
@maxxiedelu	human
@Ray_Ri_17	human
@ChipsSticksSW	unknown
@reggaehut	human
@ZizikisPlano	org
@viviankimL	human
@MejaKitchenBar	human
@Lass_breeze	human
@Rdeeyaz	human
@saarikko	human
@oyasuria	human
@pericannisaa	human
@alfani_chan	human
@SpringsCuisine	org
@Amar_K7170	unknown
@krao_indo	org
@nickxondbed	human
@missnettie	human
@ScotBloggers	org
@A___Zzz	human
@Bubblz_Gigglz	human
@PomodoroEast	org
@VnutV	human
@jennyzd	org
@Cristopher7650	human
@Mike_Khouryyy	human
@HectorRochas	human
@Tabard_Inn	org
@kevin_koerber	human
@speeroy	human
@TinaAdmave	human
@PrimoGCsStoon	org
@BrandonG__	human
@VerdieSchmitt	unknown
@watchdaddycook	org
@chefjohn_	unknown
@alecosimato	human
@IamMichelle5	human
@SCaroPR	human
@AlineOs_	human
@sweetsmellitigo	human
@shannonagain58	human
@corshacomo	human
@aLiTTle_art	human
@beattweeet	unknown
@BermCameraMode	human
@VinoTapa	org
@KatieSanchez758	human
@dariopastorelli	human
@David_O82	human
@StahlNicholas1	unknown
@ElenasFilipino	human
@ChrisJK88	human
@SkippyPixie	human
@KLATEN_KOTA	org
@itstoofragile	unknown
@imperialzodo	unknown
@YovaSianturi	org
@kevin_drumer2	human
@Hisandher7	org
@sirike_19	human
@sandzbalcta10	human
@FairyTalks	unknown
@AnnecyJ	human
@1682nyc	org
@ste80B	human
@sanurajamila	human
@beartiffy	human
@jun_lorenzo	human
@hatworkscafe	org
@JunChuah	org
@tasteofbelgium	org
@Cristina_Ash	human
@jepoysr	unknown
@norah_s	human
@LoveTMB	unknown
@eatwithjoe	human
@BrittanyAmberxo	human
@itsmeclover	org
@lemimochi	human
@nabillahnkh	human
@cafedeluxe	org
@bel837	unknown
@Padellinalovers	human
@EVazquezPerez	human
@e_eudya	org
@22June81	human
@LEstrada73	human
@HomesickMaami	unknown
@ashasbirmingham	org
@Roche_Bros	org
@LMB92	human
@phillyvegans	human
@richtysonROC	human
@ALPHARunning	human
@PastelesLaZarza	human
@Lisa_Marchbanks	human
@PulpHilliard	org
@deborahbrooks14	human
@blarneystonedot	human
@OxfordNightlfe	human
@RunningARagnar	human
@lysslisa	org
@ClubIndividual	human
@asterwinecanada	human
@JulianaCalloway	human
@TheUpSteps	org
@ASPEKTMENDOZA	human
@natGallmeier	human
@SherlockMac	human
@lau_femmeFATALE	human
@DatinIkin	unknown
@DESmondddLIM	human
@lucie_rigby	human
@triss84	human
@TopFlight_Kea	human
@ObertaOgden	human
@jeiyn	org
@mariayukari	human
@Applegate	org
@Makepalominha	human
@magasand1	org
@papergirl91	human
@VeveRacusor	human
@KruzinCuisine	human
@makeyourmeals	human
@HungryBawarchi	human
@Bank_Westmin	org
@mrstudiolondon	human
@Izzy2U_2004	unknown
@boundaryrd	org
@MMSimplyLife	human
@tatangarani	human
@JenniferSkin	human
@elclosetdegiu	human
@ema_kyk	unknown
@TommyTattz	human
@MakeUpRouge	human
@BrandStanis	unknown
@ENDIGORAE	human
@psphoto0	human
@geraldbatac	human
@Paparoxi	human
@WeAreBangalore	org
@IWFSAmericas	human
@spongebob_61094	org
@sanxiarenjia	unknown
@Portos	org
@jlynnart	unknown
@tore_nou	unknown
@cett0	unknown
@pizza_eater_	unknown
@selfcarebysuman	human
@mr_prosecco	human
@emilykayjones27	human
@marjangr	human
@I_Hate_Ewww	unknown
@inesbenfeitas	unknown
@babinkacake	human
@CalienteMexCrav	org
@gcharris910	unknown
@dbtsauce	human
@paresatbp	human
@VegasLimRoRo	human
@LoveMySilk	org
@SimpleLifeMom_K	org
@SarahsBlogOfFun	human
@ToshiyaFukuma	human
@itsjustDane	unknown
@PorioGM	human
@BiancaLawrence4	human
@AkiCherry417	human
@NewsChronicleUK	org
@beverlylkline	unknown
@DarioBarbero	org
@Zach_Coppola	human
@baldwincreek	org
@TheAndre_M	org
@misterpunx	human
@Adrianne_gee	human
@satheesen21	org
@BusyLilBeesNYC	human
@restocaptainb	org
@fashionindahat	human
@CarrieSimison	human
@Hilton_Col_Resi	org
@NVPINKY	human
@GABRIELGG12	human
@YourMediaCity	human
@MyaNov81	human
@breann55_breann	human
@roli_basa	human
@TheGrandTarabya	human
@Basiligo_UAE	human
@Ungkiat	human
@ChuckTownDaily	org
@CafeExpress	human
@harukyan0914	human
@RobinTweeted	human
@TeacherHelpForP	human
@iAmGolfy	human
@LyndsayBenson	org
@joelseahjh	human
@NeuvooHosSea	unknown
@miamtag	org
@ImTheRealCalvin	unknown
@Samantha_Zhi	human
@YinyuLim	org
@Iam_RatedR	human
@PANGJiiii	org
@StRegisAbuDhabi	human
@ThAnGMaYy	human
@aracelia49	human
@shockaco	unknown
@EAT_17	org
@fabiotelph	human
@OrSoSheSays	org
@blackstal1ion	human
@engrFernando	human
@verdugo29	human
@HeatherMischief	human
@BrunchMTL	human
@mycharmedmom	human
@0chiro	human
@StellaSanLF	human
@BobBakour	unknown
@winsktbk	human
@InnsideMCR	org
@IAmGramorous	human
@keyzjohn	human
@Katsuji_Miyake	human
@allomoncocooff	org
@MaestroPetrie	unknown
@Kwathlano	human
@o_seaman	human
@JanusEel	human
@StarletShay	human
@PriyaMahida	human
@Jepols	human
@Siki_Lou	org
@Dan0424	human
@FashionIsClassy	human
@MarthaVisser	human
@omelet_imbot	unknown
@TheRealKashMann	human
@Touch90	human
@eatinlimerick	org
@Fekiwaiki	human
@RebeccaRottman	human
@daw4888	human
@Prowler_666	human
@Marvel_Zhu	human
@WEARESpectaculr	org
@miss_chopchop	human
@antoskitchen	org
@jommnaja	human
@missmaggiek1	org
@omoshiro_cprCg	unknown
@ze11a	human
@TatiTotTot	org
@HashtagYummy	org
@JeSuisLeonardo	unknown
@4ChionMarketing	org
@Lenci79	human
@FlorenceandMary	human
@TravellingAdam	human
@PoeticMontana	human
@morphius501	human
@loco_st	human
@lazymeal	org
@slowstockholm	org
@ParveenJiterwal	unknown
@BrugesBrothers	org
@Mattcheung	human
@Neeka_Fedyshyn	org
@inMEDANcity_	human
@dashaBAZAAR_RU	human
@SandrBleihoefer	human
@THTchristina	human
@chinchin_8	human
@Claire_Burley	human
@jirafosauria	human
@ShaunaJoan	human
@CrowfootWine	org
@DennyHondo	human
@cono_sur	human
@OrDiNaRy_GuY13	human
@AnthonySellsMia	human
@HerbScissors	org
@TGIFDover	org
@saulscary84	human
@LupoVerdeDC	org
@TravelBitsBites	org
@PearlDiverTO	human
@tajlounge	human
@TeeTee0325	org
@AZDMC	human
@DanielaJLT	human
@rebeccarwells_r	unknown
@SuNtHeReS	unknown
@BBCCornwall	org
@CubixChess	human
@overricejkt	org
@BloomingBeets	org
@CDLFWorldFans	unknown
@PrettyGorgeousP	human
@TastyMditrraneo	org
@deborahggdavis	unknown
@NicoleSimone26	human
@thejuanmanila	org
@JayDukeBallard	org
@MayfairAsst	human
@naturalchow	human
@ItsMePuttie	human
@breakfast1015	human
@Ohlalalarcey	human
@actuallyclara	human
@sandra_lotti	org
@thechocojunkie	unknown
@onefitmom_	human
@aisaregohan	human
@tsuizui_geinou	human
@LauraNiivar	human
@romulus_nj	human
@Ridleyjing	human
@hondamana	human
@openingbell	human
@Gil6445	human
@MrMrsKutch	unknown
@TheBatKitchen	unknown
@PorksteakExpSTL	org
@travelabouts	human
@thisismeasht0n	org
@PrincessRiccia	human
@StaywithArmani	human
@phayyeo	human
@KucharzBogus	human
@Abibayio	human
@ammosnewyork	org
@TheVeganWeirdos	human
@richel_cole	unknown
@TemporaryWaffle	human
@wellmansrooftop	org
@villasordione	human
@Dynamite_Raven	human
@antonio_br1	human
@Wendy_Yan	human
@haponesagirl	org
@DelgadoGlennys	human
@marnimutrux	human
@italkmoms	human
@JEFF_LEISHMAN	human
@jasonlaminx	human
@YashasviK	human
@BluebellesCafe	org
@jeremyisdope	human
@androidomg	human
@moustachic	org
@AmaranthineMess	human
@lunchbreakgirls	org
@BuffAssPet	org
@LayLaMarLya	human
@GlitterMamaBlog	human
@DeryckMichael	human
@fruityouth	org
@FilmoreandUnion	org
@johnson_1119	human
@FatmaAhli1	human
@imarketsy	org
@Meryam03	unknown
@Deb_Lowther	human
@SixPackSisters	human
@SarahFOHTheDuck	human
@KohMr	unknown
@smokedonrose	human
@AnatolianGyro	human
@MKofsky	human
@R1_na	human
@Life_Style_Live	org
@hadj1888	human
@Hayatoisland	human
@jBlg1245	human
@tai_henkes	human
@BamfZombiSlayer	human
@TSKent87	human
@Aliii850	human
@fruccola	human
@SUPERADRIANME	human
@FoodieFare	org
@_AffluentEvents	unknown
@petsmine1988	org
@RaphVaz	human
@SloppyRabbit	unknown
@NoOrdinaryResor	human
@BonefishGrill	org
@nanastronauta	org
@sambrow11968109	human
@GregoryJPagano	human
@waltdeleon	human
@iFilipe76	human
@Loetjeaandekade	unknown
@LeeseysRawExp	human
@PeppersMarket	org
@sarahbettystyle	human
@zeppy_ironman	human
@ro9119	unknown
@tyiwhitcomb	org
@HopePeoples	human
@PrinceHotelKL	unknown
@Hollietabeta	human
@DariaBelka	human
@LaVerdadSuprema	unknown
@FitMeTraining	org
@IanGalaPH	human
@_thesumofus_	org
@DJ_2BoUnCe	human
@Luxeagogo	unknown
@lauraaimee	human
@soyu121114	human
@TravelsForAll	org
@Guiduz83	human
@Wolfgangssteak	org
@Bobo_Rainbow	human
@dukekenttoronto	human
@businesstradio	human
@xaviermah	human
@hellotombay	human
@SNC_Trini	human
@JAPCupcakes	human
@terencebob	human
@barbyang	human
@BooVay7	human
@iamjustlee	human
@AnBeautifulSoul	org
@dswaney	human
@deaw72	human
@zenzerella	human
@Matidamico	human
@BetweenHeels	unknown
@BOASteakhouse	human
@Thebestoffood	org
@Nayantweett	human
@prats_39	human
@tokoton10	human
@itsMeAngelaHana	human
@HenriCooiman	human
@JoeDiStefano	org
@shcreations	org
@Ameliegorgeous	human
@restoration_hk	org
@charlymodeuse	human
@KatVonTease420	human
@BigSquareKE	org
@Hypress	human
@biancalaurenmtl	unknown
@YJewelle	human
@mynameisalyson	human
@HillandBay	org
@achaimikan	human
@ttxxxttxxx	human
@VogueCharters	human
@sohofoodpark	human
@LoveSen	human
@BYT	org
@rock_kowgurl	human
@jonberrydesign	human
@TruveFit	human
@LustLocal	org
@ekowahyupranoto	human
@maiynm	unknown
@Frenchy_kitchen	unknown
@lilingkoh	human
@BridgeStGarage	human
@AlfValderrey	human
@AshleyKristineM	human
@im_monicarona	human
@virginiaetfost	human
@MichaelsPizzaMB	org
@OlivasSpring	unknown
@pendejitasxxx	unknown
@jade_jing	human
@cameraCHEYTV	human
@callmepk	human
@Wiillyaams	human
@MMGMOM3	human
@tgfcompany	org
@fareeda_drthib	human
@LeonJvanVuuren1	unknown
@CantonCathy	human
@chicityfoodie	human
@ModaMags	org
@MyHealthBuddy	human
@addsomebutter	human
@Fight4Success_	human
@knifeandtine	org
@wisdom5804	human
@ZSeb_	human
@MYdailyFREAKOUT	human
@FlYChiCkDoMo	unknown
@CurlyAndTwisted	human
@elruderudy	unknown
@Changing_News33	human
@DiningOutChi	org
@UKBlog_RT	human
@siyat	human
@keahangel	human
@cafebackyardpk	human
@Safiya_Queen	human
@Cora25901	human
@yogijax	human
@poisonsix9	human
@janicet	org
@laurasuetens	unknown
@itsmeciska	human
@muraken2cv	human
@SouperbLondon	org
@Mongyto	human
@colmirl	org
@TheGeriRichards	human
@SaikoKodey	human
@StaffMeal_R4D	org
@Christine_Liu	human
@ProvenancePots	human
@WomSanDiego	human
@NoviaVerde	human
@DDejmien	unknown
@MelissaKCraig	human
@_x_Cecil_x_	human
@MilestonesCamb	org
@lalicnutriana	human
@jesuisnegatif	human
@SvelteTweets	human
@MeinlamGraben	human
@CillasCooking	org
@persianhoney	human
@LantanaEC1	human
@Dessertnetwork	human
@meals_mayfair	org
@BenZenker	human
@RachelJYoon	human
@BreaDocDaughter	human
@Falmukhaizeem	human
@designerdiva93	human
@MelographyHQ	human
@kt3us	org
@Ke1thXXX	org
@HeatherMurphy89	human
@myfavoritesin1	human
@decoraddiction1	human
@ros_ngela	org
@deru_d_deriel	human
@ParentSpot	human
@WrittenbynickNL	human
@ManulifeCentre	human
@aomelette	human
@leziz91	org
@nigelskelchy	human
@susannawalks	human
@Eataly	org
@koersberichten	human
@elff73	human
@AngBitchKoNaman	unknown
@clubfashionista	human
@HP_Oliver	human
@DealOfTheDay06	human
@Prepkitchen	org
@TheRegentBalham	org
@_VictoriaPlace	org
@raisingwhasians	human
@jacksushiny	org
@subaholic_blog	org
@Alexmarkakis	human
@olivierbistrobk	org
@TanknChicca	human
@Sarahldngr	human
@FenFen_LiE	human
@dipeshsebastian	unknown
@KimLambada	human
@AtlasPubLeeds	org
@tinroofindy	human
@Bubbleboy77	org
@yah_villain	human
@stefhenry	org
@airliealexandra	human
@ROBERTJ_MALCOM	human
@deploeitcafe	org
@vivasosodreams	human
@_sin_sendai	unknown
@RiRiRozay	unknown
@palafoxhoteles	human
@Tina_choy	human
@DanStout2	org
@MJBisoux	human
@rudymkamal	human
@fishkuang	human
@noeldclopez	human
@FoodBlogJHB	org
@MODEmagazineLS	unknown
@MSovak	human
@newsinjapan	org
@ornansantana	human
@Me3ka_02	human
@SomaOrganicsAU	org
@purtybambi	human
@MarleneAbadine	human
@bacTremont	org
@VolterraBallard	org
@eatmogo	org
@iam_robot	human
@MissKryse	human
@kimchicult	human
@BautoinkZz	org
@ParentingBeyond	org
@lovesthedream	human
@TopgolfSAT	org
@KimBeachFit	human
@BankrollLife	org
@cravordeals	human
@smrsoundLOVE	unknown
@RejectedSnail	human
@tent0tentacle	human
@VillaflorG	unknown
@gooskigo	human
@tuckerdukesdfb	org
@unionstreetcafe	org
@MariolgaIzq	human
@Arnette196	human
@ogwyuk	human
@nuascannan	human
@jgaiety94	unknown
@bineSSG	human
@eyezapp	org
@AmplifySuccess	human
@OliviaRosaria	human
@LACrawl	org
@Sadaf492	human
@BrassTapTLH	org
@Bibsarelli	org
@adrianomeirinho	human
@Arrogant_Smoke	unknown
@CrunchiesFood	human
@popupbarbados	human
@wrapwithtiki	human
@Spectrumotion	human
@yuipyondevil	human
@carnets_aurelia	human
@cmfrtznpl	human
@gofusionngrill	org
@iLoveSkyye	human
@code_bleak	human
@Foxfieldinn	org
@authoress_cj	human
@GaltsGirl	human
@anniechang8877g	human
@AWelshBlog	unknown
@IntanMYV	human
@lovewinne1215	human
@DouglasWhitman1	unknown
@Kimberly_D_Cam	human
@RubbishWife	human
@danielleyaros	human
@WildwoodWhistlr	org
@HilmanMu	human
@ForsterCC	org
@GingerClaire_	human
@Tanikaze	human
@nihon9404	human
@jaysen_n	unknown
@indie_alltheway	unknown
@litlebitlonger	human
@chickie717	human
@ym_613	human
@Danine_Naidoo	org
@MARDI_A_BUCHAN	human
@ameagle357	human
@MadeByMeggs	org
@ChrystalClifton	human
@Miss_Angel_07	human
@EvanAnzalone	human
@SwissLybee	human
@Abbaye_Burgundy	human
@Savannah43123	human
@gelyza28	human
@Alena_Kasmynina	unknown
@CreativeMeInspi	org
@ranahkopi	human
@huukalovelybeby	human
@BourbonAndHoney	human
@Danster91	human
@hottwinkblog	org
@jeaninechoy	human
@CJ_I_AM_PNX81	human
@ANGELEateryInc	human
@RufusCarter	human
@jennoblekelly	human
@Wenona8790	human
@terramilo	human
@leaminami	human
@USAAFFamily	org
@SMontaperto	human
@TimLondonSET	human
@WayfareNola	org
@lillianchan	human
@AnneJames22	human
@MadeByBob	org
@NicolasROficial	human
@MeetaWFLH	human
@HuskAndHoneyLDN	org
@meerkatube	org
@GabrielRAMendes	human
@kieshasworld	unknown
@tintindelarosa	human
@SimplyGlutenFre	human
@i_chian	org
@ScrapnDesign	human
@lisadrewnutrish	human
@ardhietakie	human
@PlatinumP3	human
@KarenScottRadar	human
@lavalemakeup	human
@hoexianbin	human
@whatwereeating	human
@wiggles9	unknown
@siobhter	human
@Ayana_418	unknown
@adrenalynntoao	human
@tarentado	human
@dehesa88	human
@kerrytham	human
@Food_Stylist_	human
@Yana_Haleem	human
@mommy3sons	human
@DjFunkdafogs	human
@lucy_lorna	unknown
@ChefAssiaD	org
@KateKhagi	human
@OceanKeyResort	org
@HariHariCurry	org
@halihaliey	unknown
@paleo_zone	human
@TheStartupCook	human
@Angelodellas	human
@stefidragoi	human
@ssarbjit	human
@1NS1A	human
@iamjeromewong	human
@jjqb1	human
@atsuko1010	human
@LizaUtter	human
@LunchRD	unknown
@DOINME2K	human
@boyntoncafe	org
@pechluck	human
@Ground_Central	org
@SkyKat	human
@Claudie977	org
@ribbon_bear	org
@laurentguyot	org
@yamiiabdala	human
@atinylab	human
@itsmealexandra_	human
@BellemareJimmy	human
@karmaonmymind	org
@pfccoop	org
@tylerdoesntweet	human
@annie__maya	human
@TheDocketSTL	unknown
@_leahdavis	human
@parisanaderi	org
@mSKFlatwhite	unknown
@Marilynthechef	human
@miss_ntlantla	human
@SimpleSolutionD	org
@simonlovell87	human
@KBNNPR	org
@IndraPurnomo	human
@Lil_Rok_N_Rolla	human
@caviddesigns	human
@agoisfoto	human
@DukeGreenSW6	org
@Rush_MCINTOSH	org
@goldieknoxmusic	human
@jamiesarner	org
@AitorCarroza	human
@pure_win	human
@Denker420	org
@Danil_Liong	human
@Cluelessk	human
@GoGreenPeak	org
@villahobos	human
@TefalUK	org
@E__M__C	unknown
@IndigoKirRoyale	org
@AkkawiGroup	org
@culinaryconcret	org
@GeniusFoods	org
@FQchefess	human
@AGinChelsea	human
@JessBill97	human
@Ckfocus	human
@Tommy_Hampton	org
@SchoonoverAttwo	unknown
@VegLight	org
@anwarcatapang	org
@Rotana_Lebanon	human
@kyyjoyce	human
@Quimiccobonbon	human
@Teradji	unknown
@CrepesSTL	org
@KingthedarkDhn	human
@Moxies_official	org
@frogslop	human
@lacey_project	human
@elcampanano	human
@RMHSNJ	org
@naturcounselor	org
@sekoayumikan	human
@lovefoodies	org
@AndreaPM_Dhea	unknown
@ryuwulf	org
@Wit_my_Fit	human
@NRNonline	human
@leyla_ngokngek	human
@BettoCrugar	human
@ValeriaVllg	unknown
@FavorofGOD365	human
@marines1994	unknown
@wagokoroginsui	human
@MarkAgulto	human
@VelosoAntonette	human
@docesdavida	human
@Floridawell	org
@Bego_Watford	human
@Cookwithsally14	human
@LauraBoogers	human
@FatimaBanuABDUL	human
@emschuer	human
@9511yin	human
@Degani__	org
@4GlutenFreeFood	org
@MzGlitter1	human
@CalleTacos	org
@salanderian	unknown
@LenzCHU	human
@NYC_Nutrition	human
@oz__zone	human
@FlamelessCandl	human
@EleanorMayC	human
@TwoRuba	org
@VisitNorthHills	org
@VivereNewYork	human
@feelingupbeat	human
@seraphsam	human
@WildebeestYVR	org
@BocaitoCafe	org
@Mac_kenzieeme	unknown
@u_______co64	human
@CaroljpateJ	unknown
@DatDudeJuly	unknown
@ciel_pomme	human
@FuelFoodOliver	org
@RachatGautam	human
@i8fallingstars	unknown
@pfl90fatloss	unknown
@cooleygirl26	unknown
@Dretroit	unknown
@Dynasty_Dan	human
@LoreeLeiker353	human
@Cheeky_Burger	org
@eezs84	org
@Za_ZaRose	human
@PatrickARiviere	human
@skytao1	human
@bigbear1416	human
@DipologVibes	human
@johmag67	org
@SaucyPans	org
@laurentiu009	human
@tia_ras	human
@Iben_Elizabeth	human
@forand_j	unknown
@Donatella_Ac	human
@LuckyCristina	human
@Doubletall2006	human
@wbavin	human
@thita19	human
@Sokborey	human
@feliciaharefa	human
@tamadoca1	human
@thesnugware	org
@annewabeke	unknown
@BeirutiBrit	human
@SodexoYvonne	human
@Blkbeautyqueen5	human
@VdDlng	unknown
@BabetVerstappen	human
@bataco_828	human
@saltypigboston	org
@IwonaIwe	human
@YabstaCayman	human
@iksan_instagram	human
@Kaira9090	human
@pachecogap	human
@SilviaAlcarazSA	org
@granaio_	human
@cco___	human
@elenafarrar	org
@Mscakebaker	human
@rmacagnan	org
@mamamissblog	human
@rpjr7120	human
@ZeLyNn	human
@Siemper12	human
@Supacold24	org
@BlueDuckPhilly	human
@jackandlois1	human
@TSTConfection	unknown
@travelinease	human
@hotseleina	human
@WFMSouthGlenn	org
@HousewifeAD	human
@JantinhadeHoje	human
@Akansha_Gautam	org
@DeliciousLondon	human
@miss_tyny	org
@BustaCooogie	human
@mzpresumptuous	org
@reika2422121403	human
@yuka_watanabe	human
@lovelycindy7	human
@BlueKimble	human
@en2ym3	human
@mr_agathon	human
@ditchthe_carbs	org
@wilsonperez413	human
@burcuuincee	human
@Rusteia	human
@rawspicebar	org
@InstaAngarsk	human
@alittlegordie	human
@eathappyspizza	human
@Ravinath_	human
@lilysoutter	human
@CatDKnits	human
@MediaMaven_CN	human
@sqwiresstl	org
@BoyKrazyMommy	human
@AsiaGourmand	human
@GlutenFreeWoman	org
@jamalalun	human
@djilex	unknown
@4GirlGina	human
@princejofredr	unknown
@_bluegirlxo	human
@marz_shoes	human
@RafikaRahim	human
@SoHoWashDC	human
@TheWeirRooms	org
@Owenliziwen	human
@Francesca_Live	human
@Philomena797	human
@mrsmoneypenny1	human
@shannoncarino	human
@tomokoinade	human
@LilacCityMomma	org
@elly199703	human
@FoodFitandFam	human
@SumRaine	human
@allmiamiparties	org
@potinyan	human
@sapporo_cute	human
@buzzzz_off	org
@marteauyann	human
@WRResortCasino	org
@cristina_819	human
@jeromewongcj	human
@willgriesmer	human
@AmandasFonda	org
@PatrikSimpson	human
@SelectRegistry	org
@DaikiDeReiki	org
@izumizhou	human
@NickClaeboe	human
@Virginia_Delish	org
@TastingPage	human
@thecoffeejar	org
@rhum_31	human
@HappiLives	unknown
@MacJoFit	unknown
@EvaSanchez777	human
@_kolo	human
@NYCFrugalMama	human
@_healthylifesty	human
@MarieandMood	human
@empirebrew	human
@Neztto	human
@satrntgr	human
@Ushuaia_Steak	org
@savorysweeteats	human
@joanabbl	human
@nener86	human
@FabesFashion	human
@Carter_Biz_Dev	human
@diegooka	human
@AtDownUnder	human
@lazy_rieffe	human
@AdamCerny	human
@junko_dress	human
@AlbertMendonca	human
@iM2REALbiTxH	human
@WestinGurgaonND	org
@LOOKLIVELUXE	org
@Aya_latte	human
@007bambam	human
@Ina_macht_was	human
@maureencaught	human
@she_war	org
@p3ntuk	human
@ReshmyKurian	human
@milapohan	human
@2kanaers7	unknown
@StrategicSteph	human
@iBurp	human
@wangwinnyy	human
@srloetzerich	human
@HolidayInnMum	org
@rudnerbv	human
@ayano_jyj	human
@restomelrose	human
@BrooklandFinest	org
@Stickyribs1	org
@FradManagement	human
@tripsPARIS	org
@ecly5594	human
@sonething_news	human
@RT_Cancun	human
@RobinsSwtConfes	org
@RebecaBloomwood	unknown
@vicnorthbakes	org
@SoulSnakeX	human
@JenniferTourtay	human
@PamelaChuaaa	human
@ozarksentinel	org
@DesertChica	human
@Emmasalehouse	org
@missiecindz	human
@meals_camden	org
@CockSuckertje	human
@amuy0514	org
@ericamaspero	human
@luksembera	human
@SGCBus	org
@DehejiaMaat	human
@nicolamclarnon	human
@masterkeymma	human
@takuya_okmt	human
@BostonRedHat	org
@KimUlmanis	human
@dine909	org
@MissTroubleSin	human
@SMPiura	human
@DeWitsRijswijk	human
@yum110	org
@nourishschools	org
@xlelamaa	human
@PalomoBistro	org
@travel_foodie	human
@nbeluga	human
@playmatemariya	human
@azucena23	human
@ponytalesMD	org
@yehidi_lariza	unknown
@KinkStew	human
@Cooggie	org
@TheDanRojas	human
@Jyotirmoy_Roy01	unknown
@WorldWellnessUS	human
@cheayee	human
@Yudan333	human
@keikeiBECKS	human
@18th_November	human
@micPARRENO	human
@laurajane_001	unknown
@amynaree	human
@jnicreyes	human
@PavinciNJ	human
@fomalo	human
@letsgetfade	human
@kathylicious25	human
@pharr_away	human
@raspberryNrouge	human
@Geruichualain	human
@laurabelru	human
@chezpiggy	org
@SumoJapaneseSte	human
@3dietsonedinner	human
@cunhita24	human
@aleyaaaaaaaa	human
@iamkm06	human
@JenniferGreen0	human
@sabby1993	unknown
@r4fyS0t0	human
@x_mayuyu_x	human
@FinIzakaya	human
@Broham169	human
@DALELEDA	unknown
@Gayot_LV	org
@omoshiro_OfELe	unknown
@MeehOfficial	org
@RobertELeeHotel	human
@JBieberGram	human
@TobyAskerBrowne	org
@bccdny	human
@laurabeaney	human
@ArifDenkerdeck	human
@FABAlliance	human
@KeepUpJonesFami	human
@SmartBrainFeed	human
@blueheyji	human
@Chikkism	human
@AndreaZambranaR	human
@ghost_sightings	unknown
@b3nnyb3nnasi	human
@HamburgerHamlet	org
@lisbetheats	human
@e_phillimore	human
@Anna9187	human
@HappYKDorA	human
@IsaiahOs	human
@RubysDiary	human
@FortnerLayla	unknown
@fitnessmodelyes	unknown
@Berganza3	org
@MacMike1000	unknown
@HappyDaysSpain	human
@Its_kEzia04	human
@lorinmario	human
@meg_leonard_	human
@KevinFluchaire	human
@_gaffney_	human
@Jhonperezphoto	human
@smokesaltfire	org
@rochellemiko	human
@LaeshaTodd	human
@NutritionistJZ	human
@raymondtwit	human
@jamisonernest	human
@Lele_Hun	org
@UptownBred_PYT	unknown
@gritstyle	human
@heydeth	unknown
@cupidhasg0tagun	human
@miss_swanie	human
@quemeanswhat	human
@miica_ayumi	human
@niceunice	human
@NgocMathew923	human
@CAUBristol	org
@LivingSocialIE	org
@Aldonbedezz	human
@DiFioreCaffe	org
@HyeFarhanz	human
@littleredkitchn	human
@CcFoxx	human
@ansleywong	human
@hayden4561	unknown
@StGilesHotels	human
@Marshelaregina	human
@sherrid555	org
@karlaTHUG	unknown
@omoshiro_pEbko	unknown
@taxi_topper	human
@Rj_LivnHUEY	human
@SocialStepheny	human
@maura_iris	human
@CeeRoks	human
@DiandraPalancar	human
@queenofmercy58	human
@TrinitySofia	human
@Katerfrancers	human
@SimonkaBrabcova	human
@Talk_Vancouver	human
@TheDaintyPig	org
@BreadisEvil	unknown
@silviachen1225	human
@dnm_lv_dining	human
@ShirryTan	human
@LettuceLoveCafe	org
@LuciG88	human
@Tara_Polk	human
@genarogalindo	human
@LoboFellsPoint	human
@QueenMSheba	human
@AgnesJezebelle	unknown
@PattayaEmag	org
@cynthiajusdance	human
@MrJenize	human
@BiscuitsGravy	human
@lufudesign	human
@ALPHA_SHOT	human
@FoodDayCanada	org
@islands_club	human
@istao	human
@KTLovscocktails	human
@mRqWW7QvoFdyX7w	human
@BHG	org
@Hz0rockon	human
@Laikamari18	org
@cantinaomaha	org
@HrdzPaty	human
@DJSpecialBlend	org
@giveawayblast	unknown
@fukayaqui	human
@EagleEy71533045	org
@missemmamm	human
@getFoodida	org
@GeantOnlineUAE	human
@Ka_Rin24	human
@Toy_Slayer	org
@Dustyisawesome	human
@a_milyader_win	human
@CamilaFuentes65	human
@Lore_prd	unknown
@chodiz	human
@alilisa2	human
@arighttweet	human
@chictrendy1	unknown
@_CMPR	org
@Khizman	human
@MelanyPlatte	human
@AugBigHoss	human
@FitMumFormula	org
@13ezt	human
@katonahrr	org
@KateBriggs24	unknown
@boneats	human
@REBOhaiti	org
@andthatsmylunch	org
@jbbelga	human
@RossanaCondoleo	human
@LunchRulez	org
@Gayot_LA	org
@paleonomics	human
@Ramses_Hilton	org
@mickrdrz	org
@eveslife4	human
@TastiLee	org
@LuuCccaaA	human
@ChristineTopley	human
@TikaLPutri	human
@VegasTweetsInfo	org
@BTWestport	org
@mrevil310	org
@Aegyo_Prince_93	human
@BELCHITE_	human
@DamianAgrr	unknown
@drealjavimoreno	human
@TheBoysFarmers	org
@styleinlima	human
@maksum	human
@aririnn	human
@DanielSaidDias	human
@Eeyorenyk	human
@PrettyLilGrub	human
@Bradvice	human
@JudithLarry1	unknown
@pamellak13	org
@zuuru1	human
@tadeonia	human
@FarahDilaMiskam	human
@rocket_holborn	org
@TheUnknownChef	human
@Janesko	human
@ParagraphAddict	org
@flashfuture	human
@kamoterunner	human
@R3TRO709	human
@Bluuueyez	human
@SCadeaus	human
@JustaTraceBlog	human
@sartorialyogi	human
@OneMoreRepHQ	unknown
@InstagramMaui	org
@keancarmi	human
@tragweshili1984	unknown
@yangxtina	unknown
@MonahansAccount	human
@curly_gyrl_wa	unknown
@tirzaellenevita	human
@popuppulse	org
@Rocking_Virat	unknown
@catch_yuma	human
@wlfpack81	human
@killerhoneyb	human
@omoshiro_jhHnC	unknown
@HELENE_HERZ	human
@ClaudiaNjra	unknown
@PugliaSapori	human
@B_UtifulFighter	human
@3LeggedMare_AD	org
@EVSManagement	human
@QUEEN_PATRON	human
@SchwartzBros	org
@kiyori143	human
@KatherineKanter	human
@TMatozzo	human
@VinodNairHandle	human
@A_Boneva	human
@Zhenliang_Li	human
@CristiVillafane	human
@insauga	org
@Vinya85	org
@unio0611	human
@rickygal1	human
@cannolieastboca	org
@RnbowPlate	org
@dennytomodok	human
@nginfokuliner	human
@adun50	human
@arya_CG48	unknown
@consciouscookco	human
@hr_shapers	human
@MICHDYM	human
@yococco	org
@HolbrooksOville	org
@Cafecouture_au	human
@EatGuideCenOR	human
@Aaliyaheartbeat	human
@a62134394	unknown
@HeatherLynn626	human
@itworkstampa	human
@psdflyermarket	human
@VittoCasiraghi	human
@MissFancyBrown	human
@mameawwwww	human
@MarioMend87	org
@afoodgypsy	org
@joshspencer28	unknown
@JAMESGRANTPR	human
@louisesweeney_	human
@MathieuBekaert	org
@QuirkyBritches	human
@BrazziniElisa	human
@smallchun31	human
@MondayFundayRke	org
@ynatsumi15	human
@Bella_Marie_Vo	human
@MaryMelean	human
@garyCHEOK	human
@utuwatokurashi	human
@arzlie_alya	human
@verseatile	human
@CafeAdelaide	human
@MatthewTessnear	human
@AlondraIz76	human
@ladyveilchen	human
@RTpig	org
@CiteChicago	human
@Style_byChe	unknown
@strawbERIN22	human
@begildebo	human
@abanur1	human
@TingyN	unknown
@dunklee9420	unknown
@docethan101	unknown
@giftsbyruth	unknown
@vaneponce8	human
@criravaglia	human
@chakanattu_love	human
@petramonaco	human
@Janalia	org
@siMEOWako	org
@GingerHultinRD	human
@lharmonium	org
@GrandMillDubai	org
@Supershopgal	unknown
@choKathChic	org
@Beba_living	human
@AlejandroSR_	human
@ForestGrill	org
@sherwinspeak	human
@newpersonainfo	org
@ParmCrisp	org
@v_briner	unknown
@natalia22u	human
@FarahZRD	human
@TFIFLive	org
@c666s999	human
@cyndic88	human
@SailingSam_	org
@eiderfernandez	human
@decorhousefor	org
@SteFab85	unknown
@olee2730	human
@MissMarisa	human
@_jra86	human
@jalandanmakan	org
@AngelGz_	unknown
@SDRDorg	org
@LOVE_HATE6969	unknown
@fruit_shi	human
@TheOatberry	human
@WollenskysGrill	org
@ConchitaNYC	human
@DONTRIVINO	human
@NSFoodsMemo	org
@itsmebryan	human
@Joana_Rainbow	org
@KGentaur	unknown
@psycho_patic	human
@Ohana_305	org
@cherrylub	human
@Troy_Spro	human
@RobertWang_14	human
@Jess_Marie_MUA	human
@foodbyelenajo	unknown
@eduarVlz	unknown
@babysista	human
@AnnaemccordE	unknown
@KayeHolland	human
@lamodecnous	human
@mightyboba	org
@aconyan_nyah	human
@LittleLifeBox1	human
@keivitae	human
@londonsdinest	org
@DJTapside	human
@LorenPhoto	org
@JWKEagle	org
@013jada2	human
@africayoga	human
@Badboyzacclan1	human
@derenoshow	human
@alanacto2009	human
@ChristineBoegh	human
@quodavid	human
@KelliBrink	org
@NeuvooPTUS	org
@LaurieecooleyE	unknown
@lunapescada	human
@SofiaSoler7543	human
@PriscilaJrz	unknown
@Localbozo	human
@gollila26	human
@HonestlyFitness	org
@dcbonitachica	org
@carlolausin	human
@mmahmed54	human
@RakaRene	human
@0202Regina	human
@shatha_alshamsi	human
@EenhoornAfoort	human
@CanalStCard	org
@GippsWilliam	human
@cleveland_dixie	unknown
@ramzy1123	human
@nadirahmed	human
@MissLopez_x3	org
@jenjeniferjenny	human
@kevinhayes7	human
@Phunniie	human
@ScufflesLady	human
@sashayoga	human
@AmericanBite	human
@gerardomuns	human
@schweber_elisa	human
@baseblade	human
@MeredithDykstra	org
@sgrvrnk	human
@idamwolfe	unknown
@bolopromos	org
@LuceeLoves	human
@kwantalk	human
@KNOTtheEND	human
@IndependentBham	org
@ash_328	human
@pinzisan	human
@LesPommes_Milan	human
@O2_Brunch	human
@Ryosuke0811Sato	human
@kristykb1	unknown
@EldoradoKelowna	human
@AlmightyVortex	human
@llilyMonts	unknown
@DietExpertNJ	org
@EatMe77	human
@VrgaraGel	human
@DagmarBleasdale	human
@cremebalt	unknown
@ilike_rupert	human
@Christian_Cru2	human
@iamsuperjazzy	unknown
@RosemaryAkinola	human
@Invent619	human
@fado_ellen	human
@donmiguel8088	unknown
@GodalmingFood	org
@Vegascom	human
@thefoodhism	human
@MCLadyCAT	human
@PurejusKrIstal	human
@jayrayisthename	human
@amazingcooks	org
@jpierre00	org
@mzzazn	human
@NikkiMiller419	human
@BeingMrsBeer	human
@Crepesandco	org
@ehmcie	human
@DentonTrucks	org
@OldeTowneInn	org
@KARA_SMITH124	human
@imadiam	human
@Lrakike	human
@hannibaltabu	human
@devikakaran	human
@Meme30nSexy	human
@HARRY_BAIRD_	human
@CrownePlazaSD	org
@shahrel86	human
@JulianGonzo	human
@jahlovekotomi	human
@mero_hana	human
@tastyeating	human
@ADRIVTheGoGetta	human
@TheHedgehoghero	human
@briSTYLElistic	human
@ICParkLane	org
@supperUK	org
@carmenmg5	unknown
@adelia_555	human
@Lilphly	human
@Tanya8679	human
@TweetCanberra	org
@cmjones85	human
@Nadiienka	human
@manondave	human
@Benziie	org
@ciara_danella	human
@winetastetravel	org
@InstaYeysk	human
@luvcasablancas	human
@candykrutto	human
@HamptonDazeMag	org
@maannbarcebal	human
@Bespokeclimbing	human
@DnrioMndza	human
@Indie_Bell	human
@Randomthought18	human
@SaladKitchen126	org
@vasaadi	org
@curiouscarrot	unknown
@momluvannbas	human
@e4emagazine	human
@Timerdoro	human
@roexae	human
@SwankyRecipes	org
@rcchophouse	human
@Lluisatan	human
@thassianaves	human
@FashionMugging	human
@KimClar38530317	human
@mariafcuellar	human
@ParhanUmam	org
@Line00002525264	unknown
@FRBBQ	org
@AlexHPLai	human
@ricardosSR	org
@fitjust4you	human
@YuiRei	human
@hannah1249	human
@glitteryfridays	human
@HBBeansGreens1	human
@YourCouponConsu	org
@maryawerden	human
@fishybrasserie	org
@iAfRi	human
@Milagro_Cantina	org
@Une_Patate	org
@joanasnsn	human
@Sosua09	human
@rikahasriana	human
@TheyLovnDaBeard	human
@ArnoPrincestonP	human
@A1SH_	human
@WeHeartLiving	human
@nikki75	human
@donnagow	human
@JeeXiahtic	org
@TheReaLKENbasa	org
@naaomo	human
@Jimmy_Griggs	human
@LDP_Opond	unknown
@hondaiconbenz	human
@Indy4Lunch	org
@thecafe	human
@ShellyAceli	human
@johnnyrocketsrm	human
@Lachs1117	unknown
@csz97	unknown
@TamCowan	human
@phoebe_lie	human
@SparklyFaerie	human
@HansHaupt	org
@LauraFBenito	unknown
@omo_twii	unknown
@RelishBeeston	org
@JimsBCudahy	human
@Goldmember22	human
@elizabethekrue2	unknown
@TheFranklinInn	org
@NataliiaKarpenk	human
@graciawiharja	human
@novihaerunisa	human
@MillsBranding	human
@HotMamaNtheCity	human
@zack_lim	human
@Luckz713	human
@RavenMystique13	unknown
@oculz	human
@BritBeeby	human
@LakeLanierArea	org
@NaturesPathUK	human
@kaorutti_1103	human
@serenanenax	human
@GrandPavilion	org
@Yuki_Junno	human
@NOTEDplaces	org
@Heni_Tania	human
@FollowKotty	human
@Chitown_Ashley	org
@Luca_Doan	unknown
@_monique_brown_	human
@beckaboo22886	unknown
@AprilEvooGK	human
@adamparson	human
@GrowingUpKTot	human
@laurapr77	human
@desaivishal11	human
@MissBean101	unknown
@AMarkwart	human
@lovemademusic	human
@ApeyDL	human
@ThaMovement01	human
@CBBNBuzBuzzz	human
@Jzanjzan21	unknown
@aniabasak	human
@edysharmaine	human
@ChefKelvin	human
@babakml	human
@ginger_jar	org
@eaglesforjack	human
@Statue30	org
@AmaTraveler	human
@quirkyinspired	human
@DjSmokeJa	org
@dr_endorphin	human
@binhadhergroup	human
@carolinaclub	human
@ayumyummy	human
@beatricechowar1	unknown
@TheBYG	org
@DalrympleMrs	human
@coffeemkt	human
@CinthiaNegrete6	human
@6002theCeroro	human
@hbartdot	org
@JenMarrs	human
@JeslynWen	human
@LA_Promoter	org
@holandes212	human
@1023nowradio	org
@lissyM345	human
@buttaflymakeup	human
@IntertwinedKnit	human
@iloveleith	human
@J0AN7	human
@SassanoSax	human
@graceyinn	org
@RossGarga	org
@KatherineBaqleh	human
@BUMAiE	human
@vegaline73	human
@iareally	human
@tommynz_grigo	org
@Toshiofficial14	unknown
@4anappleaday	org
@thatsagoodtaste	human
@sorlo1	human
@ohsosocialmarbs	human
@nathanyoung86	human
@shemez_ana	human
@DayanaPina65	org
@kristinjflemin1	unknown
@SoyTuVitaminaA	human
@TarynCoxTheWife	human
@5and33	org
@ChooseesoohC	unknown
@ChordiemEvents	human
@baobaogeek	org
@mercaditoMIA	unknown
@juliaherself	human
@nicestaff	human
@EmilAntonios	human
@Tazziii	human
@Beacon_DriveIn	human
@judee_mai	human
@yellowashley24	human
@bluetheway_anna	human
@lindataylor79	human
@maangamo	human
@Swalpa_in	human
@KateDrakePR	human
@leehhom	human
@WaniWrites	org
@ParamountSouth	unknown
@Gelso80Federica	human
@SyafiqahHayati	human
@EkaLSwan	unknown
@AUSTRALIAERIC	human
@oebilgen	human
@s_wadge	human
@electricitylife	org
@TillerFlynn	unknown
@BabyE1849697	human
@VladaDonDada	human
@peteresse	human
@HiPhaedra	human
@BowtieBarrister	human
@mussyltd	human
@kateab	human
@applegurle	human
@lotus2525	human
@emixxxchanel	human
@TylerChow	human
@waitingbar	org
@organicrunmom	human
@SergioKonovaro	org
@olgawragland	unknown
@StuartMerrett84	human
@mrcfrenchfry	human
@igersterni	org
@ebooksm	human
@DunajskyPivovar	human
@esgehtlos1	human
@Deniztar	human
@ChefDaveHands	org
@TheVegHog	org
@ano_sinngekiga	unknown
@nikoteen87	human
@eravsorosoro64	unknown
@ChichaCanepa	human
@AisyahSinclair	human
@hashtagkillit	unknown
@MayraHuerta72	human
@thestylistaco	org
@TicketToMagic	org
@andy0727	human
@2bNikkiB	human
@immthirteen	human
@aitojyounetu	human
@kennethcruzz	human
@PandaInnPRG	org
@ANNARIKEblog	human
@TalleyNadine	unknown
@jasminesh28	human
@DaniellaVeras	human
@junqueiracacau	org
@sawchow	human
@mrpeachy85	human
@teresaettaylor	human
@monkeytreepro	org
@christinlovell	human
@IAmShaniNicole	human
@tseng80	unknown
@mnmtmr1126	unknown
@stewartleiwa	human
@PastryChfOnline	org
@iamAiniNordin	human
@fierrohotel	human
@terrifoxfitness	human
@onehandedcook	org
@sillyxtina	human
@IsaacHayes3	org
@askinnyunicorn	org
@selinbozkurt	human
@FoodieYoung	org
@TotnesWaterside	org
@JennyCastilloTV	unknown
@morphowings	human
@OysterShed	org
@BhattNaturally1	org
@Sara_bigworld	human
@manda155	human
@CatRoach	human
@viviank420	human
@RabatManzil	human
@Forensic_Lady22	human
@HannahHuke	human
@SharrrrryJ	human
@wild_leek	org
@NinaHordila	unknown
@mii_t04	human
@naomickey1204	human
@maru_0972	human
@luiz35nicot	unknown
@FXYMNX	human
@yazfes	human
@J_Wids	human
@allycialee_	unknown
@Candice_Becker	human
@johanikhlas	human
@La_TwiTwi	human
@HizamiLi	human
@yukkz2206	org
@The_Lady_Sybil	human
@TanneryMoira	org
@GrimmwayFarms	org
@jmaping	human
@Sofitel_Hamburg	org
@tylereightysix	org
@KarSue0322	human
@MartinRome92	human
@susanwebstersol	human
@honestandtruly	human
@janellelangford	human
@AdrianArnd	unknown
@rafified	human
@arnielcserato	human
@BistroUnion	org
@YuiYeah	human
@EziodOnghia	org
@jasontung	human
@rjmariano	human
@JakeAlbinson	human
@staceyzing	human
@Sophie_Nouveau	human
@kymmo88	org
@CafeForsters	unknown
@Erniechef	org
@chefmarymoran	human
@ulricawashienko	unknown
@BKsGrandmaPizza	org
@RossyBoop	human
@Mafuafashion	human
@dantus19	human
@kouda_kyoku	unknown
@saniasharie	human
@cecileasaka	human
@TMApublicity	org
@ryusite	human
@maialino_nyc	human
@IDavidC	human
@0fh2392978c	human
@Antology	human
@Fuyuchan	human
@UKMedixdotcom	org
@ss62263s	human
@Orange_Lantern	org
@Yukiko1823	human
@KeratonJakarta	human
@Kathneko	human
@FeliRodillas	human
@TridentHotels	org
@Cyrilmasterchef	human
@Nickygrand123	human
@darcibean	org
@jasminhalkic	human
@PreziosiFood	human
@edoody2011	human
@ITBGlobetrotter	human
@SavvyinSanFran	human
@janelleagito	human
@Club1Hotels	org
@Sophies_Store	human
@THETAFARI	org
@AnaBVAndrade	human
@gacikdesign	human
@richmondchamber	human
@ReaganITCDC	org
@NextLevelSup	org
@natyarlia10	human
@KittyBuick	human
@dilankeser	human
@1111Tony	human
@PatchworkMill	human
@yattamatta_	unknown
@beatrizscvieira	human
@charlottburdett	human
@MagnumBar_Rest	org
@altheahotel	org
@BaristaScones	org
@Mizuna91	human
@HimeHitsugaya	human
@jennschmidt6	human
@HanSumHustles	human
@jessica06627701	human
@areylyacosta	human
@noeales	human
@daboss27d	unknown
@EVOkitchenla	human
@TheHealthyMaven	human
@leighyamp	human
@GlocalWalk	human
@paulyt25	human
@AlTiramisu	org
@Markos_dp	human
