@MarkKalan	human
@nikoosh1	human
@KlonJawor	human
@9MainBakery	org
@kosherfoodies	org
@DWNTWNElPaso	human
@absolutViv	human
@aco_quite	human
@Corcoran_Group	unknown
@RLC_Band_Hawaii	human
@mstrooper08	org
@CatchaJob_au	org
@thisism3lly	org
@stanisadnanto	human
@MiamiSelfie	human
@ArdlyLufias	human
@Lea_Lteif	human
@TashanaKeinrat	human
@ZenBoxIzakaya	human
@denisnikulin	human
@sasoffer	human
@CommitteeRoom9	org
@akraboutique	human
@LatinoFoodie	org
@aokya__u8	human
@miamipicks	org
@ElePetrella	human
@sorairo_ramune	human
@Enjoylife234	human
@AntonSuhanton	human
@kwhiz84	human
@Electric_PSB	unknown
@atlantaselfie1	org
@mariajovy	unknown
@tylo7887	human
@LoveLivinAbroad	human
@CommishLAC	human
@alluringkate	human
@halo1expo	human
@OrganifiNow	org
@jac402_kl	human
@Leather_Lattes	human
@RubyTuesdays1	org
@SorianoPoore	unknown
@sarita_0327	human
@MiddahT	human
@LisseFalla	human
@ProductJunkieCA	human
@oakandalmond	org
@covfan1987	human
@n0ovia	org
@AnnJopb	human
@PrienceMoore	human
@cjmariano19	human
@AmbriBoards	org
@UMBELAS	org
@HazlanHamid	org
@MonteRegioJamon	human
@HyattTweets	org
@nur3	human
@FlikISDining	org
@AelitaLinc	human
@TallDrkHanSome	unknown
@eightflowers	human
@Ivyne16	human
@AmyYLee1	human
@niruhack	unknown
@tibob123	unknown
@emptyplateadv	org
@GeorgeStLive	org
@_ElGusano	org
@Sposini	human
@SouthonMainLR	human
@icar34U	human
@whitbywonderful	human
@chihiron99	human
@3ishbeirut	org
@celia_hish	human
@jodieh1131	human
@NYCTalkRadio	org
@RockinRobynsPDX	org
@PrettiMzY3lla	human
@GramAndDun	org
@BentoLunches	org
@TheLondonBeach	org
@Lemonsforlulu	human
@JesseCsincsak	human
@BolenBinkley	unknown
@adaywith_tia	human
@artfrommytable	human
@DKicksIII	org
@ShutTheFunkOff	human
@zara_zara101	human
@_Safoorah_	human
@Nikkibaa	human
@KemarBrown18	human
@REGspasiBAGUZ	human
@PressDublin	human
@charlottegrif16	human
@fitnesslover86	org
@tatuyawada07212	human
@BrownsMCR	org
@DJYURiA	human
@iamejaylee	unknown
@MarYeL_LaGmAn	org
@ehimeumarehime	human
@stryletz	human
@cutthecheeseTO	org
@angelus_0923	human
@PammieTeo	org
@PascalProyart	org
@LowCooking	org
@selectukradio	human
@thesweetthread	unknown
@Savagesalads	org
@Eso_Sy	human
@smartlyfe	org
@HotelSanBosco	human
@YusriAmry	human
@minimeeer	human
@AnomalousLondon	org
@Mandyth94	human
@monasharma181	unknown
@LIVESTRONG_COM	org
@abbydaray	human
@inselfie	unknown
@TI_Bethan	human
@MattRyanLee	human
@Paullopez76	human
@clabbergirl	org
@9174839194	human
@SabaF94	human
@paparazzidining	org
@WeAreUrbanista	human
@ChristysChomp	human
@KirstiItameri	human
@taradonnephoto	human
@pathavers	human
@meawcatty	human
@WomanTribune	human
@TheGastroNerd	org
@suzielarazak	human
@napoleonfishes	human
@sinnie620176	human
@ValkZwolle	org
@CityKitchenYSJ	org
@Ngaireb	human
@sijenbato	human
@roatanscenes	human
@shenaymcfadden	human
@coffee_fix	org
@minsangtae	unknown
@saraetbryant	org
@LansdowneClub	human
@chocomellymel	org
@tomikool	human
@spiceberrywales	org
@travel4foodfun	human
@ThereseKraemer	human
@LisaLatroisieme	human
@RoyerSuper	human
@oldsaltysglas	org
@EvelynLucinda	unknown
@sandraTj	human
@dafreckldfoodie	human
@cara_hara	unknown
@allyx	human
@SpiritofPhilly	org
@Anna_Chls	human
@morocochocolat	org
@FashionManiac2	org
@Fargo2001	human
@hilda_badai	human
@wcanty	human
@BeatriceLooi	human
@tastebudkings	human
@CClarke1968	human
@Midniteice	human
@selfmadenaldo	human
@JeaneSabo	unknown
@Maestro_liandy	human
@TheVGrille	unknown
@TheLustAngeles	human
@Shannon_Tripp	human
@PammieYeung	org
@Zatarains	org
@thisisFoo	human
@sosoblessed1	human
@docwinebar	human
@popcravings	unknown
@laurabagley4	human
@noJETLAGforFOOD	org
@CookeryIdeasUK	org
@jeremiah_dvorak	human
@Vega_Parongko	human
@malinfanworld	unknown
@PaleoLifestyle1	human
@VerdePGH	org
@shina_0128	unknown
@Bcartercom1	human
@boonishere	human
@erowarai	unknown
@clairesiris	human
@saracmartin	human
@RobertsTimmons	unknown
@AlaineRachel	human
@AdultCelebgate	org
@abhe_demonice	human
@RobsCfb	org
@AethelmaereMara	human
@BrasserieAzur	human
@shocond	human
@juliegohealthy	human
@Making_More	human
@okraworks	human
@Ostwestf4le	human
@Harold_Skimpole	human
@SAs_Finest	unknown
@AshleyRockel	human
@TheORFootman	org
@TheReclaimed	human
@eecrain	human
@121Legitimate	human
@lisagcooks	human
@colmadocoffee	human
@CeilidhsPub	org
@UkPowerhour	org
@emily_mummy	human
@ant_kneee	human
@HilarySinger	human
@Leon_1314	human
@camilea7	human
@SportsManiac93	human
@EuTenhoVisto_	human
@RedRockNoodles	human
@TheGiveawayBot	unknown
@barbie_dc	human
@jaydestro	human
@steph8798	human
@Natadi24	org
@rodg303	org
@bitterchickey	human
@RonneDay	human
@thepantrycafe	human
@yourdailycare	human
@iamcrichelle	org
@__Tete___	human
@MeatlessMonday	human
@HotelWinway	human
@Autumn__82	human
@olive_sasha	human
@pimpLBC	human
@ColatteCafe	org
@FormanandField	org
@orion____	human
@FriendsOfFF	org
@Evariopinta	human
@EdenResort	org
@charferg	human
@anais_platt	human
@aki_m0816	human
@FishHouseSP	unknown
@JTheAngel	human
@sinseeho	org
@NoodleMadness	human
@Jenn_Davila	human
@sainsburys	org
@Crybabycafe	org
@pdxpedpow	org
@SocCircDate	unknown
@NYTrendyMoms	human
@OlivarezForte	unknown
@MeghanTelpner	human
@Alexa_Curtis	human
@LittleTownNYNJ	unknown
@PatxisPizza	org
@blueyedblonde32	human
@adhine18	human
@bot35033117	unknown
@SpoonAndSeed	org
@ultimateiceman	human
@Ggstarr	human
@BradberryAlexa	unknown
@FeelXmusic	org
@nikaromanko	unknown
@EuriskaIndia	org
@HealthyDiva31	unknown
@Gift_R_Meets	human
@chefmattmoran	org
@reginaldithel	human
@JacksonPackz	unknown
@megukokoa	human
@CrossFitClubs	human
@erinatomy	human
@x_Margarida	human
@DeniseInAsia	unknown
@ChiaraMaci	org
@ImagewearPromos	org
@Tiesjah	org
@Sugartownblog	human
@KutaConcierge	org
@EatRealLiveWell	human
@Fridgecheck	org
@yy_chow	human
@MyTimHortons	org
@Nakhrewalli	human
@dolcevita13210	org
@JohnnieMaeBrown	human
@healthrd	human
@ShaferBird	human
@porci_atteh	human
@Wilson_Daniella	human
@Ethan_chuchu	human
@SnapShotNinja	human
@TheWilliamTyler	human
@uncleJAFO	human
@DJDickNickson	human
@cherology	human
@MuslimaWellness	unknown
@FiolaMareDC	org
@AlexiBridal	org
@iLovetheBurg	human
@kristenduke7	org
@MaxGeorgeTeam	human
@shinythoughts	human
@GonerillaAecce	human
@bv12tonya0216	human
@BiancaatDelano	human
@iGold2_0	unknown
@khawaja_sameen	human
@KanoelaniLopez	human
@entertainista	human
@tn_WineDrinks	unknown
@RamonaHilton	human
@blackrayne13	human
@LovinDublin	org
@LittleThingsMom	human
@BagelmanBTN	org
@AvalancheRest	unknown
@Roseandsons	human
@dirtygertywins	human
@WineRestaurants	org
@indoorcafe	human
@WaiYis	human
@Amanda_Kruse	human
@BelleLaLuna	human
@PauleBani	human
@spshoo	human
@redsdiner	human
@zombyradio	unknown
@oNlHs_K	human
@HelloTBay	org
@alecho	human
@tock_3	human
@T4TPascal	org
@dukescoffeeco	org
@LUZ_Guerras	org
@fenwickmuse	unknown
@CliffsEdgeLA	org
@cristaluth	human
@DeannaHerbalife	human
@katrsingh	human
@sweetP4yol	human
@RoyalIndiaVegas	org
@GiovanniMamaBoy	unknown
@stenoodie	human
@peoplefw	human
@cfasmithfield	org
@Pattersons_Cafe	human
@TYTHEARTIST	human
@McgriffMenard	unknown
@KCCardani	human
@homedesignfreak	human
@net_nvp	human
@AlexApostolov	human
@Indahvillas	org
@TheRealMichealB	human
@spunktitud3	human
@PhilippSchiwek	human
@LaFournoSouthSt	org
@NancyArsenaul	human
@Joey_Eggs	human
@nataliee_r91	human
@tommykswg	org
@Tanku89	unknown
@judy1sn9	human
@FedericoChiM	org
@digital_helmet	human
@FueledXRunning	human
@turflounge	unknown
@RestoGB_at_TG	org
@FENIXsupperclub	org
@sideofcoffee	human
@tiertakasirin	unknown
@pame_gonzal	org
@freshandco	org
@bshocktw	org
@ILVOLOMIAMI	org
@claaa_M	unknown
@DivasKWT	org
@RacheaLJinG	human
@MookTheGreek	human
@stephalex777	human
@gretadibello	human
@nata_hernadez	unknown
@bluemoney2020	human
@janejieying	human
@eringailsays	human
@Alex_Lysenko	human
@wnclifestyles	human
@dontcallmekatie	human
@DietBailey	org
@CuddleFairy	human
@MissBrownsWpg	org
@KellyAnnePeters	human
@ShenminQuah	human
@keunnara	human
@Shonette	human
@kappyrocks1221	human
@castellosocial	org
@PrinceAybreezie	human
@WANYI_2	human
@LaPernella	org
@AaliyahJane1	human
@workbeckmedia	unknown
@iheartveggies	human
@VancouverPicks	org
@fnkasian	human
@swoletron	human
@honeygirl_honi	human
@acrepairlittle	human
@TheWharfSeafood	org
@HedonistChef	human
@mrsmckenzie55	unknown
@MarizonRicheson	human
@OneVeronique	human
@NotQuiteNigella	human
@teporingo	human
@dzailin_dz	human
@barbz_chin	human
@_Fundraisers	org
@LAIWONDERLAND	org
@Nelsonali	human
@CoForm_Cyprus	unknown
@tynnsalvador	human
@mai_cuisine	human
@mhe_ann04	human
@SOURCEBattersea	org
@PinkWhen	human
@WRDiningGuide	org
@sahilk	human
@jana_var	human
@GatherBoston	org
@SweetZsemy	human
@CaitiesCooking	human
@JessieTrinchard	human
@Chill05	human
@rikoyama	human
@YoSoyDF	human
@Letitia142	human
@BestOfCali	org
@TheSweetChick1	human
@InterConGeneva	org
@LisaOree	human
@mpags2001	human
@FightForYrWrite	human
@MalithPriyanka1	unknown
@robiian	human
@TheDollieHouse	human
@bukitbiz	unknown
@ConanFoods	org
@FrontierChicago	org
@AnyaPFDC	human
@edlockejr	human
@kellymackinnon2	human
@cookingfiesta1	org
@ourhenhouse	human
@DeevanaPlazaPKT	human
@iYubk	human
@Miya__Wu	human
@ShadowsOnMe	human
@colonykits	org
@chikalimm	human
@Mangia_Mamma	human
@welovecleanfood	human
@blueringsnow	human
@TheParlourWB	human
@PinoDiLotoSyros	org
@junteh038	human
@juli_hztn	human
@Monkey_Osaru	human
@PrincessJeuno	org
@greenurlifenow	human
@ZGrille	org
@chikay_imnida	unknown
@kyokora1219	human
@tacolicious	org
@MommyJenna	human
@CrunchyCreamySw	human
@RWEMY	human
@AlexandraRsdo	human
@WFMOlathe	org
@eter69nity	human
@GillAriana1	unknown
@LaLoggiaSC	org
@mathiverse	human
@g_chlo	org
@BernmeisterRL	human
@TaurisDigital	human
@DocsMoosic	human
@maumak	org
@DineRnchoMirage	org
@gaythri	org
@H2OxFreeWillyx	org
@La_Hustla_	unknown
@reika_1216	human
@QuiBelleSLK	human
@teamveggieblog	human
@everythingjenny	human
@adonenazareth	human
@sambreckenridge	org
@missannmai	unknown
@stitched_ich	human
@Pena_sahara	unknown
@adragon	human
@EnigmaSexual	unknown
@VCarranza	human
@AlwaysBlue1	human
@AustinJava	org
@Hejer_Krichene	human
@c_ramont	org
@KammsRedLantern	org
@havetolovecom	human
@Arriola_misha	human
@farmerbrownsdub	human
@Miss_GraceAlana	human
@JaredDeill	human
@CozyCornerPA	org
@LiLy4na	human
@daisy23_miu	human
@snackingbird	org
@JasurKayumov	unknown
@Bistro_Becs	human
@thegabenriquez	human
@Tastefulventure	human
@amuseyrbouche	org
@hsingermth	unknown
@elaine_tin	human
@NicoleRbld	human
@BlackBearPromos	org
@jrsteffes	human
@latoyashauntay	human
@CarlaMorrison	human
@ihasblog	human
@PreciousMuir	human
@Pistachioedcook	human
@ItsSimplySharon	unknown
@VPSTEAK	org
@sofiaorden	human
@simeonkherring	human
@semraaltay	human
@AMONT_J	human
@PeCuliAr_HiPPie	org
@fritzbarleta	human
@fingerfoodism	org
@Xaviersalinas1	human
@kyradevreeze	human
@WearewaterlooUK	human
@princeregentw1	org
@EBurgerBahrain	org
@greco_james	human
@92Uta	human
@lemonandolives	org
@zoe_89_	unknown
@MonkeyUp2NoGood	human
@jorgejr514	unknown
@dianne_1881	human
@wolverinefatik	human
@ElNidoArtcafe	org
@justmeolga	human
@Lanyiling	org
@RichSwagg	human
@CnR_Pub	org
@fabulousport	human
@HerrChew	human
@Mlle_danajose	unknown
@Vernon_J_	human
@Lord_comic	org
@okelleyt	human
@nurse_mumu	unknown
@jjklee	human
@SecretsLong108	human
@RobyBenatello	human
@engku_mal	human
@imymuhamad	human
@MassalaCafe	human
@southerngal_504	human
@Cheirly96	human
@JenniferSzaflik	human
@Devyltears	human
@GERARDOLALOVERA	human
@RedStripeRocco	human
@SaraSantos2	human
@DANIEL__I__BUM	human
@XenophilyCafe	human
@keikoworld	human
@HongShiJie	human
@HJAhere	human
@AlphaAvery	human
@IrishBistro	org
@Billrossfit	human
@yenikoyyelken	human
@beautyormadness	org
@neat_island	unknown
@klebertt	human
@E_Freeds	org
@Indulgenewyork	org
@BodasconLove	human
@KevinsHotDogs	human
@gustobelan	human
@mpatricia62	human
@JCash870	human
@FoodFlicker	org
@lil_finger	human
@SLPARRY	org
@MAMO_NYC	org
@stevesy710	org
@lala_merilla	human
@KBModel	unknown
@Fmyvon	org
@Downtown_London	org
@JustMissAsh	human
@Vanilla_Beaniee	human
@BortElea	human
@Pepitabymic	human
@jalsohafy	human
@DanDiegos	org
@nevsasaurehp	unknown
@artistresidence	human
@livivian	human
@ThePigGuide	org
@Camper____	human
@AnthoPoirier	unknown
@amysolomonradio	unknown
@ebouns	human
@thepierrebear	human
@FKEssentials	human
@Wee_Watch	human
@kuuma150	human
@delish_thoughts	org
@yumyum_5	org
@YogurtEveryDay	human
@Kookiesandbooks	human
@RateMyBarber	human
@risawat	human
@PulseOS	human
@ElleSvelte_	unknown
@L0G0F0SH0	human
@williechan	org
@MaryThiede	human
@MoniquinSpeaks	human
@MeiChen512	human
@wkn20wkn	unknown
@Cheap__Geek	human
@danbrofitness	human
@ankur2g	human
@pacificstarguam	human
@Bhakhawanate	unknown
@Wholefoodviv	org
@nancimardina	org
@yogajoy11	org
@AerionMildryd	human
@WelchsRD	org
@audas_vanschoor	human
@OttawaVeggieRT	human
@passion4eating	human
@iheartblackoffi	human
@CCristine87	human
@Heero900330	human
@Ricettepercaso	human
@HikeOurPlanet	human
@paulyc87	human
@RLB2ESQ	human
@subtleassphinx	unknown
@TattooedTruffle	human
@ifyouseekmatty	human
@AuthorJude_O	human
@lolaartesanal	human
@dogsndough	org
@3FE	human
@Anonymousmich	human
@oceallaigh_	org
@achteraan	human
@RockMe_IlVolo	org
@TalkeeSociety	org
@eathardworkhard	human
@_SDP_	human
@davidbcrowley	human
@Se7eNRamieL	human
@Oda_linaress	human
@summerhousenb	org
@livnall4him	human
@Pinktrotters	human
@emywinchester	human
@AuthorBeeFavs	human
@SeanCaskie	human
@PedalBackCafe	human
@IntoTheFoldBlog	unknown
@LCAMediaCity	human
@PicnicCafe	org
@pedro_nieto_93	human
@Seraphimslair	human
@claregravolet	human
@leroe24fotos	human
@midlandshonda	org
@RunSoulCycle	org
@PeteOlsen	human
@MyWorldSimplifi	human
@JennParkerson	human
@BeyondFitUK	unknown
@jofryzgood	human
@claytownbones	human
@Stacywalfred	human
@sifupudding	unknown
@SardegnaInBlu	human
@sxsweats	human
@PrimalBliss	human
@sandigtweets	human
@paleocavediet	human
@IcemoonShop	human
@Injilaaa	human
@EggsFrankfort	org
@GrdSinem	human
@Ran_Ringo	human
@febasa77	org
@ElChinoLimYueng	org
@topofmytodo	human
@b_lavonda	org
@agiefan	human
@bentossusa	org
@uniqueradio	human
@DUnityTeam	human
@UpOutNYC	org
@cecilyfhart	human
@mf_cesca	human
@TriStreetEats	org
@ILikeLosCabos	human
@zsiti	human
@EldridRhys	human
@TheBurgerLabLv	org
@PVitoriaRegia	human
@DavidQuickBooks	human
@KateJurosz	human
@Dreamer_Vikrant	human
@veganbristol	human
@cafehabana	org
@dhwang80	org
@blk80c	unknown
@shivzi	org
@PelmeniToGo	org
@MilfordGreenPiz	org
@TrukSquad	org
@ataltawel	org
@FNBOmaha	org
@tamiinu_x	unknown
@thienkim	human
@sushi_imbot	human
@natashaeve_	human
@lbuchnik	human
@WildLife25	org
@fff_flourish	unknown
@DietHealth	org
@Vitamix	org
@hershey_goddess	human
@TheHiatusDelhi	human
@akb_gazoukann	unknown
@EDDmpls	org
@EpicureanEvent	org
@PetalsTable	human
@fboitalia1	org
@_TDUB_	human
@smskskr	unknown
@NisaOsh	human
@DocMagilligan	org
@LudashAnn	human
@marianthefoodie	unknown
@LazyPippi	human
@GoodThingsUK	org
@buesposito	human
@pretty_amyy	unknown
@AletrAmp	human
@Hyaccajp	unknown
@MilQueensway	human
@PassionIbiza	human
@MarvelasMary	unknown
@LuiFregoso	human
@qinxiesays	org
@TysonFoods	org
@YolentaVinindra	human
@abecbebec	human
@tanyacelik	unknown
@Elena_Edwards	human
@unice_yen	human
@PRINCEOFPATRICK	human
@lapostreria77	human
@fedeverasai	human
@lilyu31	human
@steinerspublv	org
@BeefcakeOrtizA	human
@crocsinia	human
@ItsElisaB	unknown
@southliveyankee	human
@MediaRotana	org
@BertramStalling	unknown
@chang_edison	human
@Diethood	human
@chikaberry0611	human
@MarkMamonII	human
@zoo_kazuma	human
@Miss_Nikkou	human
@hquaroui	human
@FoodLovesLondon	human
@legrosgarcon	org
@rakudo_okada	human
@deliverytogo	unknown
@RBishopsgate	org
@ClaCamillo	human
@riskasulaiman	human
@IAmShanCreary	unknown
@DealOfTheDay54	human
@Mapfarer	human
@baliw2eat	org
@LunaLunaFace	human
@foxaddicted	human
@ikatie27	human
@JulieBear328	human
@MIXITca	org
@shanghaijacky	human
@tksnt6	human
@riadermawan	human
@TesHomewarming	org
@MyMinions_Here	unknown
@hiroroyo	human
@FoodCentrumID	human
@thissnthatt	unknown
@aPieceOfMyk	human
@nyanchika63	unknown
@TNyceTheKid	human
@SoFabfood	org
@AnthonyOvalle	human
@vrundavs	human
@Michelle_Perez9	human
@nabeelkahn	human
@PSG1968	human
@_JoeyChan	human
@riexu	human
@pangasuki	human
@angeladenittis	human
@lovei1986	human
@SunsetGrillBran	org
@sharonablett	human
@BCpostergirl	human
@Honest_Pizza_Co	org
@AngelaThai808	human
@Touchanon	unknown
@Sk8TheGr8	human
@KeepItLocalOK	org
@mdleanne	human
@cloverBLV	human
@EatingWithErica	human
@eatzcateringco	human
@slugcanary	org
@MsHaniaK	unknown
@topnotchblog	org
@TheDublinDaily	human
@helenn315	human
@elen_tex_gomez	human
@tgistanbul	human
@PieknoscDnia	human
@jannylim_	human
@NYC_BrunchBabes	org
@luke_037	human
@HeroBurgers	org
@naturmend	human
@ShuckerPaddy	human
@krakhen	human
@jaynewu	human
@hungryfashion	org
@PostalBarbecue	org
@taichi25740334	human
@CosyClubBristol	org
@AliciaSler	unknown
@BeelaBakes	human
@InstaDpils	human
@thetastechase	org
@B_Restaurants	org
@marysal_Mendez	human
@PJGurganus	human
@heinzter	human
@ertmsy	human
@YNJIRO	org
@INFANTE_Larisa	human
@ma31richard	unknown
@imeemeg_04	human
@WyIfrid	human
@cybatar_za	unknown
@stayfit89	human
@canadianliving	human
@Meychecicilia	human
@zm_lost	human
@SandrineDavies	human
@t0nichi	human
@bebeLiebe	human
@N_Djuric	human
@PutneyCanteen	org
@dlgcdamla	unknown
@CHAKA_Kwangmi	human
@coalgrillandbar	org
@ndapuv	org
@BillyKayMusic	human
@YFPrograms	org
@ErikaBosticco	human
@haniekunie	human
@sellcop	org
@justpostitSI	unknown
@GarcesGroup	org
@chefsharwin	org
@HadyElHady93	org
@SacE4LDeals	org
@HormelFoods	org
@luvsashimi	human
@OliveBistroPune	human
@Danica_ipnp	unknown
@diiimples	org
@pamm_bass	human
@Carlos0rtega	human
@phychole	human
@ChiaraParini	org
@TDot_mike	human
@Foodielennial	human
@BrownCavegirl	human
@theblendergirl	human
@llhawaii	human
@Vasan_88	human
@Shawermatac	human
@Budare_Bistro	human
@iamderrickstwtr	human
@500brunches	human
@Dublin__Fashion	org
@Restaurant_com	org
@fairmontEPIC	org
@Tomomi__Koja	human
@liran__21	unknown
@stilettoDISTRCT	org
@kdougiie	human
@wepopop	human
@1313Fran	human
@RitaBakez	human
@packaged_facts	human
@Kkigar	human
@jneilson42	org
@cheryljooron	human
@SasedgeDABears	human
@LaGloutonnerie	org
@onedaycart	human
@GabrielCordobaA	human
@gnomeMY	human
@chrisramento	human
@JohannPerry	human
@thedansalem	human
@SWholesomeLA	org
@Thebestofpron	org
@TakanamiIC	org
@diesegame	human
@Ln_star_fitness	human
@peterallenh	human
@marcelahdf	human
@fauxfoodiegirl	human
@Yanlita_Intan	org
@Sally_Ann_Melia	human
@PonderosaMeats	org
@aunewse	human
@ira_dungan	human
@XO_umi	org
@edibletcetera	human
@DisArnold	human
@snapsanmateo	human
@LamborghiniRD	org
@JnnnLdsm025	human
@Pameliadudder	human
@xyinle	human
@colione209	human
@chilliandmint	human
@jasminevmills	human
@ryanisc	human
@linkjuice35	human
@Joeylovestoeat	human
@intanalwi	human
@blackoakomaha	org
@FrancescaEdesia	human
@mediamarmalade	human
@MillerJodie	human
@AnnaSwop	human
@HerreraChris	org
@Indian_Recipess	org
@chereviews	human
@Humane_Human	unknown
@romlk04	org
@HelenAgresti	human
@1151COAST	human
@gourmet_gwen	human
@Kasandrinos	org
@F4MChicagoWest	org
@elbo_bo	human
@t0n33	human
@dolphinyeo	human
@VampsRetweet	human
@ricorobles	human
@GabrielaTio	human
@fedeprincy	human
@wmekloy	human
@TbedsHotels	org
@mekhelle	human
@EkinY	org
@yujirowinnipeg	org
@annapolis28	human
@nohaehamid	human
@CafeSoleilDC	org
@Vickis_Beauty	human
@topeycalangi	human
@MuffulettaCafe	org
@KildaresNEWARK	unknown
@stevens_cindy	human
@queenstownph	human
@isabellawongsw	human
@princessantou	unknown
@bigbookslut	unknown
@LeanneMirrey	human
@HouseWifeLahori	human
@yasminda8	unknown
@MrFish_UK	org
@SweetGirl93	human
@CopperwoodTav	org
@SparkInVictoria	human
@XtinaRoX69	human
@59cola	human
@Koshi_Ann	human
@CarlosVga_	unknown
@commodocafe	human
@twrararu	human
@_jaredwong	human
@gaydaysLA	org
@Mad3_in_Kor3a	unknown
@tweetyardy	unknown
@JPCGrandPP	human
@moonseon0221	human
@iFiFa2014	unknown
@AmandaSirr	human
@OscarWilton	org
@valtterieroma	human
@DiditIskandar	human
@VirtualWorldLyn	org
@mperkins37	human
@CandypantsLeeds	human
@bootys	org
@Liveport	human
@SarahWhackU	human
@MemoPtacnik	org
@JimenaSln	human
@peterhandzus	human
@KitchenDaily	human
@ziehoo	human
@varreaza	human
@princessglammy	human
@seboocheflife	human
@thewinecoach	org
@ThriftyCook	org
@cma0425	org
@KeyKeyBoomBoom	org
@TORsAdventures	human
@VirNotStranger	human
@abigail_masuda	unknown
@pacita_diamond	human
@reenfernanda	human
@MYCOLCHAUNCEY	unknown
@GrinsePobacke	human
@wiLDyWijaya	human
@500Cucina	org
@alldailyvideos	human
@spatulasonparad	human
@CulinaryCater	org
@InnatStratford	org
@HealthEssence1	org
@AnneCanCook	human
@ReganJonesRD	human
@CaptainMelville	human
@TheAppleStore1	org
@Dinnersdishes	org
@veganhoneyoc	human
@YenJasoen	human
@ikeadecora	org
@anitayxo	human
@justin_pl	human
@JPAbstractArt	human
@agnescpm	human
@1pmlunch	org
@FoodiePhysician	human
@bnweiss	org
@craftymama087	human
@nicsnutrition	human
@AprilGreaves	human
@RusticaPhilly	org
@MichelBrunet72	human
@MentalityMag	human
@SiegfridCalizo	human
@hernapardede	unknown
@SammiJade93	human
@PizzaLibretto	human
@jyuricharu	human
@StevenSlicer	human
@dianavymm	human
@MO_SANFRANCISCO	unknown
@WildStrawb_Cafe	org
@LuiRob09	human
@socialpantry	unknown
@MrJezly	human
@HitWicketBar	org
@LynnStepneyR	unknown
@daniele1601	human
@CowboySciFiBot	human
@SimplyNetworkin	org
@SandraFars	human
@nana_silver	human
@jdcharcos	human
@JasminaBrozovic	org
@searsucker	org
@Dirtemoji	org
@YousayKawakubo	human
@AirboatGators	human
@dedastudios	human
@MorganPFitness	human
@jasmine19800618	human
@camillascaioli1	human
@DomesticMomster	human
@biyuchan	human
@foodiezmumbai	unknown
@nokotannnn	human
@NumPang	org
@stawbewii	human
@Cook_Menendez	human
@DBSLKitties	org
@vijivenkatesh	org
@smartFATdaily	org
@urbandazzle	org
@MontenotteH	org
@craftypig14	unknown
@Alvin84Ra	human
@MilestonesWest	org
@MimielleM	human
@_Vennesa	org
@prince_je07	human
@EricJazFoodies	org
@AlineVonMed	human
@Kitchit	org
@ArtBarCambridge	org
@LilyHealthy	org
@ashworth09	org
@Maddogg1982	human
@songpei	human
@FoodiePics	human
@emikristyn	human
@VirgiPieralisi	human
@Morphic_Blue	human
@raifhourani	org
@RosemaryQuinlin	human
@CASPERLIZZER	human
@777merbear	human
@suechtignach	human
@kruciblemedia	human
@lea3001	human
@anne_amg	human
@twist_james	human
@potspansplates	human
@CarlsbergEaster	human
@cookinRD	human
@Brandjester	org
@VERSUScaffe	human
@designseason	human
@DiabesityChat	org
@veryhighbrow	human
@SayingTh1ng	human
@utarsa	human
@orwhateveryoudo	human
@P0NCH0gg	human
@HollandParkCafe	org
@getprimenow	human
@MaguisSosa	human
@nqlblq	org
@victoria_kuizon	human
@KelsieLAnderson	human
@ThePromotivator	org
@Eyerone	human
@yogatreat1988	human
@guwa72	human
@SMOKEYFORMBY	human
@BonTonCafe	org
@hohofeel	human
@RavishSF	org
@thedinnerset	org
@Chinnie777	human
@PDXerMIAmian	org
@MsFoxii_Brown	human
@EbtheCeleb	human
@IvansFitness	human
@putrieSeva	human
@Jecepede	org
@msking72	human
@jhaninearaza	org
@KikRoqz	org
@sylvia0223	human
@NeuvooHosBos	unknown
@chefsroll	org
@baking_bloomers	human
@AngryGut	human
@FitUrbanLife	human
@asma_sultan	human
@ServicesYafa	human
@YunJae8686	human
@sweervywine	human
@cafecirca1	human
@TheSkinnyBook	org
@Deendzz	unknown
@lilllilillliil	unknown
@BigDealDawson	human
@annefromjapan	human
@MzzLibraScalez	human
@Anders_Ong	human
@maria_da_hunt	human
@inmeatwetrust	org
@DepLifestyleMag	org
@delirecipes	org
@Laurend1985	human
@tono425	human
@2ibecks	unknown
@Vendyhuang	human
@bookdraught	human
@TorgerF	human
@CSyppli	human
@leenriots	human
@CDNGardening	human
@shuggysmommy	human
@ohautepink	org
@JuliaKwinto	human
@Lusty_Lashes	human
@zooey02	human
@AdoreAngleterre	org
@lecartetresto	human
@CCserenaCC	org
@TheSkintSlimmer	human
@RealFoodMoms	unknown
@jilld487	human
@ezra_gil	org
@nuenp	org
@MomoHizham	human
@DearJuddNelson	unknown
@NCarvalheiro	human
@PieShell	org
@Vietographer	org
@dekleinebaron	human
@SunderMehra77	human
@ohsnapletseat	human
@Hush_Restaurant	unknown
@PortE4LDeals	org
@jiji_sekai	human
@sforetweet	org
@asaindelight01	unknown
@BarossaFulham	org
@ManeeratAnne	human
@valdelagarde	human
@tesswardchef	unknown
@PasadenaMiPiace	org
@nm_na	unknown
@matchalattewdrb	human
@JaguarCeviche	org
@bricklanecoffee	human
@ryscford	human
@Connoisseurus	human
@sarahstweeting	human
@March4ward	human
@No32TheOldTown	org
@smileyxiuqing	human
@kaerui51	human
@prwilson101	human
@AmandaRuth92	human
@naachan_0315	human
@TheRunnerBK	unknown
@tabbers1975	human
@ChefPerret	org
@iamAJGutierrez	human
@BLocalDetroit	org
@barrykreiley	human
@StreetDiner	org
@JacJ82	human
@myfridgie	human
@ClarksCondensed	human
@AppleofMyEye7	human
@BeccaClaraLove	human
@WFMSOS	unknown
@peachesandsalt	org
@caterersydney	org
@Harvest_NW	human
@OnlineDrLeZ	human
@HalfCupWC1	org
@LifeAnchored	human
@WymanJessica	human
@asmcy	human
@ohbabyboston	org
@Liliie_	human
@LaRoueCafe	human
@TyeHisgirl	human
@nictoyking	human
@Adelicii	human
@hereMicah	unknown
@s_poet82	human
@InStephsKitchen	human
@_VVILL	human
@AOsbeorht	human
@poshonabudget	human
@Sazzy_Sparkles	human
@DennyOey168	human
@AnnieZooms	human
@AngelaMortimer2	human
@musiccritic11	org
@AmaliadasNeves	human
@yoga_primanda	org
@sharonckd	human
@nokidhungry	org
@carriePDX	human
@jwatson50	human
@Duckypondschool	human
@Jessie_Tattoo	human
@ZiehanRashid	human
@alanetcollins	org
@tgfromipanema	org
@BEE_KHJ	human
@PortugalHV	org
@insiemecongusto	org
@Muahahahaa	human
@design25	human
@healthyplate5	org
@shintaru06	human
@DaisyGreenFood	org
@OttawaStrFood	org
@JacklynMcCrt	unknown
@emmychaniago	human
@HazriAlifiah	org
@monroeand_me	human
@LipsResto	unknown
@casseykoid	human
@cjleon14	human
@jerald_da	human
@ThoneyGsweet	human
@O_FawcettWood	human
@FoodieFrog	org
@MIDDLESOUL_JEG	unknown
@KuMuzz	human
@Meyliesa_Atcha	human
@julie_ect	unknown
@jaothri	human
@myskina	human
@SCNMAZ	org
@AlmaVlnca	human
@eleofurtado	human
@parichadtongam	human
@expparenthood	human
@karwei_ial	human
@VeggiePrimer	org
@clarzzy	human
@kimberly_luu	human
@MonAmiGabiLV	human
@C_Thoeng	human
@DinkumPink	human
@mslokaret	human
@NoSoloRioja	human
@oscarforest1	human
@SwissChurchLond	org
@JadeyTheOracle	human
@cillaboink	human
@MyDietitianCom	human
@cuteDAIE	unknown
@LesiaKohut	human
@BangiDuluk	human
@husvedat	human
@PeniuksFishing	human
@Stoutchicago	org
@VitoNutrition	org
@rajeshsawhney	human
@ITCHotels	org
@phoenixfire2010	human
@african_foodie	org
@BarbieRam_0128	human
@0919tomoko	human
@mahasbrunch	human
@GabyRcha_	human
@Chanellhoward	human
@SheladinaJoseph	human
@newexperience5	unknown
@yuledejer	human
@trendingevents1	human
@Ryon_bin	human
@iDine	unknown
@relisys222	human
@getfitwithaimee	human
@dnclaxton	human
@sing_botolkecap	human
@shaze_cafe	human
@FhebzyExclusive	human
@SirenaSeafoodSD	unknown
@MorrisNeuhausPr	unknown
@GlutinoFoods	org
@rohitnyss	human
@cartoondandy	human
@FPartee	human
@james_e_manuel	unknown
@DJSMOOVESKI	human
@carousel_sis17	human
@rosybalzani	human
@minami072	human
@wfm972	human
@DietitianEats	human
@sarahssisters	org
@CyprusRT	org
@soalperut	human
@HallesdelaMajor	human
@DatBoyHot	human
@APBCookStudio	org
@LTuckerII	org
@JohnPapaloni	human
@LKsClubSandwich	org
@ponchikproblems	org
@FatimaThey	unknown
@graenuriinoy	human
@kelz0501	org
@3squarecafe	org
@SecondHomeDen	org
@christinRwin	human
@deniseiz	human
@Missplpify	human
@veruleea	human
@beiruting	org
@FickleFrogPub	org
@StyleItUpLisboa	human
@teddybearpr	org
@Druthersco	human
@WereGoingOut	org
@southportgrocer	org
@IndianRiverOJ	human
@arturallahlf	human
@LouisYau91	human
@ClarissaMnt	human
@Queen_ETha	human
@BentgoLunch	org
@easytocookbook	human
@mealsandreels	unknown
@DrMaidenberg	human
@EnmanuelVlz	unknown
@AromaNorwich	org
@LuzSeleniaLoeb	human
@glennala	human
@olisa	human
@kbcenglish	human
@inPADANGcity	org
@alexnlevin	human
@Dannysolo88	human
@PavelKuryshkin	unknown
@nurulhifzah	human
@TampaBayLover	unknown
@GohJianCheng	human
@EmSwanston	human
@PonTheGo	human
@Sam_Bottega	human
@SayuriAmaya	org
@SoulfulBistro	unknown
@CocoandCocoa	human
@LttleBlndeBaker	human
@rouss21	human
@Susanpuno	human
@viviazona	org
@Criollo_NOLA	org
@EmilyFligel	human
@Mika_ruis	org
@Ami_Ishii	human
@angie_boi	org
@seven_mia	human
@big_sis_rie	human
@sherwin_erivera	human
@ChemistK8	human
@abandajr	unknown
@FreshNLean	org
@Bobby_Bottom	org
@Clocher_Penche	human
@hojaluna	human
@davesbargains	org
@wendymorecombe	human
@MagFox2	unknown
@SSamazon	human
@doughbrooklyn	human
@CEO4SHO	human
@Srobinson1366	human
@SYlistic	human
@LapizofLuxury	human
@MODEhq	unknown
@HamOntBrunch	org
@cheryl_dent	human
@orthogod	unknown
@kotodama_eiga	unknown
@yoloalways626	human
@chefmbj	human
@santy_jontz	human
@resepties	human
@Motivationagent	human
@EtenTafel	human
@ryanscentra	org
@MixplateMr	org
@chapaticafe	org
@twoturbo	human
@KarinaBurgos	human
@ifranklyquote	unknown
@karynpalminteri	human
@emmie84	human
@AmelythLomax	human
@YummyYummerson	org
@BestDressedJA	org
@CherylKeating13	unknown
@OpenHands31	human
@IAmMeaKate	human
@adelaidejournal	org
@FoodMeUpScotty	human
@MissWorldCrown	org
@enajrehsif	human
@jacksonferrell	human
@TinoCapozzoli	unknown
@enzorant	org
@CreativebyWren	org
@BrionesTintin	org
@Amy_Cheever	human
@GaryRapshus	human
@AelfthrythAscot	human
@AddamzDanish	human
@4JackieBrown	human
@ooum_atmosphere	unknown
@EliiShamah	human
@lauraa9110	org
@LeticiaTrre_	human
@elatedpalate	human
@k3mart_medan	human
@ayrton_37	human
@LKellyNutrition	human
@iambanga305	human
@viviannkailey	human
@DrThaisSpeaks	human
@emi_rin777	unknown
@ShihuiHow	human
@marisayotha	human
@thealbertsdeli	org
@YUNakaYOON	unknown
@GlitznGrits	human
@Emeril	human
@PhillyBite	human
@teamfactory69	unknown
@johannesburgL	human
@visitbostonapp	org
@FarrahFarrah81	human
@thefoodg	org
@JennahAshlee	human
@SpikerRainey	human
@Dram_Glasgow	org
@tsung9514071	human
@drigomenchao	human
@RAFF_er_tee	unknown
@parkandmain	org
@CottrellParkLtd	org
@JnllMhny	org
@SweetTelAviv	human
@alokittaZ	human
@olivialoardii	human
@USFoodDude	human
@ESRScreatives	unknown
@CYT_TheAngel	human
@DebsD89	human
@TwentySixStyle	human
@MySousChefApp	org
@marycales	human
@aidanorizan	human
@iamsukizoe	human
@abrilscorner	human
@i_my_me22	human
@sx2	human
@TheHalfPintNYC	org
@ElAndariegoPV	human
@HyattAmritsar	human
@W9DryGoodsStore	org
@MarleneRinda	human
@foodedge	human
@drewjose	human
@FFDNT	org
@losnsa	human
@2islands1heaven	org
@goodhlthgourmet	org
@Online_Takeaway	org
@M_Bravo_deCasas	human
@JoannSing	human
@jygin85	human
@darwinsf	human
@DiddyWoods	human
@hailanhamid	human
@GripeO_Feed	org
@NathanChongx3	human
@PyureSweet	human
@Abstarv	org
@FoodMfg	human
@JeanPulido3	unknown
@MuhammadfaridzM	human
@Culi_Amsterdam	human
@Johnh8H	human
@tavernadibacco	human
@siesta_osb	human
@StherAng	human
@staceyfukui	human
@sofatblog	org
@WalkersBarNYC	org
@pichakornk	human
@restaurant_bar_	human
@sherifiskandar	human
@KimFosterNYC	human
@WalkerGertrude	human
@sophiegoodswin	human
@Amydijcks	human
@_fashionfoodie	org
@sashrestaurant	org
@rosemaryandtyme	org
@bapboyy	human
@RadioTalkZomby	unknown
@Suznne07	human
@PinkyRedUK	org
@pandanyhc	human
@JonathanGibbs2	human
@missjennipher	human
@kcpeaches	org
@NewOutlookPT	human
@RP_Smiles	org
@evelynlingg	human
@LattaUSA	org
@CorpSourceCater	org
@Mixx_Yoga	human
@nekochigura5656	human
@ishamsani	unknown
@skyyyyjellybean	human
@caleyelise17	human
@iblogNYgirl	org
@Echo_Zheng	human
@Themodelfeed	org
@arashi_yakata	unknown
@iamED_j	human
@TamsinWinnifred	unknown
@amydallis	human
@Rollatoyz	human
@axis_LDN	human
@SmartGirlVeg	human
@anapecson	human
@neungbionic	human
@rocio_montoya	human
@mummy2twinsblog	human
@GenovasToGo	org
@Reinaleah	human
@noel1753	human
@slowbreakfast	human
@pennyw10	human
@htowntaco	human
@ChildHealthNow0	human
@fashillabyalex	unknown
@TheEdgeVenture	org
@healthyinthebc	org
@bmcathleyas	human
@MegHereThere	human
@jeremyheslop	human
@relaxmedspa	org
@GeesRestaurant	org
@nufarulint14	human
@cocoscafejasper	org
@ADVISORYhackney	org
@NataliRamirez85	unknown
@itsmejohann14	human
@sophiafakhry7	human
@GiffanyLo	human
@SeanachiePub	org
@wickedmountain	unknown
@adventureur	human
@katshappyfood	human
@Anoy7	human
@FactotumBrew	org
@5napkingrill	unknown
@VIPlaces	org
@Serenityluv77	human
@LAfashionangel	org
@HollysKnoxville	org
@3rdSectorToday	org
@Jingkrak_pusat	human
@Puddletown_	org
@MarkArtugz	human
@ConradCairo	human
@1BadGemini_Jae	unknown
@JustineIrma	unknown
@susimajid	human
@rockthegossip	human
@hectorhomaD	org
@CostaRima	org
@darklight99	human
@laylamunich	unknown
@LivingSocialUK	org
@kathswcornard	org
@w33z	human
@MehnazMakeupMUA	org
@FiverFeeds	human
@BakeWithRachel	org
@kurissyan	human
@leo0721	unknown
@Turkifaisal	human
@everydessert	human
@Sunny_Jansen_	human
@belleisabelle	human
@Newfiebutt	human
@Swift337	human
@PrimaMag	org
@NurfarahanaAziz	human
@ThisGalCooks	human
@Vinivi	org
@keyonhammond	human
@RestauComptoir	org
@jasminenjm95	unknown
@OomPanda	human
@d3wyanti	human
@peacelovefitmom	unknown
@PompeiFauno	org
@iMonchReymond	human
@VioletteDaily	human
@bhayviejiyong	unknown
@c_maus	human
@chubbyscheese	org
@Colsmfv	org
@mastercarlo1995	human
@SchoolMealsRock	org
@sketchlondon	org
@Tacosblog	human
@PHTafia	human
@GermanGains	human
@lildrummergie	org
@GstarRadio	org
@Pinkaliousyun	human
@EmilyVrla	unknown
@TheSavourBlog	human
@kaffeinelondon	org
@LeedsLoversUK	human
@LouisEthan	human
@JenniferBerard	human
@IngaSavits	human
@themary_tang	human
@Odicean	human
@MarkSargey10	human
@20sand30sgroup	org
@gringalicioustc	human
@porkslopebk	org
@MoniaBiologa	org
@YoCulinario	human
@place_pigalle	org
@treatsandsneaks	human
@Tmaruliano	human
@strawberyauburn	human
@kichulsun	human
@FelixRajali	human
@iamgeekei	human
@InfoLaPosada	org
@_Kaniya	unknown
@SharonWheelock	human
@Mork1975	org
@Cainssaloon	org
@DesMoinesYMCA	human
@yoshizou_nico	human
@iamarjoh	unknown
@dailymuse	human
@annikegami	unknown
@543pul	human
@KnorrFlavour	org
@LovingLdnLife	human
@The_Out_Siders	human
@Aoumie	human
@AlifdeenJaydee	human
@Bibonoaozora	human
@CatskillConnect	org
@bcwyngaard	human
@asparagusgreen	org
@SPB_2life	human
@joyzzzie	human
@MaloccoCafe	human
@hoyquesale	org
@chaichingx	unknown
@suburbangourmet	human
@isagenix	org
@koushouki	human
@CozyCafeIowa	org
@msn_food	human
@s_generation	org
@htvpk	org
@queensselfie1	human
@recipesbynoc	unknown
@Trucker_Radio	human
@mirjill	human
@salvatore_cuomo	human
@PLU87	human
@StreetGeezTae	human
@ChrisCarlo	human
@BottegaNicastro	human
@kirashizu	human
@ayacamoca	unknown
@misspelledink	human
@BrainBalanceMI	human
@Diabetes_Month	org
@AllensVeggies	unknown
@FredericBillet1	human
@Chatchatcatcat	human
@NeuvooPTBos	unknown
@InstaBicycle	org
@puurtymamabear	unknown
@Atomic_Digital	org
@Nightwhisper77	human
@imnikkahsy	human
@Entertainers101	unknown
@MoserSybilla	unknown
@JoesPastaHouse	org
@Farmerbright	human
@chaplinbardc	org
@PentaFoodsLtd	human
@AlddiEscobar	human
@Polo24HourBar	org
@MinervaAlex	org
@CraftyNadia	human
@RossyFriggione	human
@MesaStreetGrill	org
@adhor	human
@pradanaass	unknown
@dawildcherry	human
@Resort_Maps_NB	org
@TheHamiltonInn	human
@maitedlpuente	org
@noturavrgchyck	human
@HealthyJesse	unknown
@itsmejay1989	human
@tennyldehm	human
@MickMahonTATTOO	human
@minyen93	human
@LunchtimeMarket	org
@JacksonRye	org
@Kimchinattobowl	unknown
@Dewicincin	human
@lesleysalazarm	human
@watieysoong	human
@CAT1PRO	human
@ButterNWhiskey	human
@theogdenchicago	org
@DeliciaCoffee	human
@OuBruncher	org
@CrookedKnife_30	org
@EquinoxDC	org
@Michellelanious	human
@lauristortorice	human
@SanLorenzos	org
@chefkim414	human
@JenevieveNelli	human
@BlackRose50101	human
@Monica_Movies82	human
@mycuvee	org
@AndroidEspera	human
@epicuremarket	org
@_ChloeThomas	human
@PriyaKitchenett	human
@tvfishing	human
@foodiegourmet	human
@JAPANMANIAs	org
@AndinaLondon	org
@BeefbarMexico	human
@MsFitandFab	human
@mdobrinskaya	human
@ILoveWPB	human
@RIKitchen	human
@MeBeHealthy	human
@jennifermakes	org
@thecajuco	org
@calimesha	human
@iamamberlova	unknown
@carmonth	unknown
@_martin_salgado	unknown
@jonathanlegate	human
@AuntaeFoods	org
@NicaLady80	human
@ninihanoppo	org
@neulynley	unknown
@originalslope	human
@Cingyung	human
@nonnonju	human
@MrsJ2u1	human
@AreeNaru	human
@alanaandkyra	human
@dad2se	human
@labelladiva	human
@brisk2londinium	org
@JajairoRequena	human
@NewsandRecord	org
@JosiMarie	human
@saiun_nagisa	human
@jc_eats	human
@DCTiff	human
@mszablewski	human
@chow_down_nyc	org
@WesternBagel	human
@DanielSchmitt20	human
@corvetteflex	org
@sz_rn	human
@YellowChiliTapa	org
@RecipesTecfiz	human
@Denigan17	human
@MahaAngie	human
@thechefalliance	human
@TOMATOESdesign	human
@_HouseIDESIGN	human
@veryculinary	unknown
@SunsetVallarta	human
@mayuuuV3v	human
@HorrorByProxy	human
@gadaboutfood	human
@EventsByArianna	unknown
@poutinedreams	human
@HungryLobbyist	org
@AltyReTweet	org
@FrancesCarroll_	human
@mcacquaroni	human
@MumsTakeFive	org
@babswool	human
@backpackx1378	human
@RocioTorrj	human
@joyjezzabelle	unknown
@edibleASH	human
@theartofsign	human
@prinzdiomar	human
@emirjr888	human
@LeenaCelene	unknown
@morgan_quarter	human
@icasamadre	org
@Diseworld	human
@AnahiGnzlz	human
@angiesangelhelp	human
@CrescentFruit	org
@FadzlyOthman	human
@TheRDizzle	human
@JasmineGraceG	human
@PHXPublicMarket	org
@LUNAROSA33	human
@arrivechic	human
@vicentertain	org
@relishbyrae	human
@aliofthevalley	human
@HeathMoody1	unknown
@petagadgetcom	human
@imchechebureche	unknown
@chriscasas21	unknown
@imdnextbuffet	human
@PaulMuxlow1	human
@LivingFLA	org
@jnj5468	human
@StripHouse	org
@Logan_Can_Blog	human
@claudineroo	human
@TilleyOmalley	unknown
@KristelMiskin	org
@PrinsesaPusa	unknown
@theGABmag	org
@Restotapeo	human
@ELDEEZL	human
@VittorioAssaf	org
@sweetness91303	unknown
@MountainPumpkin	human
@aderynyunianti	human
@ZambranoEmbry	unknown
@lediamantito	human
@tami282	unknown
@JerryXNuTouch	human
@CullyAelfraed	human
@baking911	human
@mrsjoydhole	human
@brianiannone	human
@HenryandtheFox	human
@jackiiyeung	human
@GillyGoRAWR	unknown
@tilkitilkitilki	unknown
@MissSandia_	human
@Sir_Chicago1	human
@ItsNutellaUsa	human
@CarolineJBecker	human
@mori__asa	human
@Tim_JohansenUAE	human
@linchiyi626	unknown
@Mara_ClickThat	human
@LaFitnessDiner	org
@kabindrap	human
@lindapugliese	org
@UltimateQuotess	human
@shutingtan	human
@ILoveFoodiesCT	org
@Madebyjonty	org
@ShanshanMei	human
@Paolo_Pama	human
@IchelScarlet	human
@KishaBue	human
@victoriagkovacs	human
@Extreme_Pizza	org
@HouseofDarkwood	org
@Delgado1ja	org
@sassyfriday45	human
@ottoshi	human
@AlexNoRadio	human
@meandmineto	org
@odangudon	org
@CapeCodGiftShop	human
@wdoha	org
@Jeakh	human
@LorriWynston	human
@matthewkevinte	human
@swimforce01	human
@Greenz_Brothers	human
@bluenote1500	human
@ShulasNYC	org
@stansmaplecafe	org
@cyns_cyns	human
@RiverRoastChi	org
@pawofcosby	human
@Dalesio_iris	human
@francim76	human
@JustLikeMeSarah	human
@rurepping	human
@AhmadKasyidi	human
@Gypsy_Wind1	human
@sologourmet	org
@cylindrica	human
@PulengMoloi	human
@taufickficky	human
@BeckMediaInc	human
@YusufCanDirik	human
@IAMJHART	human
@sony_wirawan	human
@koswkh	human
@rolls_41	human
@Yogaclass2	org
@tomox0330	unknown
@x_xTellex_x	human
@UrbanOuteaters	human
@estar32	human
@thesassycookie	org
@KelvinMoet99	human
@VinoPivoRakija	human
@TortillasNL	human
@corymetalzombie	human
@peafowlet	human
@WhatsUpSpain	org
@Nickolaus1986	human
@skylonsouthbank	org
@chiara1235	org
@Stellawants2die	human
@EsotericIsLike	human
@Feeeeeez	unknown
@leleicapri	human
@USATalkRadio	human
@adeJULIAN	human
@JazzBistroTO	human
@IlfornoYeg	org
@vxbond	human
@momdotme	human
@BadRoBot911	human
@carina_slt	human
@Linda_Mattacks	human
@ParkHouseDenver	org
@DAVEOCHIA	human
@daviddkw	human
@Kris27jam	human
@jellyhup	human
@JAYVELZ	human
@ginmama_bcrn	human
@piesandplots	human
@1173ktsy	unknown
@LucilleFeasts	human
@paula10br	human
@vanessa_pr	human
@CourtneyPool	org
@Irsbygod2	human
@RumpusCosy	org
@melissasfoodies	human
@LadyRocknRoller	org
@makcekeskrim	human
@postandbeamLA	org
@smithpship	org
@IAmTomines	human
@Sister3029	org
@RT_PlayaDC	human
@RyonaSong	org
@KURTDiETRiCH_II	human
@MariannaFila	human
@CompletSavorist	human
@NTirelyOrganic	human
@toastdelicafe	unknown
@serene_toh	human
@aYe_iNa_Ko	human
@dreamgirlent4u	human
@RosiesDeliCafe	org
@HumphreyAlexa	unknown
@ClaudiaParzani	human
@peerieshopcafe	human
@Cubana_PMB	org
@radio_hud	org
@SmokehouseLpool	human
@lisasleftovers	human
@jm71788	org
@EmmanuelBrian6	unknown
@michelle_au	human
@langshipley	human
@LettuceJobs	org
@JesusAfashion	human
@ekatjokrosemito	org
@318SWEETSHOP	org
@ExeterTown	org
@Goheels_76	org
@ginahelm	human
@EASYDAILYFOOD	human
@Blondie1718	human
@Jenni_Marie_tog	human
@Jozie_16	human
@HerbiesSTL	org
@isurunix	human
@NielGermishuys	human
@Lisa_agua	human
@davidetmiller	org
@HeyJirko27	unknown
@flirtaciousboi	human
@UmpquaOats	org
@czerwony03	human
@ErinMcMullen4	human
@THEDORSZ_Cracow	human
@LoiJIN	human
@AndreaL821	human
@Roygitsu	human
@WellPlated	human
@TheWellnessChef	org
@OurMenuUK	unknown
@LesDeuxSalons	org
@realmomshealth	human
@debiphuah	human
@opart15	unknown
@rebe3rossi	human
@JLRivera_RDH	human
@KmiKstroG	human
@TameekaTime	human
@HemingwaysJozi	org
@pjthiel	human
@YasiDxB	human
@Elsieliciousbae	human
@SeanDolan20	unknown
@fang_Qi	human
@Laviniacooks	human
@aeizwann	human
@christianeeeee	human
@dedfishysanj	org
@le_fermier	human
@boathouseBI	human
@BreeAea	human
@alco_1982	human
@TheGFRD	org
@BuuzFeed	human
@CURBAPPEAL_GB	unknown
@GiulianoUK	human
@ThisRobGreen	human
@SavageScully	unknown
@bitch_varsity	unknown
@NaSka_Style	human
@CaterClubHQ	unknown
@1OOOsummer	human
@EatPastaChips	org
@chiccadoc	human
@mimi_313	human
@RandomFeelingRT	human
@MrsTeriA	human
@aruaru_rennai	unknown
@erna_myworld	human
@Anthonyjam88	human
@AyoRyno	human
@kberbre	human
@willakammerer	human
@taka_an1	human
@CocaColaRt	human
@BarrelYards	human
@ontamadaisuki	human
@KarakiKayo	human
@RAPMAGBOOBA	human
@moderndadpages	human
@reinaheather	human
@Bulaccino	org
@shorty_99	org
@ivyvine77	human
@xchibz	human
@niecyisms	human
@eyewonit	human
@MamasMission	human
@HealthGal1103	human
@psha85	human
@stelstellam	human
@BenyaminHartono	human
@RatanaSopha	human
@gourmetgirl305	human
@Tu_licious	human
@angking13	human
@HallysPG	unknown
@VladimirWaldorf	human
@ExploRecipes	human
@somaza_ge	human
@KopOpCoaching	human
@AlohamemCo	human
@elmy900501	human
@_cathyj_	human
@ModBodSlimdown	human
@SunnySunny247	human
@DisneyMOVlES	org
@JamesConnollyre	human
@SimpleNQ	org
@sonnervigtwins	org
@Toufayan	human
@MapleysMorsels	human
@GreenZebraGroc	org
@matthew10780	human
@MyBodybyCarla1	human
@utterlyscrummy	human
@rafina5a	human
@Rico_Peru	org
@ArmleyCafe	org
@lboogs2	human
@ShopWiregrass	org
@Glenisk	org
@TDMDresdenRow	org
@Droolius	human
@nicol_chr98	human
@noee_glez	human
@Kitchen_Society	human
@nKLRZ	human
@OmgPizzaClub	human
@TravelersLikeMe	human
@thebrunchbs	human
@Yopiko_xxx	human
@1003Yuna	human
@puttyarmein	human
@CaTomatoes	human
@MintLeafDXB	org
@DJRYUICHI	human
@bellavorcaro	human
@SuDay14	unknown
@shank_m	human
@iheartrocknroll	human
@enoved	human
@BeckyLeeHayes	human
@iamthatlady	human
@sandralouis	human
@bubalubristol	org
@CITYMALL_Leb	org
@atkot	human
@wafelus	unknown
@mehdiezze	org
@KWAwesome	org
@SmallchangesIE	human
@daisyduck123	unknown
@CaringMom	human
@SBellasWays	human
@MottsDemerl	human
@DJYummy	human
@KayleighvdHout	human
@DMGlassStPete	human
@TM_CAPLAIN	human
@kepani1016	human
@Endvillebakery	org
@CinfullySimple	org
@ForksFlash	human
@HamiltonKitchn	org
@ecmaddox	human
@izumanix	human
@bucketspadecafe	org
@jmckay1979	human
@HyderabadFoodie	human
@CanneryCasino	human
@ausyoshietralia	human
@AnnaWanderer	human
@RedsRoadhouseTx	human
@ShortCutSaver	unknown
@seishinonsen	org
@esraceydaersoy	org
@HoxtonGrill	org
@JessiVMusic	human
@NottmStrEAT	human
@nuwireless	human
@ccstewy	human
@GabrielCG05	human
@Soy_Dispersa	human
@TurkishKitchNY	human
@tlacin	human
@ElizrdbthSpeaks	human
@violetb2103	org
@nikki169	human
@ShareDishes	org
@wilabong	human
@HelpToRent	org
@CrownePlazaJED	human
@the_food_wire	human
@greghiryu	org
@CoedAdelaido	human
@ThetB_33	human
@asukataaaaan	org
@BiffWife	human
@Triple52	human
@taysemicolon	human
@alexpellegrino	human
@LoMangioSoloSeM	org
@adamchristian	human
@Ilovecakeandtea	human
@ToSwea	human
@DGSDelicatessen	human
@mimis_cafe	org
@UBURGER	org
@rosiebank	org
@gurny2007	unknown
@Starmash1	human
@Maxamegalon2000	human
@taniayako1020	human
@m4rten	human
@ice_janet	unknown
@yasminjay53	org
@PhemePhatale	human
@smarqum	human
@mad_being	human
@robfrid	human
@Lamb_Mathew	human
@LJoanFH	unknown
@ngkhaiyee	human
@BurgerBound	org
@BillyWooStahr	human
@Hoskingoode	human
@GeneDexter	human
@ryanzhelp	human
@FoodTravelLove	org
@Kerrieee91	human
@SCHOPgirl	org
@Stemilt	org
@aileen_metcalf	human
@breakfastbarlb	org
@william_price	human
@KimberlyC91	human
@KahnsKitchen	human
@Minjonko	human
@jofinaelyani	unknown
@mich_teo	human
@instagrampups	org
@Tasha_Nicole84	human
@Jayye_1	org
@fieryxspirit	human
@SinceAs	human
@StevenEAyersII	org
@DelectableEgg	human
@FreshIsIt	human
@CampbellBarbara	human
@DanielRoyce	human
@OnezyLove	human
@gastropost	org
@chloetannn	human
@brgrkitchen	org
@ChrstBrunsn	human
@Funleys	org
@Askmewhats	human
@mariahines	human
@TannyManana	human
@CecilaTham	unknown
@DurbanvilleWine	org
@Hollandontbijt	human
@vino_squat	human
@HudsonCafe	org
@restweekindia	org
@IamMaulde	human
@Lovergirlshenz	human
@wish_14	human
@AYUakeayu	human
@ShopLocallyTO	unknown
@aimeeangelique	human
@lauraissocial	human
@dr_euy	human
@DFGrilleAtlanta	human
@LaMaisonMiami	org
@exceptionalfood	org
@MangumOcampo	unknown
@LordofthePiesGB	human
@TaysBakers	human
@JerzHotSpots	org
@MadFoodieTamara	human
@MaliaEXLA	unknown
@Roosevelt933	org
@celiaLady	human
@yasminangel80	org
@jinnysdays	human
@carlydefilippo	human
@SuperLNDN	org
@uponthescales	unknown
@WhaspNutrition	org
@gastonlua	human
@toshi_zx	org
@UrbanPantryWine	org
@AnnabelleParis	human
@TruittFoods	org
@kokoking_gh	org
@Emma0839	unknown
@luisfsanchezjr	org
@DarthJaeda	human
@fqmirage	org
@StephanyBbyDoll	human
@Anne_1992	human
@Short_Order	unknown
@burnzkish	human
@mlmattes1	human
@Pierre_Victoire	org
@LifeDelish	human
@KCMODowntown	org
@EpideMickInk	human
@MonishNand	org
@francescagblack	human
@CDLCBarcelona	org
@linda_pick	human
@MAODEUL951030	unknown
@oscibella	human
@FollowbackImage	unknown
@rawsomerebel	human
@LeeBakera	human
@PiersMadeline	unknown
@KilkennyHouse	org
@iam25February	human
@DarbarNY	org
@CarraraMario	org
@MoonOverManhatn	human
@beanengineering	human
@TendenciaSur	human
@theCouponista	human
@nanoleimbacher	human
@thelambsclub	human
@kimberlyisasian	human
@healthygirlatc	human
@holidayinnist	org
@Blairbeme	unknown
@basementpadstow	human
@DiNokos_BarZia	unknown
@eggtcKC	org
@SolvingAnxiety	org
@feelmoreIT	human
@Kathi_Spikes	human
@sarettonfola89	human
@Lite_Bite	org
@aurLyzM	human
@ENT_SocialMedia	human
@inspiringwit	human
@thefoodudesMTL	human
@DiarioTragon	human
@JugglngRealFood	org
@federicoguti10	human
@deabyday	org
@TravelersClubNY	org
@UnionSqEvents	human
@Axie_Bakrie	org
@PerkosCafe	org
@alicesherryll	unknown
@LePainQuotidien	org
@georgeginis	human
@up2choiceCanada	org
@nykorodriguez	human
@Cazzygirl1	human
@modelbaje	human
@paradeclorox	human
@akkie36	human
@InstaGorkyPark	unknown
@suburbansoapbox	human
@PeakFM	human
@misz_decy	human
@OliverZeitoun	human
@YoavPerry	human
@NGUBDo	human
@WillieBoySF	org
@fenice_palas	human
@nakimusiyuu3	human
@Olivias_cuisine	human
@Chechuz	human
@saucepotdiary	org
@deepen915	human
@kennethrasch	human
@alicanavan	org
@lareinachanel	human
@Kitchinit	human
@AlexHULKPerty85	human
@FoxyProduce	org
@laura_gabs	human
@nazmimn	org
@noellbulka	human
@_aylafaye	human
@JedrekGoh	unknown
@vaniawibisono	human
@SFBodyCleanse	org
@blk80x	unknown
@BellaSupiana	human
@a_miruco	human
@anaiscollective	human
@AmyZempilas	human
@hyattmagmile	org
@KimberlyE	human
@JorgeCst_	unknown
@KennyMack8	unknown
@LoriMoreno	org
@agardeningcook	human
@FoodDoneLight	org
@Vid3oGirl	org
@eltorito	org
@melissa_ting	human
@CaneRay8	human
@mosinkuv	human
@sweetzilla	human
@NewDawn_Fitness	human
@karenb834	human
@BelfastPubs	org
@Clarissa_Yuuya	human
@Brillbrighton	org
@RokaAkorOO	org
@kobara_suita	unknown
@Live__Healthy	org
@festyinstyle	org
@BallingerSeymou	unknown
@recipecurry	org
@asayakedo	human
@gymclassjunkies	human
@DJMAGICJAY	human
@Josephsinelfil	org
@DivaAllMyLife	human
@WhyIsThereAir	org
@Nutritionista	human
@DOMDIVA83	human
@DowntownGuelph	org
@kohi52	org
@robynstore_fit	org
@AnniePagan1	unknown
@NiGEHOOD	human
@_molimu	human
@lengningyi	human
@pulsinandbeond	org
@knockonfoodrc	org
@catia_rodriguez	human
@RachelSlainte	human
@LenaCakir	unknown
@fendyishere	human
@Adiwangsa_Solo	unknown
@FreshDirect	org
@KyleEditor	human
@HanaOctavia	human
@klaten_photo	human
@harayasu0112	org
@As3tchi	org
@thrivemanhasset	org
@para_mon	human
@DinnerDivaMary	human
@BagleyRobins	unknown
@chama_jp	org
@dhianaberg	unknown
@cat_si	human
@TucsonFoodie	org
@ErinErvin497	human
@moai_ze	human
@ADIE_ML	org
@SpandeliUk	org
@sarraaziz	unknown
@shazzyg10	org
@Cheesey_andwine	human
@KTurboLicious	org
@RindalaK	human
@sinaiee_maryam	org
@AtuuySoccer	human
@lescavistes	org
@taule_elaine	human
@CYCLING_ASIA	human
@riuplazapanama	human
@pailinlyn13	unknown
@OptimalBodyC	human
@thesecretfittie	org
@kurokyoansan	human
@billbates	human
@JanaAdam2	human
@SydellFaith	org
@SirGarde	human
@nishikatakumi	human
@VicLazo	org
@lisabusby7	human
@spainfoodexport	org
@eh2681	human
@IamHusschBoy	human
@food4happiness	org
@ramramramji	human
@Tamir_Grant	human
@alphabetiya	human
@FoodnFizz	org
@jaechn	human
@wegiveaschnitz	org
@freshonspadina	org
@trader_hiro	org
@Blueykinz	unknown
@Mike_Sportsmktg	human
@OakvilleShops	human
@GFMSimple	human
@StephHasJobs	human
@TwoBiteSaloon	org
@rushandteal	human
@lmthacker1	human
@beyondlight_	human
@TweetchefO	human
@FeedMeSeymour10	human
@saramilletti	human
@jpsapitula	human
@Zanan7775	unknown
@AiKo_MinHeE	human
@PalatePro	org
@beepboop	human
@DocksOysterBar	human
@jemvsantos	human
@LittleFootLady	org
@sarahoborn	human
@FusionPeruvianG	human
@doelnest	human
@greenhorncafe	org
@chowjackie	human
@HLLondon	org
@FabioGranato	org
@Greatdjuniverse	human
@WingateMykaila	human
@SelectStores	human
@naowoochoco	human
@ObviouslyEmmy	unknown
@tincaballero	human
@LaParmigianaGla	human
@FIToneWellness	human
@ritual_co	org
@MelissadArabian	human
@AmySeanAbdullah	human
@bonjourchiara	human
@BmoreLikeNita	human
@deverespub	human
@HeatherMPerkins	human
@Doomer	human
@fave	org
@The_Funhaver	human
@yowanchen	human
@510Reichan	unknown
@parkvincent	org
@thecleaneating	human
@farm_court	human
@explorersclubmv	org
@DDogsRestaurant	unknown
@Pessimistedisco	unknown
@Lowphazer	human
@QupBBQ	human
@A_NDW	unknown
@trulyaecon	unknown
@TenTenPieMx	org
@JGumbosFlatiron	org
@Redscalgary	org
@LittleSparrowCA	org
@JeSuisPedrhina	human
@gSLAUGHTERrific	unknown
@007milo	human
@LoungeWish	org
@wangchaoirwin	human
@trenalaine	human
@Aucifersakuya	unknown
@JordannnCeee	unknown
@lubbishdump	unknown
@NomNomNYCgirls	org
@desi_leilani	human
@tunartbot	unknown
@RGBookWorld	org
@Princi_Milano	org
@Emma_James	human
@NOSTICMAN	human
@abcAwall	human
@FoDoBrittney	human
@SAnkarstrand	human
@LaTitaRivera	human
@denliner_	human
@HarshRoopchand	human
@myhlles	human
@snapshotgirlHK	human
@BurjRafalHotel	human
@xtomirisx	human
@GigiPresVitelli	human
@grittyyas	org
@patriciatalaver	human
@pearlibers	human
@LowGlutenDiet	unknown
@DavidPWebb	human
@Mama__B	human
@dessey	human
@Marvhin24	human
@_foxhomedesign	human
@safrinaay	human
@JacquelineWise1	human
@culinarychase	human
@HassAvocados	org
@chelseabressler	unknown
@cevicheuk	org
@Mandoochoi	org
@ABJbyJuliette	human
@xameliax	human
@yelenas711	unknown
@horoshoedim	human
@laplageblue	org
@HsiehCarol	human
@MommyBlogExpert	human
@machosnovia	human
@hammads	human
@GrillHouseCafe	human
@anjmo021	unknown
@MillaJohansson	org
@KitchenetteDown	unknown
@JWMCheeseSticks	org
@tysune	human
@sanipari	human
@KimHoeltje	human
@VivianeMrad	human
@RoyaAlavi	org
@OfficialComesum	human
@ForstersBistro	org
@brians24	org
@BuffaloMJ	human
@whoisadriano	human
@Kaew_S	human
@Kinaina1	human
@JesSofiaValle	human
@dramaprincess	human
@bmsahaib	human
@bethiesee	org
@MEATEateryBoca	human
@ENVYMEXOXO	human
@Tastosterone	org
@eatcookandmore	org
@MTOPPS_MODELS	unknown
@BloodShotRED	human
@The_CuriousCook	human
@TarekCoillens	human
@Haneen218	human
@billybadbird	human
@suryawynata	org
@Alexia_Lavoie	human
@I_Am_Him88	human
@DaveBngDave	human
@uedasss	human
@MAWIKedness	unknown
@myaha38	human
@FerAlaSopa	human
@MelissasProduce	org
@BigATavern	human
@RoyalMeridienAD	human
@Distilled1	human
@ItsGraceMary	human
@dmvsno1slim	human
@8172369	human
@King_Pyontor	human
@mak_mike	human
@7PecadosRest	org
@wildcloverfarm	org
@jamesbryronlove	human
@doofvfood	human
@faynstarzyk	org
@MorrisNeuhaus	human
@hrustkovaanasta	unknown
@GoSantaMonica	org
@tang_sire	org
@Phattamonn	human
@LOHANHAN_	unknown
@BowdenHeadrick	unknown
@1FitFoodie	human
@yumchachicago	org
@divadanceboy	human
@BouncewithBeck	unknown
@JoeBadalisTO	unknown
@SpringfieldCC1	human
@javierchicas	org
@yeahyeahright	human
@TheCove_Rotana	org
@nezzdcom	human
@FlatoutBread	org
@giafrese	human
@NawabeAwadh	human
@geniussocietydc	org
@FabFatale	human
@kvpulley	human
@prodgroland	human
@DiBrown5	human
@TrixieReyna	human
@trenzalore5	org
@Address_Hotels	org
@rmurray729	human
@sweetsbychan	human
@SharpWileejack	human
@CuteCatPixOnly	unknown
@junjun8823	human
@Miss_Celebrity_	unknown
@AsturiasOnline	human
@MusicianSamurai	human
@stefantsai1	human
@StaxDiner	org
@mypapersunglass	human
@DudeBall	human
@quotidiennedele	human
@nopadc	human
@myherolife	human
@lavitageorgesq	org
@ITnewsFI	human
@yessitag	org
@SanJoseE4LDeals	org
@desVins1	human
@TeriGentes	human
@WreganTomlin	human
@ForgottenCutsCo	org
@LaFille_LaMoto	human
@CSCarrigan	human
@BThomasHWood	human
@FotoDish	org
@mynolagranola	unknown
@marionlovenotes	human
@110Athletics	org
@Dayna_Callaway	human
@misterlyndellio	human
@crazywomanart	human
@Lilo_news	org
@erin2414	human
@hellomonicatan	human
@WillyazBilly	human
@iBoss_Ladi	human
@jenltrav	human
@fredericobuzon	human
@millstbeerhall	human
@ChiangmaiMarisa	human
@USofFlo	org
@Leanne_Perky	human
@mickyvickie	human
@DjDYeager	human
@patatamon	human
@BetoGmez_	unknown
@RestBaluarte	human
@MarianChaguen	human
@Thegilbertscott	org
@khaiorpilla	human
@Chlorislhw	human
@ShutterGay	human
@CinnaDesign	org
@micakyoto	human
@LaCusinga	org
@JoePadula	human
@xiuai	human
@NazliEkim	human
@BeachesBakeShop	org
@sexxah	human
@da_1sinister	org
@mitchygems	org
@foreverarlene01	human
@roachkilla1	human
@imlistreet	human
@ILBastardoNYC	org
@twt_food	human
@GroveParkDeli	org
@marowalili	unknown
@MuchaSriracha	human
@PIE_NOT	org
@SOUNDZLKFUN	human
@sumoguri5045	unknown
@MrsMChappell	human
@TamaraTamor	human
@catherinelum	human
@ViktoriaVixen	human
@Vanessa_Le21ter	human
@Terttulia	unknown
@LicaRikaLica	human
@RobertOchs3	unknown
@NickelandRye	human
@womansearth	human
@rduterte76	human
@XJAPAN_to	unknown
@ashley_marti	org
@AuntChiladas	org
@DelmyBarillas	human
@andrewesiri	human
@WFMDenverSouth	org
@RawLoveRecipes	human
@CaboFlatsPGA	unknown
@PinedaSeay	unknown
@Club_Gascon	org
@cattlegridbalhm	org
@thesmartkitchen	human
@kanika0506	human
@DumebiAgbakoba	human
@ClaireMornay	human
@hidebot1	unknown
@adaaliz	human
@AdAstra24	human
@ZeeKhanaKhazana	human
@ZoeAndreas	human
@LavonnaLingerfe	human
@LocalBitesCafe	org
@heritage55life	human
@kowality1542	human
@aleska_diamond	human
@210Local	human
@GKDIA_	org
@wearbtsj	human
@hasironumarine	human
@EclecticBliss	human
@liapauline	human
@BasicBrunches	human
@ocmexfood	org
@NfashioN_Blog	unknown
@jennhur	human
@Poshcafe_Kuwait	human
@michaelvfisher	human
@NutritionPika	human
@Raith_Gardens	human
@planttrainers	human
@mexodus39	human
@EL_logical	org
@t_TeTe_e	unknown
@RB26th11	human
@C_K_Anon	org
@justfara	human
@KevMarkXLII	human
@slocation	org
@Gab_Hd	human
@KalGuntuku	human
@LittleRascalRvw	org
@LClvn145	human
@LiaisonCapHill	org
@CandisStiebel	human
@dluxhighgrade	org
@ErosCafeNJ	human
@szilviade	human
@sUkiyak1	human
@CirenReTweet	org
@Cholosocksgirl	human
@LeolaMorduch	human
@AnthonyTGideon	human
@OcopaDC	org
@satomi_154cm	unknown
@DJMIYA	human
@MildeDarnel	human
@The_Fat_Pigs	human
@bot36683943	unknown
@ClassicCupCafeD	org
@IllusionsThePub	org
@miss_cyns	unknown
@JimmyLau888	human
@NolaSpots	unknown
@Inuk360	org
@PaulusChTjia	org
@rhonduin	human
@bluemozza	human
@mnavarreted	human
@GMatamorosR	human
@LimoncelloCCS	org
@phototropolis	unknown
@Devilich	human
@smbs29	org
@santi_nicolini	human
@JerryHerreraPty	human
@chaliceofman	human
@ForkLickinGood	human
@DandelionMkt	org
@LexxThang	human
@chicagodiner	org
@ZoysiFit	human
@MissYvie26	org
@BurgerTapShake	human
@tamarindotruck	org
@calculatedwhisk	human
@food_chick	human
@ANAisnotFriend	org
@PinkyAmador	org
@yesline_90	human
@From_LAB	unknown
@mobilelifetoday	human
@Cooked_UK	org
@Paviafb	human
@FlorianaRiso	human
@chingdyrella	human
@RUNNEY_ROZAI	unknown
@gleisyluiz	unknown
@cathhayes	human
@VaVaVanesa	human
@absorbDC	org
@rooonbrian	human
@Ifthistest	org
@36Drugs	human
@Dolly_Regar	human
@iseeyouugly	human
@kawaiikutie	human
@BusinessTraders	human
@BryantKeagan	human
@TempDeals	org
@adorablemhlee	unknown
@emmett_keith	human
@rubyslippercafe	org
@thecookapp	org
@MOdernisticmom	human
@CocoMartinReyes	unknown
@uncorkplum	org
@imamothergoose	unknown
@BarraRossaDWN	unknown
@grandcentralkit	org
@SafranaArgana	org
@bowldacai	org
@ambrarnaldi	human
@MeliCafeChicago	org
@KristinaDaniele	human
@TaraMHarrison	human
@SpacebeamTweets	human
@Josephtan66	human
@reggie_pinlac	human
@j57	org
@evieferial	human
@fit_for_dessert	unknown
@zackayu	human
@sherlynnmiko	human
@RHOZO_	human
@eatmasonsocial	org
@grownupsmag	human
@pratikkayal	human
@candycoatedpaw	human
@hungarianbc	human
@NYCTruckTracker	org
@MabsutMiami	unknown
@melianichung	human
@FitrichRb	unknown
@xharajukubunnyx	human
@mastacoschicago	human
@KariAnnKlicks	human
@rangison	human
@Vuedemonde	org
@onsantabarbara	human
@TomMorgan1049	unknown
@PorchaJ	human
@boccadama	human
@polly1976	human
@Shalz75	human
@AnaVzqz_	unknown
@redanedan	human
@MochaDaLyte	human
@SouthWestNY	org
@RachelMartino	human
@sarahjcook	human
@LWTTD	human
@rickrock63	human
@gmy203	human
@traceyscuisine	human
@AquaDSV	human
@k_l_maskell	human
@PhatCatt_BOOM	human
@Nazreen_Rahman	human
@VickiBensinger	org
@snazzynsuch	human
@sobeys	org
@saveonevery	human
@getbarback	human
@BigNickRobinson	human
@jeremszarek	human
@Zac_Posen	human
@hijorge	unknown
@DevinaJohnLewis	human
@makemoneyeasyus	human
@RidgelysRadar	human
@R_YL_Lai93	unknown
@xxautmnsflamexx	human
@BadmashFRQ	human
@Sophie__Pierce	human
@Notsostuffy	org
@bbakeshopny	org
@HalloweenBinge	human
@VivaldiMusic	human
@AdrianiuxSalcdo	human
@_gardenofeatin	unknown
@BunnyLittles	org
@zeroezeroe	human
@GRAACCEEE	human
@Massimoguerrera	human
@hiorimeiri	human
@cmokagatka	human
@carolinaware	human
@sofianycfrench	human
@TheByrdsNestV	human
@saadettguven	unknown
@ItsOnly1Deprina	human
@casualcraftlete	human
@RulfoMx	org
@thehealthymenu	human
@PHRCLeeds	org
@Jammy_Cow	human
@sainte145	human
@TheNourishedS	human
@MeiyanZMY	human
@powerxme	human
@ChocoboYuan	human
@royalozca	human
@sarajnp	human
@PARKCambridge	org
@JuiceBrighton	org
@jemlou1985	human
@embracethunder	org
@MzShortNSweet21	human
@OsteriaCasaTua	human
@InfusionBistro	human
@PizzeriaGoloso	org
@UkHour	org
@kilacheung	human
@madam_porpla	human
@Elaykins	human
@MansionNYC	org
@cheaujoo	human
@giraffetweet	org
@cruz_eliza18	human
@kaziest69	human
@ECigzz	human
@Boss_Lala	human
@Confusedmage	unknown
@dennisw87	human
@KayaNYC28	org
@AnaVlzq	unknown
@RubyLeesHHI	org
@JosephVenables	human
@anyneverywhere	human
@thelarderZA	org
@worldofastral	unknown
@StylishJourney	human
@PerformersPlace	org
@hotpotato01	human
@fullbellysis	human
@ValentinaCo2014	human
@lacromaticablog	human
@TwiPartyExpress	org
@fish_harlem	human
@bravemayu	human
@earths_choice	human
@marbque	org
@dupasseaupresen	human
@KrisKrosUAE	human
@DubreuilMarie	human
@AlohaShoyuHI	org
@onjanista23	human
@SSahilan	human
@ILoveHealth_	human
@Pector_Ales	human
@ichibanturo	unknown
@jhilaine_jc	human
@EugnieLe	human
@MattComicus	human
@RreemaGB	human
@kingandprince	org
@azleyabdullah	human
@NoisyDinoFamily	human
@LifeExtension	org
@kizianpol	human
@InimeGBoy	unknown
@mattiepeaelf	org
@beverleyhotelTO	org
@Komickarl	human
@foodbitch	human
@blight87snow	org
@thelifeofmolly	unknown
@lizzardking9	human
@alexhibbit	human
@medleyblog	org
@Dans_ma_Boite	human
@SarahHighfield	human
@LeModerniThe	org
@GutierrezDJNYC	human
@smine27	org
@BerylBomba	unknown
@vovkatevov	human
@boybeads	human
@PaleoPaleoPaleo	human
@BlairLipari	org
@Ariane_Pranata	human
@YBG85	human
@HouseofFaucis	human
@riuplazahotels	human
@ShosannaDreyfus	human
@alayahotels	org
@CNbiriyani	human
@YewookElforever	unknown
@Absoglutenfree	human
@eatright	org
@puanshafinaz	human
@TheStyley	unknown
@JulyVIIIIX	human
@ReggieFitness	human
@LycaDilse	human
@uprootfromOR	unknown
@DFGrilleHouston	org
@zutokoh	human
@CharlesettaSisk	human
@ExtendNutrition	org
@aliciahuiling	org
@RetweetItaly	human
@MyBigAppleCity	human
@rtv6	org
@primadonnasbaby	human
@WendyWa33	human
@mesjunkets	org
@NHairFreedom	human
@shenghermano	human
@eat365	org
@MidValleyPromos	org
@PackItCool	human
@KeanPeng	human
@EggandIOfallon	org
@brunchchalkida	human
@SakaeLunch	unknown
@bg_2yourself	org
@Lorisjourney8	human
@solaresandiego	org
@chcallegari	human
@LifeisaRecipe	human
@LynnYu1214	human
@ShopinStreatham	org
@Idan__S	human
@ettan0119	human
@epicuredL1	org
@twoforjoycafe	org
@BertrandMisterA	org
@SuburbanWines	org
@katsuisan	unknown
@Novitasari_F	unknown
@TavoLoera	org
@shokii	human
@katisha888	human
@Louise_08	human
@MossMarketing	human
@semeet	human
@I_smoke_you	human
@STuned_Cooking	org
@moutiz9	human
@hebakabrah	unknown
@sujudgandaS	org
@VisitKingston1	human
@Esmaltesypotis	human
@laquinta_soto	org
@DCMetroMagazine	org
@xJenn_n_Juicex	human
@necachew	org
@BronyRT	org
@Ettacwy	human
@go_duval	org
@Jilinangel	human
@valleyparkfarm	human
@natasyanatalie	human
@BlueLineSBG	org
@EliteCafeSF	org
@berrael85	human
@DarlingsDiner	org
@legouterdenanie	unknown
@toscanalatienda	human
@elow237	org
@ellycmt	human
@inMANADOcity	org
@DessertBossgo	human
@MissSustainable	human
@hakata_marin	human
@whelan1_alex	unknown
@zane_kido	human
@ruca1011	human
@ChestertonDonov	unknown
@FordsFish	org
@KuanAlice	human
@_jedi5diah_	human
@AnnetteChu	human
@pranay2112	human
@KylieCorral	unknown
@littleMsDisastr	human
@wassuppinkz	unknown
@Smoothie__Life	human
@AncestralChef	human
@TheGustuf	human
@CoverGap	org
@raghav_s90	org
@yellowcookies	human
@kevinkhoo94	human
@DanceMusicVocal	org
@Kat_Turner	human
@Merlijn74	human
@artestiq1	human
@vianneyelizondo	human
@zhungyi	human
@rudydracOO	human
@scarlettruby25	human
@fouroneohblog	human
@Rawan_Ghunaim	human
@kennedydenise	human
@JourneyOcean	org
@margaux1963	human
@playingchef	human
@eathealthy2015	human
@BuyersEye	unknown
@maryms1980	human
@OtresRestaurant	org
@SasaFreek	human
@MaximoLora923	human
@vegeTARAian	human
@BarSportMaiden	human
@ThatchersDNVL	org
@RotiMonAy	human
@HippieLove79	human
@stont4768	org
@anthonybaccam	human
@oliverdonjones	unknown
@TaylorTfulks20	human
@izzatjonid	human
@OxfordStreetW1	org
@Lappathelilyah	human
@Gnesisanselmi	unknown
@germainecsl	human
@alanslh	human
@ESWAGG100J	unknown
@pRncssLyssa	human
@miyukieee	human
@RevathyP1	human
@StFrancisPhx	org
@DukesDiners	org
@chenyingting	human
@SlyhKitchen	org
@chqmq0226	unknown
@GuillermoSlaz	unknown
@jacopodegiorgio	human
@YesiSao	human
@pbemag	human
@bigmama_young	human
@AmandaChung4	human
@JoanneIrizarry	human
@coralandmauve	human
@BG_garden	human
@patricialeblog	human
@EggandIDesPeres	org
@fourpointsindia	org
@ChaosColby	human
@djroliboy	unknown
@Its_Kay_Bro	unknown
@samc716	human
@Austar23	human
@haynaznboi	human
@rustnutrition	human
@FirstTimeMummy_	org
@Mabel_now	human
@DJMarco947	human
@craigtellis	human
@VillLicious	human
@Kunta_1980	human
@Selyemesi	human
@sco_sese	human
@roasbranbra	human
@mayumin0602	unknown
@themanchester16	human
@birdieluck	human
@MakeUpFairyPro	human
@Verushka143	org
@Christie_Clune	human
@annysszr	unknown
@IamQDJones	human
@BobsRedMill	org
@roda_iklan	human
@divalicious_m	human
@alcoholmanac	org
@Jessexca_	unknown
@MightyASLC	human
@NicksBoathouse	org
@BerryLip	human
@Time_Out_Paris	org
@WallyMagsFood	org
@Raleighfoodpics	org
@elsiesbowling	org
@Ramen___Bot	human
@EydaRahman_	human
@nuttykaty	human
@9thavegrill	org
@judify	human
@upbeetRD	human
@shasta247	human
@nohyunji	human
@I_Make_Sausage	human
@_Diablotin_	human
@HOWTOMAKEAKKY	human
@jh_pub	unknown
@VinSINical	human
@GunselUlku	human
@lucismorsels	human
@albafrancoa	org
@jcwnutrition	unknown
@JulietteBKNY	human
@ThaynaIvo	human
@cateringbm	org
@MANDPMODELS	human
@AndyAteHere	org
@littlemisshowei	org
@MarcellaPurnama	human
@kingkel81	unknown
@Curtisimage	human
@partypgh	human
@MrTVClassics	human
@miss05sexy	human
@trueartgirl	org
@LeCucumber	unknown
@Jimswan2	human
@PearlieZoza	human
@NewdealsEnt	org
@ReformSocial	org
@BrettHillery	human
@FitFierceFun	unknown
@Stormdrane	org
@gmason32	human
@chefo_in	unknown
@bgfulton	human
@BiiBiiBeauty	human
@TakeshiDemonkey	human
@JanisJoplin230	human
@mohicanbubbler	human
@Cat_Mobil	human
@kityleung	human
@Dechy_Vee	org
@G00dnesGracious	org
@Risingtidebar	org
@BESLEEKJA	org
@vivimeow	human
@catsstories	org
@mcmbot	human
@brookelippy	human
@SproutCatering	org
@allanjeffbala	human
@Syn_Athina	human
@Catch122	org
@Patty_2513	human
@Czosnkowa	human
@KritticalHit	human
@WaheedkiWeed	human
@erwinphillippe	human
@asyukinoko	unknown
@TheWellnessMama	unknown
@RunWithSpoons	human
@farmtoface1	org
@Darealest28	human
@hmjavio	human
@SylvieRochette	human
@PGHmagEAT	human
@yeechan	human
@GateBlare2	unknown
@dog_peover	org
@KellySee	human
@PaleoLeap	org
@LaLunaGodalming	human
@maralisalas	unknown
@yelpedmonton	human
@dennislennox	human
@DrC51Si	human
@ParkPlaceBistro	org
@Designthusiasm	human
@liveg2g	org
@Breezie_24	human
@Glenglen30	human
@MaxsSocialHouse	human
@vivian850210	human
@linda_pr	human
@RogerSmith_	human
@pongspy	human
@mellayamile	human
@iamoohsoome	human
@IllusionsPub	human
@tandoornflame	org
@WhittieBittie	org
@FredRoyals	human
@QuanietJ	human
@robann2008	unknown
@theKOLLAGEKING	human
@KatelynLopez527	human
@loriwellsphoto	human
@Iklan_terbaru	unknown
@CCapp	org
@iamAteef	human
@ibnu_KtG	human
@Moratti_Maria	human
@ZengoRSR	org
@BokuSuperFood	org
@Terrace_12	human
@redwagoncafe	human
@NewcastleNE1	org
@Iklan_TerUpdate	human
@NAGOMI_GINZA	org
@yakko7676	human
@OxfordFitness	org
@Francescaroncag	human
@Iklan_masadepan	human
@charleshyde__	human
@spartak19710	org
@DoingTimeAbroad	human
@dezzt	human
@AbsoluteFood	org
@savvychic7	human
@Nidura_Hahs	human
@thetedylicious	human
@maxcamposlondon	human
@Alexgee00	human
@pauloves2twit	human
@MsMariaE	human
@JoannaSormunen	human
@Gidgetwitty	human
@BrockDoomFORNOW	human
@CookitCanada	human
@mattetpauline	org
@Dtuned71	human
@FamousDavesMD	org
@Harri	human
@MarryLiu	org
@Chooks_cheese	human
@omoshiro_m1fUo	unknown
@andresv24210	human
@IklanHomemade	human
@koolaidmoms2	human
@kevmphoto	unknown
@maylifestyle	human
@TheCulinistas	human
@Miserable_Me1	human
@ViaNutrition	human
@saladelia_hock	unknown
@MyStayAtHome	org
@iklan_express	human
@Lovefoodleeds	human
@cruises_world	human
@waltzngy	human
@Bonapetittcom	human
@djvixenonline	human
@cafealfresco	org
@deb198	human
@_sara_e_smith	unknown
@Ami_missy	unknown
@BriannaSamanta	human
@BisnisPengusaha	human
@iamshhreya	unknown
@GhanaKitchen	human
@purplio	human
@lizinrome	human
@jruthcarlos	human
@PromoTerbaru	human
@yogadealz36	org
@DCNYATL	human
@northwoodsorgan	human
@mysticangel_9	human
@sonmi0111	human
@mightyarri	org
@apoldeapps	human
@RonGiese	human
@FlameStoneGrill	org
@Iklan_RT	human
@Lollergirl	human
@ipekie	human
@AndreeaCarro	human
@sorayadhamid	human
@DoUSpeakGossip	org
@Syahme87	human
@thefithousewife	human
@GimmeNomsLex	unknown
@haimeecode	human
@Luwita_huang	unknown
@eddiepereztoro	human
@purple_iklan	human
@AminehGetsFit	unknown
@sho125haru	human
@new_bar	human
@leluxure	unknown
@AgLocal	unknown
@miajonitaresort	org
@AubaineUK	org
@kcclaveria	human
@seasonship	human
@NickelDenver	org
@DEsUnion	human
@TheCorran	org
@DimitriTee	org
@MP111522	human
@EatElitePN	org
@ba_emma	human
@analuciaross	human
@the_real_d247	human
@AqabaMumbai	human
@Chef_outbreak	org
@WILDLV	unknown
@joaen2201	org
@real_EV	human
@GdLknOutBLOG	human
@hrgrill	org
@Mymummyspennies	human
@essy_indut88	human
@Tabasco_UK	org
@sketchdashaman	human
@KYVAN82	org
@green_kuniko	human
@evesparadox	human
@foodcustom	org
@Wow_SuperID	human
@PottsDiane	human
@Raksanand	human
@SmmrVbbrt	human
@zKaroKaro	human
@Iklan_JualBeli	human
@BenjaminGuzmen	human
@CkinAhmad	unknown
@mg_Miao_mas	human
@Probarmela	human
@atty_natzki	human
@ourgrowingpayne	human
@nowherebuttup	human
@Oto_matis	human
@TimmMcgee	unknown
@brasseriesixty6	org
@Veloorian	human
@Catch15DC	org
@xinerlee96	human
@DLNutrition	human
@kitchenuncorked	human
@paofrancobakes	human
@anna83wong	human
@robertaruiu	human
@LDBaking	org
@kureapayne	human
@FollowersIklan	human
@MariaGaragorri	human
@FethiyeLocal	org
@PascalWatwat	human
@BattleDiabetes	org
@MyOnlineShopAds	unknown
@RoXyGuRl33	human
@silvanaphiong	human
@GigaTools	org
@Gacktstream	human
@YEGEvents	human
@area_iklanku	human
@inher30s	human
@doneanamaria	unknown
@chitchat_chatty	human
@tsunagaru275	human
@nadabejaz	human
@dineanddrinkguy	human
@ferwe80	human
@evankleiman	human
@hooksone	org
@BonomoSilvia	human
@vibesounds	human
@lifeofanoodle	unknown
@Enkoosh_TonyNY	human
@ManneChenStudio	org
@FoodandHealthNL	org
@MexiCalbi	org
@tatsuyafukuchi	human
@Digital_Ad_Blog	human
@94Siau	org
@HilahCooking	org
@sanctumindia	org
@Cynth21994	human
@akibaokami	human
@racheltniu	human
@SweetaThanHunie	human
@TheVandersMedia	human
@alexischeong	human
@travelingfuture	human
@sahara_star	org
@VinniesCasula	human
@EatInChef	org
@KanalNuernberg	human
@LilybethPineda	unknown
@callmeMrLesch	human
@sabsab87	human
@ChefLuisBruno	human
@NajboljaMama	unknown
@JammaMikbert	human
@JuneJunIJune	unknown
@Arlene_L	human
@tapioca03	human
@IloveISwirl	org
@tenji_we	unknown
@nomeatforaweek	org
@limks_calvin	human
@TourismTOGuy	human
@itseclectichome	org
@JenKimCreative	human
@supersweeteejha	unknown
@misnoskcaj	human
@latcoot	unknown
@urbanoyster	human
@tzanakova	human
@EdwinHandoko	human
@ngsokkan	human
@OfficialGrabJab	org
@elaineJchoi	human
@andreaferone	human
@foodtrkinvasion	org
@RoannaRuizJamir	unknown
@HastagSerang	human
@merrijane	human
@TintoLounge	human
@budingaliman	org
@kumpulan_iklan	human
@GrandPark_LA	org
@PartyspacePhila	org
@BlogVicky	human
@cookwjennifer	org
@cutie_kri	human
@fightfortheight	human
@AnastaciaBGibbs	human
@ngscs2004	human
@vitaminbeetv	human
@andreagolzarri	human
@misat0_dx	human
@BerfinTanrivrdi	unknown
@GarcesTradingCo	org
@iklan_industri	human
@oblondinka	human
@apinkyaffair	human
@flyingwithfish	human
@KaraJMiller	human
@ljukeordan	human
@bewitchinkitch	human
@Daisy0322	human
@goowberz	org
@StellaYng	human
@WFMWichita	human
@seownicholas	human
@TheBLTtruck	human
@MoanaOrmond	human
@m2bin	human
@LatestHotelDeal	human
@FixedGearPlus	human
@NgyBunHong	org
@takamimichan	human
@sunshine3331	human
@shradhajain20	human
@copetincatering	human
@blueplatesamo	org
@Niecee_Rdriguez	unknown
@concheugenio	human
@LIBrunchProject	human
@Michael_HD	human
@OpiaRestaurant	org
@ilovearlingtonv	human
@Miyoungyoon	human
@Ace_aperkins85	human
@Marybel_Ae	human
@miajuana	org
@atmacaece1	unknown
@Deana422	human
@JeGa_16	org
@jeyflores	org
@GoBrooklyn	human
@pearlynyeo	human
@FedCityBros	human
@Fabio_PLC	unknown
@rudehealth	human
@AndreeHad	human
@actonepub	org
@RandallLandfair	human
@cuethecritic	human
@ananyariaroy	unknown
@MysteryChef1	human
@Pengantar_iklan	human
@natasha_UC	human
@myguiltyp	human
@WorldKitchenLLC	human
@anniehall35	human
@TheStyleMartini	human
@Sugih_D	human
@NelsonRizal	human
@canoeatlanta	org
@BoulevardDublin	human
@wrappingrebel	unknown
@VitaminShoppe	org
@websturr	human
@fornocultura	org
@WayneDCEO	org
@yukamatsuco	human
@sississima	human
@_o223_k_	unknown
@RetweetsEssex	unknown
@LisaAnnitti	human
@kamillasmg	human
@mysocialpet_it	human
@syuharu0219	human
@livingwheatfree	org
@LutskRaillway	unknown
@GSTACKS_ENT	org
@downtownbrantfd	org
@stuffedcrepe	org
@karenlovesmoz	human
@SultaanaBels	human
@urbaneer	human
@Sahasraraflower	human
@tami0607	human
@memeshewolf	human
@AFullPlate_Cafe	org
@merlionman	human
@gastronomia10	org
@KING_FINESSE_3	org
@cluuxx	human
@gourmand_g	org
@postingiklan	human
@davidfabros	human
@1spotlightdiva	org
@dessertladygo	human
@AriPutriBeatrix	human
@BallingerSibill	unknown
@grandmakitchenn	unknown
@RoundelCafe	org
@windytya	human
@hawaiianbaby21	human
@nnicolejordan	unknown
@TrueCleanLiving	human
@04Amman	human
@flavrbomb	org
@HinojosaCG	human
@DNM_LV_Bars	org
@SuperFrogky	human
@WareHouse518	org
@Iklan_Premiere	human
@danielleness	human
@cgingerich	human
@winwinfood	human
@K7K2tog	human
@Sabrina_Alex	unknown
@MilaMyloo	unknown
@HouseandHome	human
@Iklan_ladies	org
@andyyuwono98	human
@buad	human
@niczous	human
@PO_Box_Flic	org
@popqu0tes	human
@AdmirantShop	human
@jonas_aguiar	org
@ULoveAnnaB	human
@FoundingFarmers	org
@mariowspy	human
@DELLWAYTRAVEL	org
@Tangan_Pertama	human
@Frantzesq	human
@LaFrascaHfx	org
@hecc224	unknown
@Stonyfield	human
@FamilyCircleMag	org
@iklanin_iklanku	human
@CarolineALehre	unknown
@aboulfeth	org
@fascinationfood	human
@BBalaka	human
@WOW_Iklan	human
@naddelgermany	human
@nuthmania	unknown
@yoselinph	human
@ErickaUnderwood	human
@armisarmac	unknown
@BAN_News	org
@kevinakasharkie	human
@Coradorables	org
@CafeLequeux	human
@hungryemployee	org
@erinlaurawalsh	human
@lwsantiago	human
@iloveQueenieE	human
@VeniceBeach_CA	human
@mcndrl	human
@roxsybaez	human
@Salmontini_Jed	org
@Ace_Amazing	human
@DAISYBINKS	human
@mumdadplus4	org
@NORMASNYC	org
@GigiHuynhDDS	human
@huongforrest	human
@LilSproutsKtchn	org
@die_Dalla	human
@SawFirst1	human
@ChefRobGentile	org
@NorMyPrudential	human
@IPutUpNumbers	org
@NgoYourMeal	human
@KirimIklan_ID	human
@piecebox	org
@_littlemisslee_	org
@HerCocoaKiss	human
@monietoofly	human
@PhoeniciaBeirut	org
@MySocialKeysDC	org
@bukita_	unknown
@Millie186025	human
@BriefKase88	human
@Droshaf	human
@immiyulee	human
@twitpromoiklant	unknown
@ishtiaq539	unknown
@Carlo_Antonio	human
@FRBCRestaurant	org
@FoodGays	org
@RecipeGirl	human
@hellyhey	human
@MarketPubHouse	org
@yeswecouponinc	human
@Taketto511	human
@adl_hsn	human
@TAPSFishHouse	human
@SukhbirRadon	human
@lottigrant	human
@lGueuleton	org
@iJLGP	unknown
@sikimlounge	human
@StarsRooftop	org
@TTerrestrial	human
@ChartwellsMDX	org
@sonnywong001	human
@ibjefftan	human
@ammy33	human
@DiagoMariottaM	human
@_Steven	human
@PeachyTales	org
@mamapoolecooks	org
@EenaSensei	human
@akaroderick	human
@VanessaVicario	human
@urszulakozak	human
@happyveganvibes	unknown
@UKWomensHealth	human
@TizianaAurelia	human
@zalilahs	human
@tomo_yoneyama	human
@grandealbergoSL	org
@grubaddict	org
@federicafarinel	org
@hospdesign	human
@kimgecklim	human
@BlueLakeBrands	org
@LisaTAOX	unknown
@mipiacemifabene	org
@Eatmania	org
@TheCanteenNZ	org
@IndiraLabadie	unknown
@FletaSevere294	org
@ldlow	human
@SFGamerbabe13	org
@TipTopPlaza	org
@AuliaPhopho	human
@racheletlewis	human
@DickensPub	human
@tamazulokc	unknown
@deepbluesealove	human
@jtorres14982	human
@LBloggerRT	org
@LeslievilleBIA	org
@Gladess1973	human
@haaafeeezzz_	human
@ItsJTan	human
@Cute_iklan	human
@shedcafe	org
@Stinkyone4u	human
@IklanSuperGaul	human
@LadyRhubarb	human
@chetanrakieten	human
@reseller_info	human
@jamitwenty	human
@prenatalnbeyond	human
@cheska_manuel	human
@clc408	human
@Jills0182	human
@RebeccaAnn_Hall	human
@craftsmanmedia	unknown
@I_K_L_A_N	human
@LynnSaysHi	human
@slim_goody80	human
@ShwetainKitchen	human
@miss_peppyN	human
@AntonAdianto	human
@LiLDepotDiner	org
@MercyOgotan	human
@Writing_Destiny	org
@jcoconoda	human
@ReinaReinasofia	org
@Yulyan_Parwati	org
@Truffelufagus	human
@CalonReseller	human
@TakeActionWAHM	human
@LifeAsAnnie	human
@findmemymojo	human
@BarbieMarinelli	human
@Serunya_iklan	human
@VagabondFood	human
@iklanuptodate	human
@Signorelli_LDN	org
@seigalphoto	human
@bzhealthymama	human
@DanielaDiva	human
@LoveCoachChloe	human
@PenneLakewood	org
@hunteraven	human
@FrancoHair	human
@WujiLife	human
@valbenoist	human
@Update_Iklanku	human
@JessSKL	unknown
@PortageeApparel	human
@charles_tw	human
@sivibi	human
@BarbieSilvia	human
@humblerthanu	human
@StephY2Jericho	unknown
@ourpieceofearth	human
@vagabondent	org
@JayRogee	unknown
@MyOwnStory	human
@DirtyBirdusa	org
@Butter_Bahrain	human
@princess_C_sexy	org
@snacktimusprime	human
@real_Ary_	human
@luxurynshit_	org
@Doojyunnatsu	human
@missfreshinc	org
@JuliaOakville	org
@Twitt_Iklan	human
@MichaelStavsSC	human
@HEART_munich	org
@IAMBrittnei	human
@michellesnyderc	human
@kyrstie	human
@CottageonDixie	human
@kondimudau	human
@dcouveculinaire	human
@CheahSteven	human
@kibou_ha_egao	human
@h4rry_84	org
@MyinfoIklan	human
@NinNinH	human
@Laurence20502	human
@glttrvrywhr	human
@SecretLauZG	human
@somedayilllearn	human
@niiiik_	human
@CyberCash1	org
@banditnumberone	human
@CafeWorkhouse	org
@TheVickylicious	human
@stylish_gemini	human
@paulinahhh	human
@PasangIklanGue	human
@update_raya	human
@i_tiffin	human
@ShowbizManila	org
@Cestmoijullian	human
@atomdatcom	human
@denol_	unknown
@NaomiCreighton	unknown
@gortonsseafood	org
@XSkye1	human
@karinaturanova	human
@sy0_0ys	human
@niyasinckler	human
@Snacking_Bear	org
@anniesbarnes	human
@ironThonyP	human
@AboutFood	unknown
@PandaMyeonCandy	unknown
@tashasabs	unknown
@FreshJuiceCA	unknown
@namiasworld	human
@zhantraent	org
@SandiMcKenna	human
@IklanOnlineShop	human
@sitmnm	human
@dcdragbrunch	org
@BayAvenue	org
@adamgipang	human
@lifeourwayblog	human
@nergisekmen	unknown
@Ale_Bernardes	human
@sam_marvin	human
@jegoswam	human
@lovedbyparents	org
@glamoclock	human
@EatDrinkCentral	org
@Binzento	org
@keepupwithliv	human
@ratihibrahim	human
@migueangen	human
@ZinthiaIzabel	human
@jixter19	human
@EatingMadeEasy	org
@eatuptheworld	org
@_infiniteauto	human
@samuka79	human
@halalspotapp	org
@cHa_BurningSouL	human
@TariffDale	org
@HamptonsKiley	human
@preppiecurler	human
@MonicaaGDM	human
@Kennybain13	human
@theparkcafechs	org
@palinglaris	human
@NewLondonCafe	org
@WGFSonho	unknown
@danslepalais	human
@London_Places	human
@TheoSironi	org
@go_JAXfoodtruck	human
@CatasNewark	human
@SonCubanoNJ	org
@mikerice3333	human
@VeganFitnessUK	org
@OKKinderhookRG	human
@ZagatSeattle	org
@michele_elyse	human
@EuroBistros	org
@UpperDeckDavie	org
@DjTwistFan	human
@JoelDaniels	human
@CafeBijou1	unknown
@Luvbeinavirgo	human
@cheapandchik	human
@shi4arai	human
@PCademartori	human
@Qraved	org
@ginalee554	human
@britodwyer	org
@Mortons	org
@CultureCoffeeDC	human
@emmaglazier	human
@IZZICOMEIZZIGO	human
@andreallegro	human
@TamaraFarhat	unknown
@FreeInDetroit	org
@RobFiorenza	human
@lth604kt	org
@Luvless	human
@TeacherTrekker	human
@IoliasCookBook	human
@ClarenceCourt	human
@BossKelvin	human
@LifeByChocolate	human
@skitty007	unknown
@aloveafare	human
@AngleseyScMedia	human
@muzicfuzionfact	org
@kaosskitten	unknown
@JonathanOneLife	human
@ainteriordesig	human
@bi_out	human
@Iklan_men	human
@whissocialmedia	human
@KTanner38	human
@SkubyMediaGroup	unknown
@FoodConfidentia	org
@kenichi430	unknown
@risasora	unknown
@OlleiaValentina	human
@ipanase	human
@CrushedUK	human
@sodaicebaby	human
@1001_recipes	human
@Rafael_Manzano	human
@CarlottaMal	unknown
@VariationsBaker	org
@Mint_Drink	human
@Fountaindrink	human
@urkingbee	human
@Mr951Gerardo	human
@elarab88	unknown
@Salmitha33	human
@cafebelow	org
@FotosFred	org
@CADLoveOfficial	human
@panchopigna	org
@recipesreloaded	org
@bisnis_iklanku	human
@cadam_dam	human
@dygramly	human
@jeanisjeanious	human
@ShinoXxs	human
@Iklan24Jam	human
@happykidsinc	human
@prikol1001	human
@yourLBB	human
@sexyasstaji	human
@TheBetsyHotel	org
@KatlinAMk	human
@_sh0rts	org
@pippopunkie	human
@EveElfExo	unknown
@sergilop81	human
@WFM_Jenkintown	unknown
@littlehousetips	human
@PsychInTheCity	human
@GreatAlejandroB	human
@PageOnePR	human
@english_hippy	org
@barefootbaklesa	human
@mrstracey1972	human
@RajaBelanja_ID	human
@nicktendoe	unknown
@ChelseaRAR	unknown
@FucinaVerona	org
@cocomomobar	human
@OlivRomano	human
@TequilasBurbank	org
@diaflores	human
@FriscoD415	human
@arlynching	human
@SpoonsStilettos	human
@vickerysglenwd	org
@BlackLotusMedia	human
@EChanagasubbay	human
@boudinbakery	org
@thefoodscout	human
@NaturalExclusiv	org
@kellyonyc	org
@AlebuenaGuille	human
@oldsaltysbyres	org
@Asli_A_L_T_I_N	human
@gordsong	human
@100deAgave	org
@dp19812000	human
@EatLocalNOLA	human
@adesh_love	human
@KatieDeasy	human
@malusantanaz	human
@qrizshaqaye	human
@TheSocial_DJ	human
@RhongTiam	org
@AccelRadio	human
@inesmeows	human
@mistress_ishbo	human
@Lesli_Evie	human
@ChicFoodGeek	human
@yager51	org
@SouthprtRetweet	org
@LovelyInn	human
@Mhevenor	human
@sentientjoyz	human
@Hofkelsten	org
@Cathietotzkie	org
@KiasFitFare	org
@ngkn514	org
@MsFaison03	org
@GingerHenny	human
@BBWGeneration	human
@MaryBallinsheen	human
@mgavrielov	human
@rivet0122	human
@VONBAER	human
@texsaigga	org
@CCAquaticCenter	org
@bensbites	human
@silencescaresme	human
@chrisdof	human
@thebakermama	human
@triadfoodies	human
@sandragetzel	human
@princessrui	human
@coastalliving	org
@Pastey	org
@EnModeBonheur	org
@ClaudioBlotta	human
@hannah_yen	human
@flolau_b	human
@PhotosVac	human
@nicolesfitlife	human
@JSInteriorDes	human
@lauraaraquel	human
@MariVannaDC	human
@TheMysticBucket	org
@WAZROM	unknown
@EvelyneBrigitte	human
@iKimmieDiamond	human
@BlogCertified	human
@LiveEvents_fr	human
@pik0pal	org
@AnnetteLawless	human
@EdwinsCafe	org
@Zccez	org
@fernwehapp	org
@RoccaCamilla	human
@mixsa	human
@PFMinistries1	human
@deepuspita99	unknown
@JesusFe91	human
@sayblahblahblah	unknown
@LilyJBritton	human
@TheListWriter	human
@LoveThisSunday	org
@station92	human
@kicer_chef	human
@animorphs_84	human
@RinaRahmadini	human
@glorifiedtomato	org
@AOwenLDN	human
@sxrater	org
@TashSilva	human
@PositivelyStace	human
@FunSizeSaito	human
@sandUllrich	org
@mumtalkradio	org
@linamaharani_	human
@Superfuzzay	human
@IamKingRuffin	human
@elrayotaq	org
@TaiwanBrown	human
@photokolomna	human
@magoodelmundo	human
@latavolawtby	human
@MonMannequin1	human
@camille_rellosa	human
@Technologymind1	org
@Br1trainer	human
@GROD189	human
@4emilee	unknown
@heyitsmaharani	human
@shesaideditor	human
@BarrAndTable	human
@MsBrookeB	human
@Praewaawaa	human
@marciosame1	human
@fransrestaurant	human
@RecipeTaster	human
@gocoo_59	human
@marlodebratt	human
@BestWurstWagen	org
@ChanellAvent	human
@monse_sl	human
@JanineHuldie	org
@ginnygae	org
@ikululudance	human
@ShannyFoo	human
@iammekristine	human
@vitvitvitaaa	human
@iamryan_g	human
@MarcgrafG	org
@7oKurniawan	human
@FrooseNutrition	org
@mbm218	human
@arnelarquillano	human
@yusvk_jeda	human
@4ShellysFinds	human
@LOADINGBAYSA	human
@krhwon6	human
@Rinaldoromeo	unknown
@nicoleewayne	unknown
@roppolos	org
@justbeingarlyn	human
@kb24drive	human
@konakona91	unknown
@bekahann1982	human
@miss_simmons1	human
@THECOOKINMAMA	org
@sportschool	human
@LaBruncherie	org
@petersl93	unknown
@12thSouth	org
@spaceprince	human
@HosannaCatallo1	human
@dbl057311	unknown
@SabriNihari	org
@simtiaz	org
@Botany_Gaming	human
@radfordn	human
@0930422422	human
@Mamasboyathens	org
@BrownsLeeds	org
@abney_marjorie	unknown
@appledia3	human
@lillithtitania	org
@naachan0915x0x0	human
@Chefschulz	human
@46SHILO46	unknown
@AKMaleeke	unknown
@_AmitSawant	org
@dynaWY	human
@zactsmoker	human
@karynlocke	human
@NavigatorDream	human
@kexuann	unknown
@da1onlyfly1	human
@FilFoodMovement	org
@ammastifflover	human
@MS_Living	human
@detevents	human
@darkroux_la	org
@BreadBarBistro	unknown
@biarnylr	human
@Lima_London	org
@Snikiddy	org
@little_tin_star	human
@leblogdelilou	human
@bbullbbull	human
@Tyra642	org
@EEntertaining	org
@minavesguerra	org
@ArunNehra	human
@whatiatetoday7	human
@ParishATL	org
@johnpollardchef	human
@FantasciWorld	human
@CoolKem	human
@CoachHollywoodP	human
@tornadoperiperi	human
@anaanaas	human
@AlexandraTVSB	human
@mitsuru0417	human
@amomstake	human
@inablinkblog	human
@BurkhartThadeus	unknown
@princeaevin	human
@foodbabyny	org
@blast_n	human
@CARLOSPTRAINING	unknown
@TweenFinity	human
@IRSBYGOD2	human
@LailaSusanna	human
@livefit4u	human
@OttCityRetweets	human
@Twiniversity	org
@NaplesPizzeria	org
@babyginz	human
@DelloyeCoiteux	human
@ageukburton	org
@mahonchrissy	human
@AlbeeCheng	human
@nathanadney	human
@Eudaemonius	human
@MikeLikes2Eat	human
@MyOwnGreenLife	human
@SergioMendess	human
@garforthtoday	human
@threehappycows	unknown
@PlayPartyPin	human
@catelliduo	org
@babaklm2	org
@SeriLukel	org
@BellaMalulani	human
@MottaCuisine	human
@Iamkeiba	human
@CultureTripLDN	org
@WheelGoodFood	unknown
@Winnie_L89	human
@miracle7799	human
@Rachel_Nichole_	human
@kekidoll	human
@StevenNeo3	human
@ChefPBM	human
@fAsHiOnWoRsHiPr	org
@juliegozali	human
@Dalonsojr	human
@weelicious	human
@PatrickEGTT	human
@CleanDinners	org
@AlexCancino	human
@healthyAisles	human
@foodieMummyuk	human
@Oah_Picha	human
@josedamaceno	human
@ChicGeekNPetite	human
@theyoungatheart	human
@tjbefittoday	human
@PlatinuMeats	org
@MjPenthousePet	human
@christinaetsan	org
@IamCrisellaCess	human
@Danie_Lyn	human
@AustBrewery	human
@kiwiandkoala	org
@CovetChic	org
@LeesaBrok	human
@kazmic	human
@PistachioPickle	org
@MissFoxycouk	human
@RMLoSSTOP	unknown
@Dessert_Gallery	human
@edepsizhatun1	human
@BrynnyMD	human
@ZinkovichDarina	unknown
@MUCstyle	unknown
@OhBabyItsZelo	human
@BestiesBrunch	org
@elcatrinca	org
@andgrain	org
@RustyPelicanMI	human
@SBerryMarg	human
@shescookin	org
@NickPeccarelli	human
@lovetera_perez	org
@coop_55	human
@liburan_murah	human
@StephinThyme	human
@BMICalculator__	org
@BiancaGus789	human
@Clairedxxxx	human
@blackstrapsa	org
@websuccess	human
@liloolil	human
@pinkice88	human
@happyfitmama	human
@giokleigh	human
@AicahLin_7	unknown
@maizeblaze	human
@docjolt	human
@ReijStrange	unknown
@MilestonesPine	human
@y_chable	human
@lilieana_chia	org
@TheBestSteaks	org
@daimingsing	human
@ahdonnng	org
@anniesummerly	human
@JCBistro	org
@lovesfashion32	unknown
@chookschickens	human
@CanolaInfo	human
@Rita_RK	human
@shadman_nsu	human
@kepo_kompastv	human
@GavoCharles	human
@yaletownharlot	human
@SumerSloan	human
@fasanelli_xxx	org
@VikiALove	human
@JammJumm	human
@Corliss298	human
@AlejanChcn	human
@taiyou_1	human
@lbtmprescott	human
@MichaelKuluva	human
@LcSedlackova	org
@Sins_By_DAY	unknown
@TheNewburyPub	org
@AmandaYSK	human
@LeonasLalaland	human
@dadsthoughts13	human
@Averygabat	human
@ffurtado79	human
@PocoNYC	org
@Breadandbonesir	org
@Samantha1438	org
@MW_Nijmegen	unknown
@nonta3	unknown
@ChefAduAmran	org
@SpootyEhCaity	org
@KORasoi	human
@TheBrunchBros	human
@localpickins	org
@petpujaris	org
@pietromondini	org
@BANROCKGIRL	human
@RociDurrtt	unknown
@sch_christoph	human
@ms810123	org
@kongzz	human
@TerranEmpire	human
@iSaveEVERYDAY	human
@missjapan_	human
@jiahuilok	human
@goodfoodlovekel	human
@AAalipio	human
@taliclavijo	human
@IvyVeronique	human
@styleisland	human
@KODonnells	org
@sweetxiah1215	org
@WartaBali	human
@unchan16	human
@RunChristinRun	unknown
@AphroditeWatts	human
@wisat	human
@Gothcupcake	human
@1987payne	human
@WhitesofWexford	unknown
@LangCoffee	org
@cperk54	human
@chefsetmeals	unknown
@Jessejh_SP	human
@iezawawa	human
@Jared_Guynes	human
@3BrooklynKids	human
@XamachCuisine	org
@kiangii	human
@QRegenia	human
@KimClark702	human
@ScooziBoston	org
@vanyadhanya	org
@MyAtkins	org
@dudeforfood	human
@rawspiceuk	unknown
@ElisCheesecake	org
@KitchenGoddess3	human
@EglinGAH	human
@DeniVevurkova	human
@NeuvooNola	org
@BlondieMarket	human
@d0ug7a5	human
@fcbeasley3	unknown
@TuckerandBevvy	org
@TheJuicyFury	unknown
@select_sandwich	org
@CaboWaboLV	org
@yummyjeddah	human
@RunToMunch	human
@WanAhLun	human
@ParisianFlair	org
@ArnolVlsq	unknown
@AdventureofDomo	human
@babybabykim	human
@Don_Valdez	human
@melovelytandy	human
@JessicaWillemse	human
@Dominos_AU	org
@PharrellW_music	org
@1stGermanstore	human
@glasgowscran	org
@MeyWydia	human
@CHRISLAROT	human
@I_amMASTER	org
@tah007007	human
@GSOSales	org
@carawling	human
@YOB_JayDaisy	human
@JarredLemal	org
@imjeffmondragon	human
@Fitmom_team	unknown
@EatWearWander	human
@CutnCleanGreens	human
@lkatx	org
@spinzillaa	unknown
@ElynWoon	human
@nasa_nakada	human
@jrquero	human
@rayleecy	human
@designdrool2789	human
@VonViajero	human
@freelancelady	org
@soulifood	org
@nemotweets	human
@PerthBreakfast	org
@RicoRodrigo	human
@syawaerisya19	human
@ashlee_233	human
@CCI_Wine_Shoppe	org
@SusanPCooper	org
@CasaTuaCamden	human
@oliveandthyme	org
@charisedanopir	human
@MKTBAR	org
@FriendsGlassUK	org
@NancybrussellB	unknown
@CHIKIN_NUGGIES	unknown
@ArmndSolss	unknown
@Pablaxa	human
@AdieHush	human
@VeganChefApril	org
@patchispatch	human
@tuscanray	human
@Steph321delish	human
@TheFermtdFruit	human
@HendersonCox	org
@BPOND2K12	human
@VintgeWineTours	org
@Vilma342	human
@HeartMyDimples	human
@sincerelymindy_	human
@coco_nouveau	org
@SPOTNEWSonIG	human
@ToTheNextPower	human
@homedecorfashio	human
@Toomz_alm	human
@rebeldiana	human
@localkitchensf	org
@Jhpex	human
@PHLAVMEDIA	human
@ClearMedical	org
@MovenpickJBR	org
@_SP2_	org
@time4mehr	human
@AminaElshafei	human
@SaifsWayZ	org
@baovo	human
@BagelsCompany	org
@mrsinghssauce	org
@EPICNOODLEOC	human
@InstaTyumen	human
@alexzhdanov	human
@laxer1215	human
@sunsetshutterbg	human
@mischlane	human
@BeiFit	human
@SemFreshFruit	human
@AllyMcDeals	human
@AireBar	org
@7yakomq8	human
@MarcoTimelli	human
@PulsarXD	human
@SushiMyeonCandy	unknown
@journalmd	unknown
@Slaintepub	org
@Katelyn_Riley	unknown
@BoBSouthampton	human
@LPQAR	org
@sunnyrockjam	human
@Luchito_mexico	org
@EssentiallyJo	org
@dantelechat	human
@WTTRAVELLER	human
@IsabellaBeaude	human
@FredD8A	org
@ReadersGazette	org
@riamercuri	human
@seishun_bambiz	human
@hirose	human
@fashionvictress	human
@CasaLucaDC	org
@GarfishSeafood	org
@SousStef	org
@tvxqsol	human
@winnramos	human
@CJZenzick3	human
@BrittsBestBites	human
@jinglongbedok	human
@bigalbertg1	human
@pajaritorojo	human
@Christoper5610	org
@TorontoDining	org
@PenaflorDG	human
@NetworkGenus	human
@KatyaByMosquito	human
@AshaJMusic	human
@GregoryawelchA	unknown
@halfpintohoney	human
@CJE4LDeals	org
@LouiseFannin	unknown
@rjholmes123	human
@GrandmasterLynx	org
@RheaLeeMaria	unknown
@rurounichin	human
@elainezynzyn	human
@xiaomiix3	human
@golfpaths6	org
@alibeautiiroxx	human
@EdenRehoboth	org
@dindin_kitchen	org
@leelookelly	human
@IndraMuliaLEE	human
@i3thchild	human
@JudeBacalso	org
@chiangtiff	human
@MuddyMelissa	human
@T3008	human
@Urbancocktail	human
@VanJohnson18	human
@silvi_girlz91	human
@FloradalePE	human
@TrueTriniRed	human
@GoingP1	human
@ColorMeCrystalG	human
@pedrostoficial	human
@professorpixel	org
@dj_kajitsu	human
@DonnyYankee	org
@XJAPAN_douga	unknown
@AzureResorts	human
@hadskis_	human
@Tonny_Gho	human
@DoreenColondres	human
@ADajeer	unknown
@_goboom69	unknown
@AmySilbasa	human
@ritasiddiqui	human
@WynnKipp	human
@LOVEABLEMOE10	human
@MBDSD	org
@mermyblog	human
@kaikaikiki96	human
@RightCateringCo	org
@rillek	human
@cloudonna	human
@nobithaweiwei	human
@jbearmn	human
@DanielleODwyer	unknown
@msflamboyant5	human
@coolalaskador	unknown
@tawagoto_photo	human
@Desdenyc	human
@stewedapples19	human
@shashafadzeel	human
@polly674	human
@nieuwemarlean	human
@miumiuchan1	org
@laslokrasuljak	org
@AisfordArvin	human
@SuperSerge76	human
@TweetinatorBot	org
@meals_islington	org
@suntynut	human
@raphaelflores	human
@Nicole_Ada	human
@KerrygoldUSA	human
@cq_london	human
@adunlea	human
@Food_Choices	org
@sheol13	org
@Janyc2	human
@LPittari	human
@RevMariaFelipe	human
@LsnyMlgrj	human
@GhostCatfish5	human
@51CenturyWoman	human
@Swtsthrnbelle87	human
@lisaliecute	unknown
@OzziesGoodEats	org
@JenniMullinix	human
@Stacie930star	human
@WakeUpWithJC	unknown
@AntiJuneCleaver	human
@jennymichellely	human
@denekhesabi	human
@IheartBBQ	org
@reneetravels	org
@communecafe	org
@ABODEdoha	human
@comunicami	org
@cornstore_limk	org
@riofs14	human
@mybigfatscore	human
@tsu84	human
@Foodflashme	human
@shannonmackenna	human
@DJ_CYN	human
@GilgameshBar	org
@kjhammer	human
@piggy_love_food	human
@florafoodie	human
@JHQueenBee	human
@Bredz_Kuwait	human
@RoukoPoolInteri	human
@Cheesecake	org
@noheliacamposs	human
@waleed_bokubar	human
@OriOasis	org
@CruzinNitro	human
@kleinjinx	human
@savedbythekale	human
@DineAtOpus	org
@f0nqxu3ninq	human
@CladdaghPub	org
@WholefoodsIre	org
@mrs_petkovic	unknown
@iduckyboy	human
@Cleopatrasbling	human
@TheBlueFishJax	org
@ochit35	org
@KeepMeInShape	human
@akiaki87_87	human
@redsaltosaltos	human
@CrazyRoxyIM	human
@SerenaDesai	unknown
@BridgesCamb	org
@gelsonsmarkets	human
@schottenbabe	human
@FoodPandapk	org
@fatilatuti	org
@walterwilliam63	org
@nixiD_anderson	human
@tomorrowsman	org
@Kleinfallsreich	human
@macamillerivera	human
@chefaaront	human
@88_oceano	human
@luv_mydachshund	human
@MizzFHustla	human
@Blogmebeautiful	human
@cookrepublic	human
@steak_n_egg	org
@Mr_VEGtastic	human
@MoVe_TangSel	human
@xnickiboix	human
@WineGurl4u	human
@jeffwibisono	human
@UltraYOUwoman	human
@Djearwaxxx	human
@BabyMBS	human
@saisondupain	human
@fashionfoiegras	human
@typevega	human
@LuissCrmnna	unknown
@Escapeevents	human
@TheCaringTimes_	human
@DanielaBarlotti	org
@Angora_Boston	org
@NFBA2294	unknown
@firashaleemi	human
@albertoheineken	human
@DRYSoda	unknown
@kramsuperstar	org
@Bravo_McMan	unknown
@jmlpyt	human
@geisaccorreia	human
@NethertonNews	human
@DJAyeBert	human
@CEDGLOhiromi	human
@FreeRangers	org
@kieramarie11	unknown
@heyimpaulina_	human
@mdanif	human
@RichGodd	human
@AideCis	human
@WhispersInspire	human
@labellelune425	human
@Jaydon_C	human
@AnnieBraineater	human
@branchfm	org
@Eli_832	human
@JeenaIschern	human
@DrunchLondon	unknown
@sofiHuang	org
@jaysantos	human
@chanranma	human
@lita_elps	human
@SEMPheonix	org
@ExperienceNotts	org
@scatherinebr	human
@sherrymint	org
@BarrioStarSD	org
@LOCKEDOWN1	human
@sonohaus	human
@OhSoFuzzy	human
@GODDESSFAYE	org
@CPapouts79	human
@StapleFoods	human
@asaka795	unknown
@qedrehwmansaf	org
@gfbarkat	org
@Restbonapetit23	human
@annthecabby	human
@glaizapasion15	human
@LDNmessChef	org
@fashionsteeleny	human
@SansonMo01	human
@iiiFoN	org
@TheAwesamsauce	human
@Nordefors	human
@foongpc	human
@joshuacoad	human
@victoretwilson	human
@WoodfordCafe	org
@Merry120	human
@Alex_Humphries	human
@PatriaTO	org
@porrapam	human
@melissaguerralk	org
@ShanlliFermin	unknown
@JacksClapham	org
@NicoHer01	human
@missfoxyfit	human
@DFGrillePhoenix	unknown
@DirtyKanji	human
@Somewhere_Cafe	org
@FedeLozzi	human
@HealthyWitness	org
@AshleyDietitian	human
@larrywrobinson	human
@JennyBlogMode	human
@IHOP_Hawaii	unknown
@Omealo1	human
@sjbond83	human
@cloudlocke	human
@purenourish	human
@EricLeecx	human
@helenmet	human
@Ms_WillieB	unknown
@ScarlettBurn	human
@Cookordine	org
@BrendaKhuu	human
@EoeoLifestyle	org
@AnnalisaaRossi	human
@16177b17e46d434	human
@Lebistro_N8	org
@jelly_jan	human
@MyTurnForUs	human
@showchoirshow	human
@Bookalokal	org
@angieung	human
@ChennXu	unknown
@P4Polka	org
@__The__List__	org
@dcuga	human
@Marggarre	human
@FernandoMicheaT	human
@tommygee_thedj	unknown
@tiagoooliveira	human
@jackiedeburca	human
@MaryeStew	human
@WarLordwrites	org
@tikuwa05	human
@Healthiersteps	org
@drmz1982	human
@Josephinelounge	org
@mollynathanson	human
@bellezzalibri	human
@hello_lifestyle	human
@barbielaura	human
@AliLeonardMC	human
@Adobe_Sympathy	human
@ChefDesii	human
@lasvacasmeat	org
@PetitFoodie	human
@TheWBCrossing	human
@ReNewedMe	org
@rancioxd	human
@MacelleriaRoma	human
@amandaluvbb	human
@aff_beauty	human
@cookwithgrazia	org
@RailYardTavern	human
@2518ts2	human
@FairmontSanur	org
@ClairecanCook	human
@OisiiJP	org
@magnifiqueblog	human
@BayartoBaldanov	human
@Stephanie5788	org
@girlgoneveggie	human
@freshnewsqueen	org
@shortnorthcake	org
@derekfondue	human
@Station4DC	human
@HackettLady	human
@Travelmazed	human
@Mello_Lecter	human
@Bellinisokc	human
@gewae	human
@SimplyNeil	human
@iJayyQ	human
@MarketStGrocery	human
@TGISCatering	org
@MissLarue0518	human
@thefoodjourney	human
@rkozu	org
@ubicator	human
@ElevageTampa	human
@MasumiSenpai	human
@yukachaman61	unknown
@JustinTanTH	unknown
@ItsMeAnkeny	human
@Need2Lose13	org
@Today_Im_Eating	org
@joshk_12	human
@IngrdntsforDnr	org
@mur_nair	human
@clare_garcia	human
@IremKhan1	org
@1234Angelface	human
@melaneeshale	human
@NinjaBerry	human
@claudiamendezc	org
@iamXACHii	human
@Misty_Hunt	human
@Tobie631	human
@ravindran0707	human
@Mamta__Singh	org
@thehappycrab81	human
@DocBsChi	unknown
@cornstore_cork	org
@victorrusmin	human
@PitaPitRH	unknown
@shion0707shiori	human
@aimy0911dm	human
@AnyhooT2	human
@shinnygogo	human
@horny_tam	unknown
@CCBnMore	unknown
@DBLBLKcafe	org
@LouisaMcnally	human
@JustDanJenkins	unknown
@cyiphk	human
@KitchenNomad	human
@JavellaTreasure	human
@rideappdiscount	human
@J_Puffin	human
@JennyCraig	org
@surefyre_sales	human
@zhmeyer	org
@bexweller	human
@ghostofZeb	human
@iamkentpineda	human
@Deals4Worcester	unknown
@dhanny_ramadhan	human
@Stine_83	human
@LeMoonBear	human
@RandiGraceNilsb	human
@mojijung	human
@ccara_	human
@Da_Dream_	unknown
@M_IPIMPIN	human
@Andersenwifey93	human
@PowBB	human
@Lime_Toronto	org
@origintoronto	human
@ProjectSpiral	human
@NoLibsLocal	human
@AKB_thx	unknown
@amidala2112	org
@christisul	unknown
@chengpin89822	human
@JardinTan	org
@omoshiro_t1xSG	unknown
@TheFitGeekGirl	human
@PrincesaEspinal	human
@spendpennies	org
@Gerbera4U	human
@hassan_nasser85	human
@kopilighter	org
@Driffdon	human
@rjvalencia	human
@ilposto	org
@F00M1N	unknown
@choleste	human
@BakeryAndSnacks	org
@TaylaHanekom	unknown
@ryanwalkr	human
@dephitralala	unknown
@steer2910	human
@thetitimonkey	human
@Krasimom	human
@fusselfee	human
@carafelleman	human
@jamesywarren	human
@sawahtwit	human
@midtownmiamimag	human
@redneedlequilts	human
@HotButtered	human
@theproteinbar	org
@DonMiyamo	unknown
@robert_fierro_	human
@ScarbroughTaps	human
@catherinedonoho	human
@Joletapias	human
@SammiesMommy77	human
@laymembrino	human
@JaneDummer	human
@nnStffn69	human
@ReveilleJoe	human
@cblatzheim	human
@Mo7medTweet	unknown
@TheCuisineist	org
@green_corrie	human
@Mik_West	human
@5Recomendados	unknown
@daniellemcxs	human
@PANGAGAGA	human
@MelPinGu	human
@jennysfood	human
@damexican410	human
@nikkifrancisco2	human
@namennabot	human
@Are_YouFIT	org
@clydecang	human
@miriscastle	unknown
@MB_Nim	human
@yvonne_lw	human
@vosswater	org
@stupidman56	human
@watcheywatch	human
@yoshidacafe	human
@_homedecor	human
@FemiMeaux	human
@maisondetrecafe	org
@1plus0	human
@WelshBizEvents	human
@SouthernTemp	org
@zoobisou_	human
@sweetfoodie	human
@shahmeer55	human
@ezencoco	human
@cassiusroma	human
@Look_itsHasham	human
@GrandAmerica	org
@bot73030544	unknown
@Apuntate_A	unknown
@DavidSchar	human
@DFGrilleSLake	org
@princezpunch	human
@shakhalid80	human
@sdlocalupdate	org
@chrispevans1	human
@mthr5711	human
@RafaelaArtist	human
@StyleDecor	human
@misa_a124	human
@foodgps	org
@CohenJafif	human
@Darla399	human
@mislalet	org
@sucktheheads	human
@TimeWithSalad	human
@jennograph	human
@Greenberry_Cafe	org
@LayneWorldRD	org
@Casa_Enrique	org
@antoinechouery	human
@cyamamoto	org
@dbquottro	org
@SPJKT48	human
@phablifestyle	human
@FRECOPRO_TNB	org
@nero4david	human
@feedmefuel	human
@Swissotel_Syd	org
@ronblackswp	org
@katka1979	human
@cavamezze	org
@CafeBlueTX	org
@RubygcampbellG	unknown
@rusthawk	human
@NutritionVista	org
@PersonalChefKC	org
@SeedNourishment	org
@koffeeklatch7	org
@CarloArizabal	human
@thestephgef	human
@DenmarkFashion	org
@Organic_Portal	unknown
@mercurio3	human
@CheshireCatblog	human
@suuunita	human
@jude3z	human
@TheGreenOwlBB	org
@ChuppeeLove	human
@philthegeek75	unknown
@AKBBOT_	unknown
@WellerInes	human
@BroadgateLondon	org
@itsannavaleria	human
@astoriacremona	human
@NzMcKenzie	unknown
@estouest	human
@GianlucaOM	human
@RebeccadcookD	unknown
@Captn_Natty	org
@MissRuzu	human
@TerriRestaurant	org
@febrinahusna	human
@Jenny_Trip_JP	human
@regretfactory	human
@mcdonaldsindia	human
@nhinhai_kkb	org
@JZupnik	human
@aulyazr	human
@ForkReporter	org
@mhelmarbuzon	unknown
@streamusa	org
@jannphoto	human
@MaguyBoivin	human
@AvenueEatDrink	org
@Ninjapan	org
@TheDeckLondon	org
@bellasalamode	human
@80twentyrule	human
@MargyFlorence	unknown
@Bethany1202	human
@rence_g	unknown
@pretzelsrfun	human
@smultronhanako	human
@bigres20	human
@iamtiptip	human
@TheOrganicGrill	org
@Donnelly_Group	human
@Vegan_Sisters	org
@WarwickParis	org
@BreakThruRadio	org
@KatieBoBatie_	human
@NVilladar	human
@Daphne261114	human
@taicalvin	human
@waytogohealthy	human
@MobasserScorpio	unknown
@sacanaace	unknown
@foodie_soul	unknown
@gilnisarah	human
@ShowtymeRC	human
@AngyyMrttnz	unknown
@cakeandwhisky	org
@LeanGrnBeanBlog	human
@poonamsharma00	human
@tabehoudai_jp	human
@PALathamSr	human
@jamesvgrof	human
@kt_hugs	human
@wendyfulfoto	unknown
@kalehuapua	org
@BlueLinesWork	human
@bobbenjaminst	unknown
@NoSpoonNecesary	org
@Debbie17	human
@UrFriendBB	human
@transformyoga	unknown
@dennys6357	org
@PureSimpleWell	human
@GrciaMrlss	unknown
@LEMONESSE	org
@shadorunr	human
@Little_Bento	org
@xdivx	org
@The_PRCompany	human
@instanomss	human
@TheEfficientVeg	org
@AmandaGoodwinHC	human
@RebeccaB_92	human
@tamisperez_s	unknown
@dw_2y	human
@mommastuffblog	human
@AssocMediaLtd	human
@IKEA_Elizabeth	org
@mrodri92	human
@plsthepalate	org
@SalsaFotoGraaf	human
@BrigantineSD	org
@victoriakhanh	human
@hc100	human
@ccsyang	human
@PDG_Paris	human
@whiskeycakeokc	human
@momoresto	org
@WallisBar	org
@PatManzini	unknown
@ABOOMUCH	human
@instalentgram	human
@BargainFair	org
@jacquelynrbeth1	human
@KYOPPPPER	human
@heyli_a	human
@want_fun__	human
@Kelle3422558	human
@AmandaRldn	unknown
@theprovcouture	human
@Brynlln320	human
@_boomtimestwo	org
@marcolme	org
@DaPrincessJen	human
@HumpdayFunday	org
@Ein_Direktor	human
@WrittenRunway	human
@bumblebumble45	unknown
@heleenvandoorne	human
@_DroolWorthy	human
@yayopon	human
@BeingTru2Me	human
@MissCraftsy	unknown
@tymolll	human
@BuonanotteTO	org
@Hillbilly_News	human
@imperfectwomen	org
@ShapingUpMegan	human
@WanArifIzzuddin	human
@wilsonmaggie	human
@MorningLight485	human
@bdanjos	human
@Marie_Angelique	human
@blueberryzmia	human
@flowerzz12	human
@lucirebecca	human
@kadoyamitsunobu	human
@EatFirstHome	unknown
@rio_b2409	unknown
@solchisarsotto	unknown
@SortisBooks	org
@JordanUrtso	human
@TheBoMimo	human
@eieov	unknown
@kaveevivii	human
@StFoodieDiaries	org
@esangalang	human
@thefatdogla	org
@tevrdpasticcini	org
@BrutusMaximus15	org
@merkasilla	org
@iputery	human
@brunamebs	human
@keithcampbel15	human
@rdksf	human
@KavitaSri	human
@TamraWanderstoc	human
@Cartoonist_Poh	human
@ally_kearney	org
@GlitterifficMe	unknown
@alohamonkey2014	unknown
@ravenousmommy	human
@TheBloggersPost	human
@choulyin	human
@turners_f	unknown
@electricbamboo	org
@HalleelujahMom	human
@Ryklief001	human
@tyakur	unknown
@26GRAINS	org
@EatingFree	unknown
@sanmarcorestau1	human
@KyleSligh	human
@Downtowner_FTL	org
@BiteYYC	org
@Charlantino	human
@GadisBumSeungho	human
@SweetCinnamonSi	org
@thefeedtruck	org
@StepsofRomeDub	org
@raymond_cruda	human
@viancenutrition	org
@Duchessofdelhi	org
@dunningsmill	org
@AnnaSlgdd	unknown
@Chi_Chi1210	human
@SAVVYByYou	org
@Feel_the_air	org
@Gibbsy33	human
@GodstoneGreen	org
@cham_aign	human
@lnaturalchica	human
@sherie85	human
@drginareghetti	org
@iamyours_allen	org
@JavaDarrell	human
@pattyhernst	unknown
@DobrevAnna	human
@TorquayChamber	human
@toworkorplay	human
@rawrhubarb	human
@suzannestavert	human
@grubandgrogshop	org
@aconomika	human
@dltfashion	unknown
@SamuelFoxInn	human
@BelindaPonder	unknown
@KeenaDeCastro	org
@c4lin	human
@MamaMiaMaui	org
@LenaPhonekeo	human
@RebeccaBAppel	unknown
@niizealone_	unknown
@LetGamersUnite	human
@edenhonja	org
@thechattercafe	human
@tripp_313	org
@IngPhattaraporn	human
@icheerjapoy	human
@mannechen	human
@sockerpinglan	human
@genmark76	unknown
@2dayinmykitchen	human
@iamjessejclark	human
@MrMondor	human
@Jane2meBBCoach	human
@culive2ride	human
@URSSoviet	human
@Official_JAG_	unknown
@flfiona	human
@JaneRestaurant	org
@kann7712	human
@J0hnjury	human
@SELCASILLO	human
@kekulicafe	org
@ericflesher	unknown
@WulfhereWardell	human
@BLIKEFLAV	human
@KimberlyCheri	human
@t_niki	human
@ktb182	human
@Roszyar	human
@RockhouseVegas	unknown
@7_Numbers	human
@Hill_Market	org
@ChefDee1980	human
@Altafdarwish	human
@jets000079	unknown
@rychepet	human
@FlavorFinds	org
@CowandCoCafe	org
@trinielf	human
@wthegr8	unknown
@TashPR	human
@emilydjensen6	human
@fitfoodzcafe	org
@kommiepigbbq	org
@KHen06	human
@EstherKennell	unknown
@BodyByTiTi	human
@ChefAndrewR	human
@ginette4	human
@danimoreno77	human
@dasSterndal	human
@mackstheannex	human
@ColgandoArmario	human
@Jed7480	human
@bonterra55	org
@annipyhrr	human
@ChanchosTacos	org
@ally_hc	human
@FruitPastil91	org
@SaraRose_304	human
@foodiePrints	org
@niaeu	human
@iamCreationsArt	human
@Tommysdiner	human
@MANUELEMD	org
@danglinchad	unknown
@WilhelmNiekerk	human
@GlamSam85	org
@cazmonkeysround	human
@Edward5490	human
@asofiaaferreira	human
@LilyOnlineMag	human
@yellowstark	human
@sheilapthomas_p	human
@PittOphelia	unknown
@StephanyTullis	human
@nazuchan	human
@SaydeDajlala	unknown
@ceciliaccosgro1	unknown
@GraldineMartens	human
@cafeatpharr	org
@real_7_raul	human
@itselvis	human
@jaydemia	unknown
@mocosbot1	unknown
@chiemaru32	human
@Lismtsth	human
@Kroyla	human
@RentThisKitchen	human
@clarence34jl2	human
@TrishaHinds	human
@dccdn5360	human
@Foodmancing	human
@gladiator_360	human
@anoyu	human
@AhmetSamahaoglu	unknown
@JARConcepcion22	human
@realealessandra	human
@CitystarsCentre	org
@CeeBlackmountai	human
@hoteisfenix	human
@RestaurantRaidr	org
@elle_paras	human
@piempii	human
@EdenEats	org
@GiftIdeasItaly	unknown
@bentoncafe	org
@GalMeetsGlam	human
@BandanasBBQ	human
@saifulyusoff	human
@Lois61370500	human
@apinktypewriter	unknown
@katzerosarot	human
@thinspriation	unknown
@TamA_1234	human
@Maximo581	human
@IJusDntGivaFuQ	human
@pollyannahale	human
@SaltnPepperUK	org
@Nombe	org
@emmyd30	human
@marisamoore	org
@okmarket_ru	human
@JoJoBrand3	human
@carlossguzman	human
@HalfBakedLifeTx	human
@MissHenckels	unknown
@BradEringilliam	human
@FarmVoice365	human
@Lorenhia	human
@SimpleTrueFoods	org
@ELLEBelgique	human
@thirdstopright	human
@_Liziel_	human
@StreamNordic	unknown
@FregoLiving	org
@debthompson	human
@Meelat	human
@SHULA_LEHIGH	unknown
@mamafoxspantry	org
@RunMoniRun	human
@campnstyle	org
@djpumba	human
@87ead	human
@eleonorasperoni	human
@alexiegrabie	human
@italianhousepr	human
@meheartconfetti	human
@cristianmayabmx	human
@AussieMum3Kids	unknown
@DetoxDietFoods	org
@BhamNetwork	unknown
@GodOfParts	human
@public_fontanny	human
@AHealthySlice	human
@HASH_E8	org
@SamsAtLouis	unknown
@2boysandahubby	human
@engeniero_ako	human
@risotteriam	org
@cookincanuck	human
@IlkaCortesMusic	org
@FaelaMc	human
@esjeblog	human
@chigrl13	human
@callmeiss	unknown
@triplenickel	human
@sarcasticfella_	human
@mao_gallery	org
@angeloferrillo	human
@KerbEdge	org
@drakemount	human
@eatlivtravwrite	human
@dxbfooddiaries	human
@mattycornett	human
@ScrumpFitFood	human
@angelajzhu	human
@cornbreadjapan	human
@CoIchester	human
@SavoringSweet	org
@JaimeRuisi1	unknown
@BasedPron1	human
@ImeldakjonesK	human
@NVNTherapeutics	org
@kenshingurl2	human
@rkhooks	org
@Shaitaaaaan	human
@Styleintuition	human
@tyaasm22	human
@GardenVibe	org
@gocoo	human
@dilanibutink	human
@MorganDelight	human
@herronaitor	human
@MSARAB	human
@PeaceLoveCream	human
@mewinebrenner	human
@mejuicer	org
@paola_brodoloni	human
@blueviolet	org
@alleychook	human
@HeirloomLA	org
@HeshyJayScoop	human
@vomoca	human
@anliam	human
@FashionVictimHU	human
@gonnagetfitsoon	unknown
@SilvieArmas	human
@hopfieldsaustin	human
@Gracia_liem	human
@DueceHagerty	human
@visualconnexion	human
@Anna_HLM	human
@dishourtown	human
@dens0bill0s	human
@DFNNorge	unknown
@creeksideEnterp	unknown
@EVillaATL	org
@CareysInChaos	org
@renaesmithmc	human
@Willyum_30	human
@BrianGarrido	human
@ilovesweeties	unknown
@SunsolHotels	org
@TanabeTk	human
@oscargermone	org
@QuestForQue	org
@EllyJakarta	human
@Robinsbite	human
@kriselmore	human
@knowledgeofasia	human
@adeycequena	org
@CovertEater	org
@shopwithmemama	human
@Mangoat81	human
@LMbabak	human
@zakzenummerod	human
@GETINMYGOB	unknown
@YurimPLOY	human
@NixsMate	human
@JessieEmeric	human
@abouttoyz	human
@CancunCentro	human
@kentei_one	unknown
@Ashan_de_Silva	human
@uhWing	human
@Freebies4Mom	org
@flipeatery	human
@Ngitiero	org
@aaronwakamatsu	human
@shinichi0507	human
@_AdultDating_	human
@x_chyanne_	human
@missfetett	human
@Nyaboduch	human
@MVPOFTHENC	human
@ohsophianet	human
@takutomomama26	human
@JoeOng12	human
@LuissGtirrz	unknown
@goiya	human
@Homestyle_Deli	human
@healthydineout	org
@reachgina	human
@roger_m	human
@PaleoTown	unknown
@zeppy_drinks	org
@LmnMiddleOrange	org
@anykcul	org
@knlukenbill	human
@ThorpeParkHotel	org
@Sook_Kamata_Ta	human
@omgItsFunny	human
@DoTreesNotPills	unknown
@chillwinston	org
@israelfoodguide	org
@ViPhan	human
@aki_chiba	human
@wolveys	human
@AnneKPSG	human
@DarloMarket	human
@ArizonaFoodie	org
@marcolekliff	human
@mysqfrypan	org
@eltienutrition0	unknown
@gary__robinson	human
@IndulgenceCafe3	org
@bonparisien	unknown
@tonyarclark2	unknown
@kamari2001	human
@BrookeTylerxxx	human
@danieletsanchez	human
@halizafroon	human
@yessisafira	human
@DesignedByBH	human
@AstridYogini	org
@TankKayla	human
@alielengyelova	human
@KasnebNotes	unknown
@jubsan	unknown
@SmartyPie	human
@DinnerConcierge	org
@T2DRemission	human
@IlkleyReTweet	org
@jsfitkitchen	unknown
@BloodHoundBrew	human
@theshinycrystal	org
@Buenavistadeli	org
@ramanmau	human
@SyiedaZ	human
@itsJessicaV	human
@wifetoalineman	human
@FoodDoctorUK	org
@SylvamOpacam	human
@TheIntlFoodie	human
@WFMLondon	org
@alejandrossr	human
@MooreMischief	human
@samfreedman1	human
@SnapsRestaurant	human
@CoLoR349	human
@ina_majenta	human
@Su_Solo	human
@TannedChin	unknown
@iammikejustmike	unknown
@gourmetfoodparl	org
@mayet14	human
@HubbardInn	org
@TankHouseBBQ	org
@ayaji_777	unknown
@MsLadyfine	unknown
@AmotEatery	org
@JessicaAsher	human
@EsthersvaldezS	unknown
@ChaniceNykole	human
@Riyalove_1	unknown
@BeyondMeat	human
@HomesteadBlogs	org
@hnniedidityaa	unknown
@IndeBlue	org
@blueclan77	unknown
@Chompu_Kusuma	human
@allymann	human
@yumivino	human
@rachelannmorris	human
@HannahThompsoon	human
@snakenov	human
@apichea	org
@bellaboobos11	human
@elishabrady	human
@SnehasishDas	human
@KahliaandJake	human
@rjtzzzn	human
@IrinaInana	human
@GinandGriddle	org
@TrendingDish	org
@rn62	human
@MomDishesItOut	org
@picture_asia	human
@SofitelDC	org
@Grapevine_OKC	org
@PureBistroBK	human
@tweeetnadeem	org
@torareyco	human
@Remodel_w_Feia	human
@papersabq	human
@MarriottBloor	org
@Snocohousewife	human
@nidcinmar	human
@hakanmol	human
@JORGERIOSJIM	human
@mwalkerjazz	org
@Jxxsy	human
@Health_ByChoice	human
@TheJediRen	human
@LucasLinaress	human
@ElisaFagiolina	human
@DessertArtgo	human
@recettesduqc	org
@luyin88	human
@DonDurgad	org
@spiritandwine	human
@MilkRiverBK	org
@Feelgoodfoodnow	org
@Ritz_DvH	human
@Chef_Beave	human
@MarthaCWilson	human
@JustDJunior	org
@roxpace	human
@thegchild	human
@KawaiiRhia	human
@WestchesterMag	org
@samcyn007	human
@McEwanFoods	org
@tanxingjian	human
@ilenesjacobs	unknown
@TheGreyLadyDeli	org
@octavany92	human
@bordotti123	human
@LaciSue	human
@MrRuiz81	unknown
@Magdelina_Gomes	human
@wimpysdiner	org
@AzamaraJourney	org
@primabistro	org
@CinnamonChickP	human
@lb_yumecchi	unknown
@radkasokoliova	human
@SkinVitality	human
@RachelStarnes	human
@SherlyJones_	human
@ab_kimera	human
@benovate	org
@stoopidboi	org
@kerneljack	unknown
@terriclay	human
@AwkwardFoodies	org
@HealthOnAHigh	human
@LucysTube	human
@MyTweetsOffend	unknown
@SpeedTutorial	human
@AnitapochoaP	human
@Albertsons	human
@soymamaencasa	human
@LoveWithaJ	human
@BishopGi	org
@mikoleeforever	human
@SinghamIyer	human
@IngridMarionEVS	unknown
@GiouiN	human
@WinterSilas	unknown
@laurajberner	human
@CHOOSEDC	org
@SunprintCafe	org
@DFGrilleFW	org
@gurleengawrs	human
@CalienteClub	human
@WinkleRegina	human
@NakiaTakesNYC	human
@xuixaxa	human
@KrinRuizz	unknown
@KuaAinaUK	org
@kanzasyah	human
@NicoleHCook	human
@kosutano_	unknown
@Denise_Tanya	human
@mumtazmacaroni	human
@harukabanno_	human
@Cyborg_Moogle	human
@Foodseum	org
@amomlessmom	human
@zeppy_cooking	org
@banajiumu44	human
@queeniemojo	human
@DenisseMariie	human
@ABC60545914	unknown
@HappyOuaga	org
@UrgeMod	human
@abc36326292	unknown
@Gibitz	human
@PromontoryChi	org
@pure_purely	human
@thetwisttruck	org
@duyphuongdalat	human
@jpined2	human
@CelesteUrreaga	human
@whats4dinnermom	human
@19glas	human
@Dancingfrog1	human
@Islington_LDN	org
@NurdiahPutri	human
@myfatguyprobs	human
@andiboen	human
@LilMesican	human
@MPsukaigun	human
@cookingwcarlee	human
@manwailai	human
@ReviewsSheROTE	human
@SalutKitchenBar	human
@Cormelia	human
@aconsalvo	human
@_Debdas_	human
@arturo7214	human
@Jessica66233372	human
@minafurr60	human
@graciepatten	human
@thisis24	org
@DallasTalkRadio	human
@stevepike	human
@crow_ket	org
@since1219	human
@w_huot	unknown
@PolinaBrener	unknown
@JasmineN810	human
@iHERZfood	human
@kookys24	human
@Pepanut	human
@stylingamsterda	org
@tanyafosterfilm	human
@DrinkPhilly	org
@ashleyrstanley1	unknown
@Luz_MarieSB	human
@iwasthere102908	human
@FannyMontalbano	human
@LilyanaAziz	human
@Kuraranran3	human
@shannon_pang	human
@simoneadlen	human
@Running_ForLife	human
@EwanWBeauty	human
@ridisidi	human
@coolnailartist	org
@thehappypear	human
@thedanielasilva	human
@Blondedee30	human
@delRosario_fae	human
@liana1412	human
@KPNaturalHealth	human
@FrancescaScott	human
@Eyzdal	human
@PinkNizzy	human
@KCopulos	human
@PresumedeModa	human
@PandoraPhilipp	human
@LarryMcChainsaw	human
@Flowerchild0907	human
@cHiangdowz	human
@pendletwitch	human
@nomxnomxnom	human
@eastdevonhour	org
@kHevZ23	human
@MzMore	org
@QuintoKelsi	unknown
@KreiselJuguetes	human
@VZDSOKC	human
@ElizabethPoti	human
@RonaldNotMcdnld	human
@Tuscanyonplate	org
@BostonYV	org
@COMMIT2SELF	human
@colinbig	human
@deanne2622	human
@kkatie8	human
@suirenee	human
@funmiloves	human
@ethel_duke	human
@MissEstilos	human
@renalesphili	unknown
@The_Lipsticks	human
@menupages_ie	human
@AddressMarina	org
@drying123	org
@Prevention_Now	human
@vicvapor	human
@Geejeez	human
@iamedia007	human
@healthcoachbryn	human
@Kaylalove_me	unknown
@IronLotusPT	human
@byaworld	org
@juliet_valdes	unknown
@NedLuddNottm	org
@jbhotshots1	human
@matt_hew_boyd	human
@josephanthony	human
@Janinayyy	unknown
@jeejoongrong	human
@Rippche	human
@FindingFitMe	unknown
@thefatshallot	org
@ZemasFoods	org
@SpooksMcGhie	human
@KerryjcooperJ	unknown
@LocalSugarATX	org
@merh44	human
@gustoitalianouk	org
@MarketDR	org
@TAKAM1	human
@ClinkAndChat	org
@crazy4u2	human
@Aubaine_UK	unknown
@EvGBeats	human
@fikri_zainudin	org
@gracebrinton	human
@ResortAmbrosia	org
@alinahanna	human
@juliannamels	human
@Phrawsang	org
@Lenoirdining	org
@ReserveOutBey	human
@RoastersChicken	human
@oakplazagroup	org
@EarlsNorthVanTP	human
@ZoeCaja	human
@LiveOrganicRaw	unknown
@20YS	org
@SUPERRANL	human
@WoburnBrasserie	org
@ivanpareja	human
@LaGamellaMadrid	human
@Lazy_Cows	human
@lindaleenk	human
@blossomdesign	human
@itsoncardiff	org
@nathanmillson	human
@feliciasuwandii	human
@LuluMisha2212	human
@_HeidisPies	org
@farst4life	human
@TonyawjonesW	unknown
@candorie	human
@TRGarris	human
@ilovespicemama	org
@MODAsDESMODAs	human
@jewishladyblog	human
@shanzupanzu	human
@MO_ATLANTA	org
@stacymporter	human
@HuangKillua	human
@fattiedelights	human
@chambar	org
@Conny_V	org
@ceezworld215	human
@MannersandMoxie	human
@LizaIskandar	human
@ManukaKitchen	org
@TheHotPlate	human
@erikafsandoval1	human
@robinetlewis	human
@WeddingsbyJamie	human
@Leighs_Stars	human
@big_fat_diet	unknown
@TheIndieSloth	human
@teddypaan	human
@NewTritionHQ	human
@ConsuelaPrade	human
@ThurayaTalib	org
@louiselshaffer	unknown
@PartyIng123	org
@genevievevarela	human
@DearDamnDiary	org
@tobycarvery	org
@theeatsblog	human
@hebetobubu	human
@Tedsandtreasure	human
@MadeleinesPlume	org
@AmericanaRest	human
@ChefDavidBurke	org
@elzara3003	human
@sorayaanzela	human
@nesyaluveria	human
@MissLadyAmes	org
@smokebark	org
@sunshinehoy82	human
@cywong_	human
@IsaRico12	human
@SPANESS	human
@EXASOLAG	org
@benzoates	human
@PipperH	human
@Flor_Acosta_	org
@MartinMonjes	human
@RachelNgom	human
@blkbry_XD	human
@VidaCantina	human
@weightloss	human
@OptionsExotic	human
@StDavidCoffee	org
@sweet_melanie	human
@BackpackerPH	org
@GuyOverboard	human
@MyCakesWA	org
@iamnarapradja	human
@katorubi	human
@Galbi_jkt	human
@VeganEventsScot	org
@ChiaraBarbierii	human
@fitfulfocus	human
@JamilBryant	human
@GarvieMilngavie	org
@AshleyDeWarrior	human
@takitokitchen	org
@DEFisPROMISED	human
@Cjolliff9	unknown
@TheRusset	org
@SerranosGrillLV	org
@Fulgenciothe3rd	human
@SavingcentsIL	human
@fashionhasit	human
@sarahkayhoffman	human
@Knolis88	org
@cloniragire	human
@JambaNewOrleans	human
@LindaL2K	human
@iammichbengco	unknown
@BrigitaSirlova	human
@InZtynto	org
@ComoCity	human
@RicheezeMelts	org
@Inke_b2st	human
@Culinary_Local	org
@AngelinosMarket	human
@wtgNYC	org
@jroca328	org
@Dihan_desilva	human
@krnpop	human
@jerickRIP	human
@e2dietitian	unknown
@Oaktreecoffee	org
@a_hmed_a_hmed	human
@ma__dk	human
@Farahanipour	human
@rubylorikeet	org
@samlloydparco	human
@Ms_CAiKen	human
@weKitesurf	human
@sallysimpson11	human
@djnobody	human
@TheJunction_Pub	org
@Rec_23	org
@antontestfree	human
@KukuiSugar	human
@nisa_kay	human
@BeBuffFitness	unknown
@MommyBKnowsBest	human
@MothershipDC	org
@TastefulGlamour	unknown
@tedricotink	human
@bkfarmgirl	human
@saculafubuki	unknown
@djawtkazt	human
@princessjjx	human
@LiderGrill	org
@enchantinghost	human
@EarwaxXx	human
@bodymorphia	org
@CalleLillyCafe	human
@KristineAnneMee	human
@engineersialvin	human
@CharltonDaniel1	human
@TheDairyRD	org
@vega1710	human
@hadeelmoe	human
@VogueParis	org
@chuechebueb	human
@boot131	human
@bupphauk	human
@BolingLiam	unknown
@theperrybook	human
@ThuLegit22	org
@LeeHillerDesign	human
@lindarprince_r	human
@gsonu3	human
@PoppyKentish5	human
@CarminesVEGAS	org
@Avrileja	human
@CarmengkirbyG	human
@LiFEs_EASY	human
@NurseKarenRW	human
@VintageTeaChina	org
@Just__Gabi	unknown
@BouledePoisson	human
@ThatVeganChick_	human
@ndroe7	org
@theperfectfoods	human
@kabu_oilpaint	human
@AoifeManning	human
@NorieminY	unknown
@ADG_Moore	human
@karincoger	org
@techi_techi	human
@FaggyFreaktion	human
@BenGoldstone	human
@MaurineDevan	human
@SSNellan	human
@xLadyBlack209x	org
@TryCaviarSF	org
@luvgardening	human
@EvooGK	org
@theBMITW	unknown
@shaewilbur	human
@GarethHansen	human
@Tweetybirdgirl7	human
@sneakerheads13	human
@MissyOnMadison	human
@theexhibit	org
@xcori	human
@LisaWiertel	human
@fergiorno	org
@DoughboysLA	org
@G_RoundNeenah	org
@deannafletcher	human
@clairecraves	org
@YuiMugino	human
@RobertaZollino	human
@INFAMOUSDIOR	org
@chintankamani	human
@SenshiRojo8	human
@LycaDilse1035	unknown
@liow_ju	human
@paulinenotluna	human
@GiftedPrude	org
@TamraMGibson	human
@NanchatteTaka	human
@derrrfay	human
@BizzieBabyUk	org
@GoddessAsha	human
@1983MR	human
@LittleSandyW	unknown
@VenomousLeo89	human
@Beautylicious82	org
@dailyarchdesign	human
@BxYASELFmedia	unknown
@TheTastingCo	unknown
@desi_baker_boy	unknown
@decoraitons	human
@victoriavisitor	org
@AttemptedAuthor	human
@roidmj	org
@nadyatul_nadya	human
@Cafe_Brightside	human
@iosiswellness	org
@WickeD_WomaN_S	human
@suekitty13	human
@Promos_ATX	org
@JustOneSweetRun	human
@ThePascoDrei	human
@grietvanhees	human
@mamiof3kids	human
@MetroDetroitMom	org
@AbgAngesemeuz	human
@Mizz_key79	human
@RosesVancouver	human
@GonzWidDaWindz	human
@matthewfecteau	human
@thingwone	unknown
@HenryBloem	unknown
@todocancun_re	human
@LamaGhaddar05	human
@hotel_303	unknown
@tastewant	org
@ChefLekliff	human
@bberrynaturals	human
@Pichodotco	unknown
@KellyByVi	human
@wANNABEITT	human
@RiverbankBuffet	human
@EarthlyHabits	human
@devicescatering	human
@reptiles	org
@GanjuShambavi	human
@ayacco_p	unknown
@JimmysSeafood	human
@_manikdepresif	human
@TestSlayer	org
@PlateauCom	org
@CidRoberts	human
@victorialoveU2	human
@SocialClubSurf	org
@yumyumtree	human
@marianic36rich	human
@Jamie_Learning	human
@BaBuhBlacksheep	human
@bschaefflerc	org
@sirius46	human
@purelyelizabeth	human
@Dj_Funkysara	human
@lixa13	human
@vmyasaroglu	human
@simonesfitquest	human
@Bodyfatcoach	unknown
@michalski_lisa	unknown
@thejanetalice	human
@Provisionfit	human
@mammaonweb	org
@MagdolinB	human
@ElleNoirMakeUp	human
@SushGirl	human
@parispagesblog	human
@bonbonbonita	human
@Papplepaps	human
@viva_lara	human
@RDNmommy	unknown
@MakeItWorkMolly	unknown
@Lanes_of_London	human
@luvthenorth444	org
@MezanGroup	human
@jaru1	human
@dj_remmy	human
@smartlynx_web	human
@CoachKalista	org
@mr_gadget	human
@TrimstoneManor	org
@NORMA_2HOWARD	human
@keileenrosew	human
@chewiemon	human
@TOfitnessgirl	org
@DIAMONDDIVA6869	org
@watervampira	human
@putririzkititan	human
@SastrePaco	human
@McQuadesMarket	org
@NutritionwWendy	human
@Carmine8623	org
@denstreetfood	org
@champer153	human
@HedonistShednst	org
@bondziiee	org
@jadeember	human
@KristelMacdonal	human
@jasmine_espinal	human
@joanaddicted	human
@WestwoodVillage	human
@LouisacdPearle	human
@NeilleBC	org
@BritneysTube	human
@carlod820	human
@AngelaVeronica3	human
@oskarpcrespo	human
@aido_sti	unknown
@TropBananaTart	human
@OhMaeI	org
@hirosemai0207	human
@FoodIntended	org
@MO_WASHINGTONDC	org
@meatmerchant	org
@deepellumboston	org
@isuzum	human
@Ev0Lchik	human
@pan0721	human
@Robbie_lorraine	human
@styleyuhki	human
@LaughAndLoseIt	human
@LoriLynnLydell	human
@gerboyjj	org
@chowhoundgta	org
@MelissaKollar	human
@kealro	human
@Marc_Iron	human
@makeeba1780	human
@MoodiFoodi	org
@WorldsOfTara	org
@toptenthailand	human
@anoopsamraj	human
@rankingu_birth	unknown
@arycouture	human
@ecrye	unknown
@djrichied	unknown
@TheBlkHorse	human
@PartyLikeRico	org
@Emily_casta	unknown
@BirchCoffee	org
@evilcybercom	human
@KouzounasKitche	org
@Diner_Foodie	org
@TonyTuesday	human
@garlicmysoul	human
@BetterRecipes	human
@MonasDailyStyle	org
@mehmannawazi1	human
@angelwaters101	human
@jenzy777	org
@pea_tango	org
@afraliza	org
@dhronahumor88	human
@ChefLarryEdward	human
@PatriceKinley	unknown
@CLXR	human
@NirinaXX	human
@Mjm_macario24	org
@Josaan_21	human
@SavetheBaker	org
@MsRiko_xyz	human
@dawnbarber87	human
@getkahla	unknown
@SuzannedenToom	unknown
@aliciababy44	human
@lauri_bennett	org
@LeilaRestaurant	org
@IsabelleBianchi	human
@art_torikku	unknown
@MissJMGray	human
@Anna_krizzy20	org
@EmmaLake38	human
@divaqueenkim	human
@kayleblogna	human
@tanfolk	human
@joblijob16	org
@SusanbburnsB	unknown
@coltsmith	human
@angelinatallis2	human
@truffleandsage	human
@burrp_chennai	org
@FlorekFan	human
@Yara_Davenport	human
@pikkel	human
@ForgetfulMomma	human
@ShabChicDelight	unknown
@ICYU_N_V_ME	human
@Jeremiah140	human
@WholeYum	org
@ArieSeyy	unknown
@Rezagrats	human
@HayleyM_G	unknown
@losanno	human
@derick_sy	human
@jbenitezjr83	human
@SpectacleWonder	org
@4Ingredients	human
@HealthierMI	org
@Dallas_Picks	org
@BestTalkRadio	human
@ninjacentralNZB	unknown
@benjamincazorll	human
@ErikBlanks	human
@crowdmapped	org
@Amy_Hoppy	human
@RyanPigNDuke	human
@roseyroseann	human
@eatsouthfork	org
@shakeout07	human
@EggandIChester	org
@Shermandeloz	human
@aruco	human
@chldbrtheducatr	unknown
@CliffHCohen	human
@free2bimperfect	human
@NiamhsClonmel	org
@sweetphi	org
@CrazyBlogginMom	unknown
@jlslsd	human
@ammarorfahly	org
@ZOOOOMBMaster	human
@MacroMeredith	unknown
@RymADay	human
@Caliente001	org
@amichetti	human
@g_freedman	org
@DonaGershovich	human
@valeriegnow	human
@lovekarinamunoz	human
@Njoythestyle	human
@desnjen	human
@elo1617	human
@BellaBicchiUA	human
@JuliaDJordan	human
@rytkosenpetri	org
@Healthy_MC	human
@iam_AWEE	human
@PennyPincherJen	human
@wuppy	human
@SouthEndCLT	human
@saptarshi_de	human
@culchethchat	org
@richardopoliman	human
@timmyreiter	human
@keralajane	human
@RahilaHussain1	org
@CindyRys	unknown
@feliciatjoanda	human
@nido510	org
@Biteappy	org
@jcjintalan88	human
@PakAnCikYen	org
@z_snyder1	human
@carlosbuk	human
@htagresto	human
@farhanabodi	human
@InverNadcor	human
@JannAmber	human
@BlueNailGirl	human
@TweeturbizUK	org
@mrsmckay86	human
@sethirteenkay	human
@ceccesblogg	human
@ozwaz	human
@Miel_Jade	human
@Antika_Jeng	org
@annie_phang	human
@AKPTRSVC	human
@glandix	human
@MsSkinnyfat	human
@AldacosDowntown	org
@COUPONS_CODES_	human
@flirtwhoa	human
@bettyjbright1	unknown
@Reetha_Menon	org
@UrbanFondue	org
@staziieladypink	human
@instagrmNYC	org
@florence_haa	unknown
@UlissCrmnn	unknown
@aarongproblems	org
@littleoddforest	human
@Karriarkvinna	human
@Sabi3Dee	human
@kathleenmkenne1	unknown
@2thekitchen	org
@meta_guide_id	human
@RicksCafeCT	org
@dj_waami	human
@zenas_suitcase	human
@maluwkaxxx	human
@betweenbites	human
@vangieogg	human
@peddlerandpen	human
@BASVANSCHAIK	human
@ShiZuKaPeaR	human
@F_R_Group	org
@n76seary	human
@MissYanaO	human
@JBDana1	human
@HelloFood_UG	org
@modastylo	human
@Manifestoresto	org
@InstaKommunarka	human
@discovereaston	org
@GourmetMum	org
@Ralana_Eatery	unknown
@IxxyPoco	human
@arianagernet	human
@UrHealthNut	human
@iLuvHardaf	human
@Francis46035289	human
@valentine311	unknown
@RaphRoad	human
@bakemydaymid	human
@lovelearncook	org
@sunan_andry	human
@FyodorovSofia	human
@Au5en6	org
@GloriawbriggsW	human
@abangnazzery89	human
@im_famous1	unknown
@StylishBloggers	human
@Juize_Juice	human
@ujeans0511	org
@PinPin0624	human
@JJ_Fitness	human
@minazuki510420	human
@plurVErt	human
@MLandDeb	unknown
@dredjennings	human
@la_una_vega	unknown
@chuy_bazan	human
@MendezManor	human
@AlpharettaEats	org
@Flamme_	org
@OladimejiSanni	human
@jessesteepedtea	human
@Frenchparfait	human
@OJsFtSask	org
@AmieyZulaieka	human
@rcreiner	human
@yanshibrizuela	human
@vinot90	human
@stacykennedyrd	human
@atuL_H	unknown
@RachelsPantry	org
@emmiesays	human
@310Restaurants	org
@BazziCaroline	human
@RobCADph	human
@jakobi_claudia	human
@NeuvooPartTime	org
@andirabintang95	human
@DJSteelArms	human
@rellkincade	unknown
@healthymag	org
@pvhvhp	org
@AtomikKKittie	human
@Janellcp	human
@michaeldc09	human
@eMazingLakeview	human
@LPQes	human
@onewsconditionn	human
@morrisachang	human
@saverspender	human
@LouJFitness	human
@mireiaverdu	org
@ViB_tuscany	human
@UncleTom6969	human
@yuppyjasmine	unknown
@hutoranai_	unknown
@laurenkate_xo	human
@riraevansville	human
@27SoloCutie	org
@Slimwithkylie	human
@spaghettibites	org
@courtam3	human
@RibaStillorgan	org
@AramingoDiner	human
@BatamDine	org
@kimmibaby1219	human
@em4ecu	human
@TweetWTFiWant3	org
@AHLFM	human
@technomic	org
@SWAGATHABJAGGER	human
@eggsoeufs	org
@carlomezzano	human
@cathyt23	human
@xQueenChyna	human
@breeannelove	human
@thescramble	org
@NOTLcottagerent	org
@RickSpeed	org
@yamori81	human
@SpiritCruisesDC	org
@hannah_hoskins	human
@tipsyteapotcai	org
@NightlifeDAL	org
@aturmadalulu	human
@KristinBlasiak	human
@laurieshan	org
@ElisaCuteGal	human
@Amandas_tweet	human
@KitchenAt149	org
@abhikbee	human
@TurksHeadTW1	human
@Docs_PHL	unknown
@jssgllrd	org
@skkanme	human
@lollipop_punk	human
@equilibrioSvida	org
@leansmn	human
@hirot4444	human
@watzis	human
@mustbepearls	human
@rheyrecto	org
@servicefeedback	org
@iHealthOasis	org
@Raivyn	human
@marshamaung	human
@FlorenceDj	org
@FashionistaUY	human
@Jordansmyworld	human
@RicanInBoston	org
@ninomihime	human
@britsinnyc	org
@vegsoup4thesoul	human
@VIOLAptuous	org
@nigelfoong	human
@250bot1	unknown
@LadyLetItBe	human
@YourKurriosity	human
@MissCarlaJeann	human
@mrceojks	unknown
@davewatts001	human
@HeavyDutyMarcus	human
@NarrowEspresso	org
@HauteTravels	human
@PoloCocone	human
@TabbedOut	org
@Billiam23GTI	human
@madridmeespera	human
@NoddingHeadBrew	human
@SavvySavingCoup	human
@chitownlexi	human
@GraveneyMeadow	human
@savannahcoffee	org
@shesconnected	org
@skinbarlady	human
@SarahJane379	human
@JuliejmilesJ	unknown
@coccinellapoco	human
@Cutiej0hnM	org
@Alyss_	human
@PhylliskabbottK	unknown
@DarrylZeuja1995	human
@Skawty86	human
@pdmkitchen	human
@ndyken	human
@CotswoldsConcie	human
@ImAlexanderJohn	human
@thespringsla	org
@mamatsita1	human
@okatak56	human
@dizeedeez	org
@doc4k1ds	org
@AlifcHen	human
@TheDiva2Know	human
@FancyWithStacks	human
@RedSquarePhoto	org
@alamirportland	org
@asronatypes	unknown
@iammickeymark	human
@AMLIRiverNorth	human
@yuchi311	human
@nyceclubs	org
@cgtobias0709	human
@juliatengko	unknown
@Annalycis	human
@CruWineBistro	human
@MarianaMus_	unknown
@sharonskitchenx	human
@LaTerraFina	org
@SandwichTimeNJ	org
@KristolKlear	human
@MarionCalifano	human
@EvertGelilah	human
@MO_BANGKOK	human
@ohmyMMY	org
@freekaz	human
@knnarin	unknown
@SuzanneGoin	org
@foodcaterpillar	org
@angelaminelli	human
@Athlons	human
@WildFlowerCWE	org
@lnkovacevic1	human
@housedecorators	human
@SauceComms	org
@craigoboyle1981	human
@ImaculetC	human
@DelectableM	human
@MstrBrown	human
@onakapunyo	human
@J_oceanman	human
@MamaPeinao	human
@InstaUlanUde	human
@DeliverLean	human
@spam_gm	unknown
@AustinPicks	org
@BrightVibes	org
@CrysPeterson	human
@AnnalouElliott	human
@fuiks	org
@aianmejillano	org
@NickcCollins	human
@benz1171	human
@lindsayuka	human
@BreraBursa	human
@rdanna	human
@Iriscafeportici	human
@chrismoore62	unknown
@panoramicbanana	human
@bunanababa	unknown
@yoo0129	unknown
@BupeNgoy	human
@britfood	org
@kinkanism	unknown
@gerdstig	human
@EssexBridalTalk	human
@balancechaos	human
@nina_ferres	human
@scunthor_pe	human
@stylemebymayo	human
@_sarahtsang	unknown
@Mam_Cia_mommy09	human
@stclementscafe	org
@toopye89	human
@DFGrilleCH	org
@HmSchoolDisney	human
@Fyodor_Cafe	human
@StylishGeek	human
@KishaCG	human
@Sweetandyummie	human
@Pumpernickels1	org
@sheelalabsmusic	human
@SteveChooStevo	human
@OCE4LDeals	org
@Amy_Dess	human
@VecchiaMacina	human
@notimeMom	human
@Brightchamseo	human
@TheBaleNusaDua	org
@localdeli	human
@treeshurts	org
@StepItUpwSteph	human
@BanyiDublin	org
@Tap42Bar	org
@GabrielaMarinaF	human
@boultersuk	human
@MrsVendez	human
@SaxAppealOttawa	org
@_ErikaLeigh	human
@GirlyNamNam	human
@Bitesnsites	org
@LaVitaPiccolino	human
@bagameiPriti	unknown
@invaderZ14	human
@KatalinSom	org
@DFGrilleWdlands	org
@mktnjpn	org
@yukico_03	human
@Dir_GoldStar	unknown
@YummyANA	human
@AngieIyo	human
@DavisStHouston	org
@xBGIRLx	human
@TheLocalPalate	human
@MarisaValadas	human
@SamsonAriel	human
@montreal_daily	unknown
@SimonBarnaby	human
@VeruskaFGoerz	human
@DizzyMissHannah	human
@arianagstars	human
@KarrileeA	human
@RuanScheepers	human
@SpainHouses_net	org
@JiaShamsuri	unknown
@RkBenji	org
@lolarose293	unknown
@BarcelonaWineBa	org
@PetrossianNYC	org
@Olyvia1_grajeda	unknown
@arifbil	human
@racel621	unknown
@EDMSingers	org
@JonSmithSubs	human
@yogaguru5	human
@MaiAkshar	human
@Seven47Norman	human
@koba__shoo	human
@lilscrappy216	human
@GiorgioFrau77	human
@mangmangjuan	org
@MarrakechLV	human
@CarlsJrMalaysia	org
@GirlWednesdays	human
@marvinandrereed	human
@braddie22	human
@walkingyeti	org
@Kittan_Foodland	unknown
@TheCellarHouse	org
@marvinrosania	human
@CharmaineLFulle	human
@mavrickhugo	human
@saracalabuig	unknown
@VilniusNews	human
@angel_fato	human
@Half_Barbie	human
@liselleyee	human
@FatNSloppy	unknown
@BayouCamden	org
@TipsByKaren	human
@FlyBoyMcFit	human
@seanetpowell	org
@SunnieShan	human
@RibaswithLove	human
@HenryRoy5	human
@VeronicaMay10	human
@PantryDoctor	human
@EatTheBeltline	org
@rafferahman	human
@NikkiBlando	unknown
@Amor03	org
@keiichi_asakawa	human
@jellowjellow	human
@BlackfootEC1	org
@hardlygolightly	human
@jsuarez73	human
@BistreBistro	human
@Desmonds_Steak	human
@Ulaytriana	human
@GetloooseFit	human
@phillyareamusic	human
@SammiBoyden	human
@SweetCheeks0576	human
@PythPuffy28	human
@wkhai	human
@lilrhodyonline	human
@yogaclass4u	org
@hasita86	human
@MarsLuciano	unknown
@sydneyoland	human
@lowcarbyum	human
@mahnnad2013	human
@ab4nk	human
@zoebistro	human
@HotYogaGrl	human
@MrPatno	human
@ishootandtravel	human
@ontheborder	org
@feedmeupb4ugogo	human
@goflight001	org
@Coffee_Corral	org
@ClaireSlimDuton	human
@warpedlens	human
@HeatherkW4	human
@ByRowRow	human
@UrawaRedWings	human
@LefmanEliesco	unknown
@Timothy_chong	org
@grotemeloenen	human
@secondsedgwick	human
@CarlyCCxx	human
@CarmenTarr	human
@Pozo1983	human
@wieenthanu	human
@Chiara1895	human
@TNourished	org
@sciencefreak393	org
@arrrmin	human
@fishychoo	human
@Zaki_95	human
@TD_Randolph	human
@AvenueGastrobar	org
@xmandiix	org
@RuthNiedz	human
@Littlespoon_86	human
@MarinePlaza	org
@Vivek925	human
@MzRiotOne	unknown
@chima_renren	human
@CHEF_LYNN	human
@TheFoodGods	org
@staness	org
@Lacademie	org
@daddy_gida	human
@cocoaandco	human
@vibe1076	human
@theartdictator	human
@AndrewTam101	human
@davidcostacoach	human
@mayuchannel65xx	human
@lizlovesVS	unknown
@cfsouthvalley	human
@stashahealth	human
@choox75	human
@juarazr	org
@AtxQuintero	org
@SartorialSsters	org
@McKenrene	human
@modaparamim	human
@OiboFirenze	org
@desiTraveler	human
@HungryGirlU	unknown
@WestfieldTRU	org
@felix_superstar	human
@kazzxxxxxx	org
@NeuvooHosOrla	org
@WheRes_WiLL	human
@dphdjd	human
@SweetestHoney	org
@Edyachan	human
@judittokyo	org
@stage3hackney	org
@AngelicaGiannin	human
@ImagoArtisTour	unknown
@Trinity439	human
@becca_fit4life	human
@Fiona4343	human
@maureen_nuradhi	human
@JoanaAlegre	human
@TravelingFlute	human
@VizEat	org
@ThePamperedBaby	org
@ShellysShellys	org
@iPusaaa	unknown
@fariddarif	human
@RadishToWear	human
@LaFlorinata	human
@NightPhoomin	human
@jets00038292009	unknown
@leaverluv	human
@Nicola420Clarke	unknown
@MadridSeduce	human
@petitesgourman1	human
@regima_ra	org
@AFreshLegacy	org
@ithinkmad	human
@kanakinchen	human
@manusmenucom	org
@jaikumarpuri	human
@GrindRelentless	unknown
@allyGdesigns	human
@alessandrabazan	human
@shieldcabahug	unknown
@Shakashaka4	human
@philliphsquared	human
@BAlexJones	human
@jensproule	human
@Jacquelyne214	human
@723WEEEEUUUP	human
@cheryletwrigh	human
@aygm15	human
@BiceBistroCG	org
@hrtlesgirl	human
@pablove	org
@TrophyRoomCHI	human
@lookamblog	human
@DeliNYC	org
@rainshine121	human
@ShopRedSun	org
@TStroke_Montana	org
@Nana_Hmu	human
@porfss	human
@halfcrazymama	human
@filippomacchi	human
@BraleyBusinessV	org
@marnielapus	org
@Donna_Coker	human
@LISALEWISLIVE	human
@GenjiSushiBars	org
@JohnLiotta	human
@TheRealAlvinTo	human
@Hajela	human
@TGIFWestBroad	org
@TheBeautyBean	org
@_margauxfleury_	human
@nutsnmoreUK	org
@Rosana_McPhee	org
@josephdimatteo	human
@blakeells	human
@HauteCompass	human
@ASliceofIce	human
@Hagebutterchen	human
@ainzulkarnaind	human
@northshoremag	human
@tsangzillavs	human
@yen270588	human
@WhatTheTrucks	org
@HighLowVintage	org
@uxp24net	human
@DearMuesli	org
@taiiiz13	human
@keithjamesfit	human
@kimkushcuisine	human
@boucheesX2	human
@eatatlincoln	org
@mamahani	human
@Ayin_Co	org
@MashaLund	unknown
@JimmyMarmaras	human
@CeliaatTiffanys	human
@VegaSunarjo	unknown
@WanFaridNazrin	org
@ItsLeslieAnnC	human
@enithhernandez	org
@yuri_mikael	human
@MikesAtVenetia	org
@JulieRaway	human
@nantddulodge	org
@renai_sVlSd	unknown
@MDSanjeevGupta	org
@ThePastaCruiser	org
@SKiL136	human
@ItsHerSPOTLIGHT	human
@LauraBarsotti	human
@Nelly_Jica	human
@travelswagger	org
@stepeniehapi	human
@728_	human
@naive2	human
@iam_DanishKhan	human
@sinaa666	human
@NinaCheriePhD	human
@AFazroon	human
@RoxyLouWho82	human
@TownRLF	human
@skatesextattoos	human
@WhiteboxEatery	org
@pressmansuae	human
@aimai223	human
@IrkedMommy	human
@kyoseu_rai	org
@imrafaelgarcia	unknown
@msyanizam	human
@KCityBakery	org
@psAAhfs	org
@LeLapinBlanc	human
@BobEvansFarms	human
@StreetFoodOTT	org
@hahahacheungfan	human
@alexeliav	unknown
@Swtbibi523	unknown
@HeyamsFoods	org
@jburt_jrb	human
@anthonyperez63	human
@NidyaNirmalasar	human
@Kesha524	org
@pri_israel	human
@2becreative	human
@MillStBrewPubTO	human
@KikiAlbryChan	human
@SalsaForLondon	human
@Anstasiatitiana	human
@cafegusto	org
@Phuricha2	human
@galvinbrasserie	human
@viktornl	human
@TheTopoftheHill	org
@cute_couples25	human
@tischfoodcenter	org
@Szene_Muc	human
@Kimindepen	human
@MaritimePastyCo	human
@cristel_nely	unknown
@om_atic	human
@hetlau	unknown
@mamits	human
@NiceElen	org
@12nasdesuenos	human
@AngeliqueCafe	org
@BielkaSanchez	human
@sana_chikhalia	unknown
@ewongyeelan	human
@BenThompso	human
@FratellosOsh	unknown
@SeasoningNSalt	org
@JonesSons	org
@kukoalamala	human
@thenakedblondie	human
@ThinkNorway	human
@albertetgonza	human
@Viarunia	human
@Djambidxtrous	human
@csouthernhome	human
@Toby_Metcalf	human
@loopylupi02	unknown
@benzeza_pr	human
@twicebakedinWA	human
@Ella9999	human
@TheBillyKitchen	human
@SafariOnTheBlog	unknown
@TristanClouzeau	unknown
@KaiZanChicago	org
@eatatpot	org
@MardyDuffy101	human
@Herbiefroggle	unknown
@absaguirre68	human
@ida_cute2104	human
@IamAReelDiva	human
@NewmanStTavern	unknown
@letsplayguitar	human
@BarbsBurntTree	human
@ForeignCinemaSF	human
@VitaSuMarte_G	human
@VisitNCsmokies	org
@susilazhu	human
@littleflower6	org
@djkidd604	human
@_aspectacledowl	human
@ciarababy5	unknown
@CarrieRoseG17	human
@MandCoJewellers	human
@ROCKMUMMA	human
@uchuta_m	human
@mimakezan	human
@patrickyan	human
@TheVersatileEye	human
@PaulinaBrzostek	human
@busyveg	org
@ShakaZuluLondon	org
@YallLifestyle	org
@PaulieKerry	human
@dishcrawl	org
@harrycovair	human
@loveandpearl	human
@jesmejesica	unknown
@JohnFebbVidal	human
@FIND_Agency	org
@TheVobb	human
@RKJMTG	human
@DoitShashaWay	human
@RedneckGossip	human
@greedyfoodster	human
@aktund88jpn	org
@anisshyhida	human
@Saradavenport	org
@SoniaEscribano	human
@Hadi__HD	human
@gachaco21	human
@DjBooyaka	unknown
@LeslieBeckRD	human
@bar_dojo	org
@kiddieAims	org
@LocalLoafCLT	org
@MllePoirot	org
@azuazuazukin	human
@SalinaSh12	human
@MariHamill	human
@tampercoffee	org
@DavddLnna	unknown
@marcsnappy	human
@TheThreeBells	human
@MaryJoBenz	human
@donnaabcd	org
@CraigFleece	human
@JaneHB	org
@helloricecake	human
@Paoli_Pineta	org
@fatimahasilah	human
@silrave	human
@pj_james	human
@EliseMuller_	unknown
@MuraSings	org
@MemoirsOfAMetro	human
@PhilipPryke_1	unknown
@Evie857	human
@myriamfares	org
@WentyChai28	human
@GingersGaslamp	human
@EureliaHimea	human
@trillhq	unknown
@McThai	org
@ChefLizette1	human
@AttiWorku	org
@gee_es	unknown
@jumisakae	human
@SaraMarieM17	human
@PhillyArabia	org
@santiagosem	human
@p0is0nivy4	human
@miss_JHB	human
@joana_montanha	human
@Fame2112	human
@UzmaQpon	human
@StudioSamL	human
@sul_luna	human
@PastaPantry	org
@PrimroseRebel	human
@Phil_0220	human
@beahundal	org
@tamikaj27	human
@kubozy_2014	human
@tamarindolunch	org
@cjtuason	human
@MrZzToOoFlYy	human
@ThunzyM	unknown
@william_hsiao	human
@lelecoccia	human
@Dee_Rocket	human
@herme_lindaCa	unknown
@TheJohnMeredith	human
@bbibroker	org
@Vanillapodling	org
@NouriFoods	org
@Lukecarliff	human
@hannah_neilvin	unknown
@sarahvonh_	human
@PengPhoto	org
@gimmedietcoke	human
@naughtiness_	human
@Novelist_Mutima	human
@TCSRIBCRIB	org
@EdgeCatererCafe	org
@youfood	org
@pishija	human
@milas_welt	human
@schullzshaky	human
@sportsfan2259	unknown
@HarlemShakeNYC	human
@ParamountFoods	org
@brianma68	human
@MimosaCali4nia	human
@tesshugo	human
@pinewoodtr	org
@AnOpenCookbook	human
@kitchenlister	org
@wangadir	human
@masa0753	human
@kaye_v_c	org
@vision_dedeiste	org
@easyequipment	org
@ITVNW	human
@AmoiiDarlinz88	human
@PaulKumara	human
@ZiggysStAndrews	org
@mrfto73	human
@SantiTjie	human
@Karlijn2	human
@tampstamp	human
@GonnaDrinknChow	unknown
@angelacasselman	human
@moodLKI	human
@megabodies	unknown
@diamondave	human
@rjgnewdawn	human
@JaviAvilaEvents	human
@easycurry	org
@imbibeKC	org
@EverydayFoodie_	human
@sanbinirahaV	human
@fawei_weifa	unknown
@mikinyan1	human
@sdot_86	human
@_ktracho_	human
@shajanM	human
@AllisonHawn	org
@CFCaselli212	human
@blackbirdmpls	org
@tomoringo	unknown
@TheSpicyBee	human
@zulreen_zulkifl	human
@yoanferies	human
@datsyuklover	human
@IamEcatina	human
@fortheluvof	human
@sanny_pot	human
@McclintonAmy	unknown
@Rtist_One	org
@SlimmFoxxable	human
@AlbeeAthena	human
@KimMctyre	human
@PinkCreativeS	org
@_diycrafts	org
@283hane15	human
@sereneme	human
@Jenn_Harris_	human
@UgonSeikkailut	human
@ThinkfoodLA	human
@The_Heathersss	human
@OliveMumbai	human
@Gourmet_Table	org
@genuss_sucht	human
@jamesonspubs	human
@AlexisToh	unknown
@Cubanamojito	unknown
@FoodMcr	org
@LuLu_Brown24	human
@DniiaCnttrs	unknown
@caesarbryan89	human
@SuccotashRI	unknown
@ruxandrasoare	human
@tk_bulba	human
@ycwk73	unknown
@ESPgals	human
@ch33kynibbles	human
@SammijoKnows	human
@wendabandung	human
@d_shimo	human
@bonbon_671	org
@mounirhafi	human
@littlemissalmay	unknown
@bilbaobab	human
@alexandrioo_	unknown
@zithio	human
@WholeFoodsRVR	org
@Fitness_Femme	unknown
@JustBreatheAng	human
@Panoss_64	org
@MsBibiB	org
@lex23669	human
@mofumofu_saiko	unknown
@Rebecca_anne_m	human
@hanimkamaruddin	human
@hyqal_beau	unknown
@1RachelYV	unknown
@ArShianForLife	human
@fading_roses19	human
@JustKarlS	human
@IrinaHardy	human
@DGumede1	human
@Dragoncastle100	org
@UrbanGirlco	org
@niceneasyGR	human
@cheeshouse	unknown
@v1v1_an	human
@GrssRtsGourmet	org
@brounebrasil	human
@BChaoMusic	human
@instacelebsx	org
@MirandaGrace13	human
@jannyshere	human
@JessSexy21	human
@marumaruc	org
@djkelsey_RockD	human
@polly_mii	human
@ZencafeMumbai	org
@wrestlingaddict	human
@chasesada	human
@bhcmumbai	org
@HarrysCoffeeLJ	org
@bageltalknyc	org
@Glamourinapl	human
@dinnermarket	org
@akolangsiJEN	human
@hiro32kato	human
@carinositalian	human
@NathapornM	human
@TGIFLynchburg	org
@one_saifuddin	human
@mihirshah1975	human
@GabriellaPink_	human
@ichirobby	human
@MEATBALLERS	org
@KristinCook4	human
@splintercast101	unknown
@kheme	human
@yuko_veganRD	human
@mirrorballgirl	human
@ayuxxxfn	unknown
@kirbyklaus	human
@ayandeato	human
@herbertjohan	human
@SocialDiner	human
@tim_jumpclarke	human
@KloofStrHouse	org
@ayelenfernand	human
@THEFISHHOUSE	human
@eroelian	human
@FifthGrouper	human
@SDHomeInteriors	org
@vjhenderson	org
@soravecom	org
@partmezzo	human
@GrillingMontana	org
@takuyakun1004	human
@bigrubeglp	human
@BetyLnrs	unknown
@bread_winners	org
@njl_angel	human
@TrendsonTrends	org
@ThePotholder	org
@lotsafoxes	human
@keithetphillips	org
@bachtiarahman	org
@KineticFix	human
@ge2015bot	unknown
@MaryHartleyRD	human
@str8crucial	unknown
@ValerianTirot	human
@Xinyun	human
@aboveitallbrand	human
@AjitBalgi	human
@gj94ek84813	human
@JPTN	human
@TheRike25	human
@Senorita_Titia	human
@paulakelly_	human
@chouchoucouture	human
@jCo4	org
@hirokoxx	human
@AMZARismail	human
@ForkandPassport	human
@Afnlne	human
@AdrianaMosnoi	human
@Diese	human
@Kidsstoppress	human
@She_Phanie	human
@The_Chequers_	org
@furie_hahn	org
@terrafollowback	human
@Michelle_Ahn2	human
@iammai_onanong	human
@ScoopB	human
@Sakata_Gen	human
@kwokmun	human
@OneindiaKannada	human
@hmserenade	human
@hoods2	human
@xmanguy69	human
@bernadette888	human
@ch1epqndq	human
@tallman1880	human
@SuiteLifeBCN	org
@chonglei1123	human
@_michelleGois	unknown
@DFGrilleIrvine	org
@chengchow88	human
@OldHouseNN	org
@syedzafar5	human
@MyStylista	unknown
@SpitzStudioCity	org
@dekoda_m	human
@kika_Dmi	unknown
@meg1209birth	unknown
@jeansfansfonsec	human
@maddiesun	human
@SuzieYusof	human
@jacob_hi	human
@AmberMayMoore	org
@anabolicooking	human
@siniz	human
@reaNcy	human
@KashBlu_	human
@tinapanettaxo	human
@Samii_Benitez	unknown
@MoroccanGlamour	human
@djzanta	unknown
@glowitdaflow	human
@NYC_Eatz	org
@BAnnC	human
@Mr_Oshawott_2	human
@katrembacki	human
@wattdawg89	human
@Only_OneTals	human
@differenzz	org
@resh92	human
@tiffcloeluv	human
@FullCircleFarms	human
@armw501	human
@WinBigRivers	human
@capriottis	org
@vitmin_cee	human
@fannyvonfabulus	org
@ChateauMonfort	human
@crepeadiem	org
@IslandGrillLDS	org
@GaemFeliza	human
@OhMyGoat3	human
@RodneyRudder798	human
@BurgsIndia	org
@Eiman266	human
@tideblue	human
@cts3	human
@WinterHearts_5	human
@senegalbot	org
@sercanyasarr	human
@4sweetiepie2	human
@schatzli1218	human
@iamjilliza	human
@myuncutworld	human
@KernsKitchenPDX	org
@angusmacdonal10	unknown
@riacharlton	org
@lani_benitez	human
@PuritanCo	org
@shay4mo	human
@StreetChatElla	human
@ingridtan_	unknown
@VoncSoMotivated	human
@PowersOlga	human
@MiltonHarrodII	unknown
@PeculiarCC	org
@Ariel_W_D	human
@dblares	human
@heidi_bella11	unknown
@fuel500	human
@CircleCafe	org
@MySverve	org
@erickcuapio1	human
@jimdudlicek	human
@LIJLRadio	human
@RobBudiman	unknown
@matsumura_t	human
@atomsoffice	human
@jaymeschua	human
@Zayns_Notes	human
@Presiden_Anda	org
@tetes_nishiazab	human
@YoDii_1950	org
@PUPUTnna	human
@lindatheboss	human
@Stoneloves	human
@JaypeePeralta	human
@ellieschneider	human
@glowfreshgrill	org
@lovely_Ceci1	human
@jennlouisPDX	human
@AfterTheFire1	human
@ErikaWinters	human
@tativertizm	org
@jen_paw20	org
@OutnumberedMama	human
@ChristianeK	human
@baricyclist	unknown
@Pickles_Deli	org
@LiliaLipps	org
@BocaFrau	human
@LeamReTweet	org
@CHRISSPdotCOM	human
@aSWfoodie	org
@UptownCafeButte	human
@lindaethill	org
@Mery_Chin	human
@Cariitoguillen	unknown
@Raintree_Hotels	org
@nhershoes	human
@PollyPerryNet	unknown
@blackstoneic	org
@angeloliquicia	human
@lisalouise	human
@HopeNurtured	human
@shaolinyubibi	human
@InspiringPretty	org
@weightlose_it	org
@nickiem	org
@Warriorstv101	human
@Cherriepei	human
@glw83	org
@PaulaMarist	human
@AlineCCTanaka	human
@MissyStephx	human
@staystr36007240	human
@megandthesouth	human
@takeheart4	unknown
@Eddy_Fernandez	human
@tweetingmommas	human
@nickicoupons	human
@t_olea21	human
@lilianwright123	human
@RastaBeWise	human
@WildIrishWriter	human
@Missanniebean	human
@annabelnyc	human
@FitMamaRealFood	human
@anastazjaZ	human
@banoberry	human
@chattavore	org
@mandy3303my	human
@thepapafrancis	human
@TheRoebuckNotts	human
@Tia_Taylor13	human
@SarahSomian	human
@NYCFG	human
@grilledpeaches1	human
@deepamstry	org
@BertBlanche	human
@neurotrition	org
@SipSampleSavor	org
@scorpio_chick77	human
@WaLauWei	human
@fokebupapysa	unknown
@rchao1203	human
@organixbrands	org
@Kuchenbaecker24	org
@frankienbennys	org
@YiOyx94	human
@Schweizer_Kotau	org
@TashaSimone	human
@MyChef_jp	human
@JauHuei	human
@wymmat	human
@larissalec	human
@stefanuzzone	unknown
@G_Romero_B	human
@badlunchbot	org
@AAdvertisingnmo	human
@Bar1Chelmsford	unknown
@TIFOODS	human
@uberfunk	human
@melihelen12	human
@daRevoluCHIN	org
@MODEforLuxury	human
@TheHollywoodHog	unknown
@RugbyGrille	org
@caspeupas	human
@draco_dubois_69	human
@armandogoshorn	unknown
@drbRsanedrin	human
@GtMcht	unknown
@BareSnacks	org
@superb_RB	human
@meals_hoxton	org
@ToscanaSD	human
@VizziTruck	org
@dradrianalucia	human
@Keepupw_Cookie	human
@JVerasteguiT01	human
@EateryPulse	human
@ginnybakes	org
@ChefJamieLove	org
@sweetmatcha	human
@kimberrussell	human
@jprogers6796	unknown
@RossRyelle	human
@andrewrn7	human
@facecentri	org
@iHeartMiko	human
@circleoffood2	human
@MadocLeonard	human
@ohmygoodNEST	unknown
@inkie_mama	human
@nnnd	human
@its_sav	human
@allgoodeats	org
@TGIFDurham	org
@LatoyaTishana	human
@EdwinPeraltaSD	human
@tammyetedwards	human
@TheDetoxKitchen	human
@PharrSideofAR	human
@deeCuisine	org
@BLADI07	human
@stockpilingmoms	org
@bbcoachjen	human
@OlesyaD	human
@NickPurvis_	human
@Shagdush	human
@michaellrosenb1	human
@Stephiena_R	unknown
@Al3ksej	human
@CarlosAlamilla_	human
@omoshiro_kItfm	unknown
@theoauielina	unknown
@aeshah_B_A	human
@Moshilandia	human
@DesertComber	unknown
@LucaPintavalle	human
@momokafukawa	human
@kidseatright	org
@MUNCHKINPRO	human
@victormorre	human
@ARTRotana	org
@MildewMoney	human
@soulfoodhouse	org
@CorkHour	org
@JungleBrook	human
@legomars	human
@PaigeBARGA	human
@chefintheory	human
@caya47	org
@Snow_funkiest	org
@SBizaj	human
@israel_flash	org
@djanus13	human
@ayura0614	human
@mightychie	human
@EatFirenze	org
@djkatybeauty	human
@xhixhi2010	human
@tilburyhotel	org
@unprettymel	unknown
@amysymington	org
@zergiomassa	human
@Fallonicious	human
@2DoorsDownhfx	org
@Boultonandwatt	org
@alleswatis	human
@neiyosun	human
@SexyVegie	org
@zimsmz	human
@cherrycee	human
@ginsapple	org
@watchmesee	human
@jasiminne	unknown
@safarinafadzil	human
@GreatLakesSpada	unknown
@victoryofwings	human
@MyFoodThoughts	human
@rosy300594	human
@beirutista	human
@kyunheo1	org
@xonickeyox	org
@MarceloManzi95	human
@haikal_kameel	human
@AdelaEs0	unknown
@shiorin1117	human
@Miga_Chan	human
@LeLuxeLe	human
@OrdazExpress	org
@SalsaSouthend	org
@lookplaanil	human
@OrganicCupcakes	human
@ng_delight	human
@Ukeavisen	unknown
@eduardolora1	human
@coderjwc	human
@KambuaPhoto	human
@DylansBurgersTx	human
@pinkdiamond7493	human
@oasis1317	human
@marianahdc	human
@theblissfulbal	human
@TheArtrepreneur	human
@BarnabrowHouse	org
@DeHippeVeggie	human
@PepperDemon	unknown
@5280BurgerBar	human
@MrDodoWorld	org
@Mangiapf	org
@Dreamerz98	unknown
@dorichinking	human
@SweetyFita	human
@moneyhungry05	unknown
@ElmaBeganovich	human
@Tika_BossyOne	unknown
@GeorgednicholsD	unknown
@LutyensEC4	org
@Mou915	unknown
@tskrodzki	org
@JimBunds	org
@K_1DMum	human
@JeppeKlarin	human
@VMakarty	human
@BottegaMilanese	org
@Letslovebeauty	human
@ReynerAdijaya	human
@julgolean	human
@Seth51102	human
@starbapy	unknown
@bklynvegetarian	human
@szafran3	human
@alisonmty	unknown
@AraaMcFly	unknown
@WoodsideMumbai	org
@zeppy_hkitty	human
@pondipondi32	unknown
@toscareno	human
@Want_itAll813	human
@Strattonshotel	org
@brendapcatalano	unknown
@sawai_rina	human
@inapicklefoodco	human
@KINGSANTANA_	human
@arlequinsdiva	human
@Koshevnyk	human
@Aec0275	human
@SilencioMusic	human
@TaraRisch	unknown
@tiffanilouisek	unknown
@docrodolfo	human
@OutDoorsy3	human
@pblogweb	human
@krisziejebulan	human
@KhuongPhan	human
@mercaditoNYC	org
@barcefootball	unknown
@CopperheadCV	human
@dsjinspring	human
@dquintero1981	human
@lovinmy_curls	org
@JeffryXiaoLang	unknown
@wilumm777	human
@gemblong_amis	human
@KCorreces	human
@RFalcon74	human
@Luisarmandodal	human
@sandvall	human
@more4momsbuck	human
@KatieL_Clark	human
@6008saiikitofu	unknown
@amazel_chef	human
@i_am_Ms_Danah	human
@cabobxnyc	human
@arcuridc	org
@OniDewono	human
@MustardRye	human
@jessexcruz	human
@39sakichi	unknown
@beebanaria	human
@BrainBalanceIL	unknown
@serbannicusor0	human
@dfgrillePasa	org
@charlenermosle1	unknown
@mikedmerrill	org
@DAN_I_am_	human
@TheEberhard	human
@ParisCheri	org
@JohnWilliams698	human
@KerryPosh	human
@Selinargyrou	human
@simplyshimona	human
@HHHval	org
@normsrestaurant	human
@ThemadridistaSM	unknown
@ScoreUpdate_	human
@Stampede66	org
@rexbailey0323	unknown
@EABakehouse	human
@Andros1975	human
@SanxiaRenjiaGS	org
@craftymomof3	human
@fitnessfruit	human
@AlexisWright604	human
@culture_spoon	human
@shrimpovob	human
@lidek_pe	human
@MomCocktails	human
@Cavalli_Milan	human
@veggiesgetyouhi	human
@amiruul_hakim	unknown
@hngreapp	org
@VaughanRetweets	org
@LarwoodVocePK	org
@sandyn75	human
@mydealzforu	org
@anyeay_west	human
@Acranemuse	human
@Champersforlife	org
@VonnyKaliman	org
@CRZBABY420	human
@SweetStacey1	human
@P4Parisa	human
@toscana1989	org
@doreencita	human
@Anjali_Kay	human
@cornea	human
@kallistarson	unknown
@Megan_Recipes	human
@ShondartateR	unknown
@legna1029	org
@mealhoppertech	unknown
@TheLBDplan	unknown
@sakadangkuya07	human
@_PiemeepDomo	org
@FlorCarbo	human
@CristinaCooks	human
@FitGeekyMom	human
@foodwithclass	unknown
@Miss_HH__	human
@ICTToolBox	human
@instacow	human
@imheechan	unknown
@Cheesecaketruc	org
@JamalBarakat	human
@parkkiosk	org
@CompletePantry	org
@YoungsPubs	human
@ketsana101	human
@AlexAllinOne	human
@IndianGrillNYC	org
@SarahSarpolis	human
@DJPROPHET	human
@GoldenGtae168	human
@MaliaZine	human
@clickflickca	human
@losetheghee	org
@mayrenaisamar	human
@IRMASWORLD	org
@SpeedDman360	human
@MarshaFColeman	human
@tatijurado	human
@VoilaFoodTruck	org
@SohhaYogurt	human
@chrisluce87	human
@thefoodduo	human
@GlobeBerlinMD	org
@dsouza_robert	human
@LancashireCourt	human
@dtsebastian	human
@RebeccaPilger	human
@HalmsQadira	human
@PaleoPirate	human
@bitemycake	human
@SammiePhillips1	human
@Rev_Publishing	human
@MarisolNY	human
@piggyuko	human
@hobSnobbery	human
@wtfamieating	org
@djMzA	human
@catsyboo	human
@NAKAMA_106	human
@JJHapgood	org
@Sam191234	human
@SammieDaBully	human
@Chrysanthemum75	human
@AngieP91	human
@livehealtheasy	human
@TShirleen	human
@NayeishaFlurt	human
@FreakyTweets_	unknown
@MeganMaraschino	human
@lechaflan	human
@ijordache	human
@amadeus_donovan	human
@micol_a_porter	human
@itsmejag17	human
@EdgewaterSD	org
@GingerandNutmeg	org
@JaimeSlavin	human
@amandachentweet	human
@xjoe1028	human
@adoboexpressoc	org
@luau	human
@Lou_JPN	human
@Christina1Kenny	human
@NeyderDavid	human
@SOSCuisine	org
@Media1Lessons	human
@RANHomeCare	unknown
@johnandhope	human
@TrentinaCLE	org
@ShabbyChicCheap	human
@PennyDavidi	human
@gatopusacat	human
@Topvideosdunet	human
@grumpy76	org
@ViaPanini	org
@nwbeerguide	human
@mymiat	human
@yoursimplemeals	human
@WILLmatic23	human
@EnglishsoB	org
@delstwist	human
@NextCourseBlog	org
@jeasmon	human
@iloveMEIself	org
@BarAmericainNYC	human
@Saepulemil	human
@sfstraw	org
@ladysbland	human
@herworldsg	org
@BohemianFoodies	org
@TGIFVABeach	org
@SamBan92	human
@RobertoMij	unknown
@pampetite	human
@AdelaUgrt	unknown
@R_sidney_V	human
@isipisi23	org
@LilbobPat	human
@terunakacak	human
@mylocot	human
@jesipowell	human
@IoanaStef	org
@Khaeryll_Amanda	human
@PeckishinPilsen	human
@ME2KRODZ	human
@vichyk	unknown
@hobokenbar	org
@MicheleDior	unknown
@little_chefB	org
@HangTightwMarC	human
@estanciacafe	org
@Cakesandrecipes	human
@richardxchen	human
@Mrscpkc	human
@TEAMDENUIT	org
@therosetable	org
@EdwardRomero23	human
@rpnlebanon	human
@TheFillABuster	human
@OMyRaDance	human
@DJEASYNYC	human
@LibertyBar	human
@LiveSonima	org
@jerseychris1	org
@BrandiN08111989	human
@ThatPYT	human
@OwenGluck	human
@GMahn	org
@foodbenders	org
@thechariot_SL	human
@NanieBears	org
@800MYNONNO	human
@NewNaomii	unknown
@APFife	human
@bettertogether	org
@experien_CEZ	human
@superandi2007	human
@Tusitahotelkuta	org
@bnievera	human
@SofitelVienna	org
@AyuRoti	human
@thisbeautybaker	human
@iPhillyChitChat	human
@fitzeefoods	human
@EBertolaccini	human
@fransis_chen	human
@Real_Mans_Man	human
@farasidya	human
@StateandLakeChi	org
@_OfficerWilson	unknown
@trisna_kamelia	human
@gardenofliferaw	org
@gastownseagull	human
@liltokyomb	org
@itsme_dayanara	unknown
@NatoAYC	human
@usikumada	human
@EatLaRev	org
@Union_Resto	org
@IXKeyover2000	human
@Deansheremet	human
@sarahmclellanny	human
@Lil_NoB	human
@AlHajiHD	human
@ShortandHealthy	human
@VickiH_92	human
@pretyboynxtdoor	unknown
@_SUESSES_	human
@ShawndaStrwser1	human
@hollie_wakeham	human
@earletbrooks	human
@dIn_dIbV	human
@TGIFNMyrtleBch	org
@ModeloJom	unknown
@1froglegs	human
@musicgroupie0	unknown
@FraserLewis0	human
@TeaNacious	org
@UncleTrizzy	human
@ShackSTL	org
@juddweiss	human
@FortNeyland95	org
@mybodwellness	org
@everyday_fitnes	human
@kclark0822	human
@thecrucialhour	unknown
@fashionseason19	human
@HeleneDarroze	human
@LesCapricieuses	human
@BishwaParyatak	org
@LiamWhitexz	human
@NaiveAngel101	unknown
@UTM_Dining	org
@sibghat0786	human
@stoneandspace	human
@BSBPA	human
@Webstaurant	org
@GPW3ZtBhp397C7i	unknown
@thot_rv38	human
@suwichie	human
@Dini309	org
@fizzandpheasant	org
@yuzucco5	human
@SenoraBlahBlah	human
@GustoCookridge	org
@clearancequeens	human
@amiegallette	human
@UptownBham	org
@jenfer	human
@ibchilly	human
@piromi1209	human
@Sakalmert	human
@Julian_Biggs	human
@asset1106	human
@SaffronRoadFood	org
@thegraftonnw5	org
@Anglonip	human
@Skattitude	unknown
@WouterusAlbertu	human
@marieluvpink	human
@enaphoto	human
@CaraPaige	human
@Ande1619	human
@healthcentral	org
@kevindelalin	human
@JusSweetME	human
@klemmingway	human
@breadstkitchen	org
@SusanLUCKYWong	org
@TheHungryGod	org
@StittsCentral	human
@MademoiselleMMC	human
@dimito15michiyo	human
@raffvial	human
@LuAndrad	human
@FNHYDrAli	human
@ilymrx	human
@JadeBurr	human
@Biankastyle	human
@maisywapps	human
@finnious	human
@makemyyours	human
@amandabitchin	human
@_kneenah	human
@bandhbuildings	org
@kalofagas	org
@Snickerdoo2	human
@clintliang	human
@FluffyStarr	human
@scahrens	human
@mazda55	human
@dswaney82	human
@biteburgerhouse	org
@mr_jamjoom	human
@phitsinees	org
@TopazMcKenzie	human
@Changing_News9	human
@Doitallworkingm	human
@SandyLePhoto	human
@coleyann	human
@studio_unicorn	org
@ChezCateyLou	human
@livieglutenfree	human
@AztecHotelUK	org
@0924_chiichan	human
@EricaHReid	human
@wmbrownproject	human
@xAimes	human
@TheLuxuryReview	unknown
@reichan05	human
@SympaGabbcie	human
@THATrealduprai	human
@MsPelectricCock	org
@SabriDenisC	human
@gayotblog	org
@canse7en	human
@_behealthy120	unknown
@TLSQueen	human
@beliamuda	human
@freedomlove12	human
@fayan999	unknown
@UltimateBraai	org
@velu_martha	unknown
@oms1845	human
@Argenisvenzan	human
@JohnOGroatsLA	human
@Strick_lisel	human
@Bigwayne69	human
@tinat	human
@NopayBarends	human
@rfmaval	human
@IDAlifestyle	human
@cuhcur_tutung	human
@skyloungamarelo	unknown
@MyFoxHouston	human
@loolasplanet	human
@tourism_earth	human
@jasy_amm	org
@VinoCaPisco	human
@p4nd4l4nd	human
@TFCswindon	org
@Spamglish	human
@backtothedora	human
@maylenek	human
@__Niki___	human
@rahmaseptika	human
@chang_patty	human
@campbowiedist	org
@BrettGraff	human
@moco_lov	human
@esthyeo	human
@FreeLunchFor2	org
@pfunkygriddle1	org
@orbells_garage	human
@SkinnySometimes	human
@chunkychancla	human
@crazycurlysophi	human
@RJClarksonc	human
@QueenMitchi	unknown
@sbutlerbooks	org
@OroweatAr	human
@841tama	unknown
@haachan1221	unknown
@eatPALETA	org
@duckandcake	human
@ManhattanLJ	org
@goodiegoodieg	human
@jhezusb	human
@kimiblack	human
@SarahSimplyMe	human
@sunandfunwow	human
@sugarvine	org
@KFCCorporation	org
@Hectorium	human
@RodneysToronto	human
@cvccrafts	human
@MarkoMNik	human
@CarlyyGarciaa	human
@ElainePu	human
@IzzyCheshire	human
@getfedagain	human
@ayo_CWW	human
@durba_chatter	human
@JodyMaccleay	unknown
@SableandSage	human
@Kaibutsu	human
@crystalheart713	human
@ikbalkeyfibursa	human
@KcYoJin	unknown
@KattBX	org
@anthonymancs	human
@GeronimoPubs	human
@spiroborg	org
@hei819	human
@JapanCentre	org
@lifesabowl	human
@SocialMomsCbus	org
@KINGJYMNY	unknown
@maco_chang1224	unknown
@HongShingRest	org
@MellaMarthin	human
@lucagambillara	org
@Pho2HoLicx	human
@LuiluiElise	human
@eniar79	human
@ApanZhafran	human
@sufianzahari	human
@ChrystalMahan	human
@gayspace_it	human
@Kitchenability	org
@alyneddie	human
@Chatonsworld	human
@taka_chan	org
@reinnychap	human
@mossadkgb	human
@fabiolatotal	human
@TabachinesDTLA	org
@mappietokio	org
@AlexPawlik87	human
@izzanniznadia	human
@GourmetBlends	org
@xH8Hx	unknown
@kaedystar	human
@windolly22	unknown
@03020605Hyun	org
@gooochin	human
@PhillyPicks	org
@whatDMClikes	human
@thedrakehotel	human
@luisvidalgt	human
@laurarromero_r	unknown
@sweetworldofs	org
@fatgirlslim37	unknown
@JimmyScalia	human
@TanakaSale	human
@Jerry30110	human
@Dnnycln	human
@rachmaninov885	human
@manu_strong	human
@the_field_guide	human
@Roadhouse66Chi	org
@SitiNadiahAhmad	human
@sissastyle	org
@news_in_summary	human
@ZoiGreekYogurt	human
@SwitchToTurkey	org
@BNgamsopha	human
@KellyShim	human
@GinnyMcQueen	human
@andytomat	human
@CRAMPTONSBAR	org
@UsengecSef	human
@clareymoo	human
@djohansah	human
@SaikoroTheDj	human
@WytchyOne76	human
@InstaKerch	human
@KodyMelton	human
@lav_leee	human
@DailyDelivery	human
@calijulz	human
@chefmonikacsi	org
@MeetandMeat	org
@tsubame0_0	human
@LoveBeetroot	org
@deliziER	human
@eatitandlikeit	org
@GEMFoodMag	org
@MommyGearest	human
@trinity_team	human
@Gelatiscoop	human
@ApanAziz	unknown
@FabioCarreraR10	human
@Chippyelite	human
@yuu____akg	human
@sakadangmonyet7	human
@fdaallday	org
@Valduccis	org
@Angosturabit_TT	org
@mollymorganrd	human
@aMUSEingTia	human
@InSearchOfYummy	human
@Lina_Samsudin90	human
@MrAFEdwards1986	human
@Shippydoll	human
@VelezJesy	human
@Bg1renee	human
@thingswinspire	human
@Aida370	human
@Gastronomicasia	org
@Lilla100	human
@AshleykharveyK	unknown
@Martin_Lutsk	human
@Borushka_	human
@mujganyurtseven	human
@krolineBraga	unknown
@gaufregourmet	org
@w_illustrated	human
@Basenka13	human
@gapech	human
@torchheater	org
@TheRazorRamon	human
@EatWithNia	org
@thecooksrecipes	org
@amiable2amy	human
@DKamys	human
@fragolelau	human
@LovinglyAmanda	unknown
@sweetsavant	org
@Kat450	human
@merely_curious	human
@croftersorganic	org
@keetymporta	human
@Mavors1	org
@Emmawash1	org
@ayrshire	org
@Reyna576	org
@mccormick1942	human
@CottonsRShack	human
@wulfricblack	human
@cad_yellow	human
@Missundast00d	unknown
@KarlaMAGK	human
@annecupcake	human
@Yukachai_com	human
@gabrielo_8	human
@deftonesfreek	human
@appletrifle	human
@WriteNjoydotcom	org
@Vegan_Pecan	human
@JonnyNoelMusic	human
@StayPaidAlways	human
@deck_masters	org
@bloliver1	human
@bot49232127	unknown
@yinyin4334	human
@gobrasberenang	human
@LAFoodie	org
@CavemanTorie	org
@NewEnglandDairy	org
@EverythingAndru	human
@xeora	human
@JorgeSaint10	org
@MWaitForIt	human
@raquel__castelo	human
@Jx1000	org
@TheLiliana	human
@chicagofashion_	org
@grumpy1970	human
@VIVIAN_TODD_	human
@SandwichesRule	org
@WhatsEatingDC	human
@mieza_everdeen	unknown
@RustikTavern	human
@LinglingCheong	human
@RAPMAGALI	human
@claphamtandoor	org
@loversabroad	org
@FoodPornCollect	org
@deer_fattkiraa	unknown
@SewMeLove	org
@martina_mk	human
@geekncharming	org
@Di_Di_D	human
@DiningIn	org
@Chris_tina431	human
@NutButterRunner	org
@RealDanMasters	human
@cannonandcannon	org
@marcelamoreno	human
@larios_shirley	unknown
@phattwater	org
@lilianatowers	human
@IndyChatwal	org
@anatavaresk	human
@Twinkle__Puppy	human
@TheMelissaG	human
@TuesdayDickson	human
@TopIngredients	human
@mochikana1	human
@hana6_6	human
@Harold_Limbong	unknown
@SesamoBakery	human
@cosmicvoyage	human
@EllenMaryGarden	human
@chef_roc	unknown
@Japayuki83	human
@foodswiperUK	org
@animetric	human
@NEAHIN	human
@Meltonbiztweet	unknown
@waitrose	org
@theGOODSdiner	org
@SemarangZone	unknown
@FerGarcia18	human
@hey_im_kate	human
@babblingbmarie	human
@seawitchmagic	unknown
@DCsPizza	org
@Bea_Mandarinas	human
@MLiias	human
@BiteArt	human
@andy_home01	human
@writerbeckmedia	unknown
@MilaCGates	human
@hwahwachinadoll	human
@mayu_7	human
@sanzibell	human
@ateeir	human
@SavannahMcken16	unknown
@CaterinaSlv	human
@Paleeta_Summer	human
@HairGoddesss	unknown
@Elsa_Grn	org
@paigecalvert1	unknown
@ceci373	human
@PhiphiAng	human
@dsuprstar	human
@permanentdg	human
@kimmy71079	human
@1pasepatonga	unknown
@emmajstubbs	human
@Santhiyaa27	human
@YasikaFMJogja	human
@yohanasabri	human
@vynxtrinity	human
@DeeClazziquai	human
@ronaldmizrahi	human
@FreeDotCA	org
@BeyrouteBistro	human
@KarenNevado	unknown
@anneclutz	human
@GrowinUpMadison	human
@LawHolden	human
@tengek2014	human
@DannyGanem	human
@SheratonBDG	human
@BodegaAcosta	org
@TeeArray	unknown
@Graupix	human
@wesrollins	human
@iCrake	human
@CurtishmurrayH	unknown
@cybergirl2010	human
@Renzosretter	human
@noblepig	human
@danichang314	human
@ralysyadanas	human
@lil_miss_ilii	human
@GijuNair	human
@ToyaGold	unknown
@DJAKADEMIC	org
@Gastronomistas	human
@MrCharmSings	human
@ThatGalPurp	human
@_Lovee_Bug	org
@GenerationYYZ	org
@DrChcn	human
@lisaetbaker	org
@Ruhlmann_NYC	org
@NY_bestpics	unknown
@disneyfavfan	human
@vinocowinebar	human
@GoodyearKate	human
@epicurioustdot	org
@samgtzfr	human
@official_VOIZE	org
@randomlyKai	human
@akuizan3	human
@TopHashtagsApp	human
@misslinnyo	human
@Littlepancakeco	human
@Saphyre_Belfast	org
@KaliRed504Diva	human
@Coupondipity	org
@375COURONNE	org
@ricca1022	human
@LJCruzPro	human
@AhanuRex	human
@ninajansdotter	human
@dadiatmadja_yap	human
@sarari0516	unknown
@Supervivace	human
@kagitpat	human
@erinng35	human
@RattlesnakeDen	human
@SuViMonTS	human
@CJsHandknits	human
@YnnejennY	unknown
@AlessiaAzzalini	human
@Kouzouli_Sandy	human
@nars_bar	unknown
@israeliprincess	human
@k009034	human
@alvinabetsy	human
@ChristophersWC2	org
@wendishapiro	org
@ReyNhadz	human
@IdayaniDania	human
@Melissa_Dove	human
@dr2782	unknown
@Kingof4Queenz	human
@Padel_ig	human
@EveYewookBum	unknown
@2minutedrillguy	human
@toni_thanakorn	human
@jpcatering	human
@it_bittybristol	human
@schoolmomof4	human
@ArlynnBonagas	human
@UrbanDubai	human
@RupiJohalUK	human
@NyvpDiaz	human
@Kyuuisthename	human
@technovictim	unknown
@wildfirediva	human
@HonestCooking	org
@SouLFulGatherin	human
@MockingbirdCbrg	human
@TheSocialGlas	org
@ceobillionaire	human
@shadyladybar	org
@MO_HKS	human
@SoderandKo	org
@virtualglfriday	human
@Bottegamericano	org
@TheVoiceKidsPH	org
@maxwellfloyd	human
@MPWAustria	unknown
@inparma	org
@macwis	human
@Roguechef	human
@drlex1995	org
@TweetTeamTM	org
@DelMareSnack	human
@kisekiSITI	org
@foodinkgrocerie	org
@AmrOdiaz	human
@SannaParkan	human
@money_fin	human
@saturncafe	human
@aquasid14	human
@jollyinebriate	human
@EricCShe	human
@anassuwito	human
@VALDIUM	human
@inmarile	human
@LiverpoolDeals0	unknown
@Dianac143Diana	human
@djwheelan	unknown
@stella_donald	human
@ProteinPancakes	org
@NaomiDlggd	unknown
@151089572	unknown
@Bexhill_On_Sea	human
@pinoyraver	human
@Brit_tah_nii	org
@celeblasmanwe	human
@GoedEtenEnLeven	org
@nahowes	human
@iamNamster	human
@FitApproach	org
@B_Ducre	human
@543pulDe	human
@SBeauty101	human
@drana33	human
@Frozenintime10	org
@michalmccrary	human
@taraoffairmont	human
@LoseWeightMag	unknown
@BiBHQ	org
@Gigi_Mijares	human
@82SarahDay	human
@carmenelvira74	human
@SammSpice	org
@LouieFoodie	org
@JennieTeoOng	human
@YourCubeOKC	org
@2354b4765639442	unknown
@Gift_Pile	unknown
@bettylok	human
@STEEL5757	org
@MaParis	human
@candilandblogs	human
@sacsplace	org
@BohemiaBrighton	org
@AsiaPrince_KJH	org
@alBEYONder	human
@Vegas_Promoter	human
@EasternShoreMcD	org
@TheAnnelicious	human
@CentroAlManhal	human
@bewser	human
@ForkandForage	unknown
@taleusbadag	human
@stephanyaurora	human
@veralynmedia	human
@SFVTruthers	human
@cargord	human
@Fruitypot	unknown
@mokafeCCS	unknown
@wrongwroks	human
@CoConamor	human
@Huongie	human
@TheRealKajal	human
@danielamichaela	human
@pjbailon	human
@ChicagoBites	org
@HolisticHeartBt	human
@StcTsdl	human
@pertuttiitalian	human
@mameeAU	human
@zugosdelicafe	org
@jenarricale	human
@SerenityYou	human
@haruharutx	human
@NikkiChin89	human
@RealFoodRN	human
@RicetteNonna	org
@FlorenceLee0604	human
@necklaceofpearl	human
@halobeauty1	human
@marknitty	human
@Muhdhaizat5	human
@island_deals	org
@utsukushi_yakei	unknown
@bot93979510	unknown
@munchbunchdairy	org
@Pate_Moi	org
@restaurantbursa	unknown
@kyoxxxxx	human
@RedwoodHalifax	org
@pbshoreclub	org
@RosieLopez14	human
@StellarossaT01	human
@M_Awitch	human
@ShareFitness	org
@rockhousehotel	org
@VillafanaHHC	human
@dechicaholic	human
@IchiNiIzakaya	org
@LansdowneDaw	human
@stonesttavern	org
@JasSoBossy	human
@isaactanjs	human
@BeezzzzzBee	human
@JanJoostBouwman	org
@CogumeloAndante	human
@eyecarewala	human
@1953barbie	human
@rayerika5150	human
@BAYOlator	human
@SAesthetician	human
@KewkD	human
@Serena_Bakes	human
@jezhreeldiaz	human
@rairaiken_	human
@surfinchef61	human
@ReggieWynn	human
@Kate_Radtke	human
@GuernseyPark	org
@mariesworlds	human
@slowtroll25	human
@ExploreNP	org
@freemymanreno	org
@honeypablo	human
@JediDieArh	unknown
@lovejunsu09	human
@Changing_News17	human
@ThePloughSW11	org
@yui1011kaito	unknown
@RayGooch2	unknown
@Devanmonkey	human
@MrsB1022	org
@jhoepmendoza	human
@Todaysparent	org
@princessgeeta	unknown
@AlineLQ	human
@jkyh327	org
@_OfficialOP	unknown
@Julius_Galvez_Q	human
@nadiaav	human
@AngelatmichaelT	unknown
@RyaNDiZzZiEeE	human
@Soulstar8	human
@3laadeleid	human
@thedreamchazer	org
@lunchbox_love	human
@ElChileCafe	org
@RichieAzhari	org
@sparklekitchen	human
@Happy2Homestead	human
@bourbonstreetse	human
@BeeHiveOven	org
@dgeorgestdiner	human
@CookingKisses	human
@storytwee	human
@itmustb_clayday	human
@wssoo	human
@linggx	human
@luismorpheo	human
@Willoseguera	human
@zaradevlin	unknown
@LeungHenry	human
@JugglingActMama	human
@cuvism	human
@SenorCevicheLDN	org
@Mohdjazz6	human
@MaryorieLissett	human
@uplandsdiner	org
@waylandlee	human
@annelievmf	human
@rads	human
@_PitterPatter	human
@TraveleuropeEN	human
@ryanzachos	human
@spotlessmind10	unknown
@MrGriffin23	human
@KinutKamsah	human
@lauracpalmer_c	unknown
@ToroToroRSR	org
@ccoronelg	human
@joecota0101	human
@NextGreatBite	org
@Edur_Garc	human
@jonathanwuth	human
@DanielPuente21	unknown
@ZainShaikh	unknown
@tom3119	human
@TheSaxonMill	org
@PhatKidsMP	human
@cado	human
@simplysantafenm	human
@KyleKlim	human
@NicolaMeakin	org
@aln_kishimo	human
@lamont_jessie	human
@Changing_News8	human
@The_Tramshed	org
@MicheeDaDon	human
@alankarfai	human
@MYCATSRWILD	human
@BombomBijoux	human
@SauceQuest	org
@cinemascapes	org
@MariaPlza_	unknown
@FoodMysteries	human
@laurenjstrader	unknown
@CMCblog_ashley	unknown
@ELISE2P_CLAY	human
@mercymtz92	unknown
@ZWidelcem	human
@euphoRHEA	human
@TaylorEatRight	org
@drewpan	human
@ScarlettLuvsRon	human
@blend_shake	org
@sonicdriveinaz	org
@greeneral	human
@errolstevens	unknown
@douglasmclarks1	unknown
@ChdryN	unknown
@FSCairoNP	org
@Menulation	human
@Phillisters	human
@africaza7	human
@balqisthebistro	human
@OrangeMorishita	human
@echotuscano	human
@So_cyncerre	org
@BethKonopka	org
@LondonGrill	org
@amyHushgirl	human
@Debbiedoodad	human
@HungryAphrodite	org
@shivmo_shanks	human
@rima_danielle	human
@sarahhhly	human
@DavidVuillemin	human
@6ellaKURUPT	unknown
@BelPW	human
@Luv_haruka	human
@ZiaraVld	unknown
@Thehungrymum	org
@Hendralicious	human
@eatdrinkbeslim	human
@Get_HealthyFit	unknown
@MPDenBosch	org
@SherraSiangta	human
@anisss_anis	human
@Chelsea_ayley	unknown
@Fumi_Ishikawa	human
@Aylin_lin_lin	unknown
@TGCharityTrust	org
@yycmollymalones	org
@ChocL8GRITS	human
@burgos3433	human
@AngiKarangwangi	human
@Centragreatvic	org
@dahlke_w	unknown
@Joshuarockl	unknown
@TGIFNewark	org
@Changing_News11	human
@LoseThosePoundz	unknown
@DanarescobarR	unknown
@wakinkawauso	human
@Olo7Chanaa	org
@RealBlokes	org
@EimaJer	human
@HouseCleanPro	human
@LoveTravelLive	human
@SlvnHn1457	human
@LPQBEL	org
@nondairyqueen	org
@falsebaroness	human
@chanmapagreen	unknown
@SteveOhhster	human
@bernaergec	unknown
@5FingerPhoto	org
@ObladeeWineBar	org
@RiverwoodSales	org
@Artemis_Mastr0u	human
@socaliallie	org
@yorkvilleespbar	unknown
@khenhensley	human
@hoeyenSin	human
@kumaco83	human
@Ramstina	human
@BraunSSA	org
@GoodGabble	org
@McQueensDubai	org
@hungryscafe	human
@wwe_japan	human
@WinnieBiiYing	human
@whi2_d	unknown
@TheSerenyna	human
@TGIFmechanicsvl	org
@nnabavi	human
@GrillArmorGlove	org
@CoquiRojasG	human
@wlw85	human
@chew0904	human
@shirleypbutts	unknown
@didemozgen_dido	human
@saxon6732	human
@marlenebergman	human
@SabraCanada	human
@LaSalaByTheSea	org
@Donna_Weber_	human
@LilSistaNIKE	unknown
@ParkAveOrtho	human
@victorlayata	human
@Chawiporn	human
@jeancluera	unknown
@TheLoretto	org
@KykyApriana	human
@ayo__adrienne	unknown
@bonbon805	human
@larryting	human
@JUNZETAN	human
@miss_belanja	human
@Liquidbm	org
@jessehesch	human
@UkwideMarketing	human
@Local360Seattle	org
@tlarrywong	unknown
@BornRoyal	human
@MistibmooreB	unknown
@amears81	human
@SimpleBryanSays	human
@MelissaAkaFerg	unknown
@2hand2h	org
@josuechef	human
@SophiSkt	human
@MeatetcRosebank	human
@ahkl77	org
@FrankBars	org
@ahdancecompany	org
@ThinknSleep	human
@CocoLimeJewelry	human
@patrickdolande	human
@liamslakemary	org
@SliwinskaDomi	human
@CafeBaBaReeba	org
@cmworthington	human
@Guiliana1989	human
@GirlGoneHealthy	human
@stephen_bull	human
@JennRoskyTIU	unknown
@robsonjeelian	human
@BrunoMSCunha	human
@JAMES_CAPLANIDE	human
@StephsFitness	human
@stayready107	org
@SoonSpoonHQ	unknown
@GradellePennino	human
@vanewpc	org
@me_healthier	human
@DenaRochelle	human
@alifnorman	unknown
@haleReeses	human
@selectinverse	org
@Jets0000796	unknown
@bot40086232	unknown
@kilaliumi	human
@kiki_kecil	human
@Sonhos_Vividos	human
@charolizzie	human
@NewcastleCasino	human
@HotelDuvalTally	org
@tymiki2525	human
@okgethealthy	org
@minougirlblog	unknown
@boatelsegundo	org
@onceuponageisha	human
@alanpaton7	human
@IamAldrinD	unknown
@agmack828	human
@CSummersC	human
@IAmLymin	human
@twilightverona	human
@MeditOrig	org
@adiligentheart	human
@AndreaGelish	human
@ketchembunnies	human
@blackwolf0223	human
@Mhyke_Official	org
@Siobhan_Dolan1	human
@leonefabre	human
@patriciarchamb2	unknown
@puccaso	human
@benskitchen	human
@UniqueMoniqueB	unknown
@BdanVella	human
@annietrimber	human
@92s_mari	org
@lauras827	human
@JimenaDrnts	unknown
@JulnnRmr	human
@AllisonlhamelL	unknown
@Bodycoachie	human
@ameiwang	human
@JanetGoingCrazy	human
@BarCommerce	org
@DesiRecipes	org
@IEShineOn	org
@jaclynsiu	human
@CertAngusBeef	org
@el_azilron	human
@SuzaiKuu	human
@egauer	human
@NoshMaven	unknown
@LeahSaysViews	human
@suimokucoffee	human
@Liewliew628	human
@pohui	human
@organized31	human
@BolingerMary	unknown
@udin_dinn	org
@entreprenurial1	org
@OhHeyTherese	human
@pamelaoctaviany	human
@michili1020	human
@oishiijouhou	human
@dragadc	human
@MasashiS0623	org
@mudasemarket	org
@jolo7214	unknown
@schel74	human
@ashandvan	human
@kovie182	human
@CarlosSerna	human
@EnabledCooking	org
@Nishdyosa	human
@dybowski	human
@DrinkMrPink	org
@armani_claudia	org
@paolotones	human
@TodayILikeBlog	human
@ArimbiKitchen	human
@nortonsusa	org
@MunchiesNYC	human
@calvingsc	human
@CaffeVergnano	human
@bossbitchJody	unknown
@inzyrashid	human
@6megmi9	human
@NotjustMaroc	org
@thewoodcafe	org
@NienaTirra	human
@PINGG_Seller	unknown
@Medi_Health	human
@Brazai_	org
@veronicahouses	human
@Ms_J_Jimenez	human
@_rics_	human
@zahlerest	human
@_TorontoGirl_	human
@NisaSofri	unknown
@_illly	org
@abc89800301	unknown
@DanielleIversen	human
@SimpleThanh	unknown
@GotchaPuebla_	human
@fransiskapayne	human
@manggy	human
@ChefQParis	human
@staceyewills	human
@districtcuisine	human
@kumikwy	human
@stephtwist6	human
@annierafael761	human
@kakitateKan	human
@myworldpablo	human
@SheratonAbuja	org
@virginbless	human
@danciingroxx	human
@HiltonAlexndria	org
@Xdi3sel	human
@EverydayHealth	org
@jayan_sri	human
@verita_vita	human
@GiogioGianolla	human
@EMCjoe	human
@sjalexandreac	human
@DrBubble	human
@TimDrakeRobin3	human
@djkaz001	human
@kimson08	human
@SdLBkValleyGirl	human
@TheTummyTales	org
@LeanBalanon	unknown
@FreakEating	human
@missHOTRODqueen	human
@sheratonmoe	human
@TeddyP3	human
@GourmetBlog1	org
@fastrunner2b	human
@NayaLizardo	org
@PincodeTone	human
@Ekaarismana	human
@PaddyOsGranola	org
@shannonpaulap	human
@GPsRestaurant	org
@autumn_candy	unknown
@FoxholesFarm	org
@aneelshaikh	human
@heartykitchenct	human
@margiejpace	unknown
@MinMinZheng	human
@abumbrendelle	human
@zoreksky	human
@tengarnace	human
@thewayltdwayne	human
@Lila91	human
@fatdeaf1	human
@hammond_neva	unknown
@EleonoraIeva	human
@SulfFreeLiving	human
@Chelsea739	human
@thatniggacrissy	org
@JacquelinesVeg	human
@followmefoodie	human
@beckyrangel	human
@AnnWalthour	human
@PassionFishRest	org
@FrozenTropics	human
@hersh_clueless	org
@HashTgJustSayin	org
@iphonevevo	human
@ISH_ONE	human
@bumblesdragnirb	org
@InterConBali	human
@GotchaJalisco	human
@OfficialMRFelix	human
@HechoEnDumbo	org
@EatKeenwa	org
@412shin	human
@XRISTOSGP	human
@bebejaz	human
@dmariekitchen	human
@alex_neuendorf	unknown
@_yayoi0310	org
@mrjoewalker	human
@bigmaktech	human
@eauy_th	human
@BakehouseIRL	org
@takaowakayama01	human
@littlekitchen2	human
@chloemcgnourish	unknown
@momyliciousbeth	human
@margery_talley	human
@amber_lynn_7	human
@ParcPantry	org
@TuyenKamo	human
@HotelSwagath	human
@LoveMargate	human
@hasanahzulcefli	human
@DubaiBest10	human
@ckrusch	human
@missmichellemai	human
@CharlyneBach	unknown
@CarolineKent	human
@GotchaGuerrero	human
@Armaund	human
@LilCookBigCity	human
@bot52419264	unknown
@applestoziti	unknown
@MauraSansone	human
@mami2jcn	human
@Justice_NHB	unknown
@InaTocco	unknown
@abc78524359	unknown
@InspirationsWeb	org
@catsanddogsblog	org
@Vinnie2theBoi	org
@OscarPertusa	human
@DogSaloon	human
@A_L_Kessler	org
@TeripalvaradoP	unknown
@iDINNERi	human
@PheebzEatz	human
@JennaSSumner	human
@IsobellaHouse	unknown
@yada561	human
@terminator1129	org
@M_iron_shoveme	human
@matthias18	human
@Lallum35	human
@RopataCast	unknown
@Solo_Marco	human
@menlovesprada	human
@_akkoGDlovexx21	human
@rafahperlado	unknown
@SangoAms77	org
@pizzebrunetti	unknown
@DanielleKerani	human
@e_lizA522	human
@ToscaNYC	org
@AFRICAYOON	human
@yk22com	human
@renebelgar	human
@javiNosanchez	unknown
@Richly_Deserved	org
@AnaKieu	human
@akajacktom	human
@CuckooFoods	org
@bot70099215	unknown
@UlfredB	human
@FunkyChef_Mel	org
@sisenorbeach	org
@Momoko_Rawfood	human
@palomamobaile	human
@CalabriasPizza	org
@Jack3DS	human
@SomaniCaterers	human
@RobinAbrams67	human
@daylesfordfarm	org
@dai_nyatta	human
@bplaceroma	org
@AmiraFoodsGCC	org
@prapaynee	human
@MariamJMian	human
@AnneAzran	human
@fodewunmi	human
@dejeuneratydoor	org
@ericrileybrown	human
@ludabrown	human
@jessiehawthorn	human
@SoyerIndia	org
@septisutrisna	human
@AinLampard	human
@sunnysideup1151	org
@keithdyer407	human
@theslidebar	org
@LouieC71	human
@chefo666	unknown
@HansunIlona	human
@chefmarcmurphy	human
@Thuputlela_XerX	unknown
@bot38787418	unknown
@there_ly	unknown
@MarymcalvertM	unknown
@IndyE4LDeals	org
@YungaGuru	human
@Ursula7156	human
@MarioFitness1	human
@ChicagogrillinD	human
@MS_RJAE	org
@CougarCoCafe	org
@wesaidgotravel	org
@nastyaJV	unknown
@GothamVancouver	org
@katthirteen	human
@bokyung20	unknown
@SPKlein52	human
@BostonsCR	org
@TracyrsawyerR	unknown
@doctorcierra	human
@Fit_In_Time	human
@jessieboadilla	human
@ToughCookieMom	human
@WealthReportSA	org
@tossandroll	org
@thekittchen	human
@SouthboundBagel	human
@SaratogaResort	human
@GreenwichAvenue	org
@MGValdez	human
@Travel1Jo	org
@jodyyoshida	human
@LaPetiteMignon	human
@hatukoi_	unknown
@ShahanJoleen	unknown
@NicoSetiawan_96	org
@LeandraDarling	human
@BlakFace25	human
@lesliewyu	human
@jdulemba	human
@GoldenIrishEggs	human
@GymDwellingDiva	human
@livingMarjorney	human
@eatcabbagepatch	human
@Roeduaeed	unknown
@ikkle87	human
@nysuzyinvegas	human
@octavcool	org
@hair39k	human
@loudawgs	human
@Gr8OutdoorsAdv	human
@JenArmstrongHI	human
@SylvieNFawley	human
@CookinwBrittany	human
@MrsDoctoraDubai	unknown
@ladymrestaurant	org
@charleycaradas	human
@adictuz_21	unknown
@DianneodavisO	unknown
@iurbinacantu	human
@judifood	org
@JEREMYKELLOGGS	human
@PardueJean	unknown
@luigi945	org
@EdenTrattoria	org
@jaelim94	human
@StPeterFoodCoop	org
@NaturoPay	org
@ShimmyHo	org
@ChiantiAdelaide	org
@thesemput	human
@iziumytza	org
@Kracx	unknown
@Azusa_takazono	human
@altfoodguy	human
@Joseangelovega	unknown
@NitaKaroliina	human
@JenniferdblakeD	unknown
@gothiphopblog	human
@jjsdiner2013	human
@Cardiff4Lunch	org
@ClairehchouH	unknown
@ambinp	unknown
@PlanetGoaTweets	org
@LaLicenciadaRD	unknown
@F1_Barbie	human
@ExpDomesticity	human
@blushNbrunette	human
@DRABBIT91	org
@LaPalmaDining	human
@eatatcounter	org
@phiphohBie	unknown
@CovellPark	human
@TheCharlesBar	org
@CriCarlini	human
@CMLobster	org
@cumberlandfarms	org
@nicolazzochiara	human
@MichaeljsalasJ	unknown
@danashortt	org
@Kamouflage10	org
@I_RETWEET_ADS	human
@Jesse01234	human
@TSAmedia_RossF	unknown
@keeks_ekv	unknown
@SuzanaUzelac	unknown
@Margaretta6340	human
@AndreaDueso	human
@EskiciPurple	human
@CasaBardotti	org
@TarabwatkinsB	unknown
@cornishgrill	human
@SoulRockDesigns	human
@partridgesfoods	org
@LoversBelfast	org
@IndiBlu	human
@PaulinaGuinto	human
@adrienneswaggy	unknown
@mie_mimi	human
@funny_spiderman	human
@lunchthousand	org
@adinanoel	human
@ammanuelle	human
@AMTenor	human
@Gerogram	org
@PakiRecipes	org
@MuyBuenoCooking	human
@modernhotel	org
@WogaSanchinarro	unknown
@fnbdxb	human
@RustlersRooste	org
@streetrunway	human
@PBFingers	human
@tanaitanai	human
@SolerFrida_	unknown
@Shushukenniz	human
@r0xy67	human
@JaclynPerryJP	human
@erraaAlex	human
@Anianka86	human
@MargotUnlimited	human
@pranzoalavoro	human
@suedzin	human
@prettyjoviemee	org
@iamKhameleon	human
@iamcorefit	org
@SecretlilStars	unknown
@tingru	human
@rm07090	unknown
@deepaghosh2007	human
@fatdaddyslive	org
@Xander_Querubin	human
@m_hisi	org
@KitchenSanc2ary	human
@CasanovaTran	human
@BeerthirstRob	human
@Lita9990	org
@rockmanm	human
@DaniaRsll	unknown
@SetMyScene	org
@LeFooding	human
@MrReezey	org
@topstars	human
@Violetkina	human
@Braddahs	unknown
@LICKALIX	org
@JesusPedrajoM	human
@JoansjenkinsS	unknown
@yuzuri0x0	human
@RealKorotkevich	org
@krissylove	unknown
@BigHomieEnt	human
@arrington_teri	unknown
@RadhaCook	human
@stewart_ariane	unknown
@TriciiiaGarcia	human
@cerebralwannabe	unknown
@GrapeAdler	human
@jadeloungepdx	org
@IEatSleepTravel	human
@CookingOutdoors	org
@jameshunt31	human
@booqijae	human
@yayoi_hime_neko	human
@hotdoglive	unknown
@Lisanneblogt	human
@thatkatgirl09	human
@mybabymammoth	human
@qualitytourism	org
@WDN1053	human
@GinzaMiyako	org
@xchristybx	org
@CarltonLong	human
@Jspace_News	human
@WestAveHouston	org
@MrsEvaaa	unknown
@monzour_abacan	human
@ENZO_EDINBURGH	unknown
@RieZ_n	human
@hayleysworld101	human
@shinkirstine	unknown
@lelemusic	human
@ROMIHIROMI_nyc	human
@AtiyeBlush	org
@helencleos_c	unknown
@roccipaul21	human
@rgrichrd81	human
@RothMarx	unknown
@geoffeneff	unknown
@StefanoPeirano	human
@devipromo	org
@RalnaDyan	human
@PandaTaoMyeon	unknown
@AlquimiaNYC	org
@tsiklette1	unknown
@kimoy_	human
@yennymariany	human
@SlimmingWorld	org
@domenicacooks	human
@Gana_Dolares_Ya	human
@DjHectik	human
@suzlyfe	org
@EyeCandyCreate	human
@PhilGoudFood	org
@EsteeEatz	human
@degwux	human
@saladpride	org
@LucasLascivious	human
@Jets00007914	unknown
@wullybully76	human
@lancecorralez	human
@Boom_Breakfast	org
@andreDESIGNZcom	human
@LaleAinteby	unknown
@captaindasya	human
@CentroCapCentre	human
@TheBlackWhaleCi	human
@SJMitch377	org
@Kazzu89	human
@mikejmckeown	human
@genevievepung	human
@Bright_Beaner	human
@TrueNaplesPizza	human
@SOUNDMAN_71	human
@FruBergman	human
@duttonschester	org
@PatWo	human
@SUGARKAYC	human
@EvgGriego	human
@david_rip540	human
@PVerdinho	org
@marthadwhitfie1	unknown
@SlimmingEats	human
@leitihsu	human
@MsSabrinaAnuar	human
@s3xandch0c0late	human
@EnergyShot	org
@m10barandgrill	org
@sincerelyimage	human
@georgepagonisdc	human
@Abigail_Orr	human
@AngeliqueDRoy	human
@ttenay	human
@curiouslyquinn	human
@cheftai	human
@AnnaGraceNia	human
@LamesaTO	org
@PeterPizzeria	org
@EWardRD	human
@Subhansaajid	human
@imogenpaige07	human
@Bakehouse113	unknown
@andrewlaurences	unknown
@inesfilipam	human
@blamefashion	human
@matthewncalio	human
@FarmFishBakeDC	org
@CatchNoBall	unknown
@GastropubUbeer	org
@iamchristyv	org
@MadMenDeli	org
@FoodieFollows	org
@ThePearlQatar	human
@qu3up62	unknown
@MakassyOfficiel	human
@Alex_Cundy	human
@uniqemodel	human
@SimplyFabTeam	human
@alushtatoday	human
@SonomaBakingCo	human
@Pavilionlondon	org
@ThomasFMcArthur	human
@HerbSpecialist	org
@newzlasz	human
@fernandotoon	human
@JETMAN2BEACH	human
@lunatik_gurl	human
@rachaelalfonso	human
@Jeannyu	human
@forkkingchef	org
@BellaR76	human
@willteeyang	human
@thestylepoet	human
@piccolomaine	human
@NSULAWesley	human
@SofitelMumbai	org
@ecad4u	human
@MarieHewitt1	human
@FarahBekka	human
@annyeongjhe	unknown
@aromaespresso	org
@Changing_News4	human
@sambrow1	human
@DAVE24_7	human
@Olin275	human
@ManjCarthigaser	org
@vikki414	human
@ItsLauren95	unknown
@canadianfamily	org
@petitbuzzblog	human
@barristerbilly	human
@sarahlwatkins_l	unknown
@MAB_Mbizle	human
@suburbanmama	org
@BistroLouis	org
@TheLovingPieCo	org
@ParisAshiqin	human
@MissRuxs	human
@laughlovejleigh	unknown
@zubajanaina	unknown
@releasethepants	human
@Sharpeinfluence	human
@V_inTransit	human
@QGrillLondon	org
@RadDadDadical	unknown
@beterenleuk	org
@DNM_Plus	org
@uchiNOMgo	org
@rizalshanju	human
@ChefNWilkins	org
@BrenoMcTLL	human
@didiskitchen	org
@AngieWilliams45	human
@CarlaEstevez	human
@PeanutRD	org
@yinkzie	human
@Pink_Sangria	org
@erwindulait	human
@nakayoshi20	human
@Sebsmummy	org
@EXAGolo	human
@GiadaVegas	org
@CrustandDust	human
@sandrabwright_b	unknown
@trialoffaith	human
@ArturoMor5	unknown
@newhealthfittie	unknown
@SchnitzNYC	org
@DamianMackenzie	human
@lizzyS	human
@wowcatcher	human
@mintandrosemary	human
@maggiesoblessed	human
@markmeijerink	human
@BullsNationYes	unknown
@jenngoesbanana	human
@Listek4	human
@Latitude33_CT	org
@ItaliaaTavola	human
@1000giggles	human
@JessCThornton	unknown
@Mazzios	org
@Claudia_Swag97	human
@MatthewMcgohan	human
@SixFoot7Balla	unknown
@gardinermuseum	human
@jmnatz	human
@arrolloGEO_	unknown
@chickenruby	human
@CynthiarzapataR	unknown
@KellieBaer	unknown
@homeikitchen	org
@JLynnJacobs	human
@alfrescogourmet	org
@SaboreaUnoHoy	org
@funnypranks4you	human
@scoreonebay	unknown
@Guayaquil_Instg	org
@MCKLove9	unknown
@Cottage_R	human
@Fitwithjen1	human
@Cabbagetown_BIA	org
@NAlexandrowa	human
@inCIREBONcity	org
@Hey_ItsSunny	org
@Lehush	org
@Leila_BenRhys	human
@zombytalkradio	org
@TempleStgo	human
@L0L0_A	human
@HometoHomeCook	human
@markpop98	human
@SpeshalGift22	human
@MichVogrinec	human
@thelilgreenhome	unknown
@HansenJudith12	human
@emmakregus	unknown
@Emulsify1	org
@AngeloT01	org
@asakon	human
@made_n_fl	human
@MonAmiReston	human
@dj_azumi	human
@FlyNFishOysters	org
@apurva3agrawal	human
@KirstenJRenfroe	human
@drinkwithALE	human
@Jennys_Food_Ink	org
@OMABarcelona	human
@JoshMSlater	human
@rosemariejburr2	unknown
@AlwaysPony	human
@travel4leisure2	human
@iroasaran	human
@Weslodge	org
@MamaBRISK	human
@moiii_dontcare	human
@FocusedOnFitApp	org
@rhao	human
@Mikimixerz	human
@OnTheBlytheSide	org
@imbermido	human
@jerjerjer_	org
@WilliemcooperM	unknown
@Margarett7810	human
@Gjah_Yahya	human
@lovemecookie	unknown
@504UNIT	human
@jackronmalasaga	unknown
@GrillontheEdge	human
@cheska_manlapaz	org
@luckyoetama	human
@VroncAlvrz	unknown
@maisietoo	human
@excrutive	org
@drewshampoo	human
@SharmaTweeting	human
@CaylaRanice	unknown
@xNaghmehx	human
@iam_kc_allonsy	human
@ragoutfood	human
@R_Sanchez94	human
@Casadegustos	org
@semanticdmax	human
@adios56	human
@LiveLifeInStyle	human
@DickeysBBQMN	org
@JuuustMyself	human
@wiwid_krisna	unknown
@SabinevanZeijl	human
@FoodBev	org
@samuel_2609	human
@1500mmkids	unknown
@elizabethgsnoo1	unknown
@visitmonte	human
@CuratedVibes	human
@Dawnn__	human
@bekismybff	unknown
@msprettybossb	unknown
@MJPRChicago	org
@sserenee_	human
@Tanyawarren	human
@ArmCandyFetish	human
@cookingbydesign	human
@urnextbook	org
@MirandaMyersD	human
@zhuiny	human
@tessa_soon	human
@Biosynergy	human
@TheTastyWeigh	human
@Zeus_Zoump	org
@TVFGI	org
@Primeurs1	org
@J_DelimaJKT48	unknown
@travelingdubs	org
@filafresh	human
@JadeGorrod	human
@chris_ell22	unknown
@cre8tivmar	human
@eeddwwiinn83	human
@Chef_ANDY_B	org
@CasperGambinis	human
@MiddleGray	org
@TeVailima	human
@Glamorousdana	human
@pat_thinksabtU	unknown
@cubbieberry	human
@love_thecrunch	org
@TonyDavy	human
@katehartlepool	human
@aeyler06	human
@ItsYaGirlCory	org
@Ferasfares	human
@escotteee	human
@nicoleinone	human
@Yunjiaz	human
@BloggerBunny	human
@TERRY_4HESS	human
@MJB9204	human
@beckvalleybooks	org
@Gerrit_SchuerMs	unknown
@yogawithlois	human
@ricardorbl	human
@Hiker1717	human
@MichaelTandian	human
@humanityfirstuk	human
@jeanhsu	human
@xxsucettexx1019	human
@MastFarm	org
@TonkotsuSoho	org
@terrynaomi31	human
@Tashly_f	human
@CoachRomiGill	human
@SafwaanSamson	org
@alexander7300	human
@adorabos	human
@beto_aguisa	human
@holisticvanity	human
@some_cities	human
@BarSiena	human
@kanegon999	human
@SFDeeDee415	human
@momopi2	human
@Pinkladyappleuk	org
@yuanshii	org
@DJGonzoNYC	human
@eatzis	org
@CalorieCookbook	org
@KatieSerbinski	unknown
@TheDBarGrill	org
@noragpam5280	human
@beautycyncyn	human
@Tilo_G	human
@MilyYada	human
@SamsGroceria	org
@vanillaseven	human
@cire2010	human
@MissHangrypants	human
@WestEndTerrace	org
@SmithToronto	org
@TeddyNata	human
@The_Tiger_Inn	human
@reina_bazzi	org
@MargaritaBloom	org
@kayLEEEsha	human
@cgurmann	human
@Chikahisastudio	human
@Irene73800	human
@j_crucify	human
@TheLobbyDenver	org
@Turkeyreport	org
@skiicity	human
@vickyzmm	org
@janeannenichol	unknown
@alexlups	human
@CECELIAS716	org
@aCHITaxiCab	org
@lauramac929	human
@Boleyn_Girl86	human
@FefoLosada	org
@JerseygirlKH	human
@TwitItalianWine	human
@ezeTeresa_	unknown
@jonnieey	human
@haynicwar23	human
@Spafloating	human
@INDULGENTSAGE	human
@MiuMiuChu	human
@Cat_Mai_Jones	human
@londonmatt	human
@No_Expert	human
@girltrndrunner	human
@megreen777	unknown
@kuharich	org
@alexnatalie112	human
@Plate38	org
@ToneandTighten	org
@lilpaula40	human
@things2doinleic	org
@ValeSiviero	human
@SweetAsElle	human
@deliorganics	human
@TriperitaM	human
@LoganTavernWDC	org
@phatsawat	human
@eduardoLV	human
@Irishfoodparty	human
@fastfoodfred	human
@RosiBrizuela	human
@mikethegriz	org
@karamiaone	human
@AwaabAhmed777	human
@MilanoTweet	unknown
@dannynjoo	human
@naru0076	human
@MrChowsIndia	org
@IS3B	human
@leahmariaish	human
@LS25WebAds	org
@TeaspoonOfGood	human
@BobCWinchester	human
@DRandall	human
@UKBloggers1	org
@robertabriffa	human
@VeIra_Girl	human
@linarog	human
@What2doAsia	human
@sandrabeckfit	human
@DADDYS_BAD_GIRL	unknown
@GalenSilasuwFe	human
@WilkoTravels	human
@Nie_95	human
@LeGrayBeirut	org
@rockbotmbrewpub	org
@Ms_SeeVaUs	human
@nomnombearinyvr	human
@tosshi32	human
@CelesteThorson	human
@iamtickledred	human
@NanaAmmaSGyamfi	org
@TheMedEatery	human
@julzzay	human
@b3st1ntheworld	unknown
@Vapiano	human
@JohannaOlsson9	human
@CobblestoneDub	human
@FoodpalLLC	org
@ShayRahman28	human
@KellieSprinzen	human
@berlinsville	org
@edgeptuk	unknown
@KylliniBeach	human
@QuickTastyFood	human
@saintzent	human
@tiffanzos	human
@cafecoho	org
@Weirdnerdygamer	human
@HerronChevrolet	human
@peppertrekker	human
@domiNate314	human
@issamnakib	human
@ZachKhoalaBear	unknown
@filipinahippie	unknown
@Mich_Kookie97	human
@yuriko18837544	human
@ParentsTalkRad	human
@VarubodenOsla	human
@MSandwichBar	org
@fpjjr	human
@PiannaWong	human
@deadmundo	human
@HarborChiro	human
@TGIFWilmington	unknown
@GameDevRobot	unknown
@JunctionAvl	org
@mnmholder	human
@RamblersMonroe	org
@caoooooz	human
@HalloweenRaven	human
@DealOfTheDay55	human
@woodhamjk	unknown
@eMazingLinpark	human
@Jessica_Remmers	human
@AzuridgeEstate	org
@GoldenCasinoGrp	human
@realfoodwdana	org
@atenzaatenza	unknown
@GulzarGauson	human
@azumi314	human
@momochadayo	human
@stopsnapshare	unknown
@AlaraCereals	org
@priyaa8585	unknown
@BeverlySimcic	human
@BeanLoved	human
@costumegirljo	human
@Matsukip	human
@IDmaicih	human
@GianlucaForino	human
@andi_fisher	human
@cloverpoppins	human
@CordobaBedAndBe	human
@candicedempster	human
@norcalplane	human
@MariieFournier	human
@MichHomeGarden	human
@Courmayeurfb	human
@SavorysweetsNL	human
@SabrinaBella36	human
@jennvoss	human
@ChezSushi	org
@cantusfabulae	human
@116_miiiichan	unknown
@superkitchlady	org
@DonafesCafe	org
@MilkandSparrow	org
@puterapescado	human
@nailfreak28	human
@oh_carnegie	human
@brooke_1091	org
@AlliumChicago	org
@Organicocosugar	org
@sexymissy34	human
@peaceloverun	human
@poloboybraven	unknown
@TwoChicsBlog	unknown
@OneFeistyChef	human
@KatrinaMusic	org
@jacaroe	human
@OmerAbdellatif	human
@SliceMeBaby	unknown
@meepokteo	human
@beachhouseresto	org
@JarayeTRUnkLife	human
@TanyaHaffnerRD	human
@TheReadingCat1	human
@eggscomplex	org
@DelishNutrish	unknown
@Tiffanypeipei	human
@emmaspizza	org
@littleowlnyc	org
@geoXge	org
@Lgrosluxe	org
@xyferken	human
@canteen_lp	org
@rupertbj	human
@rjvitec	human
@MykoSexy	human
@IvyBarKitchen	human
@AshleyEv3	human
@RodolfoMcartney	human
@India_MasalaLV	org
@SoyelMico	org
@Latisha460	org
@TopGayer	org
@natashakhoriz	human
@goldenfreya	human
@TweetJoymakeup	human
@TJRemaneses	human
@ann__toledo	unknown
@rondelljw	human
@msrachelhollis	human
@OwlGirl89	human
@freecoupons	org
@NicoleMalloryG	human
@i_BizTalkRadio	org
@rotinober	human
@chefgute	human
@sosathemexican	human
@inDowntownJAX	org
@elisabethmihou	human
@andrewtan230514	human
@DJVadim	org
@sherimiya	human
@avenuemavl	org
@CentralTexasRT	human
@jun_anteola	human
@TheGlobalTaster	unknown
@ramblingstump	human
@ayacookies	human
@ZyLa891	human
@quilyon21	human
@acesicehouse	human
@especialdelsur	org
@CitizenBar	org
@TheMainDish	org
@wateraindrop	human
@Liquidisity	human
@nsirjoo2000	human
@bagsnlove	human
@FleurDeLove97	human
@DinasWorld1	human
@madspiky	human
@CaracolHou	org
@ShiroBelfast	unknown
@Christina32828	human
@rattanarattoy	human
@satomin310310	human
@DomesticRoad	human
@inesnorman	human
@joanaofwgkta	unknown
@JMangoWorldCafe	org
@maaaaaii930	human
@todena	human
@ninakhiv831	human
@ALovefourMe	human
@LindsayGrahamUK	human
@Tom_v_l	human
@fayecortes	human
@Girl_InBigJapan	human
@chef_vicki	human
