@alliealc	org
@LuBeltrami01	human
@Nouhaax	human
@KlingbornCo	human
@mitziaNKP	human
@zafirah_zaffy	human
@bthesmilingchef	org
@QuoVadisSoho	org
@MountDandenong	human
@MonikaChiarini	unknown
@SimchaFisher	org
@PaulinaMalvoa	human
@bones6800	human
@happisplace	org
@dDiMPleDod	human
@Hybrid43Kismet	human
@aldrinkaiser	human
@rackyc	human
@jennykarakaya	human
@Hd5612Jake	human
@miss__thompson	human
@samneo363	human
@gay_losangeles	org
@thenibblebox	org
@golieguy	human
@shakilazara	unknown
@budolero	human
@fitpregnancy	human
@TheRealCathyV	human
@puiiizilla	human
@NIVISMAIDEN	human
@jmhj1234	unknown
@CatTale	human
@mylifeisagarden	human
@PavlaHart	human
@mamarot99	human
@JennyKorn	human
@davidsingletary	human
@MS_ERiiKA	human
@Real_Freckles	org
@sidickyok	human
@flashboothFlCt	org
@ninayology	unknown
@thumbsucker64	org
@jorgephoto	human
@CampbellKitchen	org
@solasboston	human
@AshKash009	human
@teacupandcakes	org
@tymanbert	human
@Am0nstar	human
@natviauk	org
@The_NikG	human
@skinnykitchen_	org
@retselliw	human
@annamalveda	human
@JerrysFoodTruck	org
@EBElliots	human
@nawal66	human
@kitchenwareuk	human
@IslandGateCork	human
@oddittyx3	human
@tOo_daMn_fLeA_	human
@RockingJPhotog	human
@Queen_Rose_Tru	human
@piola100	human
@BigEasyBucha	human
@JacJacKhoo	human
@FlexedOutLex	human
@MissLuccyy	human
@antoharry_	human
@ham_manita	unknown
@GiuliaTastes	org
@kelitovision	unknown
@SJNNutrition	human
@ARamratan	human
@v_mango	human
@THEOne_Planet	org
@itsjessgomes	human
@DrDamodhar	human
@mokkosa	human
@AuthorDaco	org
@morrellwine	org
@illmaticmd	unknown
@JessieLev	human
@kidstrevor	org
@juanlungarzo	human
@alessandro_ibba	unknown
@Chez_Violette	human
@_WEYNT	org
@buranga	human
@kimi_timmy	human
@Michtexas31	human
@WenJosdm	human
@LansonLin	human
@g17lee	human
@mayangathira	unknown
@CornerHouseTO	org
@Dj_Awboo	human
@leeceacil	unknown
@d_mikhnevich	human
@InnaTrotskovets	unknown
@Katiie002	unknown
@francodiaz03	human
@AshleysOneDish	human
@LegacyBagelry	human
@Amyyybryyyant	org
@SylviaORenIshii	org
@janoella	human
@FaithFamilyTech	human
@ItsAllBee	human
@punnyfitriani	human
@maybemick	org
@Beautyandbeagle	human
@charlotcafebcn	org
@LizPop11	org
@Annenishadi	human
@runfreeMNL	human
@PalermosSubs	human
@saltedcarousel	org
@Nacky12	human
@betterat40s	human
@talentandskills	human
@MusicManSparks	human
@DagmarDasha	human
@hannacalado	human
@KaylasOnlyHeart	human
@momo4u12	human
@ichahandoko09	human
@RD_kitchen	human
@notAlbi	unknown
@YsabellaPoblete	human
@TSJacki	unknown
@Meals_N_Heels	human
@JojoJoby	human
@Christine031111	human
@domingo_reyes_c	org
@RT1959	human
@crysa1020	unknown
@zare_zanthea	human
@View_egy	human
@meetkvell	human
@EalcalaM	human
@Cristosays	unknown
@thopjayz	human
@ilbarmilano	org
@70PlusAccounts	unknown
@kayeanyu	human
@thebedeau	human
@baxolaaa	human
@Deshon_SA	unknown
@SweetnesBubbles	org
@MrHenryWang	human
@lilwoman21sw	human
@MeridienBahrain	org
@FrankMendez1969	human
@BlacksoulMusic	org
@benkuu	human
@LunaGrill	org
@Royals_1973	org
@05ut44xs	human
@PrincessLeahP87	human
@4fashionist	human
@GiuliaNimei	human
@kenardfitmove	human
@FruschDrink	human
@HoochyMin	human
@IAMJEWLZ	human
@aquilabristol	org
@Phatsachol	human
@anis_requelme	human
@YourBreakfastRe	human
@BlazeSchramm1	unknown
@kushalsanghvi	human
@graceinthings	unknown
@celina_di_pisa	human
@idolci_	human
@Valyuu	human
@Bistro27	org
@LaurettaIhonor	human
@neko3neco3	unknown
@VictorPerezRom	org
@janetissimo	human
@uberthemedic	human
@SunnySimpleLif1	human
@countycocktail	unknown
@vtaylorhood	human
@ak_grind	org
@VeronikawithaK	human
@christianjevans	human
@ifoxyGN	human
@kakricas	human
@kjh19z	unknown
@BearcubWilliams	human
@LaurenSpearman	human
@DougTejeda	human
@FrankiesDubai	org
@OMGCoffeeBar	org
@katyrushlau	human
@IzuanMokhtar	org
@morgandeboest	human
@MzKittyStar	human
@Vasiljevna	human
@thananannnn	human
@SynderellaSW	human
@Onthecorkboard	org
@PrinzMallari	unknown
@AleVarela86	human
@AmandaMillie_	human
@KarinaDartnell	human
@narap1	human
@fishergal3	human
@vhaniiey	human
@vidaaustera	human
@Y_A_T_E_S	human
@Weird_fysh	human
@gooddcatering	org
@AnarchistAStar	human
@nutmeg237	human
@KathyKupitrac	human
@itstwhite	human
@Meeeowism	unknown
@GroovyWizard	org
@Pornsak_P	org
@xoxchrissy91xox	human
@RetallackResort	org
@emiicharlottee	human
@JankaAvalos	org
@pabster4	human
@TheGrizzzzz	human
@iAKOme_dane	human
@shun699	human
@VeganYogaDude	human
@JesseKage	human
@louisesim	human
@Tfit365	human
@sariyan7	human
@Melisarebel	human
@justmarlou	human
@AielloKara	unknown
@BumblingEkkyP	human
@VanIslandHealth	human
@leilanicortez93	human
@MotasdeLana	human
@MusicMaestro95	unknown
@Sephia_Natasya	unknown
@davispaulio37	human
@scrumptiousfury	human
@FitPossibleblog	org
@Darleeene07	human
@supernaturaLhyn	human
@maria_singluten	human
@immediapr	human
@Katesoutham_	human
@gelamm	human
@mamimemo_coocoo	human
@MadamTanResto	org
@ExperienceSW	org
@starsspoon	human
@RadioGibraltar	org
@andreask94	unknown
@SiewEugene	human
@Keysha_Ralefo	unknown
@kara_shin	unknown
@astrella_irma	human
@chevarnegee	unknown
@Vegan_Beauty	human
@chefmommy	human
@debby060290	org
@gwendolynfda33	unknown
@uleeyelfira	human
@aleyahs	human
@Smokadajoebeatz	human
@italianexpress_	org
@garrickpinon	unknown
@alisontran_	human
@nash909	human
@cutnoni	org
@TaiiMorales	human
@artegopizza	org
@belleimalay	human
@RestaurantAT	human
@urbankitchenbar	human
@JoAnnvonWilling	human
@onefitchica	human
@Nikkiblp	human
@ElenaDelMar13	human
@Williebugz88	human
@rosecrownessend	org
@LeBlogDesBobos	human
@LoveThread	human
@joowan_	org
@AibelJose	unknown
@Six_two_	unknown
@jujuwander	human
@DianaYurkova	human
@HamizahMohdNor	human
@capucine_rose	human
@rdtipoftheday	org
@NLatchford	human
@0620_cinnamon	human
@fashionpopcult	human
@ri2kyu	org
@4thStreetYYC	org
@esupermommy	human
@WanderlustChloe	human
@LUXMGT	human
@ZaykaKitchen	human
@StefanosMkt	org
@fitgirlposse	human
@stephanieCSY	human
@azz2206	human
@livstar6	human
@LauraLingerLLC	unknown
@Tatianafmm	human
@sweetieprin	unknown
@104hma	unknown
@nayapowell	unknown
@rafita_argueta	org
@sccb_hiro	human
@CesarCervantes_	org
@VicTizySlevin	human
@az1ms	human
@Electric_Breath	human
@MemphisYelp	org
@RunCupcakeVRun	human
@BarKogi	org
@JParere	human
@Mic_Shakey_Ram	org
@s4manthav	human
@leannes2405	human
@Siravdl	human
@thethankfultin	unknown
@Sun_Rivers	human
@MesinaPascal	human
@jirokazuhiko	human
@Viva_glam_lorac	org
@MerihMarzari	human
@PHaTPHOTOschool	human
@camanthatran	human
@ChuckDalldorf	org
@TysonRossignol	unknown
@vadimbythebay	human
@JoJo_Son	human
@IAM_DJGhost	human
@MeganHJames	human
@mariapatakaki	human
@albert_fhillips	unknown
@VanessasPorn	unknown
@emanuelaisai	human
@luvbag	human
@graciado	org
@Themarketmunch	org
@agbfjewellery	unknown
@Debocaenboca_rd	human
@JAXcommunity	human
@octoberrain1972	human
@Charlene685	human
@JenniferMPotts	human
@GoNOLA504	human
@s_xxxlovexxx	unknown
@LuvenaJade	human
@KrystalRidgway	org
@Nybookieduane	unknown
@AboeDesign	human
@NenaZeee	org
@capcicorne	human
@ignatius_risky	human
@thatdaniigirl	human
@Mista_West	human
@StevenGalindo	human
@fanitrifirni	human
@MalennaSaunders	human
@EricaChristinaD	human
@bryanadampascua	human
@Rodrigodealemos	human
@ParisXVIIeme	human
@JAMALABELLA	human
@AleScherillo	human
@joycooks	human
@angelwitha	org
@cikaming0430	human
@Carolyn4Jesus	unknown
@destinyjnr	human
@siuyau_ka	human
@_Panz_	human
@mominokito	human
@DahlRandy	human
@PartyNewOrleans	human
@k01y01	human
@BrendiehBear	human
@BadBoyBaller	human
@Hotshots_Bar	org
@sabrillorente	human
@LowCarbScams	unknown
@Vandequim	human
@SunflowerNash	org
@One_OnlyChereen	human
@__Naommy__	human
@dragonkingjk	unknown
@SuyogaGinting	human
@MareanAguirre	org
@2530_Espresso	org
@HectorMingues	org
@CakeStoriesJes	org
@lovesmith	human
@MickeyMcColgans	org
@soulfeefresh	human
@ChrisDickens95	human
@Laura_uur	human
@ValenciaFit	human
@AkbarAdeni	org
@maxmeza1	human
@Leila_al2	human
@greatqueenst	org
@ren_studio29	human
@metrestaurant	org
@drewkolar	human
@PaulandPippa	human
@GretchenSweden	unknown
@Michelle_vdv	org
@aylishmckenzie	human
@JonathanBlalock	human
@HalalCartHub	human
@nikykucerova	human
@Roccobythelake	org
@BBlogRT	human
@christy_beltran	human
@JasonPaulRoth	human
@ModernWallSt	org
@Teh_Chief	human
@_youaregold	human
@GotmSmithfield	org
@rebekagomes49	human
@Madridfornia	human
@angoodhue	human
@yakei_mise_bot	human
@kidshomees	org
@clarissavvslet1	human
@established1969	human
@judynnkwon	human
@HiNaaa0527	unknown
@iamcar13	human
@Kiaraho	org
@gromilics	human
@besthealthyou	human
@martabdx	human
@abdulazizswayg	human
@mryjhnsn	human
@MiaMarianne	human
@eatlovesavormag	human
@thewalrusDC	org
@TeresaZodom	human
@JimmyHaikal	human
@iremdemirel8	human
@facesbygrace23	unknown
@Magic1161	human
@runachichi_117	unknown
@sabyYBaby	org
@shaLOVE211	human
@Jenn_Jenn79	human
@RbkBurger	human
@EpicFailsGuru	org
@Blomfield_MC	human
@BollaWine	org
@Lace86Valentina	human
@SamBurt04	human
@melly_garcia	human
@hmcolligan	unknown
@VictorVicens	unknown
@D_ArtNinja	human
@7d3f61f8aaa348f	unknown
@bintminSaudi	human
@ChuckSuggs	human
@thevolunteernw1	org
@mdcorbin	human
@mewmewcecillia	human
@kellie_dixon	human
@_cocomorocco	human
@Vinnyannhyemun	unknown
@chan07tsuu	unknown
@Ma_ChristinaM	unknown
@Cansuyaniker	unknown
@w_tsu	human
@lets_beauty_mai	org
@515Electone	human
@StrandHotelNYC	org
@neslin_ham	org
@naomi_jane	human
@SNAPBACKKIIDD	unknown
@workerbravo	human
@dhoerder	human
@AudraMorrice	org
@TheLenonVision	human
@KevinMSpencer	human
@sinrush	human
@EstherMSwaty	unknown
@laurathomasphd	human
@_hfo911	human
@f_yeah_crossfit	human
@EvelynGodoy_	human
@RecipeTrends	human
@LoreLattanz	human
@DukeDining	org
@mir_shark	org
@cypressafoods	org
@MahayahD	human
@lordgordo1	unknown
@divesoscuba	human
@asianmartian	human
@gumerealmadrid	human
@POONYPOP	human
@queenjue66	human
@VitaminOvy	human
@RichmondOysters	org
@Re_Fraga	human
@AliNDay	human
@cakesweat	human
@BanVentura	human
@CapellaStLucia	human
@lazybones344	human
@lanathemouse	unknown
@Leena_3004	human
@StevenMR1	unknown
@kukuwanglingjun	human
@jessa_assej32	org
@MissWeck	org
@M_Geezy	human
@leeya_yoona	human
@Funkibator	human
@ProperBossFood	org
@MaramKNajjar	human
@AmalfiBlueBook	org
@airgpenny	human
@RanieRosaria	human
@thecommons_syd	org
@PurpleTigresses	unknown
@crissamp	human
@Ivoryjia_xoxo	unknown
@Hotelmadridroma	org
@Simi_Automatic	human
@shonenfan4	org
@lettermenger	human
@TheLoriBeths	org
@LoveAthena	human
@IriZimmi	human
@Ell_Heartbeat	org
@iyangyangyang	org
@drkellyann	org
@Alexx_Smiles	human
@VigiliaGladys	human
@DelSantos808	unknown
@beansofsheen	human
@Kirsten_Off	human
@SocialBites	org
@Aquatic_Dreamer	human
@ParkBenchTeam	org
@PiadinaR	human
@MouktarAhmad	human
@Reena_Rana2015	human
@dreamitdoit21	human
@minusthebrian	human
@OpSeedStorm	human
@qiranger	org
@KKhassinemusic	human
@Daddylopez21	human
@roksanrothman	human
@der_inder	human
@viraniamunaf	human
@KampungArabYk	org
@fabbfaye86	human
@BluRochester	human
@Carolin93934268	human
@amandadewisita	human
@emilyshinyee	human
@paulinesudjono	human
@pink_petals_	unknown
@house406	org
@daniAtti11	org
@NICOKAWECKA	human
@johanna67	human
@littlenic1976	human
@ohxjulie	human
@oxmitchxo	human
@yockoala	human
@MelHay333	human
@YOU1105	human
@missgameifung	human
@KellyOlexa	org
@zwallace8908	human
@JazSmith92	human
@Kiwi7822	human
@abwpena	human
@Miss_RedCat	unknown
@jrboundy	human
@samirn112	human
@tennisphanknee	human
@lapbandindiana	org
@wichitaksgirl	human
@sandrabaligod	human
@BarnowskiFG	org
@AyumiJanielle	human
@DBlossomBox	human
@NocturnalWenchy	human
@susannabarbee	human
@YesEmilySutton	human
@TicklesCafe	org
@jennaleeruby	human
@M_P_Matthews	human
@HalloHeiloo	human
@RichardTuffin	human
@nkydg	human
@henrykhwu	human
@danjfdan	human
@Pokemon_Free	unknown
@leeannabmm66	human
@ZenZeroKS	org
@imgaryc	human
@sexyfoodtherapy	human
@vantasticli	human
@The_Islandgrill	org
@popeyebobbi	human
@JavabeanTW	org
@aboc_evavinud42	unknown
@ligalcar	human
@EduardoDali	human
@_philgee	human
@jugahmedabad	human
@kandibymichelle	human
@Adreeanah04	unknown
@reika_lee	unknown
@MGherghei	unknown
@bettyjo62	human
@YhodieAchmad	human
@EduardOeisis	human
@NadMartineau	human
@FatbackFarms	org
@AlPortoHull	org
@LucianaDeMaria1	human
@rsaboresmx	human
@BWest5132	unknown
@45ParkLaneUK	org
@TaraDomo	unknown
@v_4_k	human
@kablamoko	human
@misstravels	human
@hutty_zii	human
@mmstarla	human
@FlamingMoses79	human
@misshunterville	human
@EthylAbalajon	unknown
@MapleMouseMama	human
@2BootsandaFarwa	org
@BabesPromo2	org
@BeaWaltz_	human
@MrGreglaw	human
@Becca__Shepherd	human
@CPTsavaTHOT	unknown
@Juan_Andreas	human
@dunky1968	human
@415Eats	human
@DeeLDS	unknown
@theoficialmike	human
@TheWrldWanderer	org
@Halibutron	human
@Fitness_W_Maria	human
@sldigital	human
@TheHotelDog	human
@Nok_KN	human
@misscoogreeneye	human
@tloinc_forever	human
@amandadev5	human
@SoJuicyhesnluv	human
@360Charlotte	org
@Titel20	human
@MarioLocura__	human
@Sophinegiam	org
@Krendice	human
@NoManuel696	human
@Susi03	human
@KanikaNeal	human
@davidcharlestay	human
@Bongolaitz	human
@thefoodmaiden	org
@TheSocialKade	human
@GuildfordTIC	org
@nataishasworld	human
@pompomworld	human
@d_disg	unknown
@oxdxexlxixa	human
@MarcelaLeonC	human
@urukyu	human
@dcp_loveurlife	unknown
@vickey_perez	unknown
@naidupushya	human
@kmagandy	human
@uemica	human
@championSue	org
@spectrumparty	human
@srscotta	human
@MusaTurker	human
@KushalParmanand	human
@TCervs	org
@FollowbackZoomy	unknown
@KentondeJong	human
@madmanushya	human
@pmvalino	human
@ukiSuuSwen501	human
@MassiOvalles	human
@mrbickham	human
@AloGorza	human
@nyutz	org
@girlontheband	human
@botfuneur	unknown
@I_birth_Destiny	org
@nandhakussuma	human
@andr3a08	human
@JayveBP	human
@BrotherE	human
@NeeMoSan	human
@theonechristy	unknown
@tridarmoko	human
@ziddi_anar	human
@elginnewsround	org
@_MarshallJ	human
@JuneHawk20	human
@CavegirlKindra	org
@lunchboxrev	unknown
@javascriptd	org
@cezzuu	human
@annecalista	human
@HeidisRecipes	human
@BachelorKitchn	org
@EST1992x	human
@LyndsayWells	org
@whattoprepare	org
@henryooi52	human
@dominica_dawson	human
@James_diment	human
@Important_Part	unknown
@xoxoangii	human
@EchazPaz	human
@TheVisionTimes	org
@Mya3010	unknown
@Gimmeglow	human
@_N0FEARLAH_	unknown
@nikkibayley	human
@MoyaleGuardini	human
@21dian	human
@Florida_Today	human
@jdandrews74	human
@ExcelsiorHK	org
@aileentio	human
@murdoch123	human
@sbiln	human
@MerasAryan	human
@Moxieana	human
@GregoryMDunn	human
@lieman2	human
@9Tegtmeyer	human
@kikaygirljean	human
@loccalbawarchi	org
@4Art_ING	human
@2futureanthem	human
@hopenutritionnz	human
@berwickstlondon	org
@itseliza11	human
@ShamaraNicole	human
@cheer_glo	human
@miszgrace	human
@yarazeidan	human
@VeganSnackPacks	human
@steepedtea218	human
@VeWrites	human
@Jordan___4	unknown
@mrsbakerrr	unknown
@runawaykiwi	human
@efoodguru	org
@natashanavers	human
@ORIGINALjpizzle	human
@KaRmUn1019	unknown
@TBRList	human
@yogvidya_kumari	unknown
@BlueRanger61	human
@DrinkMaineMilk	human
@puckbunny19	human
@gottobein	org
@PrecioustheMUA	human
@twitnyadave	human
@piprojektz	unknown
@DanielTaura	unknown
@owlspecks87	human
@CWYDesigns	human
@bhfjr1	unknown
@a_saacosan	human
@kookiiz	human
@BlurpleCobra	unknown
@srsaul04	human
@BeauBiloxi	org
@87xxx_0	human
@vicstandrews	human
@xeeshan_83	human
@TheWallaceLA	org
@YarnBeDarned	org
@LesliRN	human
@swtrgrl	human
@chikabits	human
@Lae_Esclatine	human
@Jbnguyen	human
@JosueSoler	human
@japangelito	human
@marc_rhodes	human
@cicchettibar	org
@PethrusPlace	human
@iamNTS	org
@bakingsunshine	human
@FebriyantiEkaW	human
@HeidyMo	human
@lernoshka	human
@oreillysbar	org
@koOky_LuRve	human
@CarinCoach	human
@DrStevenLin	human
@doug_is_me	org
@RaleighBarScene	org
@strawberrythief	human
@CJBTan	human
@LuxChicTravel	human
@ferdelportillo	human
@jewelhenna	human
@PrinceAbnormal	human
@LucreziaOd	human
@cika_musiclover	human
@norkarmila95	human
@RegenceWA	org
@denisemwoodward	human
@SHOBHENVARMA	human
@Prestarter	org
@iamezrakate	human
@KaJirova	human
@TopRPGGame	unknown
@theannabelleb	unknown
@rvxen	org
@7dream8chasers1	human
@abdulhadija	unknown
@07080111	human
@HerjonedAli	human
@parulghalout	human
@sunrise963972am	unknown
@elle_rs	org
@RobynWithaYKeil	human
@jessidreams	human
@HealthyBites	human
@countrymodern1	org
@UgandaEatout	org
@iHoneyHere	human
@lymdelle	human
@LinkedinLists	unknown
@sniezus	human
@kanwal81	org
@ItsBluebunnny	human
@travelinglinds	human
@CastandCrewBfs	org
@Resto_in	human
@BeyondPoetic_	human
@yaatiaraaa	human
@superyachtpass	human
@Babat_Amirah	unknown
@DistrictFete	unknown
@DenverFoodGuys	org
@Giggleoutlouder	human
@Bootsycom	human
@AmarisdeSanson	human
@het226	unknown
@citynomadsbali	human
@jjenes	human
@llemonnloves	human
@Spunkula	human
@Darwingrr	org
@g_mo68	human
@pfinchum	human
@KutaPlayaHotel	org
@GlenwoodDriveIn	org
@PaoLJunaB	human
@cellariumcafe	org
@alvearme	human
@Azhafizah	human
@MarasGoodies	human
@CallumHartfield	unknown
@AshleyWillbonn	human
@tengkuakram	human
@narumin06	human
@eatplayliveblog	human
@EffieNiBai	human
@byyonathan	unknown
@Venomous2000	human
@jogritzenmae	human
@ChadOhman	human
@mootamus	human
@s0r7e2k9	human
@AhmadElMohandes	human
@TodayOutfit	org
@JetsBearden	org
@MimiHGilmore	unknown
@immagoodkush	human
@OfficiallyGF	human
@Leaaan_g	human
@EdwardC52305159	human
@WellerClancy	unknown
@actkie	human
@tennillen7	human
@Xoulhairy	unknown
@ashleyweeks1979	unknown
@chaletours	human
@ladybridgefood	human
@saeeed_88	human
@heydyudit	human
@memoarbi	human
@PietjePotent2	unknown
@ChloeAdamson_	human
@shadytruth	human
@mr900sturbo	human
@JosefinaCarlos	human
@davabehrens	human
@KennedySmh	unknown
@leawhitefeather	unknown
@SweeneysGrillCA	org
@iamgraciecrazy	human
@AnnPreTiongson	human
@hacking4chorltz	org
@anto_porawouw	human
@BBOY_FUGA	human
@IchnusaRST	org
@maicarulez	human
@cknamtarn	human
@rebekahahubbard	org
@lenemrk	human
@seabattle2	human
@Lat31Jekyll	human
@CharbelGhsoub	org
@glasgowgrill	org
@danielwarner01	human
@CallMeMsCeCe	org
@buygiving	org
@rubebs	human
@X_Lea2312_X	unknown
@E_Sqrd_Affair	human
@helwwhadek	human
@rikkenp91	human
@PAUL_BAKERY	human
@martheeidahl	human
@EvanBudiDarmawa	human
@DrSweetsmokeBBQ	human
@diogojrf	human
@MissAryC	human
@SofiaDurrani	human
@anjarELFyui	human
@FoodiesProject	unknown
@view_show	org
@TicTacNewsBlog	human
@mommbabe	human
@JessicaMcKeown	human
@Rossella_tw	human
@arillelyponce	human
@breecorner	human
@missktbspa	unknown
@krzko	human
@Brod_NYC	unknown
@HisHersFoodBlog	org
@yayponies	human
@codtak50	human
@sydneyxoxo	unknown
@ThiniFeeTari197	human
@marica_1029	org
@Ntshuxi_Masingi	human
@Kengweeee	human
@jennie_antro	unknown
@SammieC22	human
@MileXtweeter	human
@justiinlovve	human
@wnyazm	human
@Chesskaholic	human
@Jackalope_Jacks	org
@EstelaCaulfield	human
@UMNHM	org
@ellie_s_dowling	unknown
@Fresh_Mann2Good	human
@spabudhabi	unknown
@Melaniehuh	unknown
@haiviolin	human
@devisilviani1	human
@MikaylaSnyder	human
@727FOODNOW	unknown
@rachelleuck	human
@LesserEvilSnack	org
@KamilTimoszukPL	org
@nainong	human
@FitSnack	org
@Towalkinthesun	human
@LivingboxHome	org
@Butcher_Struble	human
@mabrisbane	human
@bestofbromley	org
@VictoriaMahoney	human
@1985Shirimp	unknown
@NoahBensi	human
@charljow_	unknown
@collectables66	human
@alice_sanz	human
@Defu76	human
@Manager998	human
@liebesfoods	human
@EatliveloveIt	org
@AonKps	human
@Adambyatt	human
@yourfitnessmag	human
@Bacon_Bits_	unknown
@Lianaduckworth	human
@TroubadourLDN	human
@MetehanBalta	human
@ScottsMargate	human
@geumelinn	human
@CorzLite919	human
@gorning_2	human
@havilahtamar	human
@ETusty	human
@poppyscupcakes	org
@NeuvooHosWin	unknown
@Dazzle_Max	human
@Besttoursindub	org
@ilovekatvllgs	unknown
@Stylebugdaily	org
@PynkPikachu	human
@abhisheksoni121	human
@kEleanoraRigby	human
@victoryshoes	human
@YevLoudy	human
@Sugar_Shey	human
@28hilars	human
@RyzenbergOn	human
@trevorjsantos	human
@ChristianFe78	human
@riskapheank	org
@e789217	human
@heidisnape	human
@hanny8081	human
@jane1346	human
@FamilyWellFGO	org
@DiegoMazzarese	human
@93330610	human
@FlyBarre	org
@SofsCostaLima	unknown
@FaraPartyDesign	human
@PirwTnk	org
@WYGJGardner	unknown
@Daniidris	human
@TheFOODESCORT	human
@sassysomza	human
@stef_daydreamer	org
@JoannaMayyy	human
@Quincy_Ault	human
@TAPAteria	org
@Kethiiketkat	human
@ddaniidd	human
@MIDDLESOUL_POET	org
@TyphoonWatchPH	human
@Credonator	unknown
@hatch94	org
@Taengboo_	unknown
@ingridhlu	human
@oakvillenut	human
@KidsChoiceCCC	human
@KarlaSand95	unknown
@WrapsbyTiff	org
@PEREBurgerBar	org
@MohdAbodi	human
@DetoxMuzik	unknown
@thehitfiles	unknown
@Worldnewsapp	org
@MReddisyar	human
@RoupeLaurice	unknown
@chefjasongorman	human
@patgargolf	human
@ianmatthew98	human
@sam22smithy	human
@MummyBarrow	human
@SalesInsideInc	unknown
@jessicamayadam	human
@KofiPaintsil	human
@Sajida35	human
@Twitlertwit	org
@faeriekim	human
@heidecamille	human
@HausZ_Offenburg	human
@alexbros91	human
@WayneStinnett_	human
@arky	human
@itsdavenotdavid	human
@MayaInting	human
@red_kjr	human
@nikkieandbabies	human
@asos_isabella	human
@c_u_8	human
@fatafrica	unknown
@southern_boyz	human
@leleboo	human
@TruffaDeMora	org
@Lunchboxpgh	org
@flyerfolio	human
@krazykeap	human
@TheBigZatan	human
@spursfanhawaii	human
@Suelforlife	human
@christys17	human
@yingying258	org
@nathalieholroyd	human
@Raja_5	org
@andileones	human
@uittiuitti	human
@foodhubservices	human
@SilviaSherr	human
@mwmakeup	human
@Takingsumzee	human
@j2m1000	human
@Winterskel	org
@Luc1aChan	org
@Mel_Deluka	unknown
@Babigrl617	human
@KKPIOS	org
@BajaTacoTruck	human
@cindisdeli	org
@redshirtbabe	human
@EatDrinkThePark	org
@Esteban507pty	unknown
@ericatilley	org
@javipese	human
@thedailygleich	human
@Landing_Mane	human
@yamamoto_yuuki	human
@nora_olalla	unknown
@KAORU_shiatsu	human
@schap329	human
@Yhdyjz_97	unknown
@Houtoven_bakker	human
@goldenphoto_pro	human
@almotamrdaa	human
@karthik_reddy8	human
@makegoawesome	org
@candycola_dxb	unknown
@AliciaLKY	human
@JustMeJaz	human
@iamnotgiorgio	human
@madellekelly	human
@LavoLV	org
@discopiggu	human
@andre_karren	human
@SilvyTorricelli	human
@1flychicken	human
@skadavy101	human
@Redcarpetents	human
@mirnadiazoni	human
@lohan_mexico	org
@Thetrendmix	human
@Kishluvv	human
@eastendeats27	org
@RayaMische	human
@higu1988	human
@shu_516	human
@_Pretty_Pisces	human
@NYCGetSocial	org
@JulietaSalandin	human
@aylincny	human
@KASPUTA	human
@emgenx	human
@QualityDairy	org
@aaNKay	human
@mashuda1712	human
@MarcoPoloNewc	org
@CTCEF	human
@ninacariss	human
@TTPETCHA	unknown
@GoldboxATL	human
@PascheInfo	unknown
@Ta2dReceptionst	human
@carlamechele	human
@HungryTalia	unknown
@vixenkm	human
@RealDjKg	human
@msrebs0128	unknown
@CamiPradob	org
@RealityofKris	human
@muthu_fker	org
@khm_dasha	human
@JoeJack88	human
@Warwick_Hotels	org
@TetaLizza	org
@wage_aji	org
@djorivest	human
@delfavanegas	unknown
@LilMissFreckles	human
@EricaKartak	human
@LukesGranville	org
@panoramalounge	human
@TodWilliams4	unknown
@spillipssays	human
@yakko1025	human
@green29799811	human
@PureOrganiFoods	human
@StacyWoof	human
@ronnieshockley	org
@ctnurida	human
@_RareBreedB	unknown
@ellekissexy	unknown
@VietaAmelia	human
@Guillianita21	human
@aromayoga	human
@RachelSherwood4	org
@happy_saki	human
@chefnathanlyon	org
@luciodublin	unknown
@ElenaSelezneva	human
@iHate_Nostalgia	human
@walturrr	human
@YOUhome_NHG	org
@pierceforgov	human
@PrincessNicki3	human
@AlbertsonsOR	unknown
@HenchNutrition	org
@JoanaRuiz_	human
@RpIrving	human
@busymommymedia	human
@AlexiGalaxy	human
@iamrafaeljohn	human
@MisakiHanai	unknown
@AlejandroCorzo	human
@SICKSTUDS	human
@TinaSeitzinger	human
@MindBodyFoodAUS	human
@colbygeyer	human
@secondmercedes	human
@TheaLucky	human
@MCLifeRocks	org
@ShuktaraCakes	org
@HuntingDragons	org
@wallpapers7	human
@rhutie0301	human
@HollenboN	unknown
@EmburyErin	human
@DiscoverDior	human
@ZedBar	unknown
@AngelColladoRM	human
@scotthill996	human
@SunflowersBlog	unknown
@PeriplosTravel	human
@SofiaSantosBA	unknown
@ckungcuisine	human
@SayWellness19	org
@AvaniRestaurant	human
@my_urban_larder	human
@ChrisDoddPhoto	human
@shonaroyston	human
@meals_marylbone	org
@AngieMerCruz	human
@what_62	human
@erinsinsidejob	human
@JadedArcourt	human
@JaviiChTwiter	unknown
@JoanLivingbig	human
@PrinsDebbie	human
@THEREALKNOTCH	human
@Baby_Doll432	unknown
@chophouseAlbert	org
@lenasdesign	human
@Melody_Malone	human
@hirakadephantom	org
@TTSol	human
@itsmissmags	human
@TeresaGadz	unknown
@TampaBayChef	org
@hiro17march	human
@CLEWoknRoll	org
@IzzyAmore	org
@Puspitarahayup	human
@AntiBurntToast	org
@nutko_vespa	human
@adijoshi07	human
@thatemilykelley	human
@JosserM	human
@jjstewfla	human
@zafinalee	human
@312TXhottie	unknown
@dearindira	human
@RaiseNGlaze	unknown
@SarahStramel	human
@BettyHillyard	human
@illegal__noise	human
@na1_h	human
@chobii	human
@Vladi758	human
@SirRubalot	human
@Jason6440	human
@Chatelaine	human
@ArvinEscueta	human
@Fifashionblog	human
@AnnisaSyarif	human
@patelamin4	unknown
@bernadomonte	org
@stalker1113	unknown
@Andrika_W	human
@NikkiDchanel	human
@mrethanmeatloaf	human
@peach_water	human
@TheyCallMeDaymz	human
@Bibi781	human
@TattooedDolly	human
@dee2pink	human
@tillietoo	unknown
@powerval	human
@SodaCitySC	human
@KieranMonteiro	human
@turinedu	human
@sarenaplaza	human
@EllenKeating1	human
@Suwanjoetjet	human
@EuroTuz	org
@MaryMaryAlmaaa	human
@jennybeemee	human
@jclien2	human
@Derby_Hotels	org
@TheCarteeImage	unknown
@Q33Cafe	human
@rubykhong	unknown
@imJeremyCP	human
@mariolunasomm	human
@MonaOfh25351	human
@diegomenendez96	human
@larrywhite317	human
@grannybiker	human
@carlofabio	human
@Thathayank88	human
@AppNovelplus	human
@Kalila_Cafe	human
@AGreathouse_AK	human
@nursemonde	human
@Natykid	human
@TheHarryCarter	human
@fufufnyk	human
@irinagonzalez	human
@kisses_4bieber	human
@arvindpassey	human
@TrimpacMeats	org
@ferchu2108	human
@karldashians	human
@licia_piper	human
@daniel0225	human
@emiliakapas	human
@LexiiBalogh	human
@radioowen	human
@joshuakleinman	human
@instagram_dn	human
@MaddawgManpants	human
@MBHouseNorman	org
@cal_girl167	human
@HelenParfionova	human
@cigarweekly	org
@PARIICHIQUE	human
@RaleighPDX	unknown
@nagacentil	human
@DawsonCyndi	human
@PeopleBuyPeople	org
@PUNTACANARESORT	human
@LoveDylanJ	human
@emz_beggs	human
@ksjm1703	human
@alaakabalan	human
@outinvancouver	human
@allieeee04	human
@AlexiaDHoe	human
@africanbite	org
@Jules_CEP	unknown
@SexyesPieroB	org
@ExtremePitaYYC	human
@Coach_horsesW1F	unknown
@Zanajeel	human
@sbchuta	human
@J_Goldin	org
@hachi_yuriko	human
@RHTIII	human
@joelquek95	human
@TedNguyen	org
@Aimeesthings	human
@danidaab	human
@FathimathXaa	human
@ree2904	unknown
@JenniferBacchus	human
@MelisaMissy	human
@maeglicht	human
@bupphaofficial	human
@JuliTrauma	human
@RoaderyFood	org
@vikingrl	human
@May_Fair_Bar	org
@KellyPlowe	human
@zeolobsterboy	unknown
@NACAROINC	human
@880ym1sh0	human
@paperbackasia	org
@gaze66aya	human
@GianYendilotto	human
@touristeye	human
@nestnestnest	human
@Aurelie_JA	human
@RdownieXO	human
@charlotte_pink	human
@LoanSanschagrin	human
@Jackiebartlettx	human
@NapaBarKitchen	human
@Lief0331	unknown
@lobstergreedy	unknown
@GF_Probz12	unknown
@TipsyBrooklyn	org
@Miza_Huang	human
@AnnabellesEdin	human
@AngieMalek	human
@thisisStephanie	human
@shibouman	human
@bostonyogis	org
@Hakki_Arikan	human
@MaicihJatim	human
@Yuka_116	human
@Dubs_All_Day	unknown
@CinMeow	human
@AcuarelaBistro	org
@pbreyes0510	human
@GIFTfrHeaven	human
@nlprimal	org
@damian50823486	human
@Foodfirefeast	org
@IamMrSilk	human
@KelownaChances	human
@mhaye_61879	human
@Savio1987	human
@itsmedalma	human
@JordanLaurene	unknown
@itsmadcrawford	human
@Darastaic	human
@pegva	human
@DJREADI	human
@santibanezdani	human
@brookette	human
@NaturalmentMama	human
@DJOsito	human
@TramontaneCafe	org
@cuponeandote	human
@lucamendouza	human
@sheldan2207	human
@TelemetroRadio	human
@Sweets_Amber	human
@B_thabody	human
@Biddy_Mulligans	human
@xomissaracelly	human
@HoebenJ	human
@kumi_vega	human
@Simona1976	human
@marumaruyaya	human
@albCuadrado	org
@yukam_18	human
@ArifMzanii	human
@TRCTHREE	org
@countrychicgal	org
@jamgum	unknown
@wall_famel1	org
@uk_dfsz	human
@MSweetwood	human
@DoraKuo	human
@servfromscratch	human
@13ba	human
@KaiqinsaysHI	human
@Lanevids	human
@anyyyaa_boginya	human
@MikeyWellers	human
@smartbowl	human
@JohnRossDany	unknown
@iarjun	human
@pizza_amo	human
@Ohio_Digital	org
@Cas_Oli	human
@bengsocute	human
@jaguarjay98	human
@bellapiranna	human
@TyphanyM	human
@TaksunT	unknown
@ElvisFreshlyCTL	human
@madhuliajay	human
@rikupiko	unknown
@HillHouseJail	unknown
@joshstoffregen	human
@Miki910722	human
@cdgravy	human
@ralfguapo	human
@akwing35	human
@AnnaWoodysDesk	human
@FBatallan	human
@Punk14bz	human
@kamya1k	human
@PioneerSettler	org
@fiewofejoig	human
@whimpsy_wink	org
@vintageblogmode	human
@hanna__219	human
@MissMuna	human
@swimlynn	unknown
@_nursuziana	human
@richiesartwork	org
@theeggfactory	org
@summerdaze2	human
@SimmiDeLuxe	human
@Olie_Besti	unknown
@CafeHabanaUAE	org
@DutchMAmericanD	human
@DockersHamptons	org
@x_LucyBella_x	human
@sunsetjoyce	unknown
@UnionSquareSF	org
@Licyisalyricist	unknown
@bevereverlee	human
@alexkemmerich	human
@aga1af	human
@Dannogz	human
@NewPageFitness	human
@G_DESIxGUECE	human
@_kimrandall	human
@betty1958davis	unknown
@yumishangxiao	human
@BriocheDoreeNA	org
@ihsanabdullah	human
@Rayman7774	human
@AtlanticReach	org
@Districtaustin1	org
@HarrysCafe1	org
@royaldixie	human
@Kawaii_Goodies	human
@TheCrouchEnder_	human
@suez_in	human
@glimeprid	unknown
@RupeeDeals	human
@SGHJerusalem	org
@hanisvarcoe	human
@outpostSB	human
@RIREI_TAMA	human
@deBezemkast	human
@AaronGardux	human
@CharMazing1	human
@LekkerTafelen	org
@AmithMalinga	human
@alrightboyz	human
@youroptimallife	human
@TheNewHobbit	org
@alchemistgift	org
@louisecooney_	human
@Young_Chronos	human
@TheLilangel1975	human
@LegsLeggyLegger	unknown
@ainsindahouse	human
@Justincredible1	human
@miraisaitou	human
@ChristyRDavis	human
@wclaber	human
@yuji979	human
@ruhila_jalil	human
@Eibs_Medina15	human
@NormaJeanDesign	human
@KoopersJaX	org
@LifeEdSouthern	org
@CostaCoffeeUAE	org
@MiisoShinsong	human
@TamaraD86	human
@rosswmac	human
@Elsa_Lilly	human
@sofouellet	human
@acmefoodco	human
@annachan_xox_	unknown
@kaemania_c	human
@mcpunpisut	human
@syaffysahari	unknown
@th1stoppromshop	org
@maxcalbucci	human
@BruneiKita	human
@FreshFries90	human
@gzicherm	human
@KatMooreMedia	org
@arahjasiel	human
@Twty382	org
@jiformales	human
@Alpunto_Chef	human
@blade1of1000	human
@adeelmirza1980	human
@yendiism	human
@leciamaria	human
@eyiq	org
@templetonprop	org
@BiancuTorino	human
@Grumpyduck	human
@iamstefanus	human
@Ruthie_ohh	human
@BimbiDotgirl	org
@xoYaya	human
@hotelicon	human
@AndreDadjo17	human
@MojoBar16	org
@ChapterOneNYC	org
@merrynancylia	human
@LuciaBergonzoni	human
@SophieB19_	human
@BarMaltes	org
@Sam__Ram	unknown
@ogulyz	human
@DianMayangsari	human
@MsUtaW	unknown
@katbayer	human
@CAPTAIN2Monster	unknown
@peanut_emm	human
@CrystalClaire23	human
@GreenLgtHealing	human
@Russia__Fashion	unknown
@cookingandcomp	human
@top_noona	human
@528Luxury	org
@dyan_evil88	human
@Sarahlenore	human
@YorkRdKitchen	org
@jadesoulcatcher	human
@Sagartron	human
@lancerietwit	human
@NaNaSiRZaQ	human
@mukaiyuki	human
@AbiAndTheKids	unknown
@gotrice4sure	human
@emblem_yokohama	human
@djfeez	human
@redmetal73	human
@DrinksEnthusist	org
@Sachse01	human
@bos_nyc	org
@callmechippy17	human
@BrewCafeBoston	org
@kimkomposer	human
@Morningblushbg	unknown
@chigobigoo	human
@anaispe11202949	human
@NessyYawww	unknown
@mami_dana	human
@xiaoshuokathy	human
@MysterHide	human
@alexandrios_1	org
@MarionOhMaron	human
@tepoyG	human
@Jeff_Kriss	human
@elitejean	human
@SONE_ryoko	unknown
@connerstewart3	org
@DTPourHouse	org
@EL_AMERIKANO	human
@HotelSnaps	org
@RayJayPerreault	human
@Arrastua_P	human
@mydinernetwork	org
@TipoftheFork	human
@ShopAlexandra	human
@RomanRoadLDN	org
@KitaKutie	unknown
@ChasingDreams22	human
@NovitaAnggi	unknown
@p_courtney	human
@ThinkBiggerSJ	org
@mrpiromalli	human
@MzR0C	unknown
@ellerychu	human
@cldetary	human
@AAkshatt	human
@PeakPhysiqueRI	human
@EddBoada	human
@AhmedAlArshi	human
@1n0nlyJT	human
@pattyimage	human
@CuTebEanZ	org
@BoboGoleMuseInc	human
@LondonFoodLove	human
@philliptan74	human
@Justinswainson	unknown
@KovesiAniko	human
@Justsaysj	human
@MOKSHAyogaDtown	org
@Alincucina	human
@ClstnPlmtr	unknown
@jayhawkmommy	human
@jeannie_kartis	human
@unbreakablejae	org
@SumMoore	human
@moodygoddess	human
@A1_Cyber	org
@hannahshapnings	human
@lexiielicious	human
@michiiGii	human
@VIRGOMktgSrvc	unknown
@nicolepinkdavis	human
@alvin_adiwira	human
@malikova_k	human
@ElnaPakiding	org
@MrJohnSarlis	human
@TryzaMonica	human
@HappyYellowCo	human
@ShimmerAndFade	human
@ponikuta	human
@a_yan1990120	unknown
@dkohler87	unknown
@SusannahCJUK	human
@thecorbettkid	human
@rossinacibo	human
@vikingdrewby	human
@ChineyPhat	unknown
@genkigonzo	human
@Gingernuts73	org
@VitalityGuide	human
@MuhdIce	human
@MK_Cuisine	org
@Kaz_Louise_HB	human
@SoldierTori	human
@AnnaaWulluR	unknown
@ArtistiKAlyuniq	human
@eyoungfit1	human
@marbellastyle	human
@IndienneLove	unknown
@anitalorileira	human
@AnAngelChampion	human
@WeeMidge	human
@IgnacioB13	human
@NephthysPhoenix	org
@shaahheenn	org
@vpjsuu	org
@mrs_meep	human
@emyliarosnaida	human
@macfanatic56	org
@alessia11musc	human
@MrJohnAguiar	human
@rausgeher_de	org
@kuruma_syain	unknown
@pkiller	human
@dilancaglar	human
@oinkcooking	human
@LucciCane	human
@maral_arslanian	human
@mommy2pmg	human
@labsJoReu	human
@IntroducingShai	human
@JorgeAmeer	org
@Abigailwhiting2	unknown
@KlydeWarrenPark	org
@yayadino	human
@earthtotiffie	human
@BoNiTaKaRmA1	human
@cityseasonsuae	org
@leo_rahman	human
@chiakimari	human
@berniejoemour	human
@gschilicompany	org
@julsthetrex	human
@diner_retro	org
@MarkMorrow34	human
@ItsTeeriffic	human
@SassyGinja	human
@SabrinaMustafa	human
@anamatusevic	human
@nikolaafowlera1	human
@FOOLLYWAYNEDIVA	unknown
@HowiesTopDog	org
@HeavyRestaurant	org
@Healthy_Bodyz	human
@itsmemelrose	human
@Marlllon	human
@datboichris23	human
@JUVENTUDGUERRE2	human
@DoctorKrulig	human
@windautamii	org
@everydaypaleo	human
@foruidsin	human
@pouchpies	org
@lower_lonsdale	human
@AlejandroTD90	org
@LoreeRubiio	human
@YSHDSHNY	human
@Casey_Goh	org
@Rezfilmbuff	human
@rubenleobcn	human
@FitnessFusionRI	human
@JennyLeeSwirls	org
@sarshelyam	human
@craftymango_	human
@hayley_sewell2	human
@Darriez_Be_Cool	human
@atsuko07103	human
@teniandriani_	human
@courtpotteriskk	human
@emandujano1956	human
@missyeanni	human
@reeeef711	human
@thatha_cutez	human
@IoannouMel	human
@ocha_white	human
@tt_x3	human
@TowerHousewares	org
@fashionista93x	human
@cakewalkr	human
@devgan_vaibhav	human
@NicolaNatali	unknown
@ElMesonUSA	org
@nadiayates	human
@rallarkocken	human
@MsViwinie	human
@FanzoElite	unknown
@ThisGirlNikki_	human
@Gastro_inside	human
@Sandra_Marticio	human
@fra_berni	human
@TheCannon7744	unknown
@laurakaminer	human
@milans46	human
@mestarbucks	org
@Melvin_Chuleria	human
@StretchChicago	org
@_PrettyVisitor	human
@DivietoRistoran	org
@weeboulangerie	org
@Staaceeee	unknown
@marketdelivered	human
@SessaSaysWhat	human
@barabaramee42	human
@zgl_ozo	human
@HastonNg6020	unknown
@Asimyar	human
@PaweIU	org
@nerivaldoaraujo	human
@muhd_zaed	human
@DvdndDiplomats	org
@VinnaSen	human
@657FC	human
@MinelaVP	human
@Li8TLeMissViXen	unknown
@suzyq821008	human
@TheWebfootBar	org
@AgusCaldern_	unknown
@rodeane	unknown
@adeliafernanda	human
@elmightyFlavio	org
@PuroPincheSA	org
@TayshaGlover	human
@CarocLine	human
@Dk7448	human
@MarshallMarsh78	human
@MyBrownBaby	human
@MealsandBoon	org
@ElToLargo	org
@Marlynguzman	human
@MariannaLentini	human
@MywalletMystyle	human
@EmilyTCT	human
@SpaceMuhngkee	human
@RoyleVictoria	human
@titleconcealer	human
@Linlinnnnng	human
@blondeandblackp	human
@Narunn	human
@ServyApp	org
@mollyatthelist	human
@LIFranchise	human
@Michael_Lee15	human
@BareBonesHealth	human
@ArielInfanteDev	human
@awubmore	unknown
@lifeofcheetos	human
@nikkaguinto	human
@TheSexyVegan	org
@ILoveMyPebble	human
@Denny_Telika	human
@Ping830407	human
@Flip_the_Planet	unknown
@writerswebla	org
@dmostovoy	human
@ChauntyModel	human
@blueplateavon	org
@standardEV	human
@KailaMcT	human
@emimakeupNY	human
@WASBAR	human
@al4sk4	human
@ShBin5leefa	human
@geolovesdrums	human
@antonioruizv	human
@charsfavorite	human
@HayatiHassan	human
@ChelseaPiers09	human
@DanRebeccaB	human
@coffea_coffee	org
@CarolineTang100	human
@ckburgess13	human
@marielchuniie	human
@DavidJDawg	org
@_TheKitchens	org
@daiqui43	org
@adhigoen	org
@kotoba_todo	unknown
@mylene_mylove	unknown
@A_Winatir	unknown
@BURHANKILIC1	unknown
@mok_oh	human
@SoFitch	org
@OperaGaga	human
@Adifashla	org
@K_Corbishley	human
@UrHunneeB	org
@lindarni	human
@anettemorgan	human
@Superking1000	org
@cpjrecords	human
@Bozmyn	org
@SimplyGBJao	org
@tomocodocomo	human
@relletasgal	human
@SUNDAY_ANABOLE	unknown
@antosica21	unknown
@EmilyMacfarlan1	human
@BRITNEYSNEWPAGE	human
@Miguelarnau	human
@Enjoy_Brooklyn	org
@Pang_Gizz	org
@nwmena	unknown
@MakeupByVeeTilt	human
@Merylguante	human
@Nebula_One	human
@Meener01	human
@BridesandBeauty	human
@jhenn_1828	human
@PRBANUTONGUC	human
@bobbie_lee1991	human
@laurasenna6	unknown
@_Imewalid	human
@ElisaSednaoui	human
@ayaka__tkzw	org
@1_DopeChicK	unknown
@nay_ferrer	human
@d0nnaw0ng	human
@ErichaHwang	unknown
@ModJinun	human
@IamMaggieWu	human
@TangelaWCraft	human
@vikika_fitness	human
@nicoblaster1063	human
@meiriata	human
@alfakou	unknown
@Ava_Sienna	human
@CharmingBelleT	human
@AdrianaMJ89	human
@Kretek_Ost	human
@more_mori	human
@claraclrss	unknown
@NophJhie	human
@Alyybalas	human
@LeighZemski	human
@SageLinQ	human
@chrissiepooh	human
@TheBeaversTail	org
@Lakergirljess	human
@kwokjonathan	human
@CHthebear	unknown
@Morgan1Beth	human
@cwnutritionyoga	org
@PAYTONKEMP	human
@newage_author	human
@YogiMami	human
@gwenalibaba	human
@DaNoi95	human
@Nenglia49	unknown
@NikkiNkdoolin	human
@Iamnathalie06	human
@souksalmiya	org
@sknguru	human
@zJadeyJungJi	unknown
@AmyPondlifePond	unknown
@franny_wei	unknown
@finetunedathlet	human
@AlluPhotography	human
@beltranchio	unknown
@LoveEatBurgers	human
@bdowiaa	unknown
@DakotaOggy	human
@EthelJames19	human
@RWS4TH	human
@imJB1D	org
@hojokukitu	human
@Marlin_Up	human
@lastchantz18	human
@Cbancal	unknown
@amyymoxbrose	unknown
@SeabreezeIOW	org
@kihut_london	org
@AttmansDeli	human
@jordangelep	human
@goobeara	unknown
@CantBuyYouStyle	human
@buttaflybytes	human
@cockybox	human
@KoKoKevinTan	human
@alaina_aisha	org
@Ceci_Macias	org
@Alicia__Cote	human
@rojmoj	org
@Vargas25Cj	human
@outlaw_ab	unknown
@casebut	human
@AmyMuit	org
@GadisKlasik	unknown
@HealthyForMen	human
@GGLiving	human
@lets_chef	org
@Antiquebasket	human
@VaneSleeve	unknown
@ChrisCartagenaG	human
@Shades_Of_U	human
@wheatlesskitchn	human
@SoleilDouxBlog	unknown
@Curlydavid5	human
@NafNoof	human
@MissPandochka	human
@DamnFriendly_WJ	unknown
@MIST_Harlem	org
@OneJumptoHeaven	org
@MadisonandRayne	org
@charlotte_honey	human
@littleHAPhounds	human
@MaxWaldorf	human
@MsDenbi	human
@billirantau	human
@PORTRIVERMARKET	human
@Leobozzano	human
@MikeHsuAAF	human
@maridanibandoma	human
@BoduDhon	org
@metabolicsuk	unknown
@uesHendricksb4a	unknown
@PrinceLouis1010	human
@TheBlackCandy1	human
@LisaAnneKiraly	human
@Rachelcgrant	unknown
@SiamThaiDublin	org
@sixsiixsixxx	human
@missionfood	human
@mimieyana	unknown
@gansie	human
@PowellBettyj	org
@sevenmedianews	human
@SlowCookRecipes	org
@AlyseMMedia	human
@miranda21485	human
@butterflyjenny1	human
@angiefliehser	human
@MapleandMiso	human
@JessicaSepel	human
@TheHenleyRoom	human
@kayenchua	human
@plantbasdfoodie	human
@applesprit72	human
@Womandnow	org
@PretUsa	org
@jimtomori	human
@chiyutosan	human
@Alpro_UK	org
@T0Salter	human
@NotSoThick	human
@CoachLouFitness	unknown
@cupcake_617	unknown
@xislaz	human
@JAGtv_	human
@SergeantBedlam	unknown
@ANewAddition	human
@evyyk	unknown
@1031Melody	unknown
@trokspot	human
@pratamarkh	human
@Cheapflights	human
@SamTheDietitian	human
@NutritionCouple	human
@NAGDLT	unknown
@EatMediaCorp	human
@AdrianJM13	human
@Sfaita	org
@star69bottom	human
@hkt_nmb_ske_akb	unknown
@DanniiBeauty	human
@mandypinet	unknown
@ihcateringcrea	org
@kestemtl	human
@emwanajo	unknown
@LittleSpoonCafe	org
@young_h_330	human
@meditationera	org
@LindsAtchley	human
@onlyunity2014	org
@tlepperson	human
@alonzodejesus	human
@LynetteNicole07	unknown
@CrushWineBarTO	org
@LaurenGarnham	human
@HealthKeyHUB	org
@GaaPalacios	human
@RadissonJersey	org
@FoodSwineIowa	human
@ochobrazos	human
@AndrewSzabo	human
@deanjustin	human
@alfredoazodnem	human
@leaf_parade	unknown
@BudapestPortal	org
@itzleanne	human
@Bob_OGTB	human
@dark___dreams	unknown
@DelectableYou	human
@mayemlake	org
@thenewlei	unknown
@wriggleapp	unknown
@jesusarguelles	human
@MrsSLRichards	human
@lOrelliee	human
@BalognaN	human
@Whit_GameProper	unknown
@leongaiksim	unknown
@tejune	human
@coldgoldicecrm	org
@BUD_KingShytENT	human
@Fort_Dunlop	human
@saaya0318sironi	human
@FrogPubs	org
@tennou_kanshin	human
@NaitsirhcUPC	human
@kiiyopta	human
@vink297	human
@knowmoreChris	org
@Eyy3s	human
@Vicky_T	human
@milamild19	unknown
@dinner2goBTN	org
@EmpireofGypsy	human
@BeautyRPS	unknown
@johnjaani	human
@alfeanaziz	human
@tankassandra	human
@zeparisienne	human
@LopezInSD	human
@lydiakurnia	human
@huangjen	human
@HijackGiraffe	unknown
@EASY_E87	human
@D_M_ENG	human
@discoverquebec	human
@glutenfree5941	unknown
@PittDining	human
@deege1010	human
@jancuksmartini	unknown
@minako4126	human
@DeMaxiii	human
@HerbaPowerCPL	org
@leeanncooks	human
@_Adrian83_	human
@Sharenalicia	human
@ProntoParatha	human
@DatesCheap	human
@Tangfasticz	human
@nw612	org
@SacWichUAE	org
@sarahmagana	human
@Marina_Lucero	human
@jerrysun1107	human
@Mackcinn	human
@gorian91	human
@MARTININCO	human
@hamuyuri	unknown
@SheratonMunich	org
@McLoones	human
@daengdaniel	human
@gabllenado	org
@najeebabro	human
@AvivaTink	human
@caffe_tteria	human
@lindseyshifley	human
@nickynhs59	org
@JoshLloyd84	org
@SuneetiMaharjan	human
@AstonSamarinda	org
@bondigal	human
@BearRowls	org
@Tuguhotels	org
@LucieVWood	human
@B3rnuSalguero	human
@Lyndly_Irene	human
@AlbertsonsID	unknown
@Bgirl_KT	human
@MoGloria	human
@niigatanagano1	human
@Nana_Ninaaa	org
@samerjeshi	human
@jliangmedia	human
@Leisa_Wilson	human
@seudictator	human
@britztakeaway	org
@Blog__CF	human
@JRLushington	unknown
@joanfarren	human
@DalstonMarket	human
@itsleahrous	human
@bj04179088	human
@ruby_kyun	org
@iamsuperdii	human
@Ben_In_A_Van	org
@husbandscook	org
@starsinjenseyes	org
@2GreatWorld	human
@sdsbl	unknown
@KahlilMoh	human
@KarinaSmoker	org
@CardiEvents	human
@bronzebeautypa	human
@daveo12	human
@ViBE_ub_cherr10	human
@SequoiaESierra	human
@davidcasey4	human
@MiguelNogueras	human
@ryn5578	human
@LMPanganiban17	unknown
@dinchan007	unknown
@DramaInProgress	human
@JosefBakery	org
@yayaberry14	human
@Moonboy_Affan99	human
@BurnsRoberta1	unknown
@rayneembley	human
@AvalonPhilly	org
@Cmenwong	human
@WhoIsDenisia	human
@AhuAtesel	human
@CamillaBelleITA	org
@RamadaStJohns	human
@alexishaynes	human
@Andit_deRavala	human
@SarahBarlondo	human
@Neands	human
@TonesZone	human
@ItsMePuex	human
@ozwxman	unknown
@AzlianaNatasha	human
@geoinla	human
@NikkieDidIt	org
@Ro_bieber04	unknown
@FabAtAnyAge	human
@CafeChula	human
@Winda_Karaeng	human
@breadgap	human
@aalovesvanilla	human
@adhebhisma48	unknown
@enchas11	org
@G_Kastriotis	human
@yuk244	human
@OrlandoPizzeria	org
@AnaLagunaAceves	unknown
@amdnutrition	human
@thebeautyguide	human
@TravellersBot	org
@BitterLife28	unknown
@LordNantucket	human
@HeirloomDining	org
@marybagriy	org
@MiSnacks	org
@caamivillar_	human
@er978	human
@Hecate_Hng	human
@cumi_aprilian19	human
@asvanessak	unknown
@Cardiffrinj	human
@beetwoot	human
@trudymcgregor	human
@HelloFreshUK	org
@Marty_Griffieth	human
@MicheLhaaa	human
@mytusita	human
@TOOTSILOG	human
@OlgaCharisi	human
@archiylaa	human
@moi_adam	human
@Kornspitz_Tweet	human
@NixandKix	org
@harborlightsRI	org
@NatMyhill	human
@eylexander	human
@ZELLEtotxs	human
@ViviAprilyani	human
@kidisgoat	human
@ece_slden	human
@LiilaOliveira	human
@SoMin_SoMu	org
@ZyraKenna	human
@FIQsGastronomy	human
@robsonra	org
@Glamazon1026	human
@lovelynau	human
@hannah_berrie_	human
@agugupinga	human
@joshwphoto	human
@AshleyCrowl	unknown
@jacbianc	unknown
@antoniodivine	human
@Thebarbiiexoxo	org
@ItsmeAireneG	human
@TheLocalTableNP	org
@brummify	unknown
@FarzanFaramarzi	human
@Amazzeeing	human
@iAlexDiamond	human
@MonsoonsMusings	unknown
@_flotsam_jetsam	org
@Angeline_Alinee	human
@myjtp	human
@MonicaBravoYoga	human
@Ladyb_q8	org
@iSusieStar	human
@RWHGP_BXL	unknown
@ellakitchenbar	org
@Missc247	human
@JJBella85	human
@merryjoza	unknown
@4BetterH	org
@imassageuk	human
@PaoloTerbi	org
@immaaurora	org
@DaniAlejandrino	human
@dannyblue78	human
@212Beer	org
@YourDAGNYC	org
@_o_Charlotte	human
@MuscleMousse	org
@_____irh	human
@akpadfield	human
@paki303	human
@andybofcheese	human
@Robbie687	human
@therankchef	human
@paaatmunoz	human
@jasonscaceres	human
@stellahuxley	human
@theSweetKabocha	unknown
@racer236	human
@LauraAngharad_	human
@meranduh	human
@WAYNEJR33	human
@phatelara	human
@helenification	human
@CharHadas	human
@BagelBoat	human
@pockeylover89	human
@GetFlockApp	org
@CoreyKelly	human
@Oh_Glorious_One	human
@NeuvooMason	org
@Truk_Yo_Gurl05	human
@2013Changes	org
@DivaAndDivine	human
@GomezSalsaOTR	human
@afmath1988	unknown
@elifinmutfagi	human
@_youknees	human
@LipstickLez92	unknown
@hthrxoxo	human
@maitran254	human
@TheLawnClub	org
@ChomazoneMR	human
@Dianainks	unknown
@erickaj29	human
@FitCalPORTUGAL	org
@souperwomanblog	org
@takeshiiter	org
@JAMRestaurant	org
@JuanfraaM_47	human
@iramagie	human
@HappyFoodies	org
@gakuma03	human
@1066Tweets	org
@chixriver	human
@MissMandy18	org
@aikolinaiko	human
@AllisonLIew	human
@MandyLiz5	human
@bomee_shop	unknown
@MykeNyce	human
@myoohhmy	human
@HartReikiCURES	human
@_MiaMars	unknown
@alpostogiustobb	human
@M_devahastin	unknown
@chaistupida	human
@Chanyeolichi	unknown
@SergiAlini	unknown
@semmiesem	human
@bangstergram	human
@dupuy_design	org
@kuirab	human
@aveevee	human
@TejausSingh	unknown
@ask_ralf17	human
@djherca	human
@Paulonso5	human
@HolidayInnCTG	human
@Jeladanny	org
@domotwitta	human
@vishaldilse2	human
@DiahVitasari	human
@WeiSong_	org
@kie_sze	human
@GingerSnappedIt	human
@febriputri_M	unknown
@barlianto	human
@SteinsKingston	org
@JessieMakoW	human
@Pancakemaster9	human
@praytoday89	human
@Lupetheawesome	human
@AeddDarlla	human
@anirin27	human
@maddarilke	unknown
@GillandMac	unknown
@gimestas	human
@Kristen_Love	human
@Tastethelovemcr	human
@anna_joey	human
@norazieranurul	human
@feder_cipri	unknown
@Diinax33	unknown
@DrTony44	human
@Enrico_Fantini	human
@Pump_Room	human
@MaijaIlmoniemi	org
@mar30maa	human
@FITNESSNGAMING	human
@Miggy_F_Bay_Bee	human
@_glamourisious_	human
@Caterwings	org
@JulianaPZ	human
@IronButtz	org
@GlassDharma	org
@nathanholgate	human
@mitsukihanachan	human
@ninierzsantos	org
@travelshopgirl	human
@qosonykakyqa	unknown
@StefanoBusca	human
@yongyong1028	human
@la_sarcastique	human
@DiamondCasinos	org
@DAngelo	org
@kitechii	unknown
@KristinCruz	human
@Krautlook	unknown
@ipsychyuout	human
@Alelitt16	human
@SB_Bales	org
@DowntownLincoln	org
@thessa_pink	human
@TattoozbyTim	human
@mikeypwilson1	human
@jlglatzy	human
@CuredBoulder	org
@DiChristine	human
@NewlywedSurvive	human
@hanaponcc	human
@gurkan_bayraktr	human
@AlomoraS	human
@BelmontDiner	org
@ivagoti	org
@doni_dee	human
@Ellie_Leva	org
@tella_tellong	human
@DFWSocially	human
@GoHealthyGo	human
@MomoRestaurant	org
@bdoOora27	human
@dreamerlover_	human
@CasitaCriolla	org
@Tweets_Cakery	human
@DreaBunny	human
@MyLittleMoppet	human
@BiancaCapstick	human
@LA_Culinary	org
@953FreshFM	human
@NiknoNiko	human
@peekaboolounge	org
@phoenixindacity	human
@mskidest	human
@BratHausAZ	human
@ZebranoBars	org
@valuskitchen	human
@markaddison	human
@CanalStation	org
@guenbtdotcom	human
@mydadisachef	human
@pyeroAlvarez	human
@cisem_cakir	org
@Rico_MD	org
@kteljance	human
@elliexwellys	human
@LusciouzSmile	unknown
@MichellePoveda	human
@iamnrc	human
@avik_indian	human
@YongqHI	unknown
@Bean_Yaletown	org
@haritha12	org
@plantriotic	org
@GirlyNotes	human
@kayokohonma	human
@Kevin_LA21	human
@jakescitygrille	human
@Soleduben	human
@Diego_OC93	human
@LouiseDainton	human
@rudycelestino	human
@wearePING	org
@LianeWachs	unknown
@pookiekare	human
@WLysaght	human
@tinasangster70	human
@TedsBBQWorld	unknown
@EnigmaTheCEO	human
@vitacafe	human
@C_JuAnn	human
@Nadia_Holliday	human
@llauris15	unknown
@Dust_InTime	org
@Mattpickop	org
@moodypalf	human
@Carole_Dixon	human
@PhoLanMooreOK	org
@RichK1986	human
@patsy__p	human
@dobelden	human
@choosingraw	unknown
@fraonducati	human
@d890227	human
@LittlePunkyPie	human
@dawngmarti	human
@djrobertson	human
@whitestreetnyc	org
@AmyTisdaleJones	unknown
@stgermainmusic	human
@NhazirahKA	human
@EyeHorny	unknown
@Nujero	human
@schelliehogan	human
@hearts_yuki	human
@Reibekuchen	human
@iheartlenzabaya	human
@3Sohaib	human
@Maya_Dubai	org
@Al_Kuba	org
@BoiMadon	human
@evilbaby1988	human
@ccmilne	human
@DanieMg	org
@Xerethra	human
@InsanityBistro	org
@KryllyFrystal	human
@FoodieEatsTN	human
@sizzlesausage	org
@urbanfoodreview	org
@arancha92	human
@SillyAlexMu	human
@informededin	org
@chongski	human
@iammr_wade	human
@Nocciolanyc	org
@FitnFoodGermany	human
@the_chef_jimmy	human
@80Sakhno	unknown
@soleslide	human
@birsencancan	human
@maryagracia	human
@Anna__Q	human
@ThePsych2	org
@mattolwell	human
@Herbalife	org
@thfallenscar_	unknown
@StellaSoSpoiled	human
@TommyStarSurfer	org
@PervyMike21	unknown
@MaestroAjicero	human
@putunanik	human
@didiwikiblog	org
@LaraDewar	human
@DutchLady	human
@Farah884	human
@cynkitako	unknown
@WildcatFlo	human
@angkana501	human
@TrappSwayzee	human
@Bontamarket	org
@NativeMonsterUK	org
@tomo_infobar	human
@MeMoGilbert	human
@kxly920	org
@kellyannewalton	human
@ropelli	human
@kmcchan	human
@albertobison	human
@024Grille	org
@Jose_Enrique	human
@YoKetchy	human
@jml_wilson	unknown
@edagudelo	human
@maggiecrucian	human
@colinkelly10	human
@SpringInRollOut	human
@MatthewRonk	human
@Lyndonimus	human
@vina_thung	human
@navasfranklin1	human
@nicmsmith	human
@HalaBadri	human
@Juweibug	human
@JigokuKitsune	human
@bluevalentina3	human
@The_Cyber_Guy	human
@MzTotaLPackage_	human
@TufinoPizzeria	org
@MidoriNoOrange	org
@ninstagram	human
@biltongstmarcus	org
@caparezzaesp	human
@TheBlueYCNun	org
@projectlife365	human
@dawnmit64543488	human
@PrawnographyLDN	human
@thunder4455	human
@jakkfrost	human
@blueberrybison	unknown
@HotelEdouard7	human
@katelaindia	unknown
@havethisthingff	org
@Mz1flysmile	org
@LoshLive	unknown
@theluxeditor	human
@FromKaroliina	human
@jessybOinks	human
@VillagePub2009	org
@aArchie_1993	human
@MsAesyavie	org
@nindyarifiani	unknown
@Eilynn217	human
@ladyyamato09	unknown
@MyzKitty	human
@bryanricemusic	human
@Alexy_Tiger	human
@mella_sarang	unknown
@biscottidana	human
@JenniferLpez20	human
@UmmuSalamahMus	org
@MaxLosk	human
@whoismocca	human
@ouboet135	human
@fkmunro	human
@AusInstFitness	org
@HipMamasPlace	human
@Samphirechicks	org
@AKsayOK	unknown
@arachiyo17	human
@13septembergirl	human
@zerikagan	human
@MSVL_	unknown
@texanerin	human
@JumeirahCT	org
@Nathalianobrer	unknown
@bratedn1008	unknown
@KarinaCecilyLou	human
@Carolineszpira	human
@Amberbambber	human
@stef_erin21	org
@nicolej_stjohn	unknown
@ElliKhiabani	human
@malaikitchen	org
@good2bes	human
@fabrianonotizie	human
@BalezD	human
@trendyBe	human
@pinkswanbeauty	human
@HultsRestaurant	org
@meryhottest	human
@TerraNovaHotel	unknown
@Skippedbeatx	human
@TheLoungeBR7	org
@lorijg3210	unknown
@vara_niee	human
@renewallfitness	human
@merlianawiharja	human
@0yc0	human
@blablo	human
@Maradonaman09	human
@mf_fans_2	human
@soo0317	org
@WFM_SouthEnd	org
@JADOREFOODde	unknown
@CraftBoxGirls	human
@beautycabby	human
@GGSphere	human
@LuxuryColumnist	org
@callysmusic	human
@aspiringchefant	org
@MomLovesBaking	human
@AmandaRipsam	human
@d_lx3	unknown
@TheTShirtLady	human
@Davecannell	human
@LateBloomerShow	human
@Tara_Louise_1	unknown
@iriniira	human
@fenny_goh	human
@PettigrewTea	org
@onceuponapicx	unknown
@EsterjordanR	human
@PalkiRestNVan	org
@msndud	human
@nuttyirishfdale	human
@djdeong	org
@ROL6121	human
@likemylunch	human
@Jim_Tru	org
@Dria22	human
@GGHospital	human
@bccairns	human
@inder_lamba	org
@RayMJ505	human
@wisback	human
@mez_te	human
@AquitaineSF	org
@QTripleA	human
@9e3k	human
@KRGerani	human
@LeezhaFarhutz	human
@NoflikLangwar	human
@LavenderLSpell	unknown
@_Karolin4	human
@Zeeylla	human
@imus_online	human
@BurgersEnMadrid	human
@bangtidytekkers	human
@IronChefFoodies	human
@meerkatSG	unknown
@magiordomus	human
@usseina1214	human
@Veronjca	human
@MoonlightDenver	org
@bello_adrian	human
@Slaters5050	org
@jelsybracho	human
@Thepigandpastry	human
@FourCFitness	org
@frankdom23	human
@lpetitescremes	human
@FranciscoCohel	unknown
@itsallsoBo	unknown
@aavanstaaden	human
@annesato	human
@FlorenceCornish	human
@alanrdeleon	human
@PigoGozzi	org
@DinAndiniJolie	org
@liri_su	human
@che_pasaribu	org
@harlampa	human
@hazrock101	human
@Jeff_EM	unknown
@HuntersLanding	human
@SupriyaRana5	human
@mirrorballic	unknown
@Mary1481	human
@Mavimat	human
@EthanClimbing	human
@CarlyRowena	human
@vicalvo12	human
@ieatsleepfood	human
@aliyaleekong	org
@IV9Liem	human
@instabake	human
@NY_CountryGiirl	unknown
@vinxi3	org
@bangkokhasyou	org
@KeciaHambrick	human
@CalistaGoh	human
@kristinyeo0901	human
@aya_kamimura	unknown
@realveniedalog	human
@chillinsb	unknown
@ltldark	unknown
@Spafinder	org
@BlackJusthe1	human
@common_bar	org
@whyjoselimon	human
@Starclearwaters	human
@MenuAcapulco	org
@ibopishak	human
@JohannMSmith	human
@oribest_1st	org
@livingdreamrtw	human
@JQ_LYN	human
@sherenmey	human
@joy_matorre	org
@elionieves	human
@djbashed	human
@EqualChoice	human
@UyaZahima	human
@thalassapolis	human
@joeydecaire	human
@gourmetchilango	unknown
@JOHAN_HANIBOY	org
@LPC_TeamIndia	org
@gmenhq	org
@cchinzy	human
@DaltonTroyPerez	human
@AkbarKh94	human
@Renita_m	human
@jocelinbv	org
@enjoyylch	human
@_annatootz	human
@dreynolds1991	org
@PropertiesMjs	unknown
@rayCHiLLLLLL	human
@jacks_shop	org
@newcastleboyy	human
@naokon24	human
@BigSkiesFoodCo	org
@deodius	human
@BottegaNYC	unknown
@Queenkaebaby	human
@laurenlsexton	human
@yukataka6	human
@_VegetarianInfo	human
@AgaveLoungeNM	org
@talunzeitoun	human
@hansomransom27	org
@ChefLindseyNYC	org
@TheKing65	human
@congreve12	unknown
@REALzakwan95	unknown
@VinaGracia05	human
@THE_SWANKER	human
@LBimage	human
@a_chamo0202	human
@andrecarmellini	human
@itsmelavanegas	unknown
@StandishPromo	org
@kristcass	unknown
@jwpine	human
@Safeway	org
@VintageHillbill	org
@myplusonenet	org
@topotopotopo	human
@Brooklyn_Street	org
@ali4horses	org
@kwboogieman	human
@georgeonqueen	human
@MonkBrewster	unknown
@SarahsTails	human
@pink0902f1	human
@yuipon19890905	human
@zoiaskoropadenk	human
@sdenisskizi	human
@JoGati	human
@fefilocatti	unknown
@MarietaResto	org
@panamatravelnow	human
@MarisaQuel	org
@brittanytione	human
@deusLexmachina	human
@wallydagr8	human
@FoodcationFavs	org
@muuuuchan0711	human
@damionhamilton	human
@secret_scoffer	human
@fashionchuhi	human
@pajamas777	human
@iTHURSDAYi	human
@thetindrum_hove	human
@TOBelgrade	org
@dtrmnd2succeed	human
@ledlowdtla	org
@starphiish	org
@shelmick31	human
@NicolaXcampbel	human
@emptyhandspvd	org
@Peifennnn	human
@sugarbabynicky	unknown
@DnIsCeSaR	human
@ayboz	human
@jonathanortiz4	human
@Lidyatataastro	human
@namix0106	human
@josiegoesWeeeee	unknown
@FoodPorn1	human
@MinotiMakim	human
@Ngozi749	human
@EmmaCampbellUK	human
@YETTIsays	human
@yugorel	human
@mitrapalash	org
@stedeangelis	unknown
@MaxiPriest	human
@PerfectBiteBos	org
@EstherSitumeang	human
@korkmaztuln	unknown
@JOBOTandLOCOT	unknown
@ukizou	human
@sadamoto_	human
@wann_ap	human
@FEST_raum	human
@MarkusRaggl	human
@HealthyHobokenG	unknown
@ozcannexions	human
@YoCtC	human
@Sunsparkles282	human
@PMOCentric	org
@shibashimai	human
@SaranNarayanan	human
@taverness	human
@BotCereales	org
@ImperialChorizo	org
@bestofworthing	unknown
@ram_aduri	human
@NoPressure365	org
@KENNEDYITSME	human
@CGourdin	human
@YaPhilllMe	human
@WhenAndWherePr	org
@okcdiningblog	org
@YATYGARCIA	org
@FAFArnArn	unknown
@JustFoodERP	org
@AmbitiousQuad	human
@ozako74	human
@haleys_uh_beast	human
@genediazc	unknown
@SonaHrivnakova	human
@ALMiGHtYBloNde1	human
@PhilippPepito	human
@jcheng5810	org
@itoyoshi	human
@EatOnlyRealFood	human
@JaylaCannon24	human
@Chohernandez_	unknown
@livesimply_mom	human
@GeegeeMaidin	human
@RebeccaNB	human
@tjumawan06	human
@_FruityBooty	human
@misscianci0	human
@PRKeeda	human
@juleseusebio	human
@shahdeez	human
@imsohungree	human
@thingsnatasays	human
@JudyAdamson	human
@newsattitude	human
@IM_BECK_JONES	human
@vincent03460	human
@robertbatty9015	human
@QMrSick	human
@BLondon_MTC	org
@heavenleex3	human
@vickykyle85	human
@annefbynf2a	unknown
@64Aylin	human
@AmandaRTosh	human
@JolienNathalie	human
@AlbertMajarreis	human
@Annanmai	human
@dinayolla	unknown
@jejakbali	org
@luurpa	human
@CheeburgerSC	org
@idaisyreeh	human
@dedutchyeg	org
@F1JHerbert	human
@SyedFaisal13	unknown
@Earl_McSoka	human
@amazingbon	human
@azu_mame17	human
@yohanchristian	human
@PhotographyFP	human
@jasmine_ginger	human
@NinomiyaOsumi	human
@rae0light	human
@Livongo	org
@3State_Success	org
@BryanYUph	human
@AlayneLangford	human
@ehjongsma	human
@CascataBistro	org
@stevelackmeyer	human
@getfitpanama	human
@jaffabites	human
@CrysMacGregor	org
@abigailsweetpea	unknown
@the1O1bgrsk	human
@giudr	human
@AnthonyDeSerge	human
@yukarigram	unknown
@77jomari	human
@DerbyCity_Chick	human
@BerkshireLovers	human
@FosterHollywood	human
@Scousescran	org
@justjill09	human
@littlebtpretty	human
@Songey	human
@handyman761	human
@KevinOKH	human
@iamLemSol	human
@BodyMotivator	human
@AuntNanci	human
@Sole_Restaurant	human
@betsyrosalen	human
@SevenDialsMiami	human
@Lea__ox	unknown
@NeuvooParsippa	org
@CyFitFreedom	human
@LittleMissKasi	human
@HappyMoneySaver	org
@rykarl_official	human
@ForesterFarmers	org
@CaitlinsCafe	org
@Qkenan	human
@TMLasTablas	human
@jasminegoh	human
@PeepsHotbox	human
@LaurenceBAT	human
@TumblrFurniture	human
@smily68109	human
@BCharlieG	human
@BattrUpPancakes	org
@Tiana_Volkova	human
@manaboutoffice	org
@Moevenpick_Ist	unknown
@ZayyOrtiz	human
@tenterden2	human
@Point__Period13	unknown
@javime83	human
@stutisp131293	human
@midnightfalls	human
@carlacarter68	human
@chayr18	human
@iamcolleenshaw	human
@CookingwithJul	human
@talinyy	unknown
@Electriquita	human
@shakeirat	unknown
@LoveThyself365	human
@Toniaespo	human
@VaroCanoDj	unknown
@Kenskie87	human
@ssopiko	human
@Ammar_Parda	human
@ToreyRD	human
@LeangLa	human
@FollowbackKnife	unknown
@Trivial_Week	unknown
@ESL_Ecuador	org
@Miss_Pumba	human
@CourtyardMM	org
@backyardpkslope	org
@quiseraeu	human
@pretty_k_boys	human
@Rocio1981	human
@Lynnsgr8byz	org
@savorysisters8	org
@jannascafe	org
@NSS_89	org
@tragicmic	human
@SpicezGarcia	unknown
@KartunisGandum	human
@HummaTaj	unknown
@RICK_Bellissimo	unknown
@KleineMiez	org
@catherineroesli	unknown
@KeyiaBest	org
@knocknock_penny	org
@NourishedOTG	org
@CastanedaMicha1	unknown
@bootycamptregs	human
@PlateMyMeal	org
@demarcodeni	human
@p_gahan	human
@bombaychow	org
@FSBudapest	org
@RealRayRey	human
@f3_ba	unknown
@mia_beach	human
@_renatoferreira	org
@Ziiwennss	org
@tutuddudud	human
@rrooffuss	human
@cafeno8	org
@edham_arief	human
@noelroche	human
@Sharon_Grose	human
@AmiraPut3	human
@pratitimajumdar	human
@YanSungapo	human
@mistercollins1	unknown
@Asuseefit	human
@himandhis	org
@shirleybkk	human
@Mullet863	human
@Yammylicious	human
@KuriSakura	human
@skyroomnyc	org
@thejunctionman	human
@DoncoKids	org
@AlanJepson4	human
@JessySiemons	human
@ToscanovaLA	human
@TheRichmondMag	org
@aaamitaaa	human
@Debsbabe2001	human
@noonpatcharin	human
@Aaron_Kingsbury	unknown
@PeaksShopping	org
@Verdekyun	human
@ksmg	human
@littleRobyn	human
@noseyrosey30	unknown
@stil_mekan	unknown
@Charles_VA_PCA	human
@Mamgee_Ruth	human
@thumbfive	human
@BigHouseCafe	org
@rtay96	human
@EatingTwoLive	org
@SusanZisesGreen	human
@AceeWalker	human
@JenaGrace_	org
@BiChips	org
@tweet_tze	human
@TheOtherHubby	human
@MarjaPylkkanen	human
@Michelle2helpu	human
@ithonkthongkey	org
@ChefPaolucci	org
@cykoticgecko	human
@EmilyCallaghan1	human
@CopyWritten1988	human
@Melimu2	human
@ThisIsWhyImKels	human
@ayukenangaa	human
@dhekartikaa	human
@JoesStogie	human
@Carrieokeequeen	human
@tuxifandecos	unknown
@BackyFromTHC	human
@dory44	human
@Landfraulein	human
@FlanagansGR	org
@ManaPractice	org
@VanessBrown	human
@siponlifechanel	human
@natsu_hani	org
@Hijadefruta27	human
@98rosjon	human
@alfonsina_pm	org
@cherrycyanide17	org
@PastaHouseMA	human
@OrlaCWalsh	org
@evelyn_pepe	human
@dannijs	unknown
@aasma_82	org
@Megann_Atallah	human
@MovenpickJLT	org
@Jonathan__Ellis	human
@JBChapmaniam	unknown
@AmiLeePhotos	human
@kwshingo	human
@psyche_laander	human
@sakurai_cosmic	unknown
@lipstickandlime	org
@anime_R1m92	unknown
@gratefulyoga	human
@upsidedakshin	org
@VanessaKBuzz	human
@shawnnovatt	human
@ihaveOJD	org
@clariisaa	human
@strawgieberry	human
@faruqsuhaimi	human
@hidenobukameya	unknown
@martinsbutchery	org
@frankie72h	human
@chaaijo	unknown
@JamesMontejano	human
@Lightreed	human
@TheMrBizzare	human
@mortiis7	human
@BrackenErica	human
@BistroMenil	org
@Aero4sCorner	unknown
@nael_farargy	human
@HoppinFrogTRoom	org
@shin_tan	human
@sweepstaking	human
@PatrickRomanos	human
@scorpious81	org
@leobrown325	human
@ceutunk	human
@enel_nl	unknown
@EmmaOMBW	unknown
@miltonswokingha	org
@Highlanderwine	org
@IANT131	unknown
@MMarquisDoha	human
@thecanburyarms	org
@JohnVenaProduce	human
@GIVM0000	human
@LaToyaSEdwards	human
@Pflzgrff	human
@danielmitra	human
@slyseven3	human
@JaeYanQQ	human
@danni0908	human
@whoelsebutian	human
@the_willz	human
@PtWkr	human
@Lightbrightz	unknown
@L2WAdvisor	org
@GameFi	human
@janiscarleson	org
@LuciusFang10	human
@neo7amin	human
@NHHealthyLiving	org
@CafePasquals	org
@FISH_MARKET_TRS	human
@KemollsSTL	org
@scnaree	human
@ZunnoonMeer	human
@Mater2Six	human
@mharky_yan	org
@vincentbyvango	human
@quartoamonte	human
@caifanmiky	human
@Hanne_SWG	human
@iamstarAphol	human
@TurntUpLV	org
@GolosinasDori	human
@jhopzki	human
@_BierBot_	human
@terispace	human
@NoviAnatic_ARMY	org
@ManchesterCraft	org
@yogipeanut	human
@Fopperholic	human
@junkun0504	human
@MustelaLutreola	human
@pregnancynet	org
@DIGITALidTWEETS	human
@Finorestaurant	org
@Chester_music	org
@Jetzdaa	human
@freezyizzy	human
@TonySm70997805	human
@Totoro14688	unknown
@ToniKoutu	human
@pepicola3	human
@DenverHyatt	org
@beatonstearooms	org
@MarvStrong	human
@zeppy_cat	human
@Deana_Ranucci	human
@twopetitbirds	human
@1Frealane	human
@melmeowchan	human
@AACPSHPED	org
@LeoAlvan	human
@MattJeffreyR	human
@Rarariandana	human
@Ram_eshK	human
@WhatsGoodPNG	human
@papersmage	human
@alj_jain012	human
@PlayboyBPAC	human
@dubai4world	human
@Mal_Capone	human
@SiriratKID	human
@Phill_Russell	unknown
@Leanneontwitr	unknown
@OsteriaMorini	org
@K_Shaies	human
@Elaine4488	human
@AntonetaFox	human
@ilovemytartle	human
@grrrcait	human
@training_usa	human
@hungrybearsblog	org
@newfidadian	human
@EmpowerRadio	org
@LaVistaLodge	human
@ohayousekai_	unknown
@divaxotic	org
@newdayvow	human
@woodwinedeli	unknown
@blackcooliy	human
@AnnieShanique	human
@daniel_shuta	human
@pursuitofsweet	human
@BrokenYolkCafe	org
@albertopetro2	human
@thefelia	human
@JohnJeeves	human
@Danishhomestore	org
@Godzsoja808	human
@dfelicia	human
@rsemary	human
@tasiaxx	human
@Mumbaiguru	human
@IntermixxGroup	human
@DuneFdkns	human
@orogel55	human
@BeckyW213	human
@LeonPellicer	human
@LucaBoesso	org
@WhereOC	org
@lovethejace	human
@TinyChefs	org
@captaincalv	human
@emlajolie	human
@PROSHKA	human
@selmaplanet	unknown
@elephantasticar	unknown
@PatioGoldfinch	org
@sabir_rani	org
@OaklandTae	human
@PHZ_Sicks	human
@marieclaireuk	org
@helloteenvini	human
@tc_mumbai	unknown
@DiningwithDisha	human
@ShakeologyRachy	human
@glamorlems	human
@james_geldard	human
@DaJenEats	org
@streetranger01	human
@HometownFoodie	org
@karideskfy	human
@HyattCrystalCty	org
@rocnationarmy	human
@Su_shekhawat	unknown
@INNA_GERNEGA	human
@LAEyekon	human
@FeedAfricaOrg	org
@Stanners_87	human
@sholuaws	human
@SanfordNoaa	unknown
@nikkillanera	human
@KathrinOutLoud	unknown
@Sahiltigeranand	human
@Jilien90	human
@xtinemedvigy	human
@MillerFay	human
@woodfirestockb	org
@jpickard18	human
@bernle	org
@BobbyPinApp	org
@EugeniaCasilla2	unknown
@cing_flozzz	human
@nomnomboris	human
@nelsonlee96	org
@MurrayMonday	org
@knom	human
@americoferrara	human
@NissinFoodsUSA	human
@galank_pers	human
@JitkaRobinson	human
@ruthpalishkg	org
@cady_lifer29	human
@omoshiro_QoGyp	unknown
@IsaiahCruzNYC	human
@therosegypsy	human
@SyakillaAzam	org
@MauuAguilaar	human
@DaGman7	human
@list_chinz	human
@AQuaintLife	human
@eee_erizabeth	human
@ItsMannyBones	unknown
@Believe_OutLoud	human
@TarasDolceVita	org
@mao09171	unknown
@STREATmelbourne	human
@HouseOfTitans	human
@rann1984	human
@FABChef_TO	human
@lady_dragon	human
@BulkPowders	human
@villafrancatv	human
@SimoneAllyne	human
@mervedemirkiran	human
@ChloeRichShoes	human
@Juperchu018	human
@matsepulveda	human
@tiarkris	human
@mabelhood	human
@josephreed	human
@meichanTJ	human
@TheDonBobby	human
@CariMarkovic	human
@DjDannyS	human
@wwjanetshaw	human
@King_LolaJolie	human
@omar_alonso	unknown
@nahird	human
@AdriLeonhardt	human
@rasfananta48	human
@ShortDawg805	human
@MellyAnneFlo	human
@thisis_hilal	unknown
@dawconz	human
@red_sofreekush	human
@UrszulaSundari	human
@rasbeans	human
@iamnatgood	human
@perhps86	human
@RayneBow_Dash	human
@theDoughroom	org
@StitchesMarie	human
@SherriNorige	unknown
@DKlipping	human
@MichaelDDevine	human
@smc_intl	human
@dominos_NZ	org
@Ipuby	human
@BanhMiBay	org
@potatoandf	human
@kittypereira	org
@medeiros_LC	org
@herotakas	org
@NadiSmith	human
@Rabberoonies	org
@elite_SKS	unknown
@nanuull	human
@inoriluve	org
@woiinc2011	org
@BossChik_Monroe	human
@MialyC	org
@Zil33184	human
@AutoChelms	human
@FoodPornVegas	org
@shefskitchen	org
@missmagen23	human
@gonta_cafeone	human
@Lin104	unknown
@House_Of_Wicked	org
@FoodAngelsNews	org
@yovitayunita	human
@Pausini09	human
@chchaca	unknown
@DebbieMilyus	unknown
@LaBoleraSaloon	human
@briel79	human
@LaurenBruno_	human
@amountus	human
@Kerwinpolo	unknown
@CarpeDieMia	human
@macnelus	human
@EleasahCakeGirl	human
@_thesixgod	human
@Roaringpurr	human
@SirHakki	human
@KiddRapinetLLP	human
@samiabouzid	human
@trappedintheory	org
@PaolaXGarzon	human
@MillCreekBarFun	unknown
@albertwinardi	human
@suzi9soccer	human
@michaelliffen	human
@Ath_Kitch_uk	human
@DQOM	human
@KatD55	human
@SYDNEYJUSTINFUN	human
@phpRTBot	org
@MarKenny	unknown
@Cadryskitchen	human
@EP_81	human
@fika_london	org
@pastorpookey2	unknown
@d_stanczyk	human
@heyybea	unknown
@fneri3	unknown
@HonokowaiDeli	org
@cookiesANDclogs	human
@LuisTapucar	human
@KCIShopLocal	org
@JanneDsi	human
@londonleben	org
@aUuuuNanakorn	human
@chloechieww	human
@amksan123	human
@GetForky	org
@fxteddyk	human
@Rachel_Boyce	human
@smileemearah	human
@pair_with_us	org
@letiziamaestri	human
@aci97	human
@KakaYard	unknown
@DeannaRowser	human
@davidfmaez	human
@the_bump	human
@ryelinnn	human
@OJIEPGA	human
@Girl_OffRoad	human
@halocandlecokr	human
@Nani_Wale_No	human
@AlessiaSica24	human
@coralgableslove	org
@SpeedyWellness	human
@ChloeDa_Beauty	human
@Lynnette	human
@DidierMorales	human
@Izz145	human
@fitjennoverway	human
@bistrokido	unknown
@dikkamahardika	human
@projectx58	human
@DavinaSparkle	human
@TheParsiTimes	org
@ikay_kriska	human
@waltertrovato	human
@MidlandBIA	org
@LBBBangalore	org
@marciniraq	human
@tidus08	unknown
@angryskatepoop	org
@anoukyve	human
@SidelinesBarNJ	org
@brrrittch	human
@Myscoopus	org
@altahac	unknown
@meenujewellery	human
@JohnCesters	human
@InstaAbakan	human
@cambridgegirl	human
@TsvetankaDimova	human
@Jerontyw	human
@RebeccaPennell	human
@BodyFury	unknown
@dboyreal100	human
@annafarrow	human
@cookitgirl	org
@MalbecCuisine	org
@djqtime	unknown
@angelvamp	human
@CalderonLarge	unknown
@SappLife	human
@MariaNoell217	human
@NuffieldHealth	org
@MMOPokemon	unknown
@HussainAlishaq	human
@TheCrowdUpdater	org
@TheCouponsApp	human
@ReelMediaCoach	unknown
@bakchang	human
@dannyg_33	unknown
@fpsil999	human
@speight_mark	human
@zothi1606	human
@AlexMariniDj	org
@Nellies_StJohns	unknown
@kolidetweet	org
@AnZiPanZDesigns	human
@wisdapraspa	unknown
@UmaizoTruck	unknown
@clara_foodie	org
@evaxtinaginting	human
@HammerHungarian	human
@levijarvi	human
@RDJennie	org
@Iloveworthing	human
@dewimul52959752	human
@placarpnana	human
@Kitsun_	human
@BargainNext	org
@dexterdextao	human
@aq_nink	org
@KatieAliciaF	org
@gogyroz	org
@Ms_Jenny73	human
@AskMissA	org
@ADre_InTheLife	human
@StacySchott	human
@Sabrie_Na	unknown
@sstenn	human
@ScrewPac	human
@onemnako	human
@buzzjy	human
@putudiah22	human
@stephenrees1996	human
@SusieJulia	human
@ThirzahSlater	human
@SoFabHealth	org
@angiesandhu	human
@HoneyBoutique_1	org
@Chris_Furtado1	unknown
@pollyvictoria	human
@EnchantdFaerie	human
@Mrs_Stoli	human
@This_isChris	human
@drkronmiller	human
@genesis180993	org
@colineseraconte	human
@wickdchiq	human
@mikyzaff	human
@LizzyBrodie	human
@borjism	human
@izzysfromthebay	human
@tfrederick313	human
@angeleneganda	human
@TheBantryBay1	human
@Mykonoscayenne	unknown
@aghniaputri32	human
@HannahSherwood3	human
@anne7ouise	human
@GFreeProf	human
@caseysadlowski	human
@RosalieRuardy	human
@DavidGCastle	human
@manubella76	human
@tsujikimiaki	human
@lifethruapalate	human
@naativity	unknown
@jeffzzz	human
@yuroyuroyuuro	human
@OMARSHINEZ	human
@Such_A_Narcist	human
@_betty_89	human
@ReginaZahejska	human
@PLACTest	org
@CruzMary1z	human
@Rob_Crooks_13	human
@monkiidansu	human
@jillyraeh	human
@zul_tsukasa	human
@nihal_fadly	human
@pizaevino	org
@Theniagaralocal	org
@susejelyn	unknown
@Leeah_Lee	human
@ai_mex	human
@KhosiButhelezi	human
@petitveau1	org
@WeAre_Adventure	human
@LeveragePerks	human
@JenCrabs	human
@DJRizEnt	org
@Borbenz26	human
@NoWayJoseCafe	org
@green19	human
@jerushachande	human
@Coach_Shevy	human
@polosidnei	human
@ashbimu	human
@redheadblondie	org
@JavierRCruz	human
@ryangm	human
@smllkit2you	org
@stapandits	human
@batharaandre	human
@obsidian78	human
@ayuchoon920	org
@ekosugiono_	human
@pretty514u	human
@ChableL21	human
@Smellyann	human
@sophierustonx	human
@IzyanMalik	human
@GeoSuper_TeeZ	org
@cclysicilia	human
@JavitoVegas	human
@soniambar	human
@innocentcherub	human
@Fatalic_Dj	human
@bodybymarktv	human
@arabiajj	human
@CruzHeidi011	human
@klguifdgfh	human
@HookedSprinkles	human
@daoloi	unknown
@BeatriceGomez97	human
@bcunny1984	human
@ThatFoodWhore	org
@BauliUSA	human
@MagrxD	unknown
@n0z0m10322	unknown
@LadyChelington	human
@slacar	human
@kriyacarbonell	human
@FabricateFamily	human
@brendap361	human
@PanisCafe	org
@SpitzEagleRock	unknown
@eliblued	human
@bloomsbury_brij	human
@jesssjohnsonx	unknown
@ROSSEYlicious	human
@aceit2000	unknown
@VeronaM310	org
@kimcoke	human
@antoniocordobaM	org
@Divz24	human
@BarcelonaDime	org
@TorresMarian2	unknown
@myhyv_ig	human
@GaetaneDW	unknown
@Recomendao	org
@1nourishedlife	human
@FelixFranzFerdl	human
@techdrones	unknown
@Stepwen	human
@thefatproject	org
@jeslovelee	human
@AudPearl	human
@LuthandoDisane	human
@bnattapat	org
@beoliu	human
@koitheatre	human
@Bonecade_Trapos	human
@dwelltimecoffee	unknown
@SidewalkSafari	human
@WestendPumphous	org
@olivia280177	unknown
@Eonee_	human
@maelennlg	human
@SaraTrabalza_	org
@XimenaN21	org
@TrendsettersMAC	human
@Zaklie_Minogue	human
@Marcha020	human
@EatingTampaBay	org
@MicahMunoz13	human
@huber_angela	human
@MaribellCaban	human
@topecadu28	human
@DeeeeeC12	human
@itzmekhriz	human
@ShopLocalSugar	unknown
@Tip_So_Topnotch	human
@triciaedub	human
@repaci31	human
@crazybluebird	human
@patri_m7	human
@bintang_xavier	human
@NinaEatsNOLA	human
@thebabybrucelee	human
@MCAngeliqueC	unknown
@lounia_	human
@LisaHardnutts	human
@ThatGirlAlli23	human
@Detha_Clyde	human
@skifefa	human
@northwalesinks	human
@soniachoi1	human
@Amb_World21	human
@rosanna_davison	human
@fdbloggers	org
@MuryoticAcid	human
@davidmntnvrgn	unknown
@EmanuelMillan	human
@AsianaSwindon	unknown
@karayuquex	human
@Daniela_Haenig	human
@CountryHouseNY	org
@TekiRosh	human
@Kram_Brulee	human
@FREDDYVALOY	human
@Keshialuvsu	unknown
@CFoodies	human
@Getrealirishtou	org
@_amylla	human
@lindseyleet	human
@jaligonzalez	human
@YAMMMLONDON	human
@SheAUnicorn	human
@festavico	human
@fakebrenthill	human
@IrinaSerrano	human
@argielau	human
@sipadmohd	human
@taylorslakeshot	org
@offy29	human
@iamchunhao	unknown
@cstilloryan30	human
@mike_erz	human
@jimmycaffrey44	human
@sayumisaaaan	human
@ALBAKER999	human
@CarolinaGuides	human
@JilliciousCharm	human
@kateturnermusic	human
@grub_social	human
@eddiemotion	human
@risangels	human
@CynthiaLe13	human
@Thompso1Tiffany	unknown
@BrokenBeautyAus	unknown
@TheNaveedShah	org
@pekpongpaet	org
@kjoreproject	human
@30plusbootcamp	org
@kivka	human
@moonmeals	org
@Pyarmahal	unknown
@sadidas1972	unknown
@EataPitaPhilly	org
@TreeVinos	org
@abbeyjade	human
@katie_rayfield	human
@angellicayi	unknown
@KatieEllenVlogs	human
@plstobie	human
@deevinesunshine	human
@KempinskiDubai	org
@gamefacelee	human
@StockFood_UK	org
@vegnutrition	org
@drummerspraise	human
@Clounie	human
@2beansandabump	unknown
@dilaaanyilmaaaz	human
@MellowMushLEX	org
@MissPembers	human
@culinarypixel	human
@DiahAdz09	human
@TheChicCanuck	human
@irishIMguy	human
@drezgodepw	human
@ValV85	human
@etcvenues	org
@Kelvinsean	human
@asimonse	human
@FLY1NRYAN	human
@ruiz_toledo	unknown
@azriman_mai	human
@ImBossBabyy	human
@debbietph	org
@marinecornut	human
@sarahjocc	human
@Fanfan75	org
@HobbyBerries	unknown
@kitcatsayz	human
@rochellebodinu1	human
@Seiyun_Park	human
@LAYDCHKS	human
@ValhallaInnTbay	human
@themanneater	human
@dubsm177	org
@pattifriday	human
@melisustacim	human
@millimellimolli	human
@ShopDesignSpark	human
@FelixMapleFudge	human
@Manny2Freshhh	human
@KevinYadao	human
@HellaRocks	human
@iamdrjazz	org
@NathelHernandez	human
@HeatherVitale	human
@DMackieV	human
@michellaoy71	human
@MIV_healthcoach	org
@The_Main_Event_	human
@Le_bon_vivant_	human
@donnak4	org
@101BeerKitchen	org
@Lynsky22	human
@AnGeBorges	human
@SchulzWill	human
@leayrusiana	human
@WalterToriano	human
@ivegotthepower	human
@BeechersSeattle	human
@TwinTailGangsta	human
@Angela_Gelato	human
@irenelentsch	human
@JnyLra	human
@FeedingSand	human
@andyleaw	human
@nikkoarnedang	human
@Gustatan	human
@VanityList	org
@_gluten_free_	org
@jasonwskidmore	human
@ModelboyAshley	human
@RacksDelray	org
@JustinMiracle87	human
@IAMKAMELA_	human
@djerod732	unknown
@KatieWath	org
@YeSiCa_BaMbAnG	unknown
@PDXfoodcarts	org
@Zambelli64	human
@winterthur	human
@Red_Cafe_24	human
@kazworld82	human
@JoleneNll	human
@PAULA_LOVELIFE	human
@red_velvetblog	human
@CoffeeandCrayon	human
@SolitaryMisfit	human
@Wandrop	human
@flyybetty	unknown
@MarcosABH	human
@LuisChalupa	human
@EmiMarinzalda	human
@ChexCereal	org
@AysegulGunaydin	human
@ioachimus	human
@paoguiliani	human
@luvcherripye	human
@MissBecG	org
@_alecmuriel	unknown
@CookingBills	human
@FarahKerrigan	human
@andreama13	human
@justsotall	human
@WoodlandsDallas	org
@sammc5678	org
@hanniye	human
@MikelSevere	human
@jxffb	human
@NwLLeo	human
@DukeSurbiton	org
@crepestar	human
@networkessex	org
@nanako0825	unknown
@DJTROUBLECHILD	human
@christianledeci	human
@PatsysPizzaNYC	human
@dsideriaa	unknown
@Bellissimoyoshi	human
@najupajoop	org
@andreaspinopico	org
@princehanu21	human
@CSonsShrewsbury	org
@MelleMoz	human
@anthonykuo	human
@Savvi_Cynical	human
@soshinfinite	org
@JanaiSuGoi	unknown
@bethw56	human
@BritishBomshell	human
@mimimini	human
@SBIMalang	human
@julietladines	human
@OlieteWorldBlog	human
@farha_aegyo	human
@iheartedgy	human
@Achi_Karisma	human
@Total_Herbalife	human
@TGKHeathrowT2	org
@Achix0815	human
@MoiRamos29	human
@BAD_RoleMODEL	human
@Marieaqme	org
@Koritari	human
@ChrisConnett	human
@EliHooli	human
@TheBigBeck	human
@HarrisonHub	org
@DannAriff	unknown
@TheFrugalDiet	human
@_tiny_bubbles_	human
@UmmChrisChin	human
@N_palmmy	unknown
@IamCharlita_	org
@hama19uk	human
@blueambeeer	human
@shanamama9197	human
@EATmarketplace	org
@BettyKnowsYork	unknown
@MetDidsbury	human
@IdaManchini	human
@BrittThomas14	human
@Pudd1989	org
@RanelsaK	unknown
@makeupbymuse	human
@MarianoMacua	human
@AshleeSullee24	human
@unheardMOON	org
@BabyKrazie3x	human
@Ratheblessed1	org
@melodyauthor	human
@narydairy	org
@MorganFreeman7	human
@becomingblyss	human
@QuijoteNY	human
@valeriejones65	human
@_minimehh	human
@BrandyLPorter	human
@JAZZYJ7_	human
@Woodalls1828	org
@WhatyagotMiami	org
@berrytrendyblog	human
@rafbarbcn	human
@lydiceee	human
@Urbanazwolle	org
@DBocksteger	human
@_madisongray	human
@PamornpolB	human
@slirt	human
@fanwebsiteApps	human
@Bradley_Smith26	unknown
@taekokp	human
@Villa_R_Tuscany	org
@ApolloSnacks	org
@sexykenny	human
@asafmtanous	human
@michael_mcginn	human
@pmanonair	org
@alohanami7	human
@kaheriveaux	org
@Barbiegail56	unknown
@magicbabening	human
@central_coast	human
@PR_SandyPou	human
@LEcoleSTL	org
@guanyinmiao	human
@Thebigtearout	human
@skiptv	human
@TripMenu	org
@Azuleijo1	org
@SanRafaelMx	human
@deepakbhasi	human
@RydbergsFitness	org
@RealAlexTaylor_	human
@DebbyMcDowall	human
@celticme123	human
@verndeville	human
@zeppy_travel	human
@eema2315	unknown
@meliplummer	human
@Kathy_cupcakes	human
@MKInsiders	org
@Sanjitadewi	human
@AtlantaPlaces	human
@_Delusion_	human
@mallanroos	human
@xo_cOOkieJar	human
@YAYAiSaka	human
@kilokilok9	human
@an_urbansamurai	human
@bendyogis	human
@CollectionEight	human
@alcazark	human
@adamlim95	human
@andy_8924	unknown
@romanianmum	human
@JuhoSuoramaa	human
@socratemckinney	human
@djgreenhornet	org
@theknackbrand	human
@Micannishi	human
@Thebestbloody	human
@ezotukor	human
@shartzie	human
@Hungry4Healthy	unknown
@KrysJeanGardner	human
@AliceVengeful	human
@BryantCiou	human
@vaishsen	org
@HealeyFaulk	unknown
@frh_alia	human
@Suitology_Paolo	human
@DianaShh	human
@Abbieinspain14	human
@ramenzanmai	human
@MissBettyTapia	org
@thejoyofcaking	org
@jimiwoz	human
@Yokoxoxo	org
@SiaAllan	human
@heyisdemi	human
@kiahandley	human
@PizzaEast	org
@Eone_22	human
@Naivana_	unknown
@SaraRoseBuckeye	human
@singlewide	human
@bsandusky	human
@hoda007	human
@iamwilliamfoong	org
@ahelicoptermom	human
@dannie_obrien	human
@AtkinsDuran	unknown
@BabyGirl816	human
@Steph_Marie_23	unknown
@AthicaToxic	unknown
@cariblick	human
@MaryStokes20	human
@clodostudioisot	human
@3princess_1dude	human
@dannymccubbin	org
@TinaAlNuaimi	human
@heylexarae	org
@thestylesafari	human
@snowwhite901	human
@imlexaa	unknown
@OpArt__World	unknown
@ShamimScene	human
@hero2theworld	human
@roy_cilooy	human
@GeorgeneLynk	human
@stefabilicious	human
@twtc	human
@Patillac1	human
@wstcoastbeauty	human
@rickydoesntcare	human
@growcomm	org
@Yelliana	human
@gramondo66	org
@michyrosenfield	unknown
@triptibhatia	human
@MostlyBJs	org
@SelfMadeMan80	human
@RestuTS	human
@mamagotfreetime	human
@samrentz	human
@jeCkaChristina	org
@Tasteofthewest	org
@_Erikaa15	unknown
@VivianillaRanch	human
@GeriDwiJanuar	human
@thiagomatthias	human
@babakitchen	human
@ghost89er	human
@grupobloom	human
@pelininstyle	human
@ginia64	org
@BodiesByBret	unknown
@innamaxim90	human
@jellytoastblog	human
@doreenfang	org
@NeuvooChicago	org
@arlettamariska	human
@Foodesto	org
@X7qra86	unknown
@HeReloaded	human
@Txakaly	human
@pencilandflare	human
@GalletaAileen	human
@geraldsfoodtruk	human
@8chisato8	org
@Cmartin16	unknown
@JarradReynolds	org
@Ellie_Tran	human
@JGonzalezGuevar	unknown
@SAmOaS_FiNEsT	human
@xoHelene	human
@MidtownBayside	human
@andyfrithchef	unknown
@jhjhfgf	unknown
@Oixir	human
@Marseillecentre	org
@DialArch	org
@cocoes	org
@LizStrensham	human
@DanyyOfficial	unknown
@wildcard33	org
@ImSuchALADYCHIC	unknown
@dorodori	human
@SalalahRotana	org
@RosaleeRoberds	human
@Perla_Melisa	human
@HappyHairRauney	unknown
@mechai09	human
@mellowe01	human
@AnisaLoveville2	human
@6smithwayzata	org
@Franmoya18	human
@shopiceland	org
@insider_Kai	human
@elevenjayelena	human
@everlasting_S	human
@JVNDEE	human
@hassan_MAADY	unknown
@001a1deltaplus	human
@ilznelle	human
@ClariBenoit	human
@KArthur76	human
@Pink_ChibiMoon	human
@maxim_muratov	human
@CheesemasterRon	human
@eatmyallotment	human
@NiecyD_88	unknown
@JenkinsAndSon	unknown
@viya_vievy	human
@quantize_kiharu	human
@omarn552	human
@MichaelsDolce	org
@Labella_Deli	human
@AMoethrath	human
@bobby71rn	human
@novi_angelsmile	human
@chrome_cherry	unknown
@jamipey33	org
@bananaoasis	human
@deanokat	human
@darkins44	org
@MistralBoston	human
@beckkaew	human
@CarlosSedanoU	human
@fvckitten	human
@rjjacob86	human
@rinekate78	human
@AllSaintsLwater	human
@AvocaBelfast	human
@miamendez	org
@WataugaGetaway	human
@MornflakeCereal	org
@jeannegerbread	human
@MiltonsLocal	org
@rhoiregino	org
@mark_of_fauxlaw	human
@DesireeNahFret	unknown
@GauchoDubai	org
@deejayskillzz	human
@MohammedWehab	human
@wabawazeer	human
@walteranjo	human
@catwey96	human
@andre_esque	human
@Ineakah	human
@StarsDalilaMars	org
@adrianyuen	human
@GavinStafford4	human
@DJANGOuture	unknown
@jcrew_junkie	org
@joefriar	human
@FoxNKarkinos	human
@Tariz8	org
@littlemermaiddd	org
@valeriecafe	human
@HFGTalk	human
@GarbanzoChick	org
@Sheei01	human
@jerseygirlci1	human
@JaySprout	org
@tarikasingh	human
@saraunderthe7	org
@BagelCulture	human
@eqasrul	human
@the_mag_house	unknown
@Jeannette_oO	human
@YostKalasa	human
@JimmyMcH	unknown
@joiski	human
@cleverley92	human
@ChristineStorch	human
@amrehjie	human
@La_Mamounia	org
@etphonehome_73	human
@LBH1928	org
@shopfornow	unknown
@teddysavova	human
@Chucknphilly	human
@NamiRoyale	unknown
@CarrollwoodCCev	org
@NicoleMcIntyree	human
@chocopurplemint	human
@HeidiMurphy1	human
@LukasGilbert	human
@krissydemsy	org
@S_Mesh	unknown
@GaylievdB	human
@sevvalkaragul	human
@ShovedInMyHead	human
@kazuhiro0312031	human
@wellcome_26	human
@MHPStrong	org
@Juls_Addiction	human
@iamvipne	human
@CMLobsterNAPA	org
@PenyazoEmotions	human
@iidako15	human
@Flawless_inpink	human
@mona_nang	human
@Jessicaxes_Lee	human
@Niko_B	human
@PeacockPomPoms	unknown
@JDGEstateAgent	org
@BdayClub	human
@miafoli	human
@clarke_casm	human
@DeSelbys9	org
@CAROLEEN_31	human
@JGuevara391	human
@Miss717	unknown
@amberflan	human
@A_dea28	human
@InMyAstoria	unknown
@zukkiin11206	human
@GiliLankanfushi	org
@DealOfTheDay07	human
@WENDYSEROPIAN	human
@YukieMiyagi	human
@thriftymom613	human
@CReinhold1	human
@Recyclebank	org
@180_nutrition	org
@katehaddan	org
@HedleyVerityBar	org
@TOMO_N8	org
@gelibeanferrer	human
@1913restaurant	unknown
@Jaas_MiiNee	human
@YogismFroyo	org
@kayDAVIDsiGELAi	human
@BenoitRoselyn	unknown
@Daiyame	org
@_nunushka_	org
@stephanieong	org
@NENRIN_	human
@Angelluispk	human
@AFrameLA	org
@MrsNewspaper128	human
@GCsocial	org
@AKOsiPENGGOT	human
@Lexii_Styless	unknown
@Serend1p1ty9	human
@velissimo	human
@captainqscafe	org
@PrisyPrettyPaid	human
@BhiveD321	org
@Pantry_KHI	human
@julie_g0802	human
@CasaLucaParis	org
@Northland_Mall	unknown
@Shahena_Ali	human
@AngelMelDesigns	human
@rufiobeatz	unknown
@EyeLuhnDove242	human
@Henriette23	human
@NeuvooVista	org
@Nigel_Adam	human
@Hilaryevaduff	human
@whatpausaid	human
@HiBeautifulDay	org
@louiferry	human
@BeaverBrand	org
@dottology	human
@DanielDafon	unknown
@caitlincooper	human
@Mystero_Poetz	human
@LeSousChef	human
@Srshiro	human
@garibaldiarts	human
@gomadch	human
@FitPaleoTwins	human
@jarheartkia	human
@Asian_InAmerica	unknown
@nathanFerrycho	human
@nec_cen	human
@SocialShopper1	org
@pxpgraphics	human
@janie_wagner	human
@MsDalj	human
@nash__01	human
@LadiesLoveMeNow	org
@thepark112	org
@travelwithnick	human
@yasushiworksout	human
@sparks2108	unknown
@girlchevrier	org
@MHCHospitality	org
@PaoLove88	org
@RacuSangiu	human
@hbnutritionltd	human
@ChiRestaurant	org
@itopz	human
@dwimedica	human
@bordinth	unknown
@Dame_Kelz	org
@joaquinaaa	human
@flickofthewhisk	org
@future_soldiers	human
@SyakirinSyazwan	human
@KeelzRemi	human
@Radisson_Erfurt	human
@raptorr427	human
@Jeliezho	human
@ImOnlyMe_K	human
@TheMurcialist	human
@yonathansurjo	human
@DredJunkee1	human
@RobertaVasselli	human
@ann7marie	human
@RockRt66	human
@lawanKJ	unknown
@Q_brigita	org
@itesser	human
@vohnmcg	org
@thekriboo	human
@howtomindly	human
@cleisonmunier	unknown
@RobynFarah	human
@RT_Slave	org
@jnawlins	human
@khairulmiza_81	human
@mayu_komori	human
@mazegrill	org
@soupcon_beach	org
@advancedgenetic	human
@msdeekay2012	human
@Rita_Harb	human
@majhoi_asenci05	human
@che_cille	unknown
@bostonsgpsville	unknown
@TheReynoldsMom	human
@VernonLeggitt	human
@VikaPolishhuk	human
@PSDavid	org
@ginabirch	human
@Danetanamo	org
@MoeHMoe1	human
@howesoundbeer	org
@globalfoodbook	org
@figue_pao	human
@DavidScottFilms	human
@Sqwishyx	human
@SturgesRobin	human
@piajassy	human
@Mr_Mew	org
@Tntonelli	unknown
@tomas_nu	human
@jahpltro_	unknown
@MJGines	human
@devondomanski	org
@Preventionfocus	org
@funda2502	human
@MyriamSelbig	human
@FateBrewingCo	org
@FlavorHouston	org
@FuipeMariz	human
@hellomelvin	human
@LueRush	unknown
@FreshiiHouston	org
@ChickfilAHarvey	org
@lisaljames	human
@DeBeauteToucher	org
@BillRossFit	human
@ymcadc	org
@SentosaSeminyak	org
@NEWellnessBM	human
@christinamather	human
@WeekendSpy	human
@OrjuwanLounge	org
@riyazactor	human
@jenerallyeating	org
@Redlilybar	human
@liatsosmarcy	human
@mogutan1977	human
@keithcheefoobi	human
@anoj_anjo	human
@AgnesMonikaB	human
@VerbenaSoPo	human
@BemGeneralApril	human
@rafzZ_90	human
@sue_shen	human
@Crazyresults	human
@KarenJeanHood	human
@Adrey	human
@Spalarnia_K	human
@danasyd9	human
@absddiet	human
@LizzettePerez	human
@LaSerreDubai	human
@moseawell	org
@HaleyErinMille1	human
@marcjeREAL	human
@Paddockss	org
@exarmyofficer1	org
@Uverworld1012	unknown
@MattPeschke	human
@JLA355	unknown
@HamzIqbal	org
@DeeAtTheCarlton	human
@FoodDesi	human
@AidanceSkincare	org
@lovelunchdeli	org
@LetsGoGreece	human
@funfoods4all	org
@irvanl	human
@queenieshiz	human
@TerracottaHomea	org
@saki_agata	unknown
@Fou_Daa	human
@cxc1595	unknown
@ErikTheMagician	human
@RoxaAne	org
@Maggiordomi	org
@YenKaimin	unknown
@TubaGulerTG	unknown
@mamakastaverna	org
@Pichaisornplang	human
@pro_messa	unknown
@AbbeyLove2015	unknown
@Chicascooking	org
@BellaVieEvents	human
@ashleyymama	human
@fittypig	human
@visitbatonrouge	org
@handbar	org
@AmeliaTrifena	org
@LRIBW	unknown
@dollface_JessM	unknown
@djbeatmasher	human
@plightfoot21	human
@Maximo_V	human
@sanacoctione	human
@triplet911	human
@VillageCigarCo	org
@_gulsahutuk	human
@BudenIrena	human
@discotokyo1984	human
@msElith	human
@JoshuaDuffy	human
@SetDaisers2Stun	unknown
@sherryhsieh8788	human
@GroveHouston	org
@CozeteG	human
@bubunzzz	human
@BBEncino	org
@Johnwoodlawn	human
@ShadowWelch	human
@nat_suneemay	human
@M_a_r_t_a_h	unknown
@bmchanyungco	human
@beriqalinag	human
@ArtColorLife	org
@nationslife	human
@u2girl1966	org
@SamualTaganeca	human
@SChocolateMagic	human
@ChiantisSanford	human
@shelley7890	human
@akudanielrobby	human
@Nicole_Lsy	human
@PiolaWeston	org
@notoriousAAB	human
@Crumsbys	org
@Emma_OFARRELL	unknown
@lifecoachcathy	human
@Just_Cynthia84	human
@DhqSexydee	human
@cuisinelinks	org
@NaturalSkinny	org
@Kak_Acan	human
@shivangisinha	human
@nightowl252	human
@rheafierce_21	unknown
@charlcarroll26	human
@HeAlThOlOgY3Pt0	unknown
@BliXemEetcafe	human
@indiatrendshop	org
@jstjaved	human
@zuwenamomo	human
@dcfoodpr0n	human
@Raphaela_Ryuu	human
@AyeshaSiddiqui9	unknown
@CarrotLines	org
@FoodNetworkAsia	org
@DJLICCA	human
@lacianfrusaglia	human
@Maira03	human
@Sucu_Va_Niju	human
@helloKitay25	human
@DAYUM_DAYUM_	unknown
@LePubSG	org
@bujhoapp	org
@ale_hikaru	org
@FoodFilmAmerica	org
@LUTUNENG92	human
@GiulianaK	human
@mvbarock	human
@ZanderIAm	human
@85255Mag	org
@monalisaraw	human
@IbizaGastropub	org
@JuCherryHell	human
@NeuvooMesa	org
@AlessandraZermo	human
@TrufflesNBacon_	org
@bogeyno2	human
@LizzyLovesFoods	human
@MsLiviaT	human
@avery64	human
@r_tnk311	human
@MTzavelas	human
@aaapool	human
@MelissaAmy	human
@jaegandoongi	org
@Vittoriowsky	org
@HoneyBie11	human
@mariadudidam1	human
@sweetsabina	human
@iamLexter	human
@TeCollec	human
@malikmoretti	human
@ken_wong324	human
@atulrai	human
@alldecordergisi	human
@coreydavey	human
@simonaguatieri	human
@Feena94	human
@jldz12	unknown
@JackieD1979	human
@xlarspanda	human
@holmberg_j	human
@MyMixify	org
@HertzNeverLost	org
@Juice247gp	human
@salvatorecasto4	human
@babyboyshad	human
@guilbertsarceno	human
@xumi_chan	human
@inucinaconmire	human
@drewdallas808	human
@UrbnBricksPizza	human
@KamathGurudutt	human
@NFR93	unknown
@stephweather	human
@HomespunKitchen	human
@CocktailsCigars	org
@kaianaya417	human
@funkybuddah	human
@TobiTT1	human
@priteshgade	human
@marilynr95	human
@thesisterslee	human
@QueenDianaRocks	human
@momokuro_win	unknown
@thomas17171	human
@WolfValdez1	unknown
@GSausages	human
@patckat	human
@Hollomandious	human
@BeGetSee	human
@WesleyJBaker	org
@winesisterhood	org
@allyinwondrland	human
@Diana11dd	unknown
@iamfabdino	human
@SommBeer	org
@LiberteCanada	human
@robininthehouse	human
@Miiiii1218	unknown
@fromshiptoshore	org
@muriellemi	human
@Liz_Chronicles	human
@dxsibo	human
@onatt	human
@ilove_rhoda	unknown
@xMariellaElisa	human
@onemoredadblog	org
@Rea_HotFM	human
@rpunamia	human
@PippinsTavern	human
@kkaralius	human
@LoveDublin1	human
@puhtreese	human
@mi_x	human
@Run_ee	human
@feiziyou	org
@sofarrsogood	human
@PauleneGonzaga	human
@FOREVERmALONE	human
@marni_ish	human
@EmmyMcT	human
@CarolStaley	human
@ESSouth	org
@Andilkk	human
@DivoStarr	human
@pawee_reyes	human
@ochamystica	unknown
@YanaOuchakova	unknown
@CJcomputersNC	org
@Michael_Tablizo	human
@LascombePatrice	human
@Quoteum	human
@AaronDPenha	human
@FoodOutsdTheBox	org
@MyFoodiePage	unknown
@zackhardie14	human
@Roseolliver	human
@rachel_felson	human
@the_foodfox	org
@loringlav74	human
@switi1	human
@comerblogaramar	human
@michycanales	human
@Gee_Adore	human
@Being_Akbar	human
@McKenzieHallRD	human
@pynkfreakadelic	unknown
@lucianochiani	unknown
@StfiGC	human
@TheButcher_Chef	org
@dtalhambra	org
@oyasonmez94	human
@SJRestaurant	org
@diversecitystyl	human
@MyTableMagazine	org
@CoworkingBot	org
@EXCENTRICCA	org
@CRISGRAMS	org
@pinkglass1	human
@TheLambertGirl	human
@ga_ilguimare	human
@TishDiva707	human
@raeannemaryq	human
@GordoManchester	human
@AEBservizi	unknown
@Barhumbug_Melb	org
@ITTAlabs	org
@djspectrumk	human
@ShanghaiA2Z	human
@DalExecEd	org
@alvarohau	human
@Buxtonco	org
@Alinnshaikh	unknown
@Cotiorazi	human
@CocoKnowsItAll	human
@Novotel_Hyd	unknown
@KimberleyAnn7	unknown
@ps92264	human
@Pauline_deParis	human
@blessed_nc_mom	human
@NatalieGreaves	human
@KiutzaHermida	human
@GypsieWanderer	human
@SharaOctaviani	human
@tamaneco57	human
@LiaArias	unknown
@folladicuriosi	org
@HausOfGlorious	human
@DJCITI	human
@VTMustard	org
@juanchi_delfino	org
@ISeeHungryPpl	human
@shabatinfashion	human
@GOGOBUY64	human
@oyveymylife	human
@MissEllenBrown	human
@itsjustmenai	human
@stamford_guru	human
@704jamaican	human
@Suomisyojajuo	org
@kotakitam	human
@maimandour11	human
@yuanqwu	human
@WEDGEdeepDEUCE	org
@THEonlyYosh	human
@PSurfield	unknown
@CoachDonnaF	human
@MhaIbrahim	human
@drufinest1	human
@cirbenpin	human
@GregoriosATX	org
@RevFrank1745	human
@tatochi616	org
@RUNWAY5FT2	human
@cdoolz13	human
@healthykids101	human
@JimmyKastner	human
@lovelyframie	human
@NAshiffa	unknown
@Is_It_GoooD	org
@Emochristi	human
@KristyMalou	human
@feesmaison	human
@MsclDrew	human
@xoxosammyann	human
@StoodlesCom	human
@JillCalvert1	human
@brian_o_bennett	human
@seemac90	human
@SofitelLisbon	org
@QuantumRebirth	human
@CMpaugh	human
@meelsmisao	human
@Syun000026	unknown
@ericdavidnel	org
@MsBrandis7286	unknown
@1073TheWave	human
@tengkylai	human
@CobanogluBurak	unknown
@LukasFronc	human
@kodanmurat	human
@njisntboring	org
@FromDistrict12_	human
@TDWsport	human
@molinanoel18	human
@feelingfab_fit	human
@paupolanco	human
@rach2189	human
@buttercity	org
@riezon0314	human
@Nong_Pancake	human
@LaportesLewes	org
@haydensmart	human
@haniqay	human
@bungahlbellamy	human
@donisetyawan13	human
@NiliMajumder	human
@travelhot	org
@dellanuna	human
@jqsnizzle	human
@Destachrisna	unknown
@KasaharaHitomi	human
@Ca_Espadilha	human
@axcanteen	org
@PalosVerdesGC	human
@purplenela	human
@VenusAngelic	human
@VicVickiez	human
@Bass_Mode	org
@Galor_London	org
@znermallare	human
@ChikaokaT	human
@rjjuniorr	human
@AlbertEsquer	human
@TheCookieBar	org
@KarmaCans	org
@martycake	human
@cougarmilfstube	human
@AlexandraHLeal	human
@jacqueline2116	human
@alserkalf	human
@jennycross81	human
@JazzieSpeaks	human
@luluhanie90	human
@CarolynRBarnett	human
@ProfessorChapa	human
@Dessertsofnyc	human
@Dauphine92	org
@rung_totae	unknown
@meatlessgurl	org
@red_valentinas	human
@WallerLinwood	human
@Dok_Noe	human
@SocialScatterer	human
@shrutiratnakar	human
@Little_Jeffers	human
@nycfoodnerds	org
@stefielukito	human
@HyunKyuRi_Na	unknown
@Dawkins_Gemma	human
@benbagsug	org
@LolaIsVegan	human
@meals_queenpark	org
@WorkoutzFitness	human
@DevanDenae	human
@chaotixc	human
@mrgsnj	org
@shiva	org
@AudreyStar17	human
@pilgrimagecafe	org
@the_big_diet	org
@Eipril01	human
@Kev_Gru	human
@bk_ladybird	human
@Isyayusof	unknown
@buffychick71	human
@lulabernardez	human
@BryanWiso	org
@AnnaCortesi	org
@DaV1E_DaVe	human
@CrazyAnchalee	human
@jessicayflores1	unknown
@SylviaKOfficial	human
@yamana_m	org
@r_serbane	human
@mmammjhz61523	human
@inner_de_miel	unknown
@Loudermilk_Ctr	org
@azwa_zainal	human
@jasminder13	human
@styleofsam	human
@SiePipit	human
@4vibranthealth	human
@blackbird_mito	human
@autumnbythesea	unknown
@Vincent_ChongWs	human
@saltphoenix	human
@GalloGaletti	org
@insite_mktg	human
@koooooookichi	unknown
@michi481231	human
@MimicoByTheLake	human
@xoxokirstyxox	human
@JenJedi153	human
@CindyHarriman	human
@MazTheDon	human
@powahL	human
@JamesCorbbett	unknown
@Nana2102	human
@searchholistics	human
@claudiasesteves	human
@JeriahDaguman	unknown
@saadbinsaeed07	org
@jjj_ko	org
@keremfever	human
@wynmaker	unknown
@startwithblack	unknown
@misskarenkaren	human
@Gezapz	human
@casscolvin	human
@felpzrj	human
@NatyPalacioss	human
@Liz_Choo	human
@wlochatypl	human
@CaptainKooKo0	human
@LastIngredient	human
@slugdragonmama	human
@Silky_BK	human
@LKimberley	human
@SoSheila	unknown
@seriouslypesto	unknown
@cookie33uk	human
@CamiiLesch	unknown
@SalutingLovatic	human
@BellasCountry85	human
@s_zaki	human
@katavrei	human
@RoboJessica	human
@empressting	human
@graceeee15	human
@sleepee_clumsy	human
@Cortkelley	human
@BubbysKitchen	org
@DJANKUSH	human
@sophiecreeten	human
@TheFrenchTarte	human
@Atico_Valencia	human
@delhiraas	human
@simeonkguss	human
@BestTPictures	human
@imDeeVice	org
@SDrecipes	human
@Writersfest	org
@rockeresq19	human
@RianeYuniPSM	human
@immaraedar	human
@HungerzDelivery	org
@evi_caro_lina	human
@TimmyJohn1121	human
@keachame	human
@GabrielaRochaC	human
@ghievalencia376	human
@MaudeGoyer	human
@IvannaSanchezS	human
@SilviaMacedonio	org
@Mayumi_0915	human
@mirigreatlife	human
@jacobdorado	human
@kiarrajasthine	human
@susie_adelson	human
@iamShengmae	human
@pcliffordjr	human
@andreasheige	human
@ncmusicfactory	human
@barrbucks	human
@ForeverRashayne	human
@PopUpsInLondon	human
@linsetchell	human
@RosiMiramontes	human
@CookseyOpal	unknown
@CinnamonCottage	human
@EatFatLoseFat	human
@AnotherLilSoul	human
@BADMANIBC	human
@girlguidejones	human
@healthsexygreen	unknown
@MAl2CH_VIP	org
@vacacionesydes1	unknown
@powerhoopzgirl	org
@jamieb1	org
@Lucasreyes_sk8	org
@NikkiLinc	human
@konst_emmanouil	human
@anapa_pantoja	human
@SquareOneWyeRd	org
@Pattylu247	human
@gyuchan407	unknown
@ABC30	human
@carrotmajesty	unknown
@illiliberation	unknown
@imblad3	unknown
@bhamevents_co	human
@hrcvenice	org
@PigletnMe	org
@StephLova1012	org
@LushMeadowKT	org
@WatJazoDrinks	unknown
@eatsomecake12	unknown
@Super__Chango	human
@lapetitegigette	unknown
@MallorieOwens	human
@yiming1990	human
@HereIsMySpout	human
@Fatguyfrombkyln	human
@MGurusu	human
@theFIREDANCER5	human
@EmelYorulmaz	human
@infoRenovatio	human
@vdyonus	unknown
@jules_alvaro	org
@erikadamico	human
@UpperFleet	human
@Afjelle	human
@PursellFarms	human
@ComptoirGascon	org
@annalisbeth	human
@jholenztrex	human
@smartiecraftie	unknown
@DeathTheAya	human
@MrsSanMateo	human
@godspeedjimmyg	human
@SecretsMaroma	org
@TinChronicles	org
@chefjamesandrew	human
@babychihiro1	unknown
@MsStreetz	human
@veeshank	human
@UrkeB	human
@DawnEV83	org
@GhillieDhu1	org
@mydomingo	human
@weerola	human
@DanieOaks	human
@weirdo_beardow	human
@GuuGarden	human
@MCstopandstare	unknown
@sryhilsradio	human
@kelveen	human
@AGomez72803809	human
@aliasger5352	human
@peachc0bbler	human
@l_choice2001	human
@AnnaBullett	org
@JacobGetsFit	unknown
@J_chriz_ty	human
@HealthyWomen	org
@benmorris	human
@_UAdmireme	unknown
@Reena_carmelia	human
@G_DGZ	human
@idrisgursoy	human
@Digital1962	org
@JungleVisionary	human
@5971_1	unknown
@su__hninn	human
@_alius_	human
@LivingKitchenTO	unknown
@Za_Luna23	human
@imspice949	org
@ildivomiami	human
@Chef_Amalia	human
@senoritadoll	human
@CookingCaveman	org
@juan_augusto88	human
@DeadlyTeaParty	unknown
@orienteast	human
@Renzmark017	human
@RadissonDelhi	org
@Adamaladdin	human
@DariaLimited	human
@claudigraf	human
@StellaMarie1231	human
@joannem1970	human
@coppaboston	org
@momo_dance	human
@TheRemarkableAJ	human
@MetaLSolter	human
@FredTourism	org
@hamu_stmr	org
@carriedavis77	human
@AKESweetie	human
@salaamay	human
@__50	human
@bowloftripe	human
@Andia_B	human
@womeninmusicorg	org
@irhtn	unknown
@zizul_rahman	human
@BulkingDentist	human
@FirleysLakoni	human
@fan_dudu	human
@MadisonQuinn12	human
@ivanozuna1	human
@WriterJennaChan	unknown
@alessandroduo	human
@Joteen	human
@yasuyuki0510	human
@myorangetruck	org
@MSDhhoni	unknown
@RustleXer	unknown
@AgentWiseBox	human
@rdhillphx	human
@Ms_Melanie_Rose	human
@Ohsofickle	human
@bayviewgarden	org
@christine_lam	unknown
@CiboTrattoria	human
@HORMIMARTA	human
@paoparazzi13	human
@ascenseur1	human
@LorraineMDavis	human
@SimplyHennessy	unknown
@dgkmikey	unknown
@Ludo_happy	org
@hvaradhan	human
@CCaassii27	unknown
@GoliathSupreme	human
@VedazzlingAc	unknown
@Kome226	human
@nitahamzah	human
@CesarRemond	human
@greedyvegangirl	human
@cestmondoudou	org
@MyHomeBootcamp	unknown
@YvesVeggie	org
@LexiMarieC_	unknown
@Z4RT4N	human
@iamtheandyman	org
@KaylaPavelich	human
@seechan_vip	human
@Giorgioac	human
@TolleDJ	org
@IcanONLYbeMANDY	human
@chictarot	human
@ArchAngelGynxie	human
@Bridge_Chelt	org
@normabeasBBC	human
@riastoyka	org
@LinetteJoseph2	unknown
@AmberKroese	human
@bellabee711	human
@dahelea	human
@BaRbIeNeKa	human
@ZoyaSakr	human
@jennbisramtv	org
@DivasDevotional	human
@BonafideHussla	human
@renlerntdeutsch	unknown
@Toinkee	human
@nataleaaa_x	human
@CA_Lifestyles	org
@kimpk	human
@FashionistaWife	human
@Bill_McCann	human
@bpointer212	human
@elizaelsaian	human
@larrygurreri	org
@MARnyanGTromanR	human
@RaryDee	human
@SammyLouise26	human
@SimonKFung	human
@iammichellem	human
@SaltWaterCafe	org
@lmz_chubby	human
@miu_miu0909	org
@ChefBriantsev	org
@StephenJacobs1	human
@DoubleTreeKE	org
@shawna_ing	human
@2NomadicFoodies	org
@EugenioMank	human
@TexterDesign	human
@ChasteGaymer	org
@inky_mama	human
@Nicolthepickle	org
@SerenaArabian	unknown
@dtaries	org
@Restaurant_Lady	org
@KingNightTuc	unknown
@BettyJeanMeower	unknown
@byAmandaBurgess	human
@fey91	human
@daniel_wirawan	human
@lollypaige94	unknown
@PrinzessinVi	human
@_nevertell	human
@missfauziana	human
@adfir88	human
@DavidAJClark	human
@BMaireadJ	human
@TheCrabShackNZ	human
@TiffanyCho_014	human
@drrockwell	org
@RCordoban	human
@greatfoodlist	human
@For1team	human
@pinchofyum	human
@koikefish	human
@the_lordclyde	org
@DJsRAFFAeDEBX	org
@TAYValez	org
@JeanetteSheets	human
@RipleyHoward	human
@_Causticgirl_	human
@ENjoydeepLY	human
@Watanabe_Aki	human
@MaiRealty	human
@najeeb_edward	human
@425323	unknown
@KRevents	human
@Kamanwan1111	human
@bethbr00tality	human
@adc_blog	human
@DreamStylesLR	human
@mainstreettower	org
@TheGarborator	unknown
@fittie_sense	org
@Lavadaxs96	human
@ruthie_x3	human
@baihaqihakimey	human
@Jess_Cakes21	human
@Soph_laalaa	human
@yuri_lovesmile	unknown
@sweetsavrybread	org
@VGood_52	human
@Haryati_Afifi	human
@yurulin_tw	human
@HF_Fazal66	human
@CrescentFoods	org
@LetiziaBcn	human
@Tazoff	org
@JennyMaister	human
@skylerzane	human
@gedelapena	human
@pchcake	org
@AnoiteMeiga	org
@spicedsaucy	human
@leejennyjh	human
@cherryRed1st	org
@SyedRezaMehdi	human
@renai_ySQpM	unknown
@tommy232323	human
@28WestLDN	org
@jennytho	human
@marqueeMILES	human
@aaelondon	org
@sugarandspiceSG	human
@vilamas78	human
@NaphatPoonnoi	human
@myktan	org
@michellekopp3	unknown
@SiAkoSiMelvinP	human
@MarilynJansen_	human
@MikuRestaurant	org
@TheFruitPeople	org
@niteshnegiii	human
@DalilaDuello	org
@MaycarMejia	human
@justsobreakfast	human
@MiamiMichBlog	human
@erichmercado	human
@confessionsofaf	unknown
@DaisyAbraham	human
@LQbistro	org
@mivestidoazul_	human
@agnesbartonsabo	human
@HausofCesar	human
@THESNOBEFFECT	human
@frankalessandra	human
@aashikajoshi	human
@PAZCantina	human
@gie_dazzling	human
@lafermelondon	human
@13GaemmieGyu	org
@JujuEats	human
@ashleypuisan	human
@Pamskid	human
@GoCurvy	human
@madellarole	human
@MJs_Restaurant	org
@djfoundos	org
@Wildernesschic	org
@Appehtite	org
@EglyonsEric	human
@xxben1221xx	human
@RobertsKatieR	unknown
@sumayliew	human
@fabgirlfitness	human
@RonStraatsma	org
@MarketsNYC	org
@BrizyuXd	human
@DCT_yuri0227K	human
@TheFullindian	org
@litewsadewi	human
@NBlachut	human
@asnh480327	human
@ATVS_PaulCrewe	human
@JennaStirland	org
@DjJayFive	human
@Meg_A88	human
@NeverCountMeOut	human
@imageunlimited	org
@MexxyMelt	unknown
@cateringBPR	human
@mrnmrsparedes	human
@SaraMaule	human
@leahfitny	human
@Jayice_JT	human
@Losiglesias	org
@jejerome_16	human
@AlexM_official	human
@brunomigues	human
@MakaylaHopee	human
@ferzys23	unknown
@krimcl	human
@biniolaurencio	human
@daniasunshine	human
@AlpineBreads	human
@SuzanneLiddiard	human
@flavorsnyc	org
@RoundHillResort	org
@2icecold8	human
@LCollinsCEO	human
@dariadariablog	org
@CristineSabet	org
@rhiza_sam05	human
@imlykabird	human
@FashionNewsEd	human
@Laufogel	unknown
@PerfectTenshi	human
@VSBramhall	org
@vonneTorres	human
@jamiexconde	unknown
@jeremiahreyes9	human
@HananMassri	human
@EvaMarie1089	unknown
@georges_jc	unknown
@Jpro1010	human
@CeliacHashiGirl	human
@iVentureToSay	human
@ArCade26	human
@kathy1672	human
@LiveHotelDrama	human
@_fashionexperts	org
@kvelez432	human
@yenny0107	human
@na2info	human
@NochesRestauran	org
@DiovelynTan	human
@margiepb	human
@FarhanAbaz	human
@mrs_smith_05	human
@maggs_yuen	human
@Aeroscientistic	unknown
@hardcoreloyal	org
@valerieyazza	human
@mori_no_ki	human
@ekaiytwtcomel	human
@anaa_gon	human
@LaCerveceriaNYC	human
@haha_waynexD	org
@Caibanez	org
@MissKT88	human
@melonsan	human
@Collinho82	human
@marialin43	human
@broncobronks	human
@winefortheheart	human
@tasiaoncom09	unknown
@Du_mmor	human
@yvonnestone	human
@mazthemazter	unknown
@chutaboy	human
@samsebelius	org
@moolagram	unknown
@scott4mt	human
@CharlieLove0	human
@MAYU_chin0301	org
@elizabthe17	human
@sumitharwalkar	human
@SPinky111	human
@GabyH503	unknown
@mrs_rosales721	human
@ddelamaz	human
@pingpongdc	org
@GoldCashGold	human
@emmam_83	human
@Inwood_Local	org
@workingout2wine	human
@SINWorkouts	org
@OhsemmmAres	unknown
@1BlakGal	human
@GodrejRGC	unknown
@YellowbirdSauce	org
@TheMomConnectio	human
@TheSHEBlogger	unknown
@gourmaniaftt	org
@lemiammiamblog	human
@Minrylx2clq	human
@Undress_Jess	human
@IrisonYoutube	unknown
@Azrim89	unknown
@FabiolaEuropa	human
@miftahoke	org
@queenkwinthawek	human
@Chef_Anshu	human
@Parish_hall	human
@mistydayokc	human
@theibizakitchen	human
@matrixdissident	human
@68sugarmomma	unknown
@a_high	unknown
@mitpool	human
@Adrien7575_fr	human
@yukkeyukke0104	human
@HighheelsDes	human
@SwagBoi42069	human
@MulanWomen	human
@Birgit_Parade	human
@J_BebyJKT48	human
@carlos_hannon	human
@joshsimona	human
@goodtimewithsea	human
@YvonneMelody	human
@CarlaDelone	human
@eilatim	human
@makebymilla	org
@DelpheF	human
@gracecheung604	human
@LeiaVisconti	org
@theClaudeEssa	human
@RITCH1218	human
@putzliciouz	human
@localbanquet	org
@kdonaldson95	human
@benchmarkYYZ	human
@poojakei	human
@KhymHarrison	human
@elide50850816	human
@onefitflip	human
@YoungMoulah	human
@viiary	human
@2cjones4you	human
@CaliGirlMesha	unknown
@maichaeldm	human
@Makzara_Cafe	org
@en6_3na	org
@Bean2Melbourne	org
@sayuriamami	human
@LucaBellaFoods	human
@EhhHaroro	human
@wigga_dj	human
@Sixtinouu	human
@kiky23it	human
@pandoribiza	human
@hemantLw	human
@heather_qs808	human
@OtayRanchTweets	org
@Leesarose25	unknown
@sam__leal	unknown
@cavewomancook	human
@gynzkie	org
@nonoz_yume	human
@budak_tomato90	unknown
@April_Carr	unknown
@tomotinxxxlav	unknown
@prendaspublicas	human
@Sabonis13	human
@VikiBabbles	human
@mmscrapshoppe	human
@BrachaBardy	org
@CharmieSyn	unknown
@SKoay	human
@Crystal_Farms	org
@sergeyfomkin	human
@JayBirdsFlight	human
@timthevillain	human
@LaShicMondrell	human
@Aprilia_SR	human
@RikaDeanea	human
@PBRcashave	human
@fitlittlelady	org
@DaRealAlexSkinz	human
@GoThrones_BOT	org
@MDankovics	human
@lamuseblue	human
@MishStyle	human
@maxxiOhhdamn	unknown
@PBandJelli	human
@ezzyboii	human
@debikeytchu	unknown
@Mumbai_Kitchen	human
@SandraBurrns	human
@FFCTraining	human
@vaniatandayu	human
@Sweetkys	human
@N3gra23	org
@reizlanry	unknown
@p0is0n_ivy3	human
@KalebNKrause	human
@Ritucci_E	human
@LeTreLine	human
@domu_uk	org
@wstokes36	human
@derosieres	human
@milljoe	human
@arosica15	org
@leo_vargas_	human
@jmacofearth	human
@SmilinginNYC	human
@amirun_naufal	human
@cacai_cute	human
@MeaganErinTAL	human
@habibghandour	human
@EspressoEvents1	org
@MaishaAhad	human
@AlfioPistorio	human
@FitFoodFoodie	org
@jlpcoach	human
@GioiaGuerzoni	human
@juliebalbert	human
@Willamus_Prime	human
@ATalvera89	human
@me9um1chan	human
@Bizniz_wman	human
@everybodyoga	org
@kayyy_shim	human
@alfiyahsukma	org
@kveti_london	human
@AidaArisya	human
@brochett	org
@WHRhuallt	org
@iammonsterdeart	human
@presentroomSTL	unknown
@nycdogwalker	human
@iamHilmiSamat	human
@aesheppard	human
@maribelmgcls	unknown
@djs9989	human
@inez_apz	human
@Dulce_Kro	human
@ottawalifers	org
@jclair24	human
@mmistral	human
@corinthian121	human
@roundtrip	human
@NarimanM	unknown
@Dream2breakaway	human
@MikeLok	unknown
@Pizza_and_Wine	human
@Bek_Razz	human
@zuLmaLOFI	human
@KcKasem1990	human
@RoyalSonestaHou	org
@Damatos85	human
@Diabetes_Sanofi	org
@thess_efi	human
@iamrjayable	org
@fuminator18	unknown
@MEALINAPOCKET	org
@Dawn18Misty	human
@valentinfy	human
@Aun_inter	human
@AlvinAlston	human
@febywiria	human
@beffy0119	unknown
@atavolaconwilli	org
@kyo_9	human
@nanppeo	unknown
@gsgarey	org
@striker543211	human
@TalaDamra	unknown
@BBSnunless	org
@supreme_burger	human
@WindyCityGrille	org
@tadasunshine	human
@williamtaysm	human
@JerryTheBull	org
@DunimaglovskaM	human
@LIBeachtree	org
@IamShawnNeo	human
@HunHunPanda	human
@nemer2010	org
@chobangs	human
@tubbssnomore	human
@ALDHIRIM	org
@NetworkngEvents	human
@tinaxx08	human
@UncorkedJen	human
@missine	human
@WFMWashPark	org
@gastonbuschia	human
@MrsSofiaGouveia	human
@ArdenWardUpton	org
@BBrownskinlady	human
@DraganaYYZ	unknown
@JJFotoArt	human
@granolitas	org
@fighty100tokyo	human
@VillageEastSE1	org
@WhatsOnGlasgow	human
@little_mo_123	human
@TheManorYeovil	human
@yespleaseblog	human
@jessibuckingham	human
@JulieBRealtor	human
@Ajaei15	human
@Deivis81	human
@IrfanCDKEY	org
@gnossiennee	human
@sachiomax	human
@LungaLungstar	unknown
@higaeri99	human
@sofievalkiers	human
@AIDSVanIsle	org
@atomiccartoons	human
@luxtravelErika	human
@nerdception	human
@iamclaratan	org
@LadySadie66	human
@ciaraoc88	human
@EmpressDimple	human
@chefthymeplace	org
@WiRuS	human
@euwyn_drumster	unknown
@inkyhook	human
@Filibertosfood	org
@nutritiouskate	human
@USCTrojan82	org
@RetweetsToronto	human
@Diniasih	human
@lytie01	unknown
@kopfzutisch	unknown
@JaxCocoGlobal	org
@Vikkyarifin	human
@Mz_Jay_Steve	human
@rockymarcianoe	human
@alyjustineee	human
@FreddyRHS79	human
@poohbearcutiie	human
@DoraVarro	human
@PeaceAndHiLight	human
@NewForDinner	human
@kelwinser	org
@LovelyHavoc	org
@MsCocothunda	human
@CherlyPrincess	human
@gsp0922	human
@tomboylook	unknown
@miltonix	org
@AtayTurgayatay	human
@isabeaumiller	human
@kasspor	human
@IranDaniel	human
@KKCity	org
@ald_fit	human
@TheOldeBarPHL	human
@RubyRatDog	human
@TiffanieLeigh22	human
@Jundaaay	unknown
@gengsunkie	unknown
@AlexBrittney85	unknown
@VictorDubanai	human
@danaburgerrr	human
@disneyxjade	unknown
@DiNapoli_IN	org
@osmiaIMechEAmb	unknown
@Black_guns	human
@BigEaterMike	org
@Y0U_1229	human
@LlirlenG	human
@queenv4life	human
@2001films	human
@FSBaku	org
@SpikePrime	unknown
@LottyHarper	org
@cosedahobbit	org
@incidentreports	human
@SoirBonsoir	human
@Freezerfriendly	org
@TFSceo	human
@Drev7	human
@Ivonamission	human
@NaluHawaii	human
@SMusgrave85	human
@iLuvMiki	human
@kimlud	unknown
@Emi_Bubble	human
@BeerdedLadies	org
@BSPsolapur	human
@Dzaryfa	human
@MaracasCantina	org
@netosoberanes	org
@thepatriciacake	org
@levin_bistro	org
@AKPURINS48	human
@SarahFewell	unknown
@june661528	human
@GaboJmnz	human
@GENYOUthNow	human
@SS_weedfeed	human
@jhemlegaspi	unknown
@lijwoody	human
@in_ntann	human
@JSkinheadYork	human
@Lafilledillyrie	human
@EwRmadrid	human
@Huw_Cook	human
@BarHoum_A	human
@ButterflyLane_	human
@ErnestSy	human
@7070naonao	human
@ninie5353	human
@ExploreKamloops	human
@NobuGizmo	human
@CuquisCook	human
@onmanja	human
@TweakedStyle	org
@majorminus1	human
@kamiyuichi	human
@BirchBarleyDC	org
@StantonSocial	org
@SilkGiftMilan	human
@alifdaningrum	human
@AnnaCockayne	human
@MOandMH	human
@maryrosalieo	human
@LOLA521	org
@SelfieRob	human
@LeilaniSebesta	human
@EfanChrstn	unknown
@S_alhamid	human
@TThurstanW	org
@thisismepipo	human
@Earl_of_Halifax	unknown
@160284	human
@vylip	human
@KELS_ENT10	human
@sfknights1310	human
@tufftity_bitch	human
@CapitalRegional	human
@YuiiFreakyBear	org
@Janett_Chin	human
@Missmars13	org
@BuggyChaput	human
@amydrewthompson	unknown
@scottyturbo75	org
@bogeyholecafe	org
@Bocabonera	human
@JHandArmyRec	human
@FaezLee	human
@EarthDesires	human
@zendorio	unknown
@HappyPixieDust	unknown
@lwrobins	human
@DouaihySweets	human
@iamARIANNE_xoxo	human
@merverkose	org
@rhizajoymorente	human
@Mystikate	human
@MelodyJoyMunn	human
@Adele_pj	human
@MaryAnnSangga	human
@labodegaregina	org
@loryseungyong	unknown
@henveiru_k	org
@TheRealGangalee	human
@therealmahina	human
@herroprince	human
@Blissful_Vine	org
@JapanInsider	human
@nan_foods	org
@emskeighley	human
@MTrof	human
@dudesofgamingwi	org
@Community_Smith	org
@2hngryvagabonds	human
@LaurenHug	human
@Jenn_Edwards1	human
@LindsayReads	human
@KNInnovations	unknown
@BackpackSnax	org
@azaliabadi	human
@anirudhbb	human
@Cris84o9	human
@Jap007	org
@getleanonme	human
@LesConfettis	org
@MRSB_BERRYBETTA	org
@wendyYbailey	human
@j_siefert79	human
@H8DATiLUBU	human
@P_Rad	human
@BaslerMeitli	human
@Yeah0Jasmine	unknown
@nats_klappy	unknown
@LaVallediVico	human
@RoccoBurgerCafe	org
@GotchaJimmy	human
@DJZACKCHICAGO	human
@HisaeJennifer	human
@SpringerTV	org
@EmlynDThomas	human
@KDTOptometry	human
@dek_Na_wae	human
@timashani	human
@PaoloFernand117	human
@CookingWthGormo	org
@MervynSteer	unknown
@dannyjf01	human
@m3y_miu	human
@MandiWelbaum	human
@DeansDinerUK	org
@BrassMeetEat	org
@MichelGeers	human
@jazdrtaala	human
@bootysisterz	org
@majalati	human
@Jeffrey10052013	unknown
@TrasimenoLake	human
@oomoomix	human
@LoversNewcastle	human
@MNFoodPorn	org
@jkmarcinko	human
@raemondluz	human
@jazz_fiend	unknown
@zomvickie	human
@Buddytruk	human
@LouiseTilden	human
@rachluvsjd	unknown
@9014koji	human
@pumasiwotily	unknown
@SurferGrill	org
@ThisIsYourAJ	org
@cake_cafe	org
@djmcgintos	unknown
@imakicola	human
@JamesWorldNews	human
@missneynaaa_	human
@evanamaridou	human
@warwickfiji	org
@thedessertscene	human
@LifeFrutta	human
@slhouse	human
@vanitynoapology	human
@MarlaCimini	org
@casillas_79	human
@meghandono	org
@unclesamcereals	org
@BlogConbolsas	human
@nrdallariz	human
@Homelyau	human
@ydediego	human
@4NOxshireNorth	human
@F_BCHRISTian	human
@buonodesign	org
@sami_in_miami	human
@HusnanTm89	human
@Ali_Hilu	human
@RedPeppersEsher	org
@RoyalChinaGroup	human
@30SuperMom	org
@eliotpearson	human
@FireflyFitGirl	unknown
@Florenceman1218	org
@hearmeraw1	org
@Dpali5	human
@Ich_bin_Erika	human
@LaurraSmith	human
@fieryfairy88	human
@drulinna	human
@copycentreleeds	org
@JordanaMRussell	unknown
@KARO633	human
@AndrewEEwing	human
@TimMyeong	human
@MirjamdeGroof	human
@MagnaConLode	human
@cultoflunna	human
@S4_Sammie	human
@Brentmatthews	unknown
@aLuHMS	org
@luciekerley	human
@Raz_ha	human
@dizz401	human
@Darneez101	org
@PourHouseTO	human
@notjoeblog	human
@JuliaFChu	human
@TheJenniBizzle	unknown
@HOTrinacamille	human
@4NWakefield	human
@DiamondDee703	human
@610labumba	human
@jordanalynch	human
@HausofBruce	human
@Niko_chappi2	unknown
@KissileTalk	human
@FineFoodCo	org
@JeniferBulcock	human
@HanHiyaaa	human
@VGNFitnessAngel	human
@dazhman	unknown
@myVCC	org
@uberjess	human
@Sanaz_Ebriani	human
@PavilionLakeEve	org
@alicehisennock	human
@Mattwonder	human
@zamelkarim	human
@ncessprincess	unknown
@denzelkingsbury	unknown
@VainillaAzafran	human
@trinikittywitty	human
@sHinEya14	human
@RiaDances	human
@OrderPodcast	org
@treyeverette	human
@missxam	human
@MichaelHerklots	human
@Warwick_Buzz	org
@Artsy_Iza	human
@_NaturalHealth_	org
@KellySilhouette	unknown
@kikipenda	human
@Charesefruge	human
@fkeegan003	unknown
@Ehab_ZQ	org
@xtremebberry	human
@j0shua_kyle	human
@TheAlbertATL	human
@vidyasgourmet	org
@LMGToday	human
@MajeedEkbal	human
@iLiveToWatch	human
@Goeland63	org
@HaruSushi	org
@mykelful	human
@twoparter	human
@TeezePlz	human
@Jun_alfred	human
@KloeavecunK	human
@Sarah_Lonigro	human
@Jimbooooh	human
@monice_vm	human
@AndreaParrish18	unknown
@simplydelizious	human
@Tavets	org
@NiCOLE_SANDRA	human
@djmisslucy	human
@OriglioBev	unknown
@gm2marie	human
@CaseAbbott	human
@audwooo	unknown
@AnnaMariaRonnqv	human
@justdiner	human
@BooK_Ku	human
@bonniebonita09	human
@huynhvihao	human
@Tanyakupelian	human
@JaceSpirea	human
@Stacy_Ym	human
@Don_Pierre_K	org
@marshallmarkt	human
@asaperdana	human
@JoAnnJohnsoninc	human
@filipafreittas	human
@happygokatie	unknown
@Gemma_Lawson	human
@LauraWard23	human
@_SHERIdotcom	org
@brunchbae	human
@dkatniggah13	human
@SaraChababi	human
@DarkAngelinla	unknown
@xindianbarbiex	unknown
@JerseyShoreFood	org
@Kati3buggg	human
@MommaDsPizzeria	org
@shey417	human
@LifeInLeftField	human
@editorssun	human
@funnyjones	human
@pinkyvenus	unknown
@emmajanesaxby	human
@PainfreeOscar	unknown
@twentyfivecent	human
@muzikscribe	human
@gordon_rozario	human
@g_giammaria	unknown
@GlassIsLife_FR	human
@nusratstweets	human
@DJflexure	human
@807ranchhouse	human
@LCBO	org
@DealOfTheDay58	human
@meyerfunkystar	human
@kwkkkkk_85	human
@brandyedinger	human
@BlindedBite	human
@dina_septerina	human
@aalmeida25	human
@GoKatGo_	human
@Kalynn_W	human
@iamPIERRE05	org
@shi____ori	unknown
@joshjanssen	human
@DJmellz1017	org
@FRANKELITONYC	human
@nora_eats	org
@SuffolkBiz	org
@bobcatsteph3	human
@ArborpointMS	org
@CristinaDePin	human
@Mphiiw	unknown
@splendyeess	human
@sarahayoub	unknown
@ellenost	unknown
@cecilyz28	human
@bebe_langga	unknown
@maelisaza	human
@6Percenter	human
@MrsCroweBird	human
@poon1111	human
@alyssa_barajas	org
@MaiiJJoong	human
@Eriza_DgHita	human
@JustOneThing87	unknown
@PrincessRoxy6	human
@Tangiefitworks	human
@NovaliaSantoso	human
@tloh	human
@w_ie	human
@bittersweet_978	org
@vasudevanviju	human
@HotelAnel	human
@MaglokoXXI	unknown
@miwamingo1983	human
@FrontFundr	org
@iTigerCoon	human
@SauzaMaila	human
@paulrenenichols	human
@stealinglucy	human
@glutenfree9183	unknown
@capriott	human
@Amy_Marciniak	human
@que_esq	human
@JaKaLDesigns	human
@LuciLawless	human
@chritam	human
@livsalguero	human
@danniclare93	human
@RDdivaMOM	unknown
@folomojo	org
@RisBrian	human
@MykALeek	human
@annahika	human
@ernestahungry	human
@ouiouicherokee	human
@ReneACavazos	human
@DalilaMennillo	human
@friskasilitonga	org
@rickyfukenjohn	unknown
@nazkeai	human
@aanandakrisshna	human
@aranelsinte	human
@jasnyder78	human
@rosefitlife	human
@cgyfarmersmarkt	org
@HollyMichaelUK	human
@ValentineHuang	human
@AntonioVChanal	human
@dishcrawlPHL	org
@barceyscoffee	org
@JorgeSantiagoJr	human
@KellieJoanne	human
@Pulitzercenter	org
@boroughbelly	org
@shoelaccey	human
@LandmarkAmman	human
@luciastevlikova	human
@Strickly_Nikki	human
@quirkycurrly	org
@wanbaharum	human
@gypsyjade	human
@HabaneroLatin	org
@papabebehillary	unknown
@phxdailynews	org
@Chai33Bercy	human
@borraborra	human
@ColinRansom	human
@Fulla_AlRad1	human
@SophieHaslettXX	human
@cntylinesmokers	org
@carmenCONdance	unknown
@gra4ham	human
@BlueSteelNY	org
@beautylabyrinth	human
@AngelaLebovic	human
@LeeKoeberg	human
@ItanCortex	human
@Sjazierski	unknown
@Joan_Schneiger	human
@rhandyFX	human
@FcTrillizosLJGW	unknown
@900408Love	human
@Hognutsbutters	org
@JOJO_Miao	human
@kwangkungzaa	human
@MzBossHawg	human
@LIFEWELLCSLTG	unknown
@tascaportsmouth	org
@lisa_tRaVieSa	human
@n8konsument	unknown
@iamralphivan	human
@cheffing	human
@ThemariiVr	unknown
@marti_05	human
@KrmsLiZaL	human
@yuy0uki	human
@KacheOnly	human
@Guida_AL4	unknown
@citiey_ieka	org
@takumauemura	unknown
@FurloughToronto	org
@staples_4	unknown
@yj_soon	human
@ForgetMeNotKP	human
@m2mstar	human
@ChristiBartlett	human
@angellialc	human
@eeemmmiii	org
@HExposures	org
@MusicsTuffAZ	unknown
@ElaineAgapiou	human
@Pao1ina	human
@may_meecsm	human
@FreshBrothers	human
@CafeGranada	human
@KissGyms	human
@kepcke	human
@IGAQC	org
@modailaska	human
@arthurbananas	human
@hrogelmtz	org
@hannahcheadle	human
@Charcastle31	human
@Turb0Tel	unknown
@mehmetyusufsuay	human
@DarylKyle_PT	human
@myevilgummybear	org
@VirginiaGiesen	human
@foodlibrarian	human
@worldfoodcity	org
@brefunefille	human
@GeorgieDaniels1	human
@strismyangel	human
@Yukachan68	unknown
@tallcedarofleb	human
@sarubauer	human
@laceandlove1225	human
@allen0289	human
@MWSJ87	human
@kornatmeg87	human
@ThreeTwo8	human
@iamgiagurl	human
@pinestreet	org
@AmourMiCo	human
@AshVeeCatch_em	unknown
@demithehustla	human
@FYW_Erin	human
@ElaPhilly	org
@amiehartnett	human
@nikkicubberley1	human
@Ambuuuur	human
@purehealthcafe_	org
@EarnshawGiselle	human
@iHeArTuX07	human
@ridermarc	human
@badbenny88	human
@aleenezZa	human
@AlcalaLoxar17	human
@tankosmarley	unknown
@AldoraMuses	human
@KryptonTown	human
@kumabado	human
@JasmineBrunelle	human
@Pink_Protein	org
@AdrianaZeferin8	unknown
@bradsdeals	org
@10509064	human
@DjJuelz203	org
@Ramkissoonjo	human
@FrugallyHealthy	unknown
@grassfedjp	org
@jacquelinev_	human
@Nalanaldo	org
@rakochan2	unknown
@KateNeschke	human
@EatopiaQatar	org
@MozaFoshea	human
@nguyen_nelson	human
@RocheCom	org
@sady1981	human
@Moonbootica	human
@boogiehardhead	human
@abovdacloudz	human
@coconut_lady	human
@Opicadinho	org
@setiawan_julia	human
@aiNuN_0910	human
@AvalotAlantra	org
@itskhariascutia	human
@ManhattanMinnie	human
@iammarkbryan	human
@IamDevonaJ	org
@heatherjenks	human
@KEITHSWIZZ	human
@toonsg83	human
@CheriseKohen853	unknown
@eman_______22	human
@clafollmann	human
@beckyweller93	org
@XJHoX	human
@gibraltar_hour	human
@jane_withparis	unknown
@llesuetens	unknown
@tagururu	human
@methodlab	human
@Brandagee	human
@Eat_Run_Smile	human
@donnajunelane	human
@OldStableStore	org
@DaniaaaFaisol	human
@AraTadinda13	human
@xiaoer520	human
@MieuxduMonde	human
@DianaVeronica1D	human
@FunniRoom	unknown
@MolarTron	human
@rinkuskitchen	human
@nuyakdude	org
@Mexicath	human
@DbSchuller	org
@AlbinaE2002	human
@prlvancouver	human
@Farzanaley	unknown
@kajderks	org
@jackieciommo	human
@Planution	unknown
@RICOdaVP	unknown
@featiza	unknown
@thefarmbristol	unknown
@AleLaRizzo	human
@AndrewCheng96	human
@msbananapeel	human
@misha_ellyie	human
@patrickboccola	unknown
@wallflourgirl	human
@mamamomtourage	human
@DaisyMayDaisy	human
@I3enja	human
@EkaDalanta	human
@RebeccaOndrey	human
@DarcyCarnforth	unknown
@Apolonia4520	unknown
@denn_levy	human
@ijuancarlossais	human
@maeinnervoice7	human
@mstinatina	human
@CookilaApp	unknown
@charoron626_yui	human
@swatisani	human
@Fadshadow	org
@jerayeli	human
@NiaSihombing	unknown
@JessFacc	human
@teereeska	human
@HlfAssdHobbyist	human
@PembertonFarms	org
@Inigollopez	human
@Daryllabalostan	org
@JojieAminuddin	org
@kitchen_knife	human
@yuribeans	human
@SarahGHenley	unknown
@MCRomagStudio	human
@GELAAPesigan	human
@sillapriscilla	human
@thejimomma	unknown
@lisa_pinup	human
@davidmcewan	human
@BellyfullDinner	human
@1CWBE	human
@kiffty	human
@ItsMeSarodih	org
@nextstopfit4	org
@MJen34	human
@BakeIt14	human
@zahrakeroppy	human
@camillal33	human
@STLVegGirl	org
@BrooklynStoops	human
@kettyjs	human
@proknifesharpe	human
@jbmgrace	human
@OfficialChefT	human
@JamesJoyceDURM	org
@cocoetcannelle	human
@AnaNiiqOlBustos	human
@wanidas	human
@iAmAustinn	human
@ShabbyMeChicCM	human
@yingy	human
@CharlotteVB88	human
@LucidImajus	org
@kimiseob	human
@just_pita	human
@sherinakamal	human
@AidanFlanagan	human
@PQueennie	human
@ARZOUXE	human
@Lewitje	human
@Iamvhynez	human
@shoprabbithole	human
@ReviveActive	org
@LnnPtrck	human
@RindaRenSdhani	human
@dfwyummyexpress	org
@Joelopz1	human
@NeuvooHosUK	org
@IeshiaE	human
@afny90	human
@1hijabfashion	unknown
@NailTheDeal	human
@mlspin	human
@tbboardroom	human
@patetlovekotoh	human
@simscupoftea	human
@LWarfle	human
@kristenatcop	human
@LesAmisDTF	org
@cleaneatingmag	org
@RPG828	human
@ChefLouieG	org
@zuppa_stiletto	human
@Spydey1	org
@VynkieTan	unknown
@Amanda_GomezM	human
@IAMYOUNGFR3SH	human
@Pyriel	human
@bingxian	human
@StephyuUBo0	human
@AbbyRadovski	human
@opi83	human
@mintgreenapron	org
@ESPAISUCRE	org
@ami_xolove	human
@AntonioRicci_	org
@Giovanni__Minaj	human
@Melly_Rosiana	human
@TheMarcMoore	human
@Dra_Gi	human
@db1124	human
@boehsesblut	unknown
@DHMarathon	human
@BeverlyTanFilm	human
@TheTerribleHook	human
@Autumn_RoseB	human
@priyadogra2010	human
@JimmyNguyen415	human
@luna_arka	human
@geeamanda	human
@MeaggsieG	unknown
@amira_raf	unknown
@OhlalaBeadtique	unknown
@ItsDeniseFong	human
@ElinaJohn2	human
@mwtrips	org
@D_Trucking	human
@Wadiebentley	human
@AshWilliams1987	human
@lloydjosephmoss	human
@elisa_marcucci	human
@heatherpeagler	human
@Itsyourgirljroc	human
@LauraJean396	human
@solessence	human
@unnikrishna	human
@TammysYoga	human
@Cinquecento500	human
@SkylorPowell	org
@shopkariella	org
@Luezoid	org
@wiljundsgo	unknown
@KLivnRTGeTighT	org
@PrinceBenoni	org
@irwandij	org
@Direk_LJ	org
@megansripleyxx	unknown
@Dmosselle	human
@JadeThomas	human
@gailmcinnes	human
@andrealeonj	human
@camp_ben	human
@TimMcRae82	human
@NeeVieSante	unknown
@qamarulmifdhal	human
@ItsMicaMiranda	human
@jakifuji	human
@zurichko	org
@estherbMFT	human
@fineshotpro	human
@Tracebell_Mack	human
@BPStThomas	org
@RockNbananas	org
@xtenegavine	org
@goagainstdaflow	human
@ABCNanaimoRest	org
@tamiyan_n	human
@Alden_Kuan	human
@kellymotivateme	human
@mike_sniper_hr	human
@myplaceboeffect	human
@CxX_Pz	human
@PonyEspresso	org
@sherwinjtb	human
@JovanckaHoman	human
@goofygoldphish	unknown
@theallergista	human
@ChefPeezie	org
@catchtaryn	human
@funkyy_gal	human
@OzzieJay01	human
@babygirl_cindy	unknown
@inSAMARINDAcity	org
@gpande07	org
@arieldmillan	human
@clemens_patrick	unknown
@ChickpeasChange	human
@sternmanrule	org
@dciplochrist	human
@AlexPangelinan	human
@theword07	org
@CSuberox	unknown
@SugarSantiaguel	human
@VillageLivinMag	human
@irfaan____	human
@vannyinc	unknown
@Stanleyadhi	human
@Lalo_ZeroAlias	human
@yk_oka	unknown
@SocialRadioShow	human
@wonghae	org
@HdyhZnl	human
@xJESUSxSAVESx	unknown
@itscorinaduh	human
@GabyDyerr	human
@lionsbaycoffee	org
@Tanjanica	human
@BensonToya	unknown
@JavieroDiviero	human
@sourdough_lou	human
@78Annina	human
@darakibr	human
@fourinfo2	unknown
@DJ_Clementino	unknown
@Judi_Curtis	human
@diogolanconi	human
@YungMike360	human
@Befancylikeme	human
@MIXTECADURHAM	org
@Oscaringarza	human
@MirandaLoretta	human
@fromparisathome	human
@apiratelife4me	human
@BrooklynBear718	human
@crystinanguyen	human
@yuvina_yuviii	human
@spldesigns	human
@Alvaro__Bonet	human
@emmafoss420	human
@letsspiceup	human
@godless_mom	human
@kamkamkam_x	human
@classybower	org
@OfficiallyCaryl	human
@elodiejsteffen	unknown
@Charlottex1x	human
@TexasTracy91	human
@K_Nicholette	human
@TeohKayMent	human
@BBPINUS	org
@NoonaJann	unknown
@GogisRestaurant	org
@LoganJrChef	human
@zefaniaregina	human
@busterscoffeeIT	org
@wallygusto	human
@SussanSharifi	human
@teddybearhugs4	human
@ButlerBentley	human
@stellyco	human
@RadFinch	human
@nutri_kidz	org
@alfredopatino18	human
@LatinaMami64	human
@natural_bby	unknown
@CevichePiano	unknown
@ALEX_GONZ413Z	human
@VanessaChigabri	human
@rebeccalee91	human
@NesquikArabia	human
@mycolorfuldays	human
@ask_ellen	human
@StellaMarinaNJ	org
@Stars63184	human
@sandyy_sp	human
@absolutraia	human
@samosahatsudai	human
@ClAudIaNRoMaN	human
@Saffron_Beno	unknown
@RDGourmet	human
@Quennie_Kitchen	human
@lemilcollazo	org
@dashley339	human
@Coyotemoonlight	unknown
@HaulinOats1	org
@Msaleflowers	human
@DaichiMail	org
@rewindexist	unknown
@jvmty	human
@Prettii_Black	human
@Legenddeli	org
@vinylheadkent	org
@DoRiteDonuts	org
@rubyjnkie	human
@amiragassi	human
@Hornets_Nest	org
@Naaanix	org
@BoatStKitchen	org
@tull_2003	human
@karloakakarlo	human
@beatricecerliaw	human
@AbuBoth	human
@soupbarUB	human
@natanierisk	org
@swaggeratfrow	human
@dammnncryssii	human
@devikanietha	unknown
@UveGotMeal	unknown
@IllusoryAngel	human
@FaStCaRzFrEeDoM	human
@kellytnzd	human
@PEPEillustra	human
@redhead_demon	human
@ArtIsLifePhoto	human
@GrouponMY	org
@Kitty923_MIT	human
@biNkS_xP	org
@FitabilityUK	org
@ParcCalgary	org
@cathiidempsey	human
@QuinceKitsilano	org
@dawnmonroe83	human
@sequinsponies	unknown
@maaaymarcelino	human
@keing116	human
@SieresILVOLO_	human
@celest_in	org
@QweenHollywood	human
@MelanesianGirl	human
@geminimiho	human
@namchyno	org
@uniwbi	human
@geekymatriarch	human
@SheraMissu	org
@BestRecipesEver	org
@Kyle_Hson	human
@auzz1O	human
@caw727	human
@BoulevardBurger	human
@ChandleeAteshn	org
@LJaneRutherford	human
@dada30897	human
@hrmttmm33	human
@traveloni	org
@sand_della	human
@lien_lim	unknown
@LukeBetts12	human
@CharlestonsCaf1	human
@RKsolidNYC	human
@vaniatweet	human
@ModelAntoinette	human
@soulfoodstudio	human
@AMuhuz	human
@DanilHaqidqid	human
@dawnleejiayi	human
@Lorenacrvg	human
@EagleRanch	human
@TammyGaines1	org
@LuvlieBee	human
@AnnetteHollas	human
@LauraLalie	human
@EdwardsBlogging	human
@gianluca_bertu	human
@elleusirk	human
@alvin_toah	human
@fang2_shy	unknown
@LexMediSlim	org
@WilliamAmin	human
@laurenreedthis	org
@chehade23	human
@rhi_everall	human
@xoshivani	human
@EricaShayla	unknown
@Jus_lis	human
@bigbruh357	human
@LauraMichelucci	human
@5stardivamakeup	human
@soytentados	human
@vandy_46	human
@NadiaMurdockFit	org
@pinkhsu	human
@Can_Caramelo	org
@akosimarienette	human
@About_Jane	human
@yenanuar	human
@amber09miller	human
@Bessiescreation	human
@seextrame	org
@KyaBistroBar	org
@AzMilkProducers	org
@Beach_Rotana	org
@BaileyBenner87	org
@Shishang_Zazhi	org
@krystlemcgill	human
@AtlFreshYogurt	org
@Mohammed7amodi	human
@RuteLancaMusic	human
@Bronx411	human
@Amrishah_amri	human
@MODA__L	human
@kate_hislop	human
@collettell	human
@alwahdamall	org
@UniquelyKelseyB	human
@Mandaraye89	human
@derschoeneali	human
@forevergordord	human
@peijun_yee	unknown
@kylasmuse	human
@westboroBIA	human
@ClaudioLimina	human
@digadelha85	human
@erbasmansion	human
@DDSoFla	org
@RealtorsHotLine	unknown
@Gilriel	human
@kellywilliams36	human
@bobbyblingo	human
@rezzelasser	human
@TaniSoberanis	org
@cakewhiz	human
@DowntownCLE	human
@AshleyShantell	human
@Franglaiscook	human
@xxxxxnana	human
@HaziAnis	human
@MichelleOros	human
@RockCreekTandG	org
@ashelyavis	human
@MsNYAmerica13	human
@winniecatherine	human
@DeniseourbseBID	human
@belmodo	human
@Yogi_Yogini	org
@Risyki_MJJ	human
@RoxyHutton	human
@hXcHana	unknown
@Lisa_SFF	human
@Michael_Mike_H	human
@bluem1ck3y	human
@bakerrosew	human
@croquefood	org
@OhIalia	unknown
@rohibur_rizqi	org
@verlainegemayel	human
@DasDelicious	human
@WendyCristina_	unknown
@christin_clo	human
@RyanPratama_1D	human
@Dra_Saludable	human
@LadyBreizh	human
@doodle115	unknown
@DidicheNamour	human
@ellierossy	human
@HappyKidsRhymes	org
@NatsMadriz	org
@katwright18	unknown
@LilMonster2013	human
@InMoodforFood	human
@FSSantaBarbara	org
@bendeejay	human
@anabelgarciacam	human
@yomiqaila	org
@MamaShelter_L	org
@Wesley_Wong_JH	human
@Fitness_Gent	unknown
@aaroncompetitio	human
@StevenS9B	human
@vitico_714	human
@diannephan	human
@speeddaterva	org
@lovelyricha1	human
@jackywinsonisme	human
@yayanoopy	org
@primrosedk	human
@BrazwellsPubNC	human
@Farm2me	org
@Jasons_HS	human
@PrfectPairings	unknown
@salman_albanna	human
@ModellistID	org
@LiyanaFathin	human
@Sapphireseven77	unknown
@djreddiamond	human
@NurSyabella	unknown
@moneymike9	human
@EvePetitePeste	org
@JoseOriela	unknown
@sergeiniebla	unknown
@HeiressHudson	human
@lb20131010bot	org
@ikumi_i_i_n	human
@LovelyMaterials	human
@gwoh	org
@estrefu	human
@DTsuboi	human
@BrinkLiverpool	org
@linabutik1	human
@stylegamut	org
@WeightLoss23245	org
@clarinetnunez	human
@Medianlestari	unknown
@haambleapp	human
@AllBlend	org
@tanyarenee22	human
@HumBesharamHai	org
@tatianacpedrosa	human
@MezehGrill	human
@brantonecard	unknown
@jlhlee8183	human
@Super_Hera	org
@mahr_tn_eek	human
@ZOLTAR328	human
@MauiFishCo	org
@2SparrowsChi	unknown
@DerrickZonca	human
@slkgoh	human
@willtubarao	human
@barriques	org
@biebslovats	human
@LilWaterCantina	org
@FunSize0	human
@janjee92	human
@Mile277	org
@HanksOysterBar	org
@SwainIsabella	unknown
@Keepah	human
@shopaholicmommy	human
@WhereBaltimore	org
@gpatmides	human
@WholeHealthYYC	org
@greenderbyky	human
@tammyjill825	human
@burgerdivas	human
@NawabSaahab	human
@recipeSunshine	org
@Beardmylife	human
@amyboyte	human
@rickyduarte23	human
@KeepItRealFood	org
@rainbowgloves	unknown
@Maiaako	unknown
@popchipsUK	org
@Georgis_07	human
@Caroll_Farmer	human
@11thStreetDC	org
@kayintayen	human
@aks_1493	human
@Electricgrrrrrl	human
@edwinlww	human
@Thecardhouse60	unknown
@NYCphotograph	human
@x_Boulton_x	human
@TattooedMumsy	human
@anaily	human
@Amandabnguyen	human
@CroesyBoy	human
@drashc	unknown
@dhcarterart	human
@FroggiesCatina	human
@farensabri	human
@Dizzyvulture	human
@aslendernewu	org
@Def_Jc	unknown
@yougottaeatthis	org
@PrincessNomad	human
@MsEbabii	human
@YchadNicolas	human
@BiaWallace_	human
@25PentA	human
@Roberta_DV	unknown
@mssdarling	org
@DesignRambles	human
@CorinnaBolpagni	human
@ModerneBarnRest	org
@only_xiaoteng	human
@elijahgarcia_	unknown
@EmilyKrasny	human
@paulspoppers	human
@KamikaJanae	org
@OutExperience	org
@fadhlizulkefle	human
@alysnwndrland	human
@TanyaRecipe	human
@mrbijoy	human
@_EnGdl	human
@CookieTokyo	human
@lerus_ka	human
@ZonkaGear	org
@kumi_aka_mc93	human
@_CarmenLaura_	human
@supperclubots	org
@Nicksnacs4u	human
@gerryval_	human
@Marivir	human
@HomeCraving	unknown
@yukiccyooo1	human
@Carlosmenac	human
@renatetf	human
@littlegemsla	human
@afridishahnawaz	human
@luciamariex	human
@OCandT	org
@lefashionjunkie	human
@ASOS_RachelBass	human
@SuffolkTech	org
@severinewelcome	unknown
@BigGirlDoBetter	human
@MichelleGlean	human
@elainekyt	human
@TracyMLacey	human
@ocacti_dubai	org
@smart_eye_x	human
@Brazil_Yoga	human
@nikulasss	org
@Nicolachristou	human
@KookzKaii	org
@COCOAUSFQ	human
@Charleyb8	human
@kingporteous	human
@editsnailworld	org
@4NBucksNorth	human
@LewiPratama	human
@KardiGaN_BLaQ	org
@alim786	human
@CheckRecruitmen	human
@Jimboroosk	human
@newgolddream71	org
@paulsdesigns4u	unknown
@EssexVenues	org
@dianacarmichael	human
@SashSpa	org
@Lizz_Porter	human
@i_am_shabzster	unknown
@piazzesco	human
@jrpopfan	unknown
@AlishaBrignall	human
@Pathologic242	human
@yello62	human
@joseluishorn	human
@Nessa_BJ_Sunset	unknown
@CakeMechanic	unknown
@freshmamablog	human
@QuintenLyman	unknown
@FIONAFERRER	human
@NoraTobin	human
@lineaton	human
@elainlam	human
@sportiejones	human
@HattricksTavern	org
@Scozzier0	human
@SilentSoul_	human
@shoberific	unknown
@isesatlanta	org
@KelebekDiyeti	human
@PorcoCafeFresh	human
@YTKColumba	unknown
@Miyuuchan09	human
@SkauMatt	human
@iamkuhtreenuh	human
@silviu1859	human
@PHILIPPESPES1	human
@hopecooks	human
@laurenwalterss	human
@SLissMia	org
@artatequila	org
@KikkaG89	human
@tranism	human
@BenRisinger	human
@RjNatiqMughal	unknown
@HipVeggies	org
@OgataSayaka	human
@indieebuzz	org
@babsiell	org
@RoocioSarba	human
@OA_Amy	unknown
@Kamino89	human
@heyrowld	human
@KrazyCouponClub	human
@misschisme	human
@KJatiova	human
@StephonJS87	human
@msmai_punipuni	human
@catherinecwyee	human
@HoCloRentals	human
@theathenianuk	human
@FullFuli	human
@TheToyInsider	org
@bazaartweets	human
@FryUpSociety	human
@SanCarloLeics	org
@jangeorge_swe	human
@Its_Haleyyyy	human
@PinkCakePlate	org
@loveurlocalmkt	human
@ThaHairDoctor	human
@iamaguscattaneo	human
@honeytech	human
@tossitossi46	unknown
@yEAR_monTH	unknown
@seppanenteemu	human
@ElisTable	org
@FWConeyIsland	org
@SweetNSassy92	human
@dimemedia	org
@mr_robmichael	human
@nickypereira	human
@Donna_M_Spiers	unknown
@222smile222	human
@JoanaClerigo	unknown
@IBOMLLC	org
@mahakhyra	human
@_AmandaSimpson_	unknown
@jaynonnie	human
@marcossperz	unknown
@travelleco	human
@BabyIsh37	unknown
@Heater2	human
@JemilsBigEasy	human
@Beauprandevents	human
@earlg22	human
@DennyWeinman	human
@PTBabySteps	unknown
@jodi_uehara	human
@cabestree	human
@JunisaRayna	org
@baracinta15	human
@MelissaCole	human
@camilogvillegas	human
@haziema_izura	human
@alexshook	human
@ErrCohen	human
@MalatestaMaison	human
@nicole_pasqual	human
@mrsslapntickle	human
@VitalityHealth9	org
@evonfusco3132	human
@Torbax	human
@ifwordsdonthurt	human
@miss_lomolu	human
@thaiairy	unknown
@TeresaSimmons93	human
@CourtneyHollid4	human
@UTEP27	human
@gomaam	human
@BatoAlsayed	unknown
@ellam0ore	human
@LaurenNGibson	human
@Restaurantecomd	human
@wildfolkheart	human
@yui3510603	human
@IsaacEsss	unknown
@Naturo_Meta_Sun	human
@SharonRooney5	human
@xxtamkxx	unknown
@Nelie_Whyte	human
@reelectric	human
@nero_tw	human
@velasco0500	human
@Sandmilli	human
@s_anyada	human
@Jennifer_Brandt	human
@danielioannou	human
@lucettagreene	human
@Gluten_V	human
@smplydetrishous	org
@Itscalledstyle3	human
@veggienook	unknown
@squiggles_09	human
@hashmumbai	human
@Weight_Wars	unknown
@CoolRiverCafe1	human
@YaZzii_504	human
@ShahSaaeiyn	human
@NightOwl_CHI	org
@wuihua	human
@BradJillTravels	org
@adnileM73	human
@dqktr	human
@quericotapas	org
@ToroSalaoOof	org
@TiiOlga	org
@SirRabbits	human
@foroguanacaste	org
@init4thelngrun	org
@coolplacesuk	org
@stuffwrap	org
@alyaniisa	unknown
@BeluFaundez	org
@ToriLaBuenaVida	human
@kathysweetheart	human
@NatiPerugino	unknown
@smallANDcomplex	human
@DDNEFla	org
@MrsBeerSnob	human
@WellPreserved	org
@TheoryChicago	human
@Xaviersworld	human
@ayumjanuari	human
@MyAllergyLife	org
@_joanness	human
@InspiredHseWife	human
@jiniia	unknown
@workeralpha	human
@Eyekimm	unknown
@evoolution104	org
@RichardMyGym	human
@Megs1D4God	human
@naiashashi	unknown
@almatadoursex	org
@ShekinahJahziel	human
@LinaMasrina	human
@simonetoon	human
@fanny086	human
@iwillbe61	human
@explosive_donut	human
@BazRana	org
@Mnmapc825	human
@laurenmichellie	human
@jjputichispi	human
@Tatik7	human
@ricardomella93	unknown
@MadisonsPorn	org
@rwaynet	org
@NHParris	human
@Jcarolinarosa	human
@DOPKitchen	human
@ctlstudio_	human
@RodnerFigueroa	org
@Frangepasseport	human
@tanoosh89	human
@fionaProudMummy	human
@KingsHead_Kits	human
@rubylike_8	human
@kristinabessell	human
@907nita	human
@TheBridgeTavern	org
@Marianol02	human
@percyjonseda	human
@nenavangs	human
@DjEscalade	human
@MATRIXFAN	human
@spawnedin72	human
@ShaunCarvery	human
@djschoeny	human
@BlowfishSushi	org
@VenicetheMenace	human
@joandajer	human
@SaveonIL	human
@AntoineDingDong	org
@JesJesMarie	human
@ChristineBerres	unknown
@greystick	human
@DarkianNia	human
@PostBadFoods__	org
@SndaCity	human
@Makeuphooked	human
@TheGCGerry	org
@OlenaHeu	human
@The_Social_DJ	unknown
@rahul_tejyan	human
@foodbevnews	org
@yuriko49	human
@zenti_zenzen	org
@hafizie_kedek2	human
@HyuwhTengz	human
@LiveEatHealthy	org
@TheHobokenWife	human
@CapocacciaTO	org
@LeeMccleskey	human
@NadineMoreland	human
@SlowMarketLDN	org
@Linkiet	human
@LoSonaBella	human
@alitalempicka	human
@carlogregory	human
@michaellally18	human
@willisturner	human
@keyconnrob_keke	human
@ClodixBurlesque	human
@NicoletRockwell	unknown
@bbtopyk	unknown
@JoannaIsMyName	unknown
@duck_inn	org
@rocrus72	human
@MsAprilFish	human
@EliecerADeLeon2	unknown
@dmduv468	human
@andreamaitran	human
@Spicelines	human
@BadHabitRoom	org
@iamjwash	human
@julaikaabdulah	unknown
@michael_edwards	human
@coachcathymott	human
@juleetopper_MUA	human
@rorosocks	human
@maddyschiavone	human
@Kimpton	org
@EliteTravelGal	human
@roberry82	human
@tbandab	human
@TimPeroAhrendt	human
@SophieHamerMUA	human
@KelloggsUK	org
@joanneTang38	human
@Marc_Aristide	human
@MKAdventures	unknown
@h_tothe_D	org
@AhHaoPYF	human
@beau_clau	human
@tMorishima43	human
@AlixLM	org
@RetweetMeBiatch	unknown
@_vEn12_	human
@denshortblock	human
@DianaNasir1	human
@LauraLedas	unknown
@fastestZar	unknown
@kekeFromTaiwan	human
@sweetiesal	human
@missYELoooooo	human
@RebeccaS246	human
@ElpeluTKB	human
@GracieKlutz	human
@hayzelpalomar	human
@jandacafe	org
@Amin_Kassim252	human
@HASPhotoDesigns	human
@JakeHipwell	human
@MiaMartins4	unknown
@real_tya	human
@RunInRedSox	human
@_mrsberryhoward	unknown
@Atropos069	human
@amalia_opi	human
@KimRude	unknown
@thevaldezTO	human
@MVinansky	human
@opusbangalore	human
@SteakRanjang	org
@BankersHall	human
@d84jennings	human
@gcwingman	human
@AddisonLee1985	human
@ShopNiirva	human
@_LaMaggie_	human
@Tweakyfbaby_	human
@AlmaStjk	human
@djluv305	org
@Outzie	human
@susanti_cen	human
@cat9764	human
@JStarzBeat	human
@ShintaDewiii	human
@4NFarnham	human
@MichaelaJB	human
@cheers_bingo	human
@racomimaima	unknown
@guimy_more	human
@inBANJARMASIN	org
@inbredhybrid	human
@LPPCafe	org
@bijSlik	org
@LaurelFleming8	unknown
@HeadleyHills	human
@ArtisanBreadIn5	org
@myhome102006	human
@DSCI_Connect	human
@bassilgamal	human
@PepeTorrejon	human
@San_Tapia	human
@DorisMeridith	human
@weiweihyukmi	human
@courtneydaisey	human
@heidi_frenchie	human
@thirdeyephoto	human
@BeckyAmyLew	human
@Jodebrave	org
@kerrynmcdermott	human
@hussain0216	human
@tallandtrue	human
@paperplatechef	org
@TildeTaco	org
@violettaqueen	unknown
@trininista	human
@anamarte23	human
@mikulskidariusz	human
@lorri1956	human
@charlenelingz	human
@latekatefoodie	human
@JubyBenavides	human
@LuigiNistic	human
@saulcutcio	org
@ladygankster	org
@chinaquilet	human
@markvreyes	human
@talktoptourist	org
@th_purpl_lady	org
@newcokeandtaco	human
@JustEnza	human
@miissayy_	human
@MontsePoveda	human
@tokyobeen	human
@phyzal25	human
@randy_paddy	org
@condoshomesTO	human
@TheWeekendGourm	human
@IvonneIsuta	human
@mmfkid	org
@inesha83	org
@CenTexBeat	human
@wanderdust_niks	human
@Chefjbf	human
@Super_manuel01	org
@duponthenning	human
@Shannono1982	human
@wildcaughtreds	human
@abellis4	human
@a23743372	human
@CarlosGarciaE	human
@fadoirishpub	org
@Niki_LawsonTW	human
@millettandmore	human
@custommadepink	human
@CultivarWine	human
@ladyluxvintage	human
@KidShelleens	org
@myurbanmarket	human
@bituinanaig	human
@mark_tj	human
@RestaurantNews1	human
@Brachavillas	org
@pevergara	human
@sexysetch	human
@MCailipan	human
@yumean0820	human
@icqz	human
@DosSegundos	org
@JanfenR	human
@awesome_bacon	unknown
@CEBTruman	human
@ichrisarciaga	human
@octopixy	human
@msangel_jojo	human
@ASpangaloo	human
@untalpedro	human
@sebcentner	human
@rikafitrikasari	org
@Viljamitz	human
@tjendanabistro	human
@benz2born	human
@NeuvooSouthamp	org
@alfariiiz	human
@Degustanplacer	org
@telly26336256	human
@NadiaComincioli	human
@KatherineBass	human
@mememoniq	org
@aanggita181	unknown
@MarcoAR88	human
@GodsbestV	human
@saori_s_14	human
@mare24bear	unknown
@EasyGourmet	human
@TzomBerlin	org
@kalifornianboi	unknown
@Deej90Jake	human
@Tash1Luv	org
@LipstickArsenal	human
@RecipesTwoDivas	human
@prettyupme	unknown
@thedogandbear	org
@CurryMasala_	human
@StansDonutsCHI	org
@tahirkhan9	human
@IAteMTLTours	org
@uruguay_bot	human
@Romnick_dahan	unknown
@JojoWestSide	human
@Mic_L_Mcc	human
@BondiBalm	human
@betsylife	org
@thefredelement	human
@quebeon	human
@DishesFMkitchen	human
@popjung097	human
@HEARTdino	human
@a_d_b_design	human
@Sari_b2	human
@BravoSeeMe	human
@rl672	human
@MdotDrizzi	human
@samiramaye	human
@Mbrown96Moo	human
@RaquelTG	human
@golf_freestyle	human
@LYNmeyourear	unknown
@HotelGuadalmina	unknown
@PavlloZengo	human
@GiuliaT	human
@milestone_brant	org
@lionelldixon	human
@urbanicon82	human
@htly6f	human
@theladybruncher	org
@miki_1119	human
@Just_Me_Period	human
@Karolina_Ryszka	human
@socialpalates	human
@linhyxpoo	human
@tinteddesign	human
@AlisaValentin	human
@MsFrugalone	human
@harumotomaika	human
@NewportBSR	org
@CassLovesBieber	human
@LMKstyle	org
@umbertosani	human
@VladaLevshuk	human
@pammy_vrstg	human
@ish_warlord	human
@ruthguestphotos	human
@ritsukohawaii	human
@halfcrazyben	unknown
@imlavigneit_	human
@WorkoutHealthy	org
@imPRINCEOFEGYPT	unknown
@TBULLARDJR	human
@manueldg97	human
@MarkysBBQ	human
@rbcfang1313	human
@fantabulesslife	human
@ChicagoISDiva	human
@zeFashionConyo	human
@Flonsdale	human
@matsu_nad	unknown
@casheerose	human
@FilaBimbosourek	human
@HomegrownIn	org
@lifeisbeauty00	unknown
@veeleitao	org
@J3nnyb34n	unknown
@AmbassadorHote3	human
@EzraSujeevan	human
@FOREVER_SAINT	human
@xxpresso	org
@NEESii	org
@gabita_bs	org
@ainhoaojanguren	human
@AngellaLeung	human
@farezashah	unknown
@simplytina78	human
@_joemorrissey_	unknown
@Ayu_Ceper	human
@DJDOLOR	org
@FieryBull	human
@donnascalise	human
@Sofiiorio	human
@BariatricFoodie	org
@AndriesClaes	unknown
@Que_jadore	human
@William_Sap	human
@Krystal_Leandra	org
@lefthandof	human
@nitusexy	unknown
@lowcfoo	human
@incinnar8	unknown
@StFoodAlliance	human
@Hope_R6	human
@TCGreenMedia	human
@cantinarooftop	human
@mr_barlow89	human
@YowDudes	human
@AprielOrtega	unknown
@LeVinParfait	org
@hustonbrian	human
@gardenmentor	human
@lukeatlt	human
@KerryMusicman	human
@cookiesinheaven	human
@The_Gourmetress	org
@omarpa	human
@smartredbeast	human
@JOMObaby	unknown
@MJisBane	unknown
@PicNicWinebar	org
@Lovely_LongLegs	human
@cairolfz	human
@Asha_Tabassum	human
@thisbejuan	unknown
@TFizzle95	human
@AllenaMehlig	org
@DanHad	unknown
@putrisilviana	org
@local_lux	human
@Khuloud_bubbles	human
@1Truegrace	human
@MorrisJameela	human
@ChrisDayish	unknown
@FashionGlamCo	human
@sunshinesgrille	org
@Kevingodiva	human
@cincin49	human
@Gingerdred	human
@JaySinclair	human
@Hemera7	org
@EBensetti	human
@TiffanysResto	org
@tasteandsound	human
@JackAnderson999	human
@shannon0111	org
@vixrowan	human
@mimiditca	unknown
@TorontoCityLvg	human
@LaurenzosMiami	human
@ISIS_NEUS	org
@janeb33	human
@NailiKardashren	human
@monikabaechler	human
@pariparikaleful	unknown
@wesleygunter	human
@Zhenguoz	human
@Atkinjet	human
@MJF_JAPAN	org
@miitany	human
@TokyoLebanon	org
@lupe_cordova	human
@GwenChateau	human
@ezzy940615	org
@My_Baby_Doll	unknown
@handbag2000	human
@s_ammari	human
@MhdAsyrafRzli	human
@magda__natalie	human
@_1stClass_Lady	human
@PolitklyInkrect	org
@Dza559	human
@SwainCourt	human
@JessicaTFitness	org
@yourwanderlust	human
@Puglia_Tour	human
@eoinser	org
@sweetrhizza14	unknown
@GABRIELKAMPOS	human
@liakurtz	human
@rui0102	human
@TinkJul	human
@djshadowsteve	human
@dylanyoung448	unknown
@GabrielKane81	human
@joshamrock	org
@PoetRaeMonet	org
@gigi_flood	unknown
@wendybottrell	org
@CEREalprocesS	unknown
@shelleyhopkin10	human
@tofu_product	org
@FootyDezigns	org
@LaurenRodrigue4	human
@MajedFekri	human
@LivinUnleashed	org
@BolchJack	human
@iamjennybatalla	human
@ThaREAL_B	human
@oliviafayg	human
@hannahgregory30	human
@ZornicaKuca	human
@BuckYaFeelings	human
@MurphBC	human
@HitokuchiBoston	human
@TheRealCil	human
@AtelierCafeLDN	org
@Devyburac	human
@Bostonandting	human
@DoubleB_NYC	human
@PatriciaKara	human
@XxXjustzoeXxX	unknown
@SiegelDay	unknown
@lalayola	human
@CINDIEMINDIE	human
@kaaaylargs	human
@joeydragonlady	human
@DanielMMcKnight	human
@_rina_1109	human
@sarinovita529	human
@TreyHigdon	human
@DeiraCityCtr	human
@67burger	human
@SciNewsyTweets	human
@mika110913	human
@panji_sudoyo	human
@NiveenR	human
@TakeItToCourt	human
@QueenR0se	unknown
@brownboyswag	unknown
@PieCommish	org
@ekkaNW	human
@rectoversomag	org
@Filippolidori	org
@blackhorse_kf	org
@PseudoPsychoJap	unknown
@mviendavv	human
@doctorshei	unknown
@CsbaysahCianneh	human
@ide_suke	human
@CotelleOrianne	human
@Cosmo407	human
@Go13313y	human
@achiesguerra	human
@StephieLAdams	human
@WhoresCircus	org
@jazzyjazzyjazzy	human
@PoutyDee	human
@VintagePhilly	org
@kimdevogel	human
@chelsea2004aa	human
@andoyranay	org
@NEBokeltsen	human
@ParentsCanada	org
@Hugoharrisfit	human
@rei424	human
@JSaundersDrutz	human
@GoldPlatedFood	org
@hadid__gigi	human
@lady_emelye	human
@Nellie1991girl	human
@vedovitoday	org
@ElishaMauger	human
@GlutenFree4Tea	human
@CrabsPensacola	org
@dichao	human
@coloredair	human
@sprinkles418	human
@BeAngelBeauty	human
@DadSwagg	org
@everydaykalu	org
@Joykwendo	human
@oishiiden	org
@TheCollectionAE	org
@SharasKitchen	org
@itsmeoneal_v	human
@CloverRiot	human
@therambar	org
@blancaliciouz	org
@lynnzieee	human
@itsjessicas16	human
@3abood_casper	human
@ditzyaindigo	org
@BMOREBrian	human
@TheBravoBlonde	human
@SocialStylz	human
@rosaritovas30	human
@JaCkS0n89	human
@dAKAnLovely	unknown
@heidiaiken	human
@acidism	human
@Pi_NGuin	org
@Hitmaker_ANGEL	human
@jqquah	human
@Kaoru82o	unknown
@app_lands3	unknown
@BeirutMCR	human
@NicholeGadd	human
@spearmanchris	human
@shahel	human
@pegasus_blue	human
@robert_veres	human
@jackiesangel8	unknown
@tielwingsmama	human
@AlexisMautoneRC	human
@IbeliceS	human
@johnnagiolagon	human
@josephspendlov	human
@MyUniChef	org
@WytheHotel	human
@SVRVishnu	human
@marianne_r16	human
@javskie21	human
@poyzilla	human
@kanoair2011	human
@KiinsMaejor	unknown
@adistyadish	human
@la_ambrosialee	human
@hallam_ed	human
@ponnnakii	human
@Halawanyy	human
@RunningLife01	human
@LadyDLily	human
@MissLocker	human
@gabjazmine	org
@gustavorivdelaf	human
@julpmajestika	org
@Misty_Blue213	human
@KMichelle916	human
@SarahRylee	human
@zhang_jersey	human
@drewharps	human
@omoshiro_FIZh3	unknown
@KitchenCents	org
@picimbala	human
@malsimons	human
@CindeQuille	human
@Syzenna_	human
@renai_y89nF	unknown
@affan_m	human
@NeoCove	human
@cogemarimo	unknown
@djpursey	human
@JournaudLea	human
@MatteoAvidano	human
@denize_sp	human
@hollywoodcurry	org
@lau_locatelli	human
@Ying0	human
@PsychoBeelzebub	human
@lanovialanovia	human
@AdCarbol	human
@kimmy_fitness	human
@Kill_Meal	human
@FalafelHooriya	unknown
@juliuswong247	human
@TheAmandaRose	human
@saskiawidi	human
@22thesquare	org
@JeaneteGCompean	human
@iamvayielicious	human
@n_ski_0607	human
@prettyktm	human
@gastrosalvador	human
@Alice_Siaw	human
@coffeebns	human
@LangfordGoose	human
@StFrancisLinks	org
@HomeboyInd	org
@CornerCravings	human
@fttbabymama	org
@RosenHotels	human
@WPBCC	human
@Yel_Yint	human
@SmallTwister7	unknown
@nsteinberger	human
@BubbleChild	human
@haho0707	human
@Mariposagrill	human
@FranceNet_Geek	human
@kristinnamitic	human
@LittleCupcaker	org
@digitalcrusade	unknown
@JeanyLie	human
@Oror_404	human
@AzzurreSpirits	human
@fredblagden	human
@Daniel_Thwaites	human
@toomuchtoostep	unknown
@KrizIan22	human
@townbrookhaven	org
@chiaracamell	human
@theShaneguy1	human
@19BJF	unknown
@skotchskotch	human
@DirtyCurty20	human
@shashg9	human
@MsBPassionz	unknown
@yusminoernithda	human
@zeppy_1980s	human
@SweetYears8	human
@GoVeggieFoods	org
@mickellogg	human
@burnhambeeches1	org
@AntoCalderon24	human
@SML_hk	org
@LorenzoAdcock	unknown
@LokiiJay	human
@RazanFawaz	org
@SynchronEssence	human
@NAOMISLIGHTS	human
@iamVivienCaryl3	human
@TX_Smokehouse1	org
@nickyzthrough	human
@efahmi	org
@cungharto	human
@mikevensel	human
@clarise_1	human
@melianach	human
@choge08	human
@KrisDachi	human
@RacksPHL	org
@booksbarksbrews	human
@AYtwoAY	unknown
@DELICIASDUNAMIS	human
@izelhomes	human
@Eli_silvestri	human
@rilzy	human
@aclarkwhittle	org
@EnoviB	human
@OSU_Cutie	unknown
@MegsHui	human
@tinsexy007	human
@STEELDALLAS	org
@NicoleXs1	human
@lukieejackson	human
@theDUNK360	human
@MidFeastTruck	human
@MS_LAFAWN	human
@Equality1975	org
@flyasakite	human
@RockBurgerPMA	org
@BuildersChelsea	org
@VoluteAge	unknown
@CinCinUK	org
@murraymuzz	human
@omkisbung	human
@ialave2012	human
@ROCKS_NC	org
@LaVaMaOorXj84	human
@e_x_i_l_e1	human
@CreatorFilm	human
@zarlitos	human
@FairhavenTours	org
@AndreanaAndy	human
@Oscar_Tonado	human
@Gabriellechanyh	human
@TThrane	human
@8118Aknp	org
@Chuffingcharlie	human
@WestinBlueMtn	human
@roirahmat	org
@kenekthedots	human
@TimeOutBeirut	org
@Shara_ppon	human
@KChevalier	unknown
@Onigiri03JP	human
@TiUClare	human
@djoenaedikoesno	human
@Catch_Our_Eye	human
@MinnieHope	unknown
@Fingerlickineat	human
@adagon123	human
@tobruckave	human
@Bypriscimiguel	org
@dj_soltrix	human
@maggio_k	human
@mesaroova	org
@cmfolwell	human
@ChelmsfordLover	human
@i_am_ela	human
@JonathonRedmond	human
@Vistamag	unknown
@LargoCafe	human
@maryjanelovett	human
@JayGar2009	human
@THE_REAL_DEZ	human
@I_AM_ThePrince	unknown
@Jessicalazala	human
@Marcuzzo2five3	human
@AmberJayEnergy	human
@imghegnzg	human
@AnniieWright	org
@KPicnicbakery	human
@Oftravelntales	unknown
@guzel_chica	human
@mohdshamzurinda	human
@MemoShowaikh	human
@qishaiyanaharun	human
@lazymeg	human
@DMactheDon	human
@DHaddon87	human
@happinoko	unknown
@djbystedt	human
@heroangel	unknown
@DowntownMobile	human
@Jo8Bean	human
@TroppiColori	human
@BailbrookLodge	org
@mnpooon06	human
@DJSaKiE	human
@SpringTonicPR	org
@Gladysyeap	human
@RoyaleDiary	human
@havaianastan	human
@disheroapp	org
@vip_gd_of_BB	unknown
@sattvawellness	org
@Iamraloreche	human
@STeVeAsinas	human
@StormiNormanEnt	human
@shiruba_buretto	human
@WJBRInternet	human
@NickyShip	org
@AM0408	human
@tremontnyc	unknown
@KarinBerzanski	org
@MarmarayHotel	human
@AlexCrisanSarbu	human
@AndimarcoLapola	human
@jeffdevera	human
@aprettyprice	human
@NEOSnacks	human
@IsabelVacilotto	human
@DanishSuperman	human
@BayCitySea63	human
@forksandrec	human
@VEGESENTIALS	org
@BatmanInTheHood	unknown
@TerrineLA	human
@bigcracker22	human
@clubmagazine	org
@Diana_Catharina	unknown
@mariezjohnston	human
@xoxoDutchgirl	human
@JackelinV	unknown
@TimLihoreau	human
@cafeberlin	org
@riley284	org
@FitnessAgent	human
@GlamDivaZA	human
@ASKBIS	human
@mchadwick1	human
@yourcitytrends	human
@RayRayItalian	unknown
@Crisperezlacruz	human
@NoToastBlog	human
@EEna_wEE	human
@OrlandoHamilton	human
@DiverseStyle	human
@presidentaJQ	unknown
@sinyal_nov21	human
@Mr_Zii	unknown
@romatheexplorer	human
@DJTINYTIM	org
@jessieliviaa	unknown
@carlitaslam	human
@rinnieey	human
@jeeter_skool	org
@headphonaught	human
@AnaRosalina_09	human
@HoneyMedina	human
@BlackBookInk	human
@seedoi	human
@staymich	human
@BeepMair	human
@mugzoh	human
@PiPoTime	human
@Peteran51778939	human
@Flourishbelieve	org
@Katalysthealth	human
@daygirl11	human
@flyboyt3	unknown
@MommynRosie	unknown
@XIO_0404	human
@shelleychn	org
@fotojunki	org
@FratelloAnalog	org
@RJDaMonarch69	human
@nicnyx	human
@questionforall	org
@ADHAISHAQ	human
@o_karen	human
@Beckognition	human
@younghickorysd	org
@yehiaelalaily	human
@PRNEFood	human
@BeadCrumbs	org
@RichardYek	human
@YinHanCYH	org
@GetHealthierwMe	unknown
@AndyPauHandoko	human
@ahendr1234	human
@vin_ann	human
@welcomebreak	org
@24supermarket	human
@Sexiiqueenyaya	human
@jackstraws	org
@mamchenkov	org
@Jamey_wbu	org
@GringZT_6B	human
@abemiu	human
@fayefflower	human
@kohshinyi	human
@PhietShum	org
@Gourmet_Goat	org
@imacwalker	human
@Alltidrodvitt	human
@julianinieves	human
@alex_y_vergara	org
@SaltAirVenice	human
@CharlesAustin21	unknown
@YeeiideeBiebs	human
@sartoreality	human
@EliDaPrince5	human
@healthyneda	human
@CJVerone	human
@eddsuha	human
@johnnyspizza	org
@thcint	org
@WhatAtlantaEats	human
@dhowe321	org
@karma_karma0110	unknown
@PburghProud	human
@jamie2258	human
@atHOMEwithJOY	human
@05Yonash	unknown
@KosherVillas	org
@Davjlan	unknown
@ocaroline94	human
@SdotKdotS	human
@DJaLLoUTpACo	human
@Niademe	unknown
@DelarosaMalcom	unknown
@inspnutr	org
@ISavoy	human
@AlbertsonsCO	unknown
@gweniiegwen	unknown
@CT_BallHawk	human
@solahgatei	human
@PizzaVetriPHL	unknown
@leunglambs	human
@CirenzSonG	human
@FranciscaaaaP	human
@noraaeel	human
@davetheubergeek	org
@biancamille18	human
@GemmaLian1	human
@elisamariapilar	human
@NightLifeinA2	unknown
@heather_bbc	human
@Naviss2101	human
@pollenandgrace	human
@BecauseGustave	unknown
@StarHotel_WV	human
@RealDietitian	human
@sarasu0527	human
@ronmanjarres	human
@Artigiano_QS	unknown
@PrimeroEdge	human
@pasticcerialice	human
@PDIDDY80	org
@HannieRae	human
@micaang	human
@faisalnemo	human
@Ean0708	human
@simonebernhard	human
@facebookguide2	human
@TheRazor_Queen	org
@BbTa_news	org
@SaskiavanOmmen	org
@Estefaniareyesn	human
@LoveLifeAcky	human
@honeykerren	human
@idiNk0zo	unknown
@za3franwvanilla	human
@thekitchen	human
@according2eva	human
@health4life8	unknown
@SaraMariaBessa	unknown
@EmmaBrazier1	human
@Weavers4Fitness	human
@Top5_BOT	human
@Elle_Milan	org
@PictureRest	human
@openkitchenfood	human
@WayfairUK	org
@danireich	human
@NJtheQueen	human
@DidsburyLounge	org
@Thoughtsnviews	human
@resultsin45mins	human
@Chantal001	human
@EvellynBaxter	human
@paulcuzcurry	human
@hysha1110	human
@inouenyamo	unknown
@kyutiekyuu	human
@MIKAAtniss	unknown
@_devaughn_	human
@megustabutter	human
@quezleong	human
@ManifestoCafe	org
@exerciseangels	human
@GraceRoces	human
@jengontherocks	unknown
@AspectBar	org
@edoc67	human
@SmurfLabi	unknown
@Tarahammett	human
@kouzurestaurant	org
@rawtillsept	human
@cchecastillo	unknown
@NatytaEscudero	human
@WongAhhBee	human
@Jane_YSY	human
@_sugarcats	unknown
@Kezkez_Liap	human
@QPPartnership	org
@SlimTrimThin	unknown
@lucyros88907907	human
@Jon_Hassall	org
@cherylmarquez	human
@tqas_shah	org
@May0058	human
@Dest_True_Self	unknown
@FashionPM	human
@lachicadelaciud	human
@hanwitwicky	human
@Viioletcrush	human
@satomisfridge	org
@marcossudvarg	human
@camgould	human
@SabihaBelyouha	human
@la_racha_blog	human
@divasparkle	org
@aimi0218justin	human
@Asya_Star_1	human
@m_zakrzewski88	human
@AChance_of_Rain	human
@Lacuocaerrante	human
@TinaMnM	human
@Harmonikk_Abyss	org
@ChartwellsK12	human
@chefchowblog	org
@KenzieFernandez	human
@MaferBellido	human
@roottohealth	org
@tonicandremedy	org
@BOURBONSTEAKLA	human
@vrageous	human
@AlexaTowersey	human
@GlossNRoses	human
@AngelaMcGill	human
@Joannarosess	human
@RedcastleHotel	human
@Monchosbcn	human
@SazKill	human
@bisttt	org
@KelseaHamilton	human
@aiqaqhaleeda	human
@Brunosca	human
@complimenti_	human
@JoanneMMiller	human
@i_am_kuishinbo	unknown
@methereckless	human
@SkooPants	human
@pecora2011	human
@iAhmed77	human
@Jeanne91	human
@dieylaaaa	human
@shaunnahall90	human
@thizzdell_jr	org
@CCommunity	org
@hana_pinontoan	org
@sarah4c	human
@thedocndiva	human
@MPerformanceFit	human
@PeterEMatthews	human
@PlaymateBilly	human
@BastienPoulain	human
@ChicHealth1	human
@sophie_garrett	unknown
@mark_king1	human
@MYlecordonbleu	unknown
@HeyAnnabay	human
@Akvaristan	org
@Ohh_CHINito	human
@Chepsuey	human
@Qdmixedmami	human
@McSnackerton	human
@QueHerself	human
@bahyam	unknown
@CHerii_BombB	human
@PedroLuevano	human
@deshpandeji	human
@Miyasuma	human
@mamiact	org
@yoshi44masa	human
@elovatiamora	human
@OrganicsBakery	human
@BlissfulBeatric	human
@m_7418	human
@MaudePurdy	unknown
@RainbowRM	unknown
@dotluxurytld	org
@PartridgesSW7	org
@RecipesClub	org
@Wallysturtle	human
@BigMouthLV	human
@grassrootsvegan	unknown
@merilandia92	human
@TiffanySage__	human
@CASMF	human
@raffyabad	human
@instacollective	human
@HappyfoodHeleen	human
@RedWine4Me2	human
@chomu_0130	human
@latheluvable	human
@devainyou	human
@lisafirdaus	human
@jgboghos	unknown
@hvarcegovac	unknown
@floralxgiraffe	human
@xxx_jocs	human
@Nabillaandi	human
@sabriinnaa1	human
@1961_502	human
@On_The_RocksZA	org
@MonicaKade	human
@Kojika_x_banbi	human
@yellow4ranger	human
@TiffanyPonce	human
@AnaGorgeous	human
@uciedasasuke	unknown
@elpocerocolorao	human
@stefansi	human
@Violet_1297	human
@ford3512011	human
@TheVojanBNG	org
@RedFinCrudo	org
@loff_it	human
@carlo_bersamira	unknown
@AmyFergen	human
@dragongirl888	human
@gscolamiero_93	human
@ChiChopShop	org
@ktflower78	human
@glukats	human
@DJMieTamai	org
@gonyisland	human
@ChenyuChuang	human
@ashsappetite	human
@Mission2goal	human
@bluebox81	unknown
@cclip_710	human
@AzizUlWahab	human
@adoptedSTYLE	human
@tuzjanna	human
@chadj20154	human
@StarlaShin	human
@CDENLZ	human
@1_hottcommodity	human
@BLACKCHyNADOLL5	unknown
@Ofertadehoyrd	unknown
@rosa_marbella	unknown
@cholopadua	human
@jayr_7582	org
@slantedk	human
@zsofaa	human
@scardys1	human
@RecklessEverett	human
@Cafe_Lift	org
@Albeandre	human
@Sofi_Cafe	org
@YvesAngelo	human
@monicanicnique	human
@Pookum2x	human
@AndresGarciaPH	human
@cangork	human
@Cunningly_Me	human
@kotone_57	human
@ELENACERESA1	human
@mdcdski	human
@PipsRowney	human
@27SeventyFive	human
@ESeattleMama	human
@remondi	human
@ymn79	unknown
@omfgitsMiiia	human
@eva_angelynn	human
@alythmccormack	human
@iamrissoledadv	unknown
@kimooooeka	human
@TomoyaMorishita	human
@melux1981	human
@ELDJVITUS	human
@TheAppBusiness	org
@ypkn11	human
@Longstroke_Keko	org
@WendyWeb21	human
@SMalawiya	human
@IAmLeilaGold	human
@Cynantia	human
@laiaXxX	unknown
@stmita	human
@abbiethong	human
@goodeats365	human
@dgreeny85	org
@stefanmathez	human
@OWHBottomLine	human
@julia_freckles	unknown
@jerseychef13	human
@Spoon_Ha	org
@NeuvooOmaha	unknown
@bloodmuffin12	human
@lhutch64	human
@ichigotubu15	human
@MindyBotel	human
@_KMichelle	org
@ShawnGeeNYC	human
@AnisBonnie	human
@NorthantsREC	org
@M_ALeona	unknown
@WallflowerNYC	org
@WoW_Bromley	org
@adictikworld	human
@VoodooEntUK	org
@digellabakes	human
@rishlobee13	unknown
@EnochHenry	unknown
@SMELyoness	org
@aleeexguzman	human
@Tessemaes	org
@iBeepU	unknown
@MachoBistro	org
@OSwftWlkr	human
@themissjuelz	human
@JackieinParis	human
@Sweet1985Jewels	human
@nathali1610	org
@homerleal	human
@eseemebe	human
@JolandaDaThesta	human
@kmcorder	human
@XRowDeeps	human
@zoehollister	unknown
@torii321	human
@TheWineStalker	human
@EdibleIndy	org
@BrittMorenoTV	human
@sdwyatt	human
@FLPGQD	human
@mohdiman13	human
@GoddessJulie41	human
@Chantier_Tokyo	human
@iambidduraj	human
@lynneherlynPPAX	human
@ReaLR2Tu	unknown
@ThitibhonRU	human
@CafeDeParisN	human
@Jblaze69G	human
@TamSumsum	human
@NHC_OFICIAL	unknown
@MoreThanMayo	human
@ost0112	human
@letscookingbook	human
@jessicatbyrne	human
@BritBriann	unknown
@ElPulpoPaulBaq	human
@MR_COLD_HEART	human
@vtran814	org
@AijaGreen	human
@maisonapois	human
@bettysbanter	human
@perkings	human
@krisclarkhd	human
@Fofa_xx	human
@Shanjoygulle	org
@Asian_Foodie	org
@According2Joy	org
@YogReport	human
@davidherubel	human
@Hortonix77	human
@sebastianscala	human
@SaORi_aRahiHciM	human
@Smiletable1212	human
@getSimpliFit	human
@mhonric	human
@Edcalles	human
@Breezwrld	human
@elysplanet	human
@mykyouichi	org
@PaulKindersley	human
@freshenupdetox	human
@catpy	unknown
@ramsesnababan	human
@LasSocialesTwit	human
@LynGinelsa	human
@Hungrybellythai	org
@wonderyinci	human
@SolMadruga	human
@vnotebistro	org
@lovelywifeblog	unknown
@timdavidurl	human
@Lokoz_Star	human
@kgdigfdfsg	human
@ryousuke610816	unknown
@siscasubakti	human
@threez	org
@jesseniagc	human
@RUTHYOG	human
@squarelakedeli	human
@owned_dog	human
@juhasztallcorn	human
@Luv_ologist	org
@TheBongHandle	human
@FayBrillantes	human
@ntkanit	org
@kathlouise	human
@Kod2Laturk	human
@karladiazOF	human
@Twistcatering	human
@harvestupenn	unknown
@J_Amani	human
@EcoEmo96	human
@chocolatteA2	human
@sebnemkaya	human
@otishuff	human
@TaleThief	human
@MikeHinton4	org
@JusticeJonesie	human
@Lucydegxx	human
@IriiLuna	human
@jacksenmenardi	human
@Chezz_Gerdi	org
@eatdimestore	org
@mitKnorrfit	human
@BigGirlBigMouth	human
@haydenkitchen1	org
@SerenaJojo	human
@sunnywendy09	human
@katiesolan	human
@Natra_Anuar	unknown
@dmcgee604	human
@WholeFoodsATX	org
@30ishStylist	human
@Lygonz	human
@georggie1	human
@runningforacur1	human
@HerrEllie	human
@saadarshadd	human
@Samifarooqi	human
@kinoyblog	org
@Restucz	human
@SheWolfMemoirs	human
@StoneHearthNews	human
@AmpersandHotel	human
@Reesie_TBird	org
@katieannbernal	unknown
@jawnerz	human
@babyrockmyday	org
@___aino	human
@Babylon13069202	org
@modagami	human
@MarissaISA	org
@GrillLegends	human
@nash_29	human
@elenimast	org
@AuntAnoud	unknown
@ArMalinelli	org
@MzMarie1988	human
@tabbycarter	human
@AnastasDenisova	human
@L3it0	human
@micahgordoncx79	human
@lindaguerrerogo	unknown
@JLindleyAgustin	unknown
@Egaabbii	org
@LeDeliceE17	org
@kokoadii	unknown
@takieaa	human
@NapoliStyleit	human
@GarcelleB	human
@ArielHunt1	human
@MisterBeardWash	org
@ChelsGorczyca	org
@RealNoisyBoy	unknown
@nathasyanoveria	human
@_Anooooo	human
@GAMusana	org
@kinkykiddo	unknown
@kim_kym92	org
@YowDondon	unknown
@patriziakayla	human
@Aamir_74	unknown
@ChocoBeel	human
@accohen	human
@TheMiniPost	org
@vikhyprasetya	human
@ReymondComms	human
@Greeenguy111	human
@VictorBayma	human
@G__DESIGN__OWN	unknown
@KevinEzequiel07	human
@leglaryn	human
@anime_xkIZ9	unknown
@TK1219_SWIM	unknown
@dimaxblog	human
@WheelgatePark	human
@Jeanikee	human
@AB_sexpistol	human
@itgmilk	human
@SolvoReputo_1	human
@HairMistress_	human
@Creo_en_my	human
@n_e_j_k_o	org
@StyleUp85	human
@lil_x1988	human
@tallguyandgrill	org
@HomeTime_app	org
@TTNLondon	human
@Pablo_88	org
@SIMAGMUSIC	unknown
@qing_arch	human
@LoudLooks4U	human
@LegendaryWriter	human
@miera_aqeela	human
@andika_ariff	human
@fercuria	human
@tag1110s	human
@SullivansPubRI	human
@adelacar95	human
@ClaudiaBeeston	human
@same0n	human
@Jfresh704	unknown
@Sergijasanada	human
@Sara7978	human
@BevHillsFarmer	org
@candy_weiss	human
@Chrisdeloatch	org
@VSyaKim	human
@jpdn	human
@SaintMumma79	unknown
@chifafa	org
@amable94	human
@l__pi	unknown
@TheMeatCoBH	org
@dhaniyahya	human
@lolywowecoq	human
@DJNICKKKK	human
@N2312Neagoe	human
@MGhorseracing	unknown
@LakendraSorescu	human
@originalpresto	human
@mi_momo0724	org
@amyboox	org
@Its_BeeIsMe	human
@OrchardsH	org
@emperormenay	human
@IllusionaireS	org
@abobryan	human
@adwa_afiq	human
@Cadrian_Mg	human
@UnitedJuice	human
@BienBowieCortez	human
@BrannonVeronica	human
@whirlygirl72	human
@Shiv_KumarSMO	unknown
@stylecontext	human
@JubileeMarket1	human
@MutashimNazhif	unknown
@kelcieskreation	human
@OConnors2014	org
@darklosser	unknown
@Brittany_Mason	human
@AuroraGR	human
@art_of_abstract	human
@haikili	unknown
@hansy_k	human
@cristy_reyes	unknown
@JT_L0VE	org
@alxlifestyle	org
@IreeneVany	human
@julyotan	unknown
@nattalvr	human
@ademarina	human
@barbarazaminato	human
@MoniqueBTheWMP	human
@quatrofromaggio	human
@missteenussr	human
@Cheese_Boutique	org
@mkh917	human
@kkugelmann	human
@Ditchthe_	human
@Absigelly	org
@queennoreen	org
@RedBlurr	org
@IWTheHealthyWay	unknown
@KBlackeagle1	human
@WinoMcFarlane	human
@HealthGlam_Sam	unknown
@BehindSeams	human
@EleonoraSorato	human
@cilchen	human
@onle1Sha	human
@angiemiret	human
@BelgianWaffleIn	org
@Banani9679	human
@mathiaservyn	org
@frecklednettles	human
@jtcordero90	human
@vertuguy	human
@ronaldandrianto	human
@bandung_yummy	org
@ReformedFatgirl	human
@eduaguilera16	human
@jimjitsu13	unknown
@CaraMia7381	unknown
@Sukito_San	human
@itsmeKATring	human
@roguesnbrogues	human
@AimeeFleckArt	human
@JollyLao	human
@ewarren85	human
@StarLanes	unknown
@blburg	human
@sisb_omnipeople	org
@NARUMI0815qb	human
@itscorklike	human
@CyberKitti	human
@TOfoodandwine	human
@gabrielagironq	human
@mariacrescini	human
@Scott1984_FP	human
@malucodan	org
@hiro_hk_627	unknown
@katieallstars	human
@Kiss_Fitt	org
@TheCandiceM	human
@NewYorkcom	human
@bieber4lifes	unknown
@AnDyRamiro36	human
@dabulTONE	org
@thehouseofmia	unknown
@haziqkiwi	human
@rothbarandgrill	human
@NoBeefWithYou	org
@bipolarfetish	unknown
@GKArmstrong92	human
@Marina_Ilona	human
@gillett_wayne	org
@EmmaculateMusic	human
@JamCanSing	human
@paulcolaci	human
@HeatherLesz	human
@wandreyph	org
@Nanito222	human
@Ms_Monica_Keyon	unknown
@matteblackmandy	unknown
@AnnetteInVan	unknown
@CheerleaderGril	human
@ramseur	human
@toasted2go	human
@_luciagrace	human
@Faisal_69_Ali	unknown
@freyja_axazael	human
@FoodRascal	org
@iB_Monet	human
@SrDrYpN	human
@RoseEnriquez	unknown
@SaintOnix	human
@MaCheyenne	human
@Chris_Collins33	human
@OrganicLiving_	unknown
@_ClaraPicard	human
@almarWho	human
@AromiRestaurant	org
@EthanhTakamine	unknown
@JulianaDaniella	human
@adibkhld	org
@itsmeRoRo	human
@KarlaSammut	human
@PerrysCafeLA	org
@don__datos	human
@BuliMazwi	human
@Gabby_09	human
@Sonmezerr	unknown
@TrimmingTheFat	unknown
@kaizerk808	org
@mistakingz28	human
@siwel89	human
@ToriTornado1	human
@SasaAlegria	human
@Superpyjamagirl	unknown
@cindyvdgraaf	human
@KurantNYC	org
@MyIcing	human
@TeuzMusic	human
@mochakittykat	human
@1226kdv	human
@miamaiami66	human
@nytak	human
@MowdifiedKIMMI	unknown
@JoSanlleyH	unknown
@chinarosemarie	human
@alhyunki	unknown
@idahocafe	human
@ChriszyEvers	org
@soupspicenice	org
@AQRestaurant_SF	org
@EHamdallah	human
@Basstoune	unknown
@iamerick21	human
@daskochrezept	human
@GLAMazonianASH	human
@ieatistay	org
@TourettesTapir	human
@DBrunchClub	org
@mrtlpz	human
@MoreBitzofMe	human
@woohoo4sa	human
@TheWineShrine	human
@iamunique_18	unknown
@farmerleejones	human
@kt0011jp	human
@alfredchan83	human
@thirzamaulita	human
@kwsof	human
@missradhikaj	human
@Russell_Writer	human
@MugShotUK	org
@Les_Oliva	unknown
@MilanoCard	org
@SunniAndTheCity	human
@SnactNow	org
@chibaryuichi	human
@pamecoto_	unknown
@wiing_jiian	human
@love_est_	human
@marcelmiranda	human
@FineDineLove	org
@ShayaWeinberger	human
@PabloxkyxD	human
@chacha_ndudz	human
@jaycrisologo	human
@GtFitWChristina	human
@MakeupbyMikey	org
@modcommonplace	human
@herefordandyork	org
@minumminummy	human
@WillieDegel	human
@kaosuaylunla	human
@sailingdh	org
@Kingslay10	human
@MzTrice30	human
@TheMillingRoom	human
@BallinasloeGirl	human
@MaroliSebastian	human
@Threadsoffriend	org
@selinalang	human
@SanTanBrewing	org
@MarriottMB	org
@150cm_view	org
@MicuPerez	human
@martooner	human
@kehri_behri	org
@LimJustina	human
@faery_kate	org
@thetinroof2	org
@IanMakay	unknown
@Battrisyia	human
@cattwing	human
@michybee_	unknown
@TheLodgeBuffalo	org
@deeppink	human
@judieannabbot	human
@fOoNg_PeNg	human
@InsideOAbout	human
@BRolla	human
@Travis_H_Brown	human
@gluttonlv	org
@longfellowgrill	org
@DawnsTube	human
@izaan_syazreen	human
@YoumnaSherry	org
@soultravelers3	org
@adnmstk	human
@IAmGatlin	org
@WongPhoenix	human
@ReySaBopp	human
@crisyanjr	human
@DYpaolaDY	unknown
@GlenfordFarms	org
@HidayatSofi	human
@JFORGES22	human
@BestofTampaBay	org
@Globdules	human
@haitu1	org
@thomasmjcheng	human
@pizzaville	org
@Diner248PA	org
@LadyChaChar	human
@OlivoGroup	human
@Rudy_Ibarra	human
@briller13	human
@KetteringPark	org
@daysj95	org
@BlackDivaPty	unknown
@MadisonsResto	org
@JW_Steakhouse	human
@mary_rea	human
@SherilynNee	human
@fendyzachariey	human
@swtykhm	human
@Be_TN	org
@EnjoyPandy	human
@C_zzle	org
@GChrysson	org
@MeapodanPato	human
@LoveMyDressBlog	human
@freckledmamma	unknown
@KillerTacosHI	org
@RedBeeMarina	unknown
@concordedoha	org
@MetClubChicago	org
@AllWriteNannyLA	unknown
@13MatTaylor	human
@JabbarCash	org
@ToBeThode	human
@goldbely	org
@NinaCastillo891	human
@Adanette	org
@carltonfarms	human
@DagmarEcu	human
@myshrks	human
@dorukhankaraca	human
@PrinceYoungRuwi	human
@lulitalpda	human
@ladyluck8987	human
@PattieCordova	human
@CGuilhermeAz	human
@RiseMindBody	human
@lamaisondusteak	org
@no_jami	human
@19Sty	human
@Klove20102010	org
@greenseeker1	human
@rionlin	org
@jody_jacobs	human
@Tech_Boss	human
@essyadinda	human
@haroon_gul	human
@ANNAdventurous	human
@lifelovingblog	human
@nickyzena13	human
@makilingmiracle	human
@ddcosmetics	human
@adot2009	human
@ElsieCalo	human
@mana1211	org
@anita_gs91	unknown
@CrystalUnique	human
@MareAntelo	org
@Nixdo_EN	org
@lucadeil	human
@nawako_kakko	human
@alexiseunice	human
@SoundsmithMPLS	human
@PastaFlyer	org
@DrRenee	human
@FitGinny	human
@OutDoLife	org
@Swissotel_SKO	human
@HimeSoph	human
@amirdiana88	unknown
@AnnaCobain1	human
@kumarayush4ever	human
@girlintheknow03	human
@SassW0191	unknown
@Airelive_	human
@RelishEventsUK	org
@ChelanFresh	org
@MyFairVegan	org
@HotelPullmanRos	org
@3DDLT	human
@Gudifo79Mega	unknown
@TINGnovbaby	org
@PamTejeda	human
@dbvernon	human
@HeartofDeborah	human
@Momofuku15	unknown
@_AnnahRose	human
@RobGreyling	human
@cafe64MN	org
@IamBabylys	human
@Tracey_woodward	human
@itsmesakura03	unknown
@arashmoallemi	org
@RG_coffeeshop	human
@Booyah02	unknown
@CesmatCody	human
@happylamby	human
@jankliciouz	unknown
@Melissa_in_NC	human
@Dollygirlfash	org
@CaptnMmh	human
@Birgitta_R	human
@LavanderiaResto	org
@kunjedsada	human
@PauuMeloJB	unknown
@martinpitw	human
@COMPYPIE	unknown
@NK_pinkyaya	human
@ogamix	human
@PESHerbalife	org
@amandajchan	human
@Sine67	human
@rizwansaleem_	human
@catolreis	human
@x3hoppie	human
@kylah_eide	unknown
@ElifKaracaoglu	human
@TFBSteak	human
@MaryjosePA	human
@sweeeetooth	unknown
@KelsiVesca	human
@Reynardg	org
@CypressHQ	unknown
@CharliiRose	human
@LovebySabi	human
@Kunares	human
@StonyBrookOils	org
@windog	human
@discirate	human
@leofoltran	human
@Londonbeachspa	org
@J_RockThe_Dog	org
@ALCastroverde	human
@SandyNWilson	human
@Johrten	human
@NinaCuccari	human
@bubblyluchz	human
@CuriousKafe	org
@Marci_Anto	human
@tipnow1	org
@StarBaby_21	human
@ionaberdeen	org
@kathygreg93	human
@MandyMJK	human
@Nashville_food	org
@melsykesjr	human
@EllyseSalter_	human
@ilsolitomenu	human
@Chryltn	human
@KristiLarsonVNL	human
@_crongchan	unknown
@UKWildcatGirl08	unknown
@AzwanKimori	unknown
@Steakout_UK	org
@FishOutofMalbec	human
@one18empire	org
@HotelEmeraldNBO	org
@TrisyaAzahar	human
@SooEpiccc	human
@ponorit	human
@ElijahSykes	human
@SalmanAAlsaby	human
@Sublahoi	org
@LM_Piccadilly	org
@DoctorSalad	org
@ricardoch16	human
@marciaJ1991	human
@Paulimlopez	human
@Littleleafshop	human
@albertsandtv	human
@veggiealien	human
@robsonrosaa	human
@rinnyassyifamar	human
@paulvitagliano	human
@kattyr3	human
@nahoreon1124	unknown
@stolenandstray	org
@MetromixCHI	org
@oninjordan	human
@leeuniforms	org
@HarvestSoul	org
@brandonv92	unknown
@PrinzeCharmingJ	human
@RealCuteCoconut	human
@hamiltonrobert	human
@iscariot	human
@Dellaterrapgh	org
@onegroovy_chick	human
@SarahPayne55	human
@deneuvienne	human
@Ashukar	human
@johnnyfreebooze	human
@Dado54London	org
@shortorderla	unknown
@OMGitsScottyB	unknown
@gwennwright	human
@nork_11	human
@MsKathy0724	human
@aringursoy	human
@ShoppingBid	human
@Eve1D0201	human
@JojoeFLy	human
@Hayley11Shannon	human
@jadedmagnolias	human
@KaylieLynnAZ	human
@IAmPmob	human
@hward888	unknown
@soyo4351	human
@qttbean	human
@RafaelOteroA	human
@sleepingchrissy	human
@csramachandran	human
@laurence1989	org
@neishamr	human
@estelle_couture	human
@KrisErris	human
@024Maris	human
@grishmaurya	unknown
@sunshynehs	human
@perleandrio	human
@jiji973	human
@dudewalsh	human
@kumasanw2	unknown
@FerrareziL	human
@taulukos	org
@nidaon	human
@uhojLien	human
@DmitryMStarks	human
@SDHomeTheater	human
@Andrew_Daniele	human
@Co_005	human
@VickyyZhao	human
@AmyrulSaid	human
@DovetailNY	org
@Kira_T	human
@BawiBride	human
@LeungComsa	unknown
@kingofcanadajj	human
@hotforwords	human
@therunnymede	org
@cchicki	org
@cafeklatsch	org
@855Sheller	human
@chijaek	human
@iWork4UGlos	human
@ravon65	human
@fotograaf	human
@skeekies	human
@BarbiRiccitelli	human
@Fleetstreetfood	org
@beemoreartistic	human
@jesskazen	human
@kimtarohesti	human
@RobMarsh82	human
@ilector	human
@PetsBreeds2	human
@fakuhvillegas	human
@Dreameronline95	org
@RezanDenizmen	human
@Im_DeDe	human
@AnieGarciaa	human
@VisitLancashire	org
@pjonlas	human
@WendAddictRED	human
@Yoshitaka_B_2C	human
@ChammingT	org
@MAMENCOMUNICA	human
@Pandaa_Tan	human
@BrittanyHGale	human
@BentleySoBe	org
@ICmedonline	human
@TheCultureur	human
@labbaquino	human
@feranadilah94	human
@EggShopNYC	human
@TangySorbet	human
@Missuptan	human
@PureLifeForYou	human
@madalenav	human
@MarvelousMason	unknown
@x_princessdeej	unknown
@jjallenjr	human
@ChelseaHaskins	unknown
@scandinavianbld	human
@EggsMcManus	org
@vickiemeiqi	human
@raddincake	human
@OptimalCells	human
@seoulsociety_	human
@aliwatson117	human
@ArcherBrighton	human
@urbanperspectiv	human
@Jenifer_lwy13	human
@fashclicks	org
@rheen_	human
@ShidaAyob	unknown
@peteZAAZ	org
@girlyyoung11	human
@NiNeNsUyA	human
@peri_mom	unknown
@thisaaronmsfood	human
@iGottaTravel	human
@cedceballos	human
@TravelFoto	human
@felmarut	human
@janefebrian	human
@handance88	human
@DinnerWarehouse	human
@ArdhiEndorse	human
@BreeBiancaHill	human
@SabrinaGafken	human
@haloKT	human
@jfeilbach	human
@HealthyPassion1	unknown
@anastasi60	human
@KubbyKendal	human
@Jaydamon1	human
@Eatdrinkdezign	org
@che_nieves	unknown
@nus318	human
@foylejobs	unknown
@HarbourBridgeCT	org
@Annelienne	human
@natashAmusing	unknown
@MMowgali	human
@PTPA	org
@chasingwonders	unknown
@besaqib	org
@TexasMedClinic	org
@FairmontMtKenya	org
@jasonparker06	human
@felix_wegener	human
@kcolraw	human
@_Oanh	human
@MirdieBird	human
@ajcolcol	human
@FashionableEats	human
@ChocolatewGrace	human
@jinkouben	human
@greyPSYCHo	human
@ChefAntonioPark	human
@Melanyb12	human
@Aldydmt	human
@HappsHealthHome	org
@andykho	human
@maferlabe	human
@ChangingVases	human
@champtheartist	human
@KatyVestal18	org
@gamargaretha	human
@callmerosey	human
@elainegotauco	human
@desiresjq58	human
@comocomecami	human
@Jeffreykyk1994	unknown
@em_bby_	human
@Narushima_ryu	human
@AbbyAbbie24	org
@RiversEdgeFan	human
@MissSashBuble	unknown
@anton_31	org
@iBen_kO	human
@HomhuanSuppawit	human
@djmac_nificent_	human
@anikettherockma	human
@wira_tjahjadi	org
@kirstyloveday	human
@Dameon_Macleod	human
@ZiadAbbout	org
@bing_har	human
@Ottoman3bar	unknown
@soniavss	unknown
@xsakura3	org
@Abrawib	human
@yunanerrs	human
@LyricGirl01	human
@Jaymacafe25	human
@verolynne	human
@lipgloss2blush	unknown
@RoseTintedLani	human
@chefjoshuasmith	human
@KarenPJ	human
@Follower2God	org
@FamilyInSpain	human
@shoutabyss	org
@receitasdecozin	human
@FreyaChild	human
@Seif_24	human
@aedopontoan	human
@LieCia	human
@HIGHxHAND	human
@innocentpixie85	human
@avillagefarm	org
@boulan41	human
@TheFoodCartel	human
@LastChild1986	human
@101creditcard	org
@Oficial_DyS	human
@LeonElse	human
@sfjoge1	human
@chefcalvin1	human
@EAosher	human
@patogiacomino	human
@IHZ94	unknown
@haaiqaaljumat	unknown
@ShaneyKay_93	human
@sindyhira	human
@connectedcloths	human
@KSomrat	human
@VikingProducer	human
@gulsahlar	human
@fashionbyidag	human
@LDimbers81	human
@hoteltravelsolo	unknown
@TheBasqueMarket	org
@PeterCornelius_	unknown
@jamarfreeze	org
@kasumyung	human
@XiiaoWaii	human
@miznelliebellie	human
@GothamTrotter	org
@urban_cavewoman	org
@foodtrucksaz	org
@meggartland	human
@janeImvip	human
@1kuteblaqchik	human
@HighBuddy	human
@digzsygirl	human
@Welshfoods	org
@white_senses	human
@CJStoneMusic	human
@TvFoodAndDrink	human
@tingting_hu	human
@alesananda	human
@BarbaraaCaro	human
@Trish_Dawson	human
@BFG_News	human
@myfitnessdiary2	human
@FitSaleh	human
@sisterscap	human
@sandeeyw	human
@RhubarbAVL	org
@JMerzades	unknown
@MaribelH_SP	org
@lalalareina	human
@thewickednoodle	org
@asus980	unknown
@neytella	human
@picpicmee	human
@carris_lee96	human
@athletefood	org
@T_Stan	unknown
@ChompingGround	org
@PiFoodStore	unknown
@Lamittafrangie	human
@HaziqMerican	human
@tomcassas7	human
@HANGARtaste	org
@CarinaYoloSwag	human
@martiistanbul	human
@__vharrison	unknown
@VivienneCafe	human
@catholicfanatic	human
@AcentosCafeBar	org
@Annsolaf	human
@SueHanna_	human
@greteminumets	human
@sabarrios	human
@ErSEA_SHIPsCo	human
@GoGreen_SV	human
@Tim23Moskal	unknown
@YoSoyMattyB	org
@bEibihVie	unknown
@wirexter	unknown
@Ayy36	human
@topcatbecks	human
@NatCaparroz	human
@arefiq_luqman	human
@Kathleencbee	human
@GustavoArellano	human
@yazmier05	human
@FCGTCG	human
@MLoParis	human
@ETLCblog	org
@j_promos	human
@samdanguilan	human
@Preachas_Wife	human
@AfricaN0419	org
@nputri_407	human
@tevitalianstyle	human
@YanaGrosul	unknown
@Canli_Maclar	unknown
@madddywin	unknown
@amesekrani	human
@ArticulatedLife	human
@jayelterrible01	human
@koloysova	human
@rich527	human
@sophianue	human
@emmyjayb	org
@mfa_s12	org
@bangkitawang_	human
@SnapsofMyCloset	human
@ianmccray	human
@SashkaBukashk	human
@kriziosa	org
@RapJuggernaut	human
@RtsEgy	org
@Nicolino_Love	human
@7_Alive	human
@Shendy_86	human
@LinggaHotel	org
@MaVeronD	human
@mannahousebaker	org
@AKSHRAJJODHA	org
@Mercia_Voorkop	unknown
@B24_Lounge	org
@Mani_Kinoshita	human
@MissCortez100	unknown
@WrapLifestyle	human
@liu_yufei	human
@dolphinkrishna	human
@SabrinaTassini	human
@LaRucheMumbai	human
@Flip_X696	human
@VisionaryIAN	human
@macnmomorsels	human
@dbubis	human
@TheAdamson127	org
@Maykmahman	org
@styleweeklyaus	human
@standbyghost	unknown
@IntelyDine	human
@Anglers_TW11	org
@Fightingfit4fun	human
@SantanaRaes	unknown
@Hotel_Laguna	human
@StevieT65	org
@TheScotchGirl	human
@CelticCoveSA	org
@norima_13	human
@globol10	human
@eiiloiiza	human
@takeofthetiek	human
@htt11	human
@saaasbo	human
@umef_unepos52	unknown
@MMusikerRD	human
@KuraraSaegusa	unknown
@NYMediaWorks	org
@DeniseDoeve	human
@annaberga97	human
@BethanieMaguire	human
@DjElixx	unknown
@Dine2Find	org
@beachbodysuzy	unknown
@ShelbyAnnG9	human
@Comptoir102	org
@BikiniBridgeXXX	human
@laiyee23	unknown
@candantopdemir1	human
@icandytog	org
@FHSfreebies	human
@SamCannellcom	human
@MichLx0	unknown
@LynetteBenner	unknown
@laclabichenow	org
@NeuvooOceansid	org
@surreystreatery	org
@AntonioMoralesB	human
@diabeticFoodie	human
@DjLuger	human
@RichardB11_	unknown
@1991Veklenko	unknown
@KPossible7	human
@peasfortwo	human
@Julitorelax	unknown
@maria_fpr	unknown
@syaheera90	unknown
@LolaClover	human
@PizzaHutLebanon	org
@browniesoutbox	org
@ViennieV	org
@Otepry	human
@Hippossina	human
@themoms	org
@EaSteffes	human
@Tejas_Tacos	org
@macescolin_	human
@Pyoguez	human
@aikititay	human
@JessAbran	human
@NicoleHintFLY	human
@ikatirrr94	human
@BigBootyJudy814	human
@bronzeyourbody	org
@TastyVixens	unknown
@JorgeLPosada	human
@JosephMoyet	human
@thymeoutfoodco	org
@msjennalhuiller	org
@Sofosfobuvir	unknown
@mizz_xlelex	human
@CaptainCian	human
@bunnymsm97	human
@garrettcecchini	unknown
@lizliv_	human
@BrainiacRodent	unknown
@fazilfadil	unknown
@NourArjaan	org
@ogawachieco	human
@iamtwiza	human
@yuu6114	human
@Makeupmonologs	human
@PinkSkymagazine	human
@mizzsassyjazzy	human
@mrsroebling	human
@isolatediguana	org
@ZeynepSekban	human
@XoStasiiXo	org
@JocyDayana	human
@Angel_Njh	unknown
@Belberry	org
@VenenoSandoval	org
@shareSocialMail	org
@karasilverman	human
@DamnSheCluelexx	human
@ALCOSales	org
@DanCOOK_	human
@tjdeluca	human
@florianroser	human
@zoeternijen	human
@David_10495	human
@YULANDAJONES	human
@GinxMinty	human
@mffayne	human
@Clean_Seoul	human
@GenesisInsSvcs	org
@chiputchan	org
@rexhame317	human
@riskan	human
@x_x____empty	unknown
@GPlumb27	human
@iamTineKArtiaga	human
@AlanRRust	human
@cassandrasaxton	unknown
@slotcandy	human
@Emily_Pinfield	unknown
@Leedalton1	human
@GrubRestaurant	org
@HBOats	org
@latin283girl	human
@Jeanette199	human
@gloryofindiaca	org
@OneLastSurvivor	human
@stephaniee0327	human
@surabhi_lal	org
@CharlotteHMacy	org
@worldwide2014	unknown
@DelRayPizzeria	org
@febnjane86	unknown
@MarsupialBernie	unknown
@sdeyoung	human
@dtjrealmc	human
@KeanuLopezD	human
@WSouthernBreeze	human
@StillClickaz	org
@princepaulpage	human
@Fede_says	human
@CaptainBCN	unknown
@FrancesCottrell	human
@RachaelBooth16	human
@KDDinCLE	human
@LeeSutton4	human
@AliceStyleDiary	human
@HiteLabelle	unknown
@AstyPurba	human
@clarestokes65	human
@bralitzbemey	human
@vydevie	unknown
@JogjaBersama	org
@vinomofo	org
@WestChico	human
@candyweir	human
@heerlijkcafe	human
@tmgraphicsllc	human
@MissMaisieBaby	human
@fitnessangelf	human
@conclavebog	org
@timcanpipi	human
@Creepshow2000	human
@wentrz	human
@leiram09	unknown
@Hogspy	org
@Panierdesaison	human
@tragiccouturist	human
@Lucy_Gemma	human
@OpenTable_SF	org
@TigerBeerUS	org
@EmeryRee	human
@DrArnoldFran	human
@sladesta38	unknown
@PartyPartyParty	human
@sistersofsouth	org
@iKimee_	unknown
@Jota_jorge2000	human
@prncessmrtypnts	org
@tomerryjane	unknown
@sergioarce74	human
@vafebinort	unknown
@thomaskpt	human
@ChefJames	human
@JinxyHoneyBee	org
@bornpacked	human
@NlPepi	human
@candicesuccess	human
@LightsOverBruna	org
@Charms_4_You	human
@SHEENsational	human
@NCLoverUSA	human
@desbuncio	human
@mikuuuurin	unknown
@MichelleOHF	human
@giainpe	unknown
@SexyinBikini	unknown
@djpheenx	unknown
@MikeHainsworth	human
@CampervanGift	human
@stavirs	org
@1021pal	human
@MandyAlcos	unknown
@Mikecroscopic	human
@tue_kw	org
@AquariusDaGreat	human
@RizalN2	human
@ArancinaUK	org
@LeeWilsonMusic	human
@ayakakunishima	human
@bonifyedhusla	human
@Parinda_R	human
@mingming85	human
@NICKotineeee	human
@Belushisdugout	org
@jpandbrimelow	org
@GoldenOcala	org
@laury_verdieu	human
@HawthorneCafe	org
@DeniCityGirl	human
@MiiReee3	human
@violagrl09	human
@lisa_kvs	human
@danieladaide	human
@otabmik	unknown
@damiano05	human
@sharongadbois	human
@SolisSochi	human
@DaWaCCo	human
@PCM_tweets	human
@younilife	human
@FerraRocher	human
@WeHateJasmiine	human
@weeduff	human
@alxsal	human
@ymtootla	org
@RealMotty13	human
@SofiaLawton1	unknown
@itmsquad001	human
@Timmy1965	human
@erinfitz27	human
@MellieSwagg18	unknown
@slingeerulz	human
@smcvpride	human
@OnMamasMind	human
@neenchanchan	unknown
@sololander	human
@SDFHC	human
@Astana_Nury	human
@imtcuddy	human
@NosebagNI	unknown
@zsuzs_journey	human
@Shi_yun91	human
@CVanAuk	human
@SmilinOccasionz	org
@365REBEL365	human
@Vero_Lovemusic	unknown
@kjerseykids	human
@kmmilne	unknown
@demon_craves	unknown
@cutech1ka	human
@jdmartin83	human
@AimeeDomingue36	human
@inspiredinitaly	human
@JoyHabeHouston	human
@EarthRoller	human
@SibsMacd	org
@TwoForTheBar	human
@eventstrendcom	org
@DaTravelingBar	human
@cotygonzales	human
@AndreaNakayama	human
@DJDiCEUSA	human
@Recessionista	org
@lipstofingers	human
@ratihpratisti	human
@Hawaiian360	human
@andeline	human
@hanzfreed	human
@SophieRush1	human
@eziraRamli	human
@Cicalia01	org
@SnookAura	human
@XtianStanP	human
@urbnubianizm	human
@magicalmakoto	unknown
@ratneshnagori	human
@jellyemme	human
@DJ_CHOPPS	human
@vittorious1	human
@zkharmaz	human
@Socstar35	org
@_moth_	human
@inhaleeloveee	unknown
@kp_85	human
@audsandeven	human
@BreakfastIdea4u	human
@sacha_88	human
@DANGITGAVIN	human
@BrasserieWitte	human
@lyle_angel	human
@YbyYabani	human
@Benziino20	human
@liuliveeat	unknown
@willwdoug	human
@foodteacheruk	human
@_terni	unknown
@FitSquadJenn	org
@LatinFoodFest1	human
@SaccosMentor	org
@hiltl	org
@PAOTruck	human
@MissShelleyLee	human
@LittleAlice06	human
@mommyenvy	human
@CharisPixie	human
@Hanzel_Dimas	human
@Ellie_Krieger	human
@Cookwithruthie	human
@nahnohamady	human
@RiverNorthChi	human
@JoshRink	human
@LeoMolloy2	human
@toastedbuffalo	human
@MinnaAng	unknown
@Priyanka_AN_	human
@ABuff56	human
@GoodDinnerMrsMe	human
@VividImaginAsia	human
@YourstoDefine	human
@AN15Ax	human
@JesseSaysHello	human
@KiddEdwin	human
@YungEm24	human
@Martalina86	human
@StitchyBlue_	unknown
@gourmetgarageNY	human
@mX_breed	unknown
@DianaDowntown1	human
@peggy_tee	human
@miinot	org
@TheRampFeed	org
@AugustusKambi	unknown
@QuiethouseCE	org
@girlamericana	human
@Maarkeed	human
@cupidintrng	human
@DBinbekphoto	human
@Kerrie668	human
@san4art	human
@Picsher	org
@yuwen1115	human
@putrisiiperry	human
@minseomikki	human
@Leina_Atina	human
@SPEDONK11	unknown
@guyonthehigh	human
@jgoriginals	human
@dorkysdeals	human
@giezella_anna	human
@PHIFFERJ	human
@VictoriaGourmet	human
@iamKarenJimenez	human
@AmonittaBonita	human
@iranyti	human
@uamuzik	human
@sublime_lemons	human
@HallieDrew	human
@RueLeChat	human
@LeMeridienBali	human
@mayux32	human
@FGordillo	human
@adorebynat	org
@skefun0727	unknown
@kieranc90	unknown
@EduardoAguayoA	human
@prov31charm	human
@priscillaxlynn	human
@oneladyb	human
@KeriiKing	human
@Tiddlerrr_	human
@gloriayadira	human
@lovebeets	human
@LisaMendeDesign	human
@shortybobdumpty	human
@_mynameisBee	human
@misssaether21	human
@RoyalPalmsHotel	org
@karlitaville	human
@yuria1291	human
@TexasBurritoCo	org
@thickmadam17	human
@clean_roots	org
@lostodora	human
@WilliamsburgW	human
@Ruweidah	human
@ToryRaw	human
@NatashaWerner	human
@esy_revi	human
@MarkChing	human
@ralucarcei	human
@Phil_Huynh	org
@SoniaMajeedFC	org
@1DirectionGram	human
@zufacoxemeq	human
@Crystallmc	human
@aanharkodineja	org
@DEEavenJER	human
@PornStarsOfTwit	org
@annabellemi	human
@Aquangelina	human
@marlon_martz	human
@jawointhahood	unknown
@N3WSP4P3R	human
@Neonetha	human
@Angiebstudio	human
@Melanie_Leahy	human
@LesterAquino_	human
@erentandogan	human
@mavigladyator	human
@LewissofMoseley	human
@JohnPower81	human
@djleoliver	human
@RosaSmiith	human
@dr3am_b3ing	human
@ArrowheadGrill	org
@BrandGreet	org
@OweeeeenYap	human
@Freywyn	unknown
@brandiespiers80	human
@TrianaApts	org
@4rakawa	human
@Lulyperezcakes	human
@tombaylicious	human
@Benjami71305159	human
@cleancalories	human
@NEL1stNEVER2nd	unknown
@Keikari_Haiku	human
@JoJowelsh17	human
@Candy_Kiss90	human
@jules792000	human
@Claudine_Nich	human
@kristyle_nguyen	human
@iamliljam	human
@tagalove21	human
@asicophoto	human
@N_Lifestyleblog	unknown
@snapchatcooking	human
@HeatherTwist93	human
@TiffysHomemade	human
@cafefrancaisSL	org
@alyssabsmith	human
@ayyasui1985	human
@zk_pt	human
@FerrariThings	unknown
@JessicaOlmi	human
@OmegaSeedSpice	human
@HandSTAND	human
@Luciananac	human
@Lakwafo_7	human
@ZoesKitchen	org
@AlessandraDC3	human
@Azarodining	org
@YasminLClark	human
@Belle_Suhail	human
@takorou88	human
@Chelseym_xoxo	human
@falafelmywffle	human
@GokmenOfficial	human
@tonconcept_ton	human
@gustoguides	org
@BonosBBQ	human
@BCARRINGTON	org
@ChrisAshbach	human
@KiamaBlowhole	human
@HollidayMUSCLE	human
@RianneSchuwer	human
@destinyblogger	human
@mallatbayplaza	org
@amimuuu	human
@JayEstevez54	human
@IncogFredo	human
@HKConcierge	org
@totalmanchester	org
@maelovesbubblet	unknown
@tyoMSFTS	human
@Mr_Briman	human
@windaseptiy	unknown
@MernaEltorki	human
@VersatileVickyk	org
@letitbe2387	unknown
@OllyHRees	human
@noralasz	human
@PatriciiaJones	human
@koolkatkrupa	human
@aritabag1din	org
@AleHerlina	unknown
@LAeateries	org
@SuthidaCJ	human
@ikka_w	human
@Vicohdzh	human
@heenadeepak1	human
@DarrellPrivett1	human
@enemy24_07	unknown
@iprytz	unknown
@alronic	unknown
@LdnBites	human
@ilmastrocerimon	unknown
@dyran_luna	unknown
@diegopeixotinho	human
@VandalStar	human
@lorraineLAWD	human
@bisbafood	unknown
@Patordi	human
@R6Sister	human
@dhikasyandi	human
@Aungle_Samantha	unknown
@CodeblackFaith	human
@BeeViaOh	org
@darylko	human
@e_k_brinkman	human
@annrkiszt	human
@thepetitecoree	human
@amaialife	unknown
@JanniE_Uy	human
@Yuncooks	human
@pamela_ho	human
@AlliesFeats	human
@ingvildbarnes	human
@roadbikecity	human
@BlueRoosterSRQ	human
@iamElla_Diaz	human
@JaquiGinoble	unknown
@mufa_filanies	human
@seriousmockery	human
@jason_blacklock	unknown
@jBerndes	human
@Janysha	human
@mimicutelips	human
@TheresaPell	human
@kea_girl	unknown
@NyteVizionENT	human
@ayamiyamamoto	human
@aki_penguin	human
@19Becka	human
@spiloy	org
@RizalSadiman	org
@jessnut__	unknown
@Prettyleighsei	human
@cikmimiee	human
@jenannrodrigues	human
@tableofferings	org
@lisalcheung	human
@LaSocieteMtl	human
@The__Blacklady	human
@DashAlThani	human
@selaazalea	human
@pulcherbag	org
@jubelkediri	human
@BKFoodie97	human
@JaynaRDavis	unknown
@jamilanelson	human
@ardyatama8	human
@HeatherOTH	human
@kotakasablanka	human
@xeniabaykova	human
@Nerf_or_Bacon	human
@MongolSantino	human
@davonbrock	unknown
@a1exandralauren	human
@UCSCDining	org
@VomFassIndy	org
@ExcaliburCourt	org
@ivuwiwuvajiy	unknown
@itskatyaazarcon	unknown
@KatBerton	human
@CEDLUCCIONO	org
@fishpeoples	human
@oliopuro	org
@Yobyz	human
@Chr13stma	unknown
@clschmit	human
@XeniaNails	unknown
@AngelFairyGirl	org
@b_silb	human
@moshio13	human
@TheAnarCHris	human
@andrewgreyson	human
@pedro929	human
@ukrockmania	human
@DanHigginsIE	human
@Kami_Ramdeen	org
@WhoaXAmandaX	unknown
@MsFashionAsh	human
@bellonazoe	human
@820ykr	human
@DjBitches	human
@KimKeepIt_Real	human
@ToddBower	human
@xX_Sekken_Xx	human
@Marc_Hartkamp	human
@Ravenvelle007	human
@MiuMandy	human
@Mukhsinyangbaik	human
@KamaFitness	unknown
@syafsallehuddin	human
@_Cjae_	unknown
@buddyTruk	human
@ChelseyHardyxx	human
@AndreaBLaVoz	unknown
@FatHenAndFlo	human
@kuriousity4	human
@HolyfordFood	human
@KarenPersson1	human
@_52kcaj	unknown
@giseleyag	human
@jooelmendizabal	unknown
@Hamimah_Hamdan	human
@crishaalyziah	unknown
@florrsnow	org
@Pure_Consult	org
@bobylimijaya	human
@cookescatering	human
@isa_belilla	org
@edmaima	unknown
@HEAVYSPITTERS	human
@VahniB	org
@Chambre_de_emi	org
@ecearas	human
@SandyGunger	org
@1017_GANG_BSM	human
@DianaSavaniRD	human
@ChannaShoshana	human
@juliefishing	human
@BoroughMpls	org
@wtrestaurant	org
@HomemadeFLA	org
@MhairiMackellar	human
@BeeCaramelFRAP	org
@iamfayeng	human
@vellacasey29	human
@PdJFood	org
@77Tsuuu	unknown
@lauraandluke	human
@SandiPlantos	unknown
@hell0bAbykitty	human
@kenna	human
@kimrrivera	human
@tweetmack07	unknown
@moccastyles	human
@NotasMedicina	human
@MV_Moms	org
@Royke_J	unknown
@Designing_Gal	human
@Hollyhobbie6351	human
@Chef_Dyrell	org
@BrittanyDCLT	human
@Maaaarrky	human
@CyJohnT	human
@fohola441	human
@stefano_kr	unknown
@Vintageprocess	human
@1titbout2femme	human
@Blacklilac16	human
@MeNacE_goOn	human
@MintM8	human
@magalhaesfitnes	human
@dj_djohnson	org
@EthniCurls	unknown
@Nequiiz	human
@brcnparmaksiz	org
@IrabellaRobSten	unknown
@th3harold	human
@KitchenPalz	human
@iamDonDolla	unknown
@AMERICANO_4	human
@ThoughtlessTees	org
@MistaPM	human
@TheGoodBag	org
@Bianchi_Claudia	human
@adamsj9	human
@Adokan88	human
@oyaolalia	org
@tokodubai	human
@HellYeahCrisse	human
@SilviaBoschBlog	human
@AmitAnonymous	human
@tzarlang	human
@4N_Northwich	human
@robinrandolph	human
@BilalMarsou	human
@jennifer31388	human
@cucciname	org
@BAMI_LONDON	human
@Dear__Charlotte	human
@zyosi_syo	unknown
@Puterimai	human
@magic_breakfast	org
@Karla_rch	human
@appletreewb	org
@LomasEnt	human
@yit415	human
@RachelBale3	unknown
@PBaby_Dont_Cry	human
@juliette_choco	org
@tumho711	human
@DAWINDISCH	human
@tsimgill	human
@Dan_Koehn	human
@KymHuynh	human
@robsloiola	human
@Ali_Whitey	org
@DeSmitten	human
@tonamorn	human
@BreatheAndy	human
@starboy369	org
@mlex93	human
@NoemitaMA	human
@MrBlover18	unknown
@GLVICYMI	human
@omoshiro_LSbdR	unknown
@cami_percepied	human
@AdviseMyStyle	human
@Jestafari	human
@Joanna_Herman	human
@mossburg00	human
@MiouMiouDrapan	human
@Marwa__Magdi	human
@ParagonBeautie	human
@TaKshaKMIA	unknown
@iLordson	human
@ShorthornRD	org
@ElChihuahuaUT	org
@thecounter_cafe	human
@MichaelBrewer10	human
@TommyGunnzNIGHT	org
@vkottyv	unknown
@VananM	human
@RJCastaneda	human
@IsaaMRG	org
@orangemylesy	human
@Kejuan_Li	human
@HackneyPlastic	org
@julioiuls	human
@iiwrites	org
@HealthyMonday	org
@iamRicahmae	unknown
@TheILOILOEye	unknown
@TheJasonTerry	human
@nithsluckystar	unknown
@thegreganator	human
@ParentstoAdopt	unknown
@billsatterwhite	human
@MunchiePunch	human
@joyzhanzy	human
@tonyas123	human
@mphappenings	org
@KrystenBachler	human
@tastingPR	org
@TheChileVine	org
@MedifastSD	unknown
@damier80	human
@zhitears	unknown
@coralandbone	human
@rob_rubicco	human
@Veetorious	human
@antrouse	human
@M_A_ALMULLA	human
@MorenoDesigns	human
@thetrufflelady	human
@TTiME_9	human
@ard_town	human
@PokemonOnline2	unknown
@iamivyliong	human
@ChaeleyBarber	human
@marlina_marzuki	human
@SnezzyP	human
@ThumbelinaBella	human
@garganofreewifi	human
@rainknife	human
@badmanrahul	human
@haruko414919	human
@jj_wwow	unknown
@JacquieDiPego	human
@KenzieEiznek	human
@ShilohFarms	org
@j0anpotz	human
@MsAdetunji	human
@CaroolynBush	human
@amyCBandBP	unknown
@akillilea08	unknown
@vogelnet	human
@magia2000	human
@AgungChoi	human
@BDOWN64	human
@FinanceWeekly1	org
@JoshuaPWinzeler	human
@Andly_moshi	human
@Jaci_ps	human
@jessicapereirag	human
@reillyannewhite	human
@QuestHotelCebu	human
@chriscelestin	human
@SonyaDishon	human
@gEeKfAsHUn	human
@GeekyElephant	human
@JoeySkeleton	human
@Keri_Mellott	human
@8ABrasserie	human
@gerliemaycallao	human
@IrishUSAMom	human
@DrLouFran	human
@JennaObrien15	unknown
@myloves1989	human
@IlariaNasca	human
@No12restaurant	org
@yolexis17	human
@NewhallRefinery	human
@MokaVida	human
@Gia_is_Here	human
@MothersApplePie	org
@Year_of_Sundays	org
@clrissaa	human
@ElectricSunBlog	human
