@GloriouslyGood	org
@ThisIsWhyImFULL	org
@Lovelogist_L_	human
@GrandmasComfort	human
@SnackSurprise	human
@dine_here	org
@foodnomnom1	org
@FoodHighlight	unknown
@7nOaHlHkW3	unknown
@PigsTrough	human
@SouthernChef123	human
@BagOfPeanuts	human
@AnIceCreamCone	org
@APHInternation	human
@QueenCooking	human
@FoodPornNews	org
@HealthSharer	human
@auboisenchante	human
@thepaleodiet2	org
@DeeSircher	human
@AussieScenes	human
@hormonarse	human
@vineexp	human
@iblakegary	human
@LadyValyTV	human
@AdolfoSmithFood	human
@FoodRetweet	human
@searchforrecipe	org
@StamfordsFoodie	human
@DatingFLL	org
@GLassdezignz	human
@inspiredlyfit	unknown
@DebiDavies	human
@postcardsfromny	unknown
@getfedyes	unknown
@wefindthebest	org
@RecipesSnack	org
@dinnerdx	unknown
@sexysleepwear	human
@NUTRiBULLETFans	human
@ciokolove	human
@EssexFoodPorn	org
@whybh12	human
@Tweetrameshwar	human
@drjenniferad	human
@BobbyDoTube	org
@FreeShopping_	org
@queencooking1	human
@Simi_m85	human
@ONLYOffers1	org
@cookingcart1	human
@warmtote	human
@FrozenMOVlE	org
@CoffeeBrue	org
@foodpages	human
@breakfastmag	human
@baileynutrition	human
@cookingme198	human
@rixscafe	human
@MostYummyToday	human
@PostermywallsjA	human
@Snackgasm	org
@CoffeeCrewUk	org
@aashu_affection	org
@sediain	unknown
@ScenesfromBali	unknown
@DealsBasket	human
@HealthyTweetsUK	org
@japanese_okashi	unknown
@InstaSydney	org
@TheDonutShop	org
@TodoSushiChile	unknown
@wwebmart	unknown
@WHATSAAPSHARE	human
@ricetteperte	human
@scenesfromrehab	human
@cookbook2893	human
@MrCrabBuffet	org
@Anusha587311	unknown
@lunch_gurunavi_	unknown
@Recipesworlwide	unknown
@Instasiun	org
@TheRandySteel	org
@daidaikemool	human
@MaggieHighway	human
@coupongenie	human
@NewYorkResto	org
@MedicinalFood	unknown
@444_nal4b	human
@hotelsyes	unknown
@roumila26	human
@scenesfromparis	unknown
@TastyRecipe_	org
@Tweets4Vegans	human
@InstaMaui	org
@pleasealoha	human
@ind3ed	unknown
@TvlunchBot	human
@tmxtmx	human
@ronfeir	human
@Cookingmaster1	org
@BOT22619969	unknown
@OptimumHealth30	unknown
@chunky_punky	human
@theAmazonChef	human
@NYC4Lunch	org
@scotlandscenes	unknown
@SouthendFitness	human
@BrassPickleDeli	org
@porto_vino	human
@LocalFarming	org
@songislove	human
@CookingCurry2	human
@breakfastman0	org
@SFFcbus	org
@twinama	human
@ladybreakfat	human
@recipebreakfast	human
@scenesfromrome	unknown
@breakfastidea1	human
@breakfastonlin1	human
@king_breakfast	human
@fromcentralprk	org
@Indy_Events	human
@daybreakfast	human
@Atlanta4Lunch	org
@Daniiprettygal	unknown
@breakfastflavor	human
@Chicago4Lunch	org
@LauriMParker	unknown
@TheStreetCircus	human
@lifebreakfast1	org
@Upropastitelj	human
@garydlum	human
@pelavig	human
@crestcafesd	org
@healthytips357	org
@aditikapoor24	human
@priya_8585	human
@yuzo	human
@NetworkingEssex	org
@TasteLikeLov	org
@IntertwEAT	org
@bukuro_minato	human
@tinundice	human
@veggiebeet	human
@InEssexBusiness	human
@Octopus_Nation	org
@cookingseason	org
@AustraliaPlace1	human
@iluvMyDelhi	unknown
@CollegeScenes	unknown
@foodpandas476	human
@arbazena	human
@BillericayNews	human
@algarvedotcom	org
@ChalkwellTalk	human
@EssexTweets	human
@InstaIbiza	org
@ChalkwellNews	human
@BrentwoodTalk	human
@alia_alia10	human
@ShoeburyNetwork	human
@33kanrinin_bot	human
@BasildonTalk	human
@gastronomy	human
@scenesfromvegas	unknown
@Marketing4Essex	human
@InstaAusBeaches	unknown
@greenpwrmonitor	human
@AthensInsta	org
@BraintreeNews	org
@gatormommy123	unknown
@FindFollowTweet	org
@LoggiaGloria	human
@Leggotunglei	unknown
@ChigwellNews	org
@inspiredpaleo	unknown
@EssexHomeBuying	org
@24DaysLater	org
@TyberZannxxxx	human
@ChelmsfordTalk	human
@GraysNetworking	human
@ChigwellNetwork	human
@EssexHealthClub	human
@Promotion4Essex	org
@DC4Lunch	org
@foodeteria46	human
@ThurrockTalk	human
@RainhamTalk	human
@HockleyTalk	org
@BtchesWhoBrunch	org
@supplements200	human
@EssexHouseBuyer	human
@fansofnetflix	unknown
@boynextRAWR	human
@KatiaBrega	org
@ShoutEssex	human
@BuddhaSushiVi	human
@ChigwellTalk	human
@CorringhamNews	org
@Recipleaser	org
@realwhizart	unknown
@LaindonTweets	human
@RelaxInMiami	org
@ColchesterTalk	human
@ohiru5han	human
@LoughtonTalk	human
@ChadsWestCoast	org
@Foodtrucks_OC	org
@ShoppingWoman1	org
@BananaRoti	human
@LeighOnSeaNews	human
@ChippingOngarUK	org
@FromageGourmet	org
@getitupforme	human
@EppingNetwork	human
@paleofire	human
@frugalmaniac	org
@FoodSharer	org
@De_Lidious	org
@Ale_Na_va	unknown
@Essexreviews	human
@postermywalls1	unknown
@BZER777	human
@InstagramMV	org
@FrnddRjss	unknown
@AnglCrrscc	unknown
@instapolishgirl	human
@PbloGrciia	unknown
@DanniRmss	unknown
@KthiiaMndz	unknown
@FlippCsttll	unknown
@JimnnaRyss	unknown
@EdwnnMor	unknown
@BraynCsttr	unknown
@RociiAlmdd	unknown
@ClaudRsas	unknown
@AdrinVlzqz	unknown
@JesscaDrn	unknown
@MarioUscngga	unknown
@GrrdHrr	unknown
@AlnndRzz	unknown
@AngllGnzlz	unknown
@CoolBrighton	org
@Blogging4Essex	human
@MonicBlttzr	unknown
@sonathcloth	human
@RelaxInSoBe	org
@chock_s	human
@CookingExpert2	org
@sinefmbreakfast	human
@VinylrobotLA	human
@chefcooking321	org
@BenfleetReviews	human
@burgersandjeans	unknown
@chirachisushi	human
@888infinito888	human
@chefocuisine	org
@BWBrunchNYC	org
@ambplanning	human
@RevealSouthend	human
@RayleighTalk	human
@EssexSafety	human
@EssexBlogger	human
@Angie_FM_CILY	human
@blackwhitevivid	human
@EssexRetweeter	human
@EssexSharing	human
@insta_hamburg	human
@JayJeansCafe	human
@myrecipemagic	org
@EssexCharityRun	human
@EssexDelivery	human
@fatlosspfl90	unknown
@FoodinSouthend	human
@fujisawa_info	human
@a_love_i	human
@layoverlife	human
@doncaster_uk	org
@Food4Southend	human
@FoodinEssex	human
@littleislandstu	human
@ArmyWifeNMomma	human
@holidayhqteam	human
@BBCRadioFoyle	human
@EssexBlogging	human
@Yummy_Lummy	org
@fishnchips2go	org
@InstaWaikiki	org
@EssexServices	human
@EssexGyms	human
@D9_snippets	human
@derek_hysteric	human
@MusicinSouthend	human
@thehungrycat	org
@Iupdatejamaica	unknown
@Fancy_Edibles	human
@thefoodtrucker	org
@InstaKL	unknown
@andy37927	human
@scenesfromkauai	unknown
@MusicEssex	human
@asahiken_okayam	human
@melisahdr	human
@The_MommyGuide	org
@USplaceslist	human
@Toronto4Lunch	org
@RelaxInDubai	org
@treksaf	unknown
@PerlaQuintana09	unknown
@FoodSnobNation	org
@RafaelaQuinta09	unknown
@SaboreandoMadri	human
@StuffedTeddy	org
@VeroBistro	org
@PerlaPiedra09	unknown
@CabosNews	org
@EstefaniLpz	unknown
@alfredkee	human
@DarioQuezada9	unknown
@ReviewsEssex	unknown
@NuttyAboutHlth	human
@CardiffBizShow	human
@missmamo	human
@alettlewis	human
@NeuvooHosCha	unknown
@parentbuzzz	unknown
@lifeoflawyers	unknown
@MarcBianco	human
@TalkingGoodFood	human
@brunchpgh	org
@InstaMalta	unknown
@j_cohl	org
@SouthendSharing	human
@StamfordBiz	org
@himenotable	org
@lenongrumpiRI	human
@DiscoverSelf	org
@crayonhouse	human
@Dublin4Lunch	org
@richtweten	human
@ILOILOTracker	unknown
@andrewhaas13	unknown
@London4Lunch	org
@TheFoursBar	org
@_selfveda	human
@wowfoodclub	human
@ubotipixih	human
@muzaxyken	human
@mokelulepo	human
@uvogahicu	human
@Import_Foods	org
@asederyfi	human
@yfahidymi	human
@ewakoqonro	org
@eqydopugs	human
@eqodulib	human
@aqyfateky	human
@cysoqife	human
@uzyvoguby	human
@hucypyred	human
@kifofacoj	human
@ajumimiqpo	human
@awikohudmu	org
@rewikorybn	org
@amazefih	human
@badycojeca	human
@ubuqyxovri	human
@jynyfobub	human
@jymozovun	human
@ibykorune	human
@elapowyryh	human
@hoqiwevee	human
@uvodozyko	human
@kynowage	human
@azicahah	human
@yzixudyc	human
@yjovoralar	human
@yvynojipy	org
@acakecic	human
@terowogave	human
@ozezirem	human
@ekyxowuce	human
@ufejumil	human
@pohuluxik	human
@ekoqibugp	human
@kytapobyq	human
@ijifuriry	org
@uvejybugp	human
@gyjybola	human
@obeduhehn	human
@lepusene	human
@uzagufewy	human
@instaCancun	unknown
@idadevady	human
@ytojajowi	org
@dasykizu	human
@ijydozize	human
@tyziqicuny	human
@arujocepya	human
@acorezeh	human
@upynalyjav	org
@ulopojazi	human
@bitexybiga	human
@BananaFaerie	human
@yqigokiki	human
@inspired_2day	org
@avybinyrko	human
@izycikybn	human
@kobypyxio	human
@ironapif	human
@vujejuhikib	human
@Ee_Khor	human
@epygygag	human
@TSUT01	org
@ryxahopusp	human
@emujinodac	human
@Boston4Lunch	org
@enacower	human
@CasyWubeer	unknown
@thehaasmachine	human
@StadiumGarage	org
@cosmeddicted	human
@FeelingItaly	human
@DanielasNYC	org
@PromoteInLondon	human
@JJMZHANG	human
@MJ_Viola	human
@anissahelou	org
@freefunfund	org
@BoutiqueCloset1	human
@VIVO_Cafe	org
@daikanyamakadan	human
@bot50677722	unknown
@insta_new_york	human
@SpaofSpa	org
@prestezza	org
@picnictoday	human
@FlavorQuotient	human
@TheMewsSouthend	human
@ocan_tweet	human
@HawaiiOlelo	human
@lensandwood	human
@ScenesfromSeatt	unknown
@AppRestaurants	org
@MFM926	org
@BankOfRecipes	org
@MateOverMatter	org
@ATB_SecurityLtd	unknown
@MatchaDrinkers	human
@pottery_shop	org
@AniLnda	human
@PromotionEssex	org
@DixieGrillWPB	org
@AnahiRmrz	human
@nobodyplace	human
@cookingexpert6	org
@VermontCompanie	human
@SouthendDeliver	human
@BraintreeTalk	human
@moroccony	human
@KittyGinaMeow	unknown
@Miami_Eatz	human
@toms_kitten	human
@MontrealGram	org
@InstaKharkov	human
@star_wars_gifts	human
@BizBloggerUK	unknown
@30secondmom	org
@InstaLasVegas	unknown
@BroncoBurgers	human
@PHOTOSintheWILD	human
@EpicEssex	human
@PietrasantaNY	org
@InstaKyoto	org
@SevenPoint2	human
@ROCify	human
@PaulaMaier3	human
@FoodWeekly1	org
@Import_Foods_	unknown
@Law1Gloria	human
@businessUKblog	human
@WineUva	human
@tomontheshore	human
@your_home	org
@alikeofficial	human
@Seattle4Lunch	org
@BelloRestaurant	org
@nofrieschip	unknown
@SoFlaToday	org
@herbalshop4u	org
@SebasFdz_	human
@MartiniOlives	human
@fattybiscuit	human
@BayAreaStartup	human
@kanamechari	org
@AleLepri	org
@0006932957	unknown
@EatingInLondon	human
@fieldfarefoods	org
@localgrownsd	org
@roguelumen	org
@LA4Lunch	org
@InstaPrague	org
@scenesfrombora	unknown
@silentvoice3313	human
@AllCoffeeTweets	org
@lunchisan	human
@Business4London	human
@LondonSharer	human
@skinyfitlicious	org
@vjogiya	human
@aman_cosme	human
@denverestaurant	human
@WestQueenWest	org
@tsuyopon1101	human
@GVisuals	org
@BrunchNoir	human
@photo_nsk	unknown
@ChristophersFF	org
@nomusukobot	human
@GuuToronto	unknown
@mtactacan	human
@aATLTaxiCab	unknown
@sexy_miyuki	human
@Food4London	human
@MlNlON	human
@AlfonsoGmz_	human
@bakedbyrachel	org
@WhiskeyGirlSD	org
@Reviews4London	human
@wassi_inca	human
@LondonMustHaves	human
@BlogMyLunch	org
@LaiLaiWonq	human
@SanjaHudjec	human
@MeSoHungryTruck	org
@cinefil_	human
@brisenoTOM	org
@DemBonzBakery	human
@_WeAllGottaEat	org
@FARMHOUSEtavern	org
@jamescapetown	human
@Samuel_vel_	human
@CupCakeAffair2	human
@Carreta_dAyuda	human
@szk_hrm	human
@884GohanMemo	human
@C_Fernandez__	human
@Watch4London	human
@Alcatranrod	human
@thefoodtasters	org
@bigflavorsblog	org
@SecretFitFam	human
@birra_land	unknown
@Lauffrau	human
@POSmateAU	human
@florentsd	human
@FoodiePleasure	human
@House_74	human
@cano_Mau_	human
@CountJugula	human
@Ms_Terree	org
@infoodnetwork	org
@rishi_modi	human
@AletheaBu	unknown
@DonCSeide	human
@ViliVzca	unknown
@PrecBelovBless	human
@TREVORALLSTAR	human
@foodieduud	human
@bestdietworld	unknown
@elitefatslayer	unknown
@elaine620	human
@TuttoParioli	human
@marmur1	unknown
@teresaponmesa	human
@koottandotcom	org
@IRunColumbus	org
@josiekaret	human
@dan330msp	org
@featured_foods	org
@hk_hellskitchen	org
@PlanetVeganism	human
@FreshBestLocal	org
@VEGASandTONIC	org
@IndonesiaTrends	org
@SouthendGroup	human
@IcemoonHolidays	unknown
@InstaKabukicho	human
@PoetryAnneLyrix	human
@Dietgasme	unknown
@lunch_pop_tokyo	unknown
@mehuldes	human
@pulistbook	human
@Golgo_Bot	unknown
@riovic_	org
@LpCathy	unknown
@SashaEats	org
@blaBarcelona	human
@George_Voros	human
@JapanRetweet	human
@Swaggoodies	org
@yami__kitty	human
@lfooddrink	human
@NelsonBarillas3	unknown
@CJNutrition	org
@JazLla3	unknown
@Art4IM	unknown
@ArtMatters2me	human
@DinkyDawgs	unknown
@nguliner_	human
@HeartbeatSnack	human
@instaBavaro	unknown
@JanneRoppola	human
@KPearsonRoofing	org
@smchickbigdeals	org
@CanteenLondon	org
@RGFemWorld	human
@StackingCoinss	org
@myrecipepicks	human
@DRecipes	org
@HadleighReviews	human
@meg_xgirl	human
@RecipeTweets1	human
@montorgueilreco	human
@HeavenlyHappy1	human
@WeTuscany	human
@edgarrestaurant	org
@pocketlondon	human
@CleanDropMobile	org
@mitaka_an	human
@SecretSouthend	human
@tsugarusyamisen	human
@SoMaStrEatFood	org
@Pure_Logistics	human
@CastelloLara	human
@koen2010	human
@DCDAMONCLARK	human
@enjoiappp	human
@JuliaFuentes54	unknown
@DoncasterInfo	unknown
@andrewehaas13	unknown
@HomesteadWish	human
@MINlONS	org
@Mrs_Rach_M	org
@EasyBreakfast	org
@famishadnetwork	human
@MontrealOn	unknown
@Giinster	human
@toobusytoeat	human
@HotelBravo07	human
@instamia	unknown
@LIPSapp	org
@DrTangumonkem	human
@SuzCat_BiVi	human
@LERUFFO	human
@EssexTalk	human
@nereo_Cast	human
@rollinoatstampa	human
@BrittanieSweely	human
@Japan_Craft_Art	human
@pame_Becerril	unknown
@mangolisa	human
@Kaseys_RVC	org
@FitzroviaW1	human
@BOLLYWOOD_BITES	org
@Jeelinb	human
@DaFronte	human
@ParisInstagram	org
@100daysbyMaja	human
@jimfishnick	human
@LBITK	human
@Cuban_Bee_71	unknown
@BerkeleyBrennan	org
@New2Yoga	unknown
@DytGamzeSanliAk	human
@pie_robot	human
@user1566233	human
@Sara_Gallardo23	unknown
@swagseason1988	org
@Bro90	human
@_tuker	human
@laxysane	unknown
@gahepelo	unknown
@ylijumezas	unknown
@chimiyuki	human
@iDineIndy	human
@uqidadacpe	unknown
@upupywoxy	unknown
@leisai	human
@ygehekojq	unknown
@g_michael_salon	org
@cookbook12983	human
@iqodumot	unknown
@Torgovtseva	human
@disyxozarj	unknown
@KissFmMedan	human
@relehaxi	unknown
@YliysMag	org
@DNishikoku	human
@InstaBrisbane	unknown
@foodfrenzyfans	org
@Wassix1997	unknown
@bistro_cocotto	human
@photorele	human
@pugyu1973	human
@kaitaKarlheinz	org
@ivanhoefalmouth	org
@aratametakumi	human
@happymealskenya	org
@Music4Essex	human
@altopascio_h	human
@PokerFansYes	unknown
@the_feedfeed	org
@PASTArrific	org
@MissAngelaDavis	human
@WilsonLeeFlores	human
@HerrMiM	human
@Miami4Lunch	org
@InstaDresden	org
@ColumbusBot	org
@Healthy_Helper	human
@OpalDPennField	human
@EasyCatch1446	human
@TheSeasonedMom	human
@ChocMission	org
@your3daytrial	human
@MoVernie	org
@ReSetteNYC	org
@sakura_japanese	human
@Carole_Delisl	human
@barcodedc	org
@fonsarelo	human
@ThePostpoet	org
@DeniseSanger	human
@UtsavNYC	org
@_yumi_bb	human
@SexyHealthTips	human
@Chefstableffld	org
@maggieunz	human
@anahiSelma	unknown
@SinCityExaminer	org
@ainastyle	human
@Thriving_Today	human
@DailyBestSelfie	unknown
@ichange_coach	org
@ILZetaPPK	human
@CHIHIRO_aka_NM	unknown
@BarcelonaInsta	org
@CBRFoodie	org
@trends_selling	org
@MangetoutCafe	unknown
@1iloilo	unknown
@booboogal	human
@MyDDublin	unknown
@hidemaro13	human
@LossArts	org
@dof1988	human
@lilyyoshitaka	human
@kobedek05	human
@sakurasaku7138	human
@mcaldwellauthor	human
@SmoothFLL	unknown
@DNM_Chicago	org
@FamilyFreshMeal	org
@seebo5588oh	human
@GeEkYGoSsiP_	org
@MrsKathyKing	human
@venicescenes	unknown
@suzukia1987	human
@daikichi386	human
@SweetNSourDeals	human
@endorphynn	org
@InSouthFlorida	human
@CuliRecipe	org
@HappyBubbleGal	human
@ipemobev	unknown
@HalifaxOn	unknown
@Food4FortOnline	org
@BrazilGrillNYC	org
@MiltonKeyn_es	human
@BusinessSharer	human
@JoshEstrin	human
@InstaSingapore	human
@jitasolal	unknown
@ugivozybm	unknown
@visitwaikiki	org
@sehiheputa	unknown
@bubisuke	human
@yumemama7	human
@xebubika	unknown
@Foodetc	human
@RecetasPorMenos	human
@AlsCabin	org
@AustinpalStacy	unknown
@KanelaCafe	human
@ajezelokuj	unknown
@esavafaruz	unknown
@DebbietheRD	human
@zyrygeceim	unknown
@wiruvuxe	unknown
@eqiqewubad	unknown
@DrGaai	org
@pisebynawe	unknown
@emefumycr	unknown
@PalisadeSea	human
@neospo1989	human
@awohemoft	unknown
@JohnJGeddes	human
@ysiqadig	unknown
@AONFitness1	human
@irygiguve	unknown
@Rhitrition	human
@CPC504	human
@wedopofede	unknown
@NovelGenius	human
@xobocepuq	unknown
@jobijyzie	unknown
@atuxakywqa	unknown
@dyvepifo	unknown
@adyqohofu	unknown
@xiqacymaw	unknown
@ecuhusoc	unknown
@egucokyw	unknown
@etamuxypu	unknown
@zydabezy	unknown
@FamMadeSimple	human
@Playwright49	org
@AllisonMarieCha	human
@Bargain_Finder_	human
@AnhiOch	human
@ceejaydeleon	human
@nagisaboys	human
@GldiisRoj	human
@OdalsCrvvjl	human
@CrrlaMirlss	human
@chungscatering	org
@ketchingup	human
@inbouron	human
@skuii876	org
@AustinsAleHouse	org
@sportparadise	human
@TeresaAmbra1	human
@Zul_Slgddo	human
@UKIndianCurrys	org
@plante1987	human
@ReinMorlls	human
@Tacononymous	org
@NeuvooCsrSea	unknown
@GrciAlvrzz	human
@instatagcanada	unknown
@AljndRys	human
@Amberor	human
@LaCarbonaraNYC	org
@SandsVenue	human
@BoilerRoom7	human
@vheaventeaneck	org
@mikearce	human
@IntermezzoNY	org
@urchinsg	human
@callmemochelle	human
@bodegaexpressve	org
@GabyyEstv	unknown
@jbcday	unknown
@anoosrini	org
@ZedC	human
@BrianDNYCRadio	human
@ProtectSouthend	human
@muck_bang	unknown
@tuchiyat1986	human
@akihikosato1985	human
@kenzi219	human
@foodArtgo	human
@halloweenGram	unknown
@oravanpyora	human
@gohan_dokoikou	unknown
@fukuchi19875	human
@flavorfulworld	human
@mokotokamiya	human
@chiaki_oikawa55	human
@ayasuzuki1986	human
@OOingle	org
@thefoodbot	org
@BourbonNY	org
@miyomiyo1ove	human
@foodpicturesgo	human
@BaseBallBeer	human
@punkharo	human
@BlogFrogs	org
@paleo88diet	human
@patroclo75	human
@CikLilyPutih	human
@FoodPotions	human
@ArroW_MaNWi	human
@anassanyc	org
@SanDiego4Lunch	org
@yukky_1101	human
@kai19808	human
@ceigac	human
@hatori1890	human
@mochi19896	human
@TheBrassRailNJ	human
@MarronisLounge	org
@cecilekuni	human
@anne_asai	human
@TavernOnRush	org
@GonzoGourmands	org
@mie19800987	human
@TablaoNYC	org
@SombreroNYC	org
@mikessupercitgo	human
@CrabbyGeorges	org
@jenzcorner	human
@ryu198617	human
@DUFFYSGRILL	human
@YourLDN	org
@InstaHongKong	unknown
@konditorandcook	org
@iCabway	human
@cecilikeido	org
@DrumstixNigeria	human
@sobermeup0	human
@masayakato1985	org
@BOT01987257	unknown
@foodrecipesgo	human
@Boski1402	human
@corawong0812	human
@adrchen	human
@DawnHillDesigns	human
@VetteHap	human
@marlinbz	org
@foodofhistory	human
@royaloakvillage	org
@KoichiroM	human
@doubututatito	human
@foodcitygo	human
@IDawta	org
@hela_cumbres	org
@stuffspec	human
@figsolivesdxb	human
@anguiano_esme	human
@ArielDePrada	human
@leesiemaszko	human
@ahmedfawzyfahmy	human
@FoxHoundLuo	human
@tastemauritius	human
@VillandryBakery	unknown
@wokstar	org
@FoodieLoversCom	org
@cochonbutcher	org
@instamonaco	unknown
@rabbit121515	human
@Brighton_RT	org
@DaKaChiaSG	human
@mostlyraw	org
@foodloversgo	human
@MissesDoe	org
@tapadeal	org
@IamArah	org
@bestofvineorg	human
@NORNIRONFOLLOW	human
@5694Betty	human
@toto_ramirezz	human
@BustMyGlock	human
@foodnetworkgo	human
@CANEDOALAN_	human
@5693Jones	human
@SebasArias_T	human
@chillidaddy	org
@JenniMerc2	org
@AmberHolt567	human
@CandiceFH1	human
@ichangemymove	org
@GarrettDobbinus	human
@CaitBlanc	human
@silasvalverde	human
@_x_Cecile_x_	human
@MikiHope	org
@PoppyKavon	human
@PoppyDelargy	human
@foodhacksgo	human
@RetinalArousal	human
@liewhuiyi	human
@nhatranginsta	human
@BeerIndex	human
@FitnessDietFood	human
@ICGFT	org
@TheFunnyJock	human
@AvaFairstone	org
@wataraisho1960	human
@gar5693	human
@BuyADomainUk	unknown
@keva_hunt	human
@fukuyoken	human
@AAS_Tutorials	human
@thewebsfastest	org
@QueerHayden	unknown
@chihuahua19874	human
@paloaltotechcom	human
@hellofoodgo	org
@foodmattersgo	human
@djselinalight	human
@KatchAstoria	org
@SouthernNest	human
@ocfooddiva	org
@prathummat	human
@billyscrabs	human
@VegetarianLuver	human
@kaze_kami	human
@Tsyen10	human
@cojicoji0716	human
@YUCALINLIN	org
@AmazingMatt	unknown
@instagramcc	org
@KatiaTorr0	human
@ClarenceYardSS	human
@TUZYLAK	unknown
@CaryStCafe	human
@MiguelZrr	human
@Southyorksbiz	org
@GradeACue	human
@MaiderIri_	unknown
@GabySrez	human
@jin0217_	human
@CafeCocoaLatte	org
@TomsRiverOnline	human
@It_ANDANTE	human
@DeCapitaineNYC	org
@Halversons1	org
@ChefdeCambuse	org
@turaco1985	human
@OLEAIBEACH	org
@noodlestation	org
@MadHattersSOS	org
@restaurantfairy	human
@Whit_by	org
@ThisIsDaisy	human
@Philly4Lunch	org
@rinarina19661	human
@WorldFoodCritic	human
@shimon_lee	human
@bot35303538	unknown
@foodstylego	human
@USFoodCritic	human
@ryunosuke_h	human
@ilovesoholondon	human
@RTFRED2GAIN	org
@chapatiman	org
@yogyapromo	org
@star_wars_toy	org
@SpoonzCafe	org
@nickswicheswpg	human
@monhan1985	human
@dimilles	human
@snoopy1962	human
@finelivingarch	unknown
@monkeebusiness3	human
@umma_mii	human
@TabuleToronto	org
@LondonPopups	org
@MotherStuffer	human
@sherimcnally	human
@ny_on_instagram	human
@iFifaWorIdCup	unknown
@Coromandel_Roma	org
@Brianma68	human
@141Bradford	org
@morrisru	human
@azabujubaninfo	human
@SocialAlertsDC	human
@HashTagKCMO	human
@saku_nazu	human
@cheguthamrin	human
@LS_Health	org
@ImageOfNepal	unknown
@kidcochildcare	human
@LS_Nutrition	org
@EatBrighton	org
@fixyvoxitam	unknown
@Missjen325	human
@AiriSakurai1999	human
@LimonJungleNYC	org
@ToledoTalkRadio	org
@ArturoCbr	unknown
@LivingSafely	human
@LS_Seniors	human
@MOsDubai	org
@LS_Parenting	org
@Ar_Handy	org
@yknk_al	unknown
@GagFire2015	unknown
@PrasannaBidkar	human
@BruggeInsta	org
@IslandsToday	human
@wiska11	org
@RedSeaMallKSA	org
@QuotenInstagram	org
@vancouver_rt	human
@produceforkids	org
@keychro	human
@ahmadah133	unknown
@MGCafeATL	human
@BOT05971530	unknown
@HenrysPDX	org
@ExDELIGHTS	unknown
@whosfordinner	human
@CaffeVillagio	org
@soringbeauty	org
@divetolunch	human
@vivianafoods	org
@TS_tsugumi	human
@StayFiveStar	human
@BeerAuthNY	org
@Bonita67	human
@FreshBarNOLA	human
@MilliganRoselia	human
@The_Trip_Daddy	human
@de_stinction	org
@food24h	human
@pingvinolog	unknown
@BrunchCouver	human
@PeekN2Paradise	human
@sandiego411	human
@__toy__sp	human
@expo_Milano2015	human
@Estela_Dluz	unknown
@health8life	org
@ccarnival01	org
@shibuya_hana	human
@HibachiXpress	org
@Love_dorayaki	human
@houkancho	human
@sutaba_ikou	unknown
@smashburgerfans	org
@DonMofongo	human
@TheAppleFarm	org
@scotts_seafood	human
@KashaDanielle	human
@lakerfans32	human
@higekuma_sencho	human
@almstedsmarket	org
@RntaaLun	unknown
@RtRecipe	org
@rkeyserling	org
@cookingtimer	human
@Seafrontsubway	org
@palmoswince	human
@caitafondeur	human
@tiller8888	human
@Vietnamesegod	human
@HnnaGzzmn	unknown
@UDoGreen	org
@eatmybugs	human
@CasimirNY	human
@TamrCsttro	unknown
@anhonestbuck	human
@RosyJimnzz	unknown
@VctrUscng	unknown
@cafejikko	human
@sl1lm	human
@loseweightbliss	human
@NaylFons	unknown
@CarminaLancelot	human
@Olym_Picture	human
@fairyburger	human
@EstrllRmir	unknown
@grv1174	human
@airticketjim	org
@MirnCsttr	unknown
@YsiicRams	unknown
@recipesdlybread	org
@ModelModele	org
@Lau_Suarrz	unknown
@TheMarketP	human
@anaxpto	human
@KvinRoddrgz	unknown
@latinaprpro	human
@Frugal_Foodie	human
@heilbronnpix	human
@PugPug_Love	human
@souththailand1	human
@orgharvest	org
@mail4rosey	human
@ricos_pizza_	human
@SaMoFoodies	org
@MommyMomentBlog	org
@theroguevixen	unknown
@TheSixthWard_NY	org
@HurleysNYC	org
@BuzzPaola	human
@ElixirSoupJuice	human
@Jak_lillh	human
@aHousewifecom	human
@spexontoronto	org
@scenesoflondon	unknown
@royal_sportsman	human
@IndustryNightIn	org
@SiripalaBot	org
@Bacon_And_Legs	human
@XFilesFanaticus	human
@BOT95367057	unknown
@EpicBusinesses	human
@iPad4Life	human
@cecil_hoshino	human
@astronomyguide	org
@PedroNajera_	unknown
@InstaOdessa	unknown
@GP_1978	org
@DeadMouseSqueak	human
@3courselunch	org
@lilly_ravisara	human
@sweetpennies	human
@ClnEatingVegGrl	human
@BrixTavern	org
@XuntaTapas	org
@SansBaking	human
@toronto_rt	human
@AboutHealthNews	human
@SanTenChan	human
@TheAlpineDeli	org
@baptistekoy	org
@ExperienceSeven	org
@taleweaver	human
@MeerkatsNow	human
@pizza_gram	human
@Beatepdx	human
@AudreyJeanne	human
@BourbonStQueens	org
@futoshijapanese	human
@LasagnaForLife	human
@checo_oh	human
@TheBPress	org
@bot41262334	unknown
@tabetai_sagasu	unknown
@OURCHRISTMAS25	org
@KemSalleh	human
@DishcrawlKAM	org
@Merentia	human
@violaoamor	human
@wearychef	human
@AilaCorbin	human
@tamzinsparkles	human
@awesomecuisine	org
@BrineOysterBar	org
@frugalfoodiemom	human
@__nicole28	human
@giginow	human
@RestaurantRowNY	org
@kafe_watashi	unknown
@ichangemyweight	human
@OKC4Lunch	org
@Chef_Events	human
@hiltonsuiteswpg	human
@tmasada_pop	human
@janebeecham	human
@Negation2010	human
@ai_lav_you6735	org
@Befashionably	human
@TheBBDirectory	org
@socialburstja	unknown
@BarbaricIvana	human
@PassionFoodHosp	org
@loveucats	human
@newginsui	human
@recipesprep	human
@aco_nani	human
@edible_exp	org
@japan_namer	human
@UP2CHOICE_US	org
@bot31248512	unknown
@GourmetTrading	org
@TalkRadioZomby	org
@EventosNY	human
@bot33991912	unknown
@west_hokancho	human
@valmg	human
@yunpopnut	human
@KitchenMonsters	org
@airinhishou	human
@I_Love_Redgage	org
@SweepTight	human
@ezconnection	org
@FortLaudEatz	human
@DMS1382	unknown
@nom_nom_mom	human
@Igofboston	org
@PeepholeWorld	human
@ViryDiaszz	unknown
@NeuvooCsrPit	org
@Pulse88radio	human
@securetechs1	org
@bot23321849	unknown
@the_RealVegas	human
@iippuku	human
@MillesimeNYC	org
@toledokiko	human
@RadioFLL	unknown
@models24seven	human
@owenjerome	human
@LovingLeeds	human
@ScenesfromMonac	unknown
@undermusicinc	human
@ikuko07	human
@Frenchie_Cute	human
@cesegolusu	human
@ILoveBlackDress	human
@DavidNicholscNV	human
@Lindsay_too	human
@Kamaron_Kyser	human
@SB_Alliance_UK	human
@InstMontpellier	org
@MurderKingFR	unknown
@BrunchCork	org
@denverchefdude	human
@BigDaddysMix	human
@photos_redgager	human
@Theeastendgrill	org
@trendy_artist	human
@usumtwit	human
@Phoenix4Lunch	org
@TomPinterest	unknown
@downtowndiane	human
@Viviliciousxo	human
@alejandrotorio	human
@PancakeHouseCLT	org
@FeliipeCPuerta	human
@Sarun_deewani	human
@bot41001764	unknown
@Mum2MumUk	org
@PaulinaCbrr	unknown
@cookingera1988	human
@Anminro	human
@vigorstrength	human
@aNYTaxiCab	human
@DNM_Mia_Dining	org
@EZRecipes4U	org
@Hedonismie	unknown
@SchoolhousPaoli	org
@lalessiuccia	human
@galmission	org
@FillMyTum	human
@CookMeLean	human
@weLOVErecipes	org
@OKCChirps	org
@Brooklyn_1694	human
@ayudabe	human
@Yumeko55	human
@Anu__SS	human
@PureData_Report	human
@Bharat_redgage	human
@mr_whitelocke	human
@Bap2_s	human
@NecklacesFash	human
@Paellagram	unknown
@SwallowUsDaily	human
@likesandlove	human
@wine_robot	unknown
@HopskotchLvpl	unknown
@carolinelqw	human
@offortunity	human
@Atlanta_Dining	org
@mandarinfox	human
@delishealthyfit	human
@InstaKPbIM	human
@lucybeecoconut	org
@yumgoggle	human
@1sMyLife	human
@spunkysuzi	human
@cosicosishibuto	human
@sandrabeck	human
@TrucksforLunch	org
@OTereasa	unknown
@FreshlyMilk	human
@CorinthiaLondon	org
@WithABlast	human
@Nicole_Orozco23	unknown
@ImageOfIndian	org
@TeaganDaner	human
@Superfood_Vegan	human
@3rdrockhome	org
@khmerbird	unknown
@Ggerri	human
@TweetMunich	human
@Ephemerienne	org
@iamhazel888	org
@Mango_Queen	unknown
@grnmn1	org
@aarronlambert	human
@MealsAWeight	org
@ILOVELOCALHFX	org
@hashtags4wine	human
@ladericake	human
@jhulsishida	human
@japannows	human
@LindasLunacy	human
@SFFcleveland	human
@twanderingeater	org
@SweetnSvry	human
@Kmix_1069fm	human
@SpaceshipsLB	human
@foodfaithfit	human
@NanandByronsCLT	org
@diet_mai_	unknown
@wizardQi	human
@Renskitchenchef	org
@echoandrig	human
@merridees	org
@AmeliasBistroJC	org
@js655	human
@TrattoriaConshy	human
@Zscafe	human
@NewYorkPicks	org
@foodplaces	human
@elainem329	human
@PmDalila	unknown
@GFHomemade	org
@BelSteinhoff	human
@TeRry_p	human
@rayfilwong	human
@toyodome	human
@Franktuary	org
@bharatsharma004	unknown
@EnjoyCoffee_UK	org
@ilovebairroalto	org
@Sheffieldis	human
@Singhdalwin	human
@kiar0	unknown
@socialbelly	org
@LaKritchen	human
@Rkoyano	human
@tsushopperblog	unknown
@ArealSM	org
@_BodyMagic_	human
@WineAndGarden	human
@ValleyFoodTruck	org
@jets00041476917	unknown
@Tiffiz	human
@IwasEst78	unknown
@TalkNashville	org
@PoweredUpBeck	human
@xoxoMarckGelo	human
@MiamiMSavings	org
@smarmur0	human
@FNOcharlotte	human
@The_CheeksterX	human
@WANK5	human
@cob_life	org
@DomingosMoreira	human
@bharatsharma08	human
@cooljulster12	human
@bot35096327	unknown
@i10media	human
@LifeWithLovebug	human
@CharlottesW4	org
@5ChurchCLT	org
@StanleySeaforts	org
@rugbymackay	human
@TIUdaMAN	human
@BWRwinchester	human
@CyprusTweets	human
@34WindsorSt	org
@oh_big_pig	human
@gourmettravel	human
@MUSIQSUNIQ	human
@oimelda	human
@LawSchoolME	org
@AllHealthBot	human
@bot16011171	unknown
@FightCancerYes	unknown
@bloggersbest	org
@ProfessorSaving	org
@SelfieRobot	human
@JEREMY19778	human
@maruumaumameshi	human
@tomato_hi	human
@instaNewOrleans	unknown
@pan_itido	unknown
@DataGroup_Org	human
@CalicoRockMenno	human
@ClassicHarbor	org
@bharatsharma003	unknown
@charleneflash	human
@AKB48bot8	unknown
@JulietWhite11	human
@CCbyMWilliams	org
@Cappuccino_18	human
@KarinaGuar5	unknown
@sweethachi_	human
@SeafoodUK	org
@HelpMehBrian	human
@0ulu_ulu0	human
@quinnsnyc	org
@movementismeds	unknown
@Rudys_Winnipeg	org
@Lowell__25	human
@nana_snjk	human
@tunerbabes	human
@BridgitteLesley	human
@NeuvooCsrCha	unknown
@Brianmoraa	human
@MaiderIribe	unknown
@eastonFoodE	human
@TheEddy_Yes	human
@IsabelLucas88	human
@c_schreiber89	human
@MeechamDez	human
@piecesofbazil	human
@FoodBloggerAI	org
@SUPERliciousYUM	human
@NathaliaRncn	human
@CortneyJohnelle	human
@MoreToolPower	org
@JohanaFabrer	unknown
@ot62427457	unknown
@Kobonaty_Deals	org
@SaraCuev	unknown
@MonicaMre_	unknown
@LucyNetherton	unknown
@bigglive	human
@LoRoRD	org
@MyMilitarySvgs	org
@Primo_135	org
@RafaelMas_	unknown
@39551962	unknown
@cookingquinoa	unknown
@KarlaQurs	human
@brunchcritic	org
@Uuuu109	unknown
@EvaBarraz	unknown
@jetsetbarlounge	human
@MyLastBite	human
@livingtgourmet	org
@RichardEWillard	human
@RaquelAcoc	unknown
@scorpio_319	human
@pendejascaseras	human
@RelaxInNetwork	org
@NOLA4Lunch	org
@RaM_Yu	org
@darioelcid	human
@ByreRestaurant	org
@RelaxInKeyWest	org
@MetroStereo	org
@obcoffeecompany	org
@kiki_BFF	org
@emoko0211	human
@getthedatelook	human
@AlFayezReef	human
@paolacast86	unknown
@ParrotCareCtr	human
@NoraMart897	unknown
@bot77423608	unknown
@Udining	org
@CozyCountry	org
@TentsnStuff	human
@canariasgram	human
@YadiraMadr	unknown
@AngleaWojtczak	unknown
@chjssr	human
@DineOutIndy	org
@Redgage_lover	unknown
@Savvy_Fork	human
@MokhaladZubaidi	human
@urbanbohemian	human
@SWHealthyBlog	human
@MalangCafe	org
@AdelaCastn	unknown
@AllAboutDublin	org
@IsabelSrna	human
@iLoveDN_	unknown
@Sexy_Trainer	human
@KONx73	human
@ChiefBoomstick	human
@CintiaNva	human
@MapManagement	unknown
@AlexiRdnas	human
@twitmeal	org
@clipncrazy	org
@774melbourne	human
@SandraHurta1	unknown
@LaPlageStBarth	org
@Jos_eArango	unknown
@TrippinBoston	human
@JannyHe	human
@pinkbigmac	unknown
@yuki0858	human
@MaribelLozano81	unknown
@RuckstoEat	org
@MnicaRive5	unknown
@SuperiorGent	human
@onezerohero	human
@StunnerJ	human
@RocioRsas	org
@LennyHuntley	human
@thedelidoctor	org
@Scvjetkovich	human
@instaAbudhabi	unknown
@PlantBasedJJ	unknown
@charkwayteowluv	unknown
@Livedance365	human
@daisyumblog	human
@hotcurrysauce	human
@MadisonBistroNY	org
@adayinfun	human
@SocarratNYC	org
@BocekCafe	org
@breakfastweek	org
@samygiubby	human
@ApplebarJuices	org
@ID_Hendyyy	org
@ZidVicious	org
@mistress_an	human
@JasiveQuinta	unknown
@houie4equality	human
@Mia_Nikolodakis	human
@MiamiHereWeCome	org
@vanesschoi_	human
@Salvolutions	org
@CausaFelicidad	human
@bot76662908	unknown
@goestiwijoyo	human
@CheeperSteeper	org
@RebeccaGF666	human
@talkradiomoms	org
@deadheadland	org
@fuku_ok	human
@GabrucciJoseph	human
@LINEbot2	unknown
@syurumattyan	human
@TwittoSpia	human
@KimberlyAlcol	unknown
@TracyWoody_TV	org
@TaniaMonrr4	unknown
@RKAdventures	org
@Jennasm66663888	org
@pastamorefoods	org
@dodgeradio	human
@LoveEarlGray	human
@SouthendToday	org
@RoseGrdnCenter	human
@Olivers160	org
@fit_gurus	org
@_AnNaBaNaNaaaaa	human
@mothertalkradio	human
@TopekaTalkRadio	human
@VallartaVisit	unknown
@monogusaya	org
@EmbodyMoreLight	human
@BrownstoneB	org
@mtyukifield	human
@MagicOfMakeups	unknown
@sapphiremounty	human
@PhotoByPixie	human
@TheCoffeeCo_	org
@FranklinBeeps	unknown
@NetTalkRadio	human
@PeonySweets	unknown
@ElkeRicablanca	human
@DagabiCucina	human
@wildnjuicy	org
@GraciousPantry	org
@sierrax0x	unknown
@MairnMrttn	unknown
@GvMaillard	org
@TheVillaDuck	human
@AdrinVillnv	unknown
@talkradiomommy	org
@GnsisMnddz	unknown
@esteban876	human
@bot97115955	unknown
@claridadton	human
@SubwayEsher	org
@CarthyJenny	human
@JoaqnGnzl	unknown
@nenephiro	human
@Patanga_Love	human
@cafe_elite	human
@FabiolaFlor8	unknown
@tarkun	human
@00091390683	unknown
@Visit_Africa	org
@BernardNoirchoc	unknown
@TanyaThomp_	human
@annixontong	org
@AprilDearGreen	human
@Turner18Joanne	human
@EatLoveShare	org
@totsuka1147	human
@myveggieweb	human
@trudyjones300	human
@00073225282	unknown
@6blahblahblah9	unknown
@HBervely	human
@walker_va	human
@jets00052705085	unknown
@scholarship_now	human
@EmeliaAnddy	human
@LATimescitybeat	org
@AL_gmilh	unknown
@BrunchLover	unknown
@liu_meihui	human
@YisllZmrann	unknown
@AfrcHrnndz	unknown
@chris_dips	org
@00037157569	unknown
@alterjiwo	org
@katsumi911	unknown
@MissKateWi	human
@theodrops	human
@wordswithsoul	human
@Nao_Grciia	unknown
@RicardoSoles76	unknown
@alex31c	org
@buska_cbarone	org
@FartingCrow	human
@Powel_Powel	human
@whiteAnne_	org
@lisaparks25	unknown
@TomCoupon	human
@bot09105762	unknown
@afoodiedude	org
@ArmanTjandra	human
@SwiftTrust	human
@KathleenWlka	human
@LadyBrittanyMoo	human
@PowelCarrie	human
@slbirchy	human
@FlowaRowland	human
@KathiesCloud	org
@HannyLast	org
@0001353811	unknown
@LatinoFoodFest	org
@LeonSanchezA4pX	human
@Fasiontolive	human
@wineladyjo	human
@JillMorgan_	human
@BansteadNetwork	org
@bachelorbasics	human
@bravoristorante	org
@CathyJohnson_	human
@goafterthearena	unknown
@MariCanCook	org
@WFM_Symphony	org
@LEONARDSIMPSON	human
@AfricaTrippin	human
@ModernHatch	unknown
@WhiteCarla_	human
@stewardsjohn	human
@joanwhite25	human
@00094060091	unknown
@mozodejaf	org
@Best_Nora_	human
@MariamHierro	org
@jewelscostanzo	human
@Houfoodpark	org
@CrlssLrra	unknown
@andreaYates_	human
@dyqeqebuhe	human
@kinkaizakaya	human
@LangyawMedia	org
@InstaMaidan	unknown
@HedyHrmdaa	unknown
@MagicBerlinda	human
@ZenBodyArt	human
@ToWhotofollow	org
@s00061936646	unknown
@EasterYeoh	human
@MissJones300	human
@ChristinePark_	human
@healthy_eating4	unknown
@richenyc	human
@AnnySpierce	human
@Audreystewart_	human
@0004899865	unknown
@Luis_Crmnn	unknown
@maydouglas490	human
@timmy_nolan	org
@AnnGzmaan	unknown
@BarbaraJhnsn	human
@MteoRivr	unknown
@JDonedeal	org
@extravirginshop	org
@ecgatchie	human
@Ivy23Smith	human
@jets00007919	unknown
@TheBrunchBoys	org
@imJBRubianes	unknown
@ff_I_retweet	human
@CathyAllen_	human
@estrellaines8	org
@sarabethsnyc	org
@onakattpekorin	human
@kei_takemoto_78	human
@The_Red_Goose	org
@JOEDOEchef	human
@instatweetslove	human
@CeciClooney	org
@christiespierce	human
@BeingIPKKNDian	human
@lucascabow	human
@claudiaAckmn	human
@ytv_marketing	human
@BCLittle	human
@KyotoyaJapan	human
@RattleNHumBarNY	org
@VioltDran	unknown
@MALENAGONZALEZC	org
@EstbnMnddz	unknown
@e5bakehouse	org
@claridad37	human
@CarolCastroenam	human
@homemadehooplah	human
@JaBistro222	human
@Naijaknowhow	human
@lifetotable	org
@its_a_fab_life	human
@veggiebuzz	human
@irislovesbirds	human
@kpop4eva83	human
@shava12000	org
@chendelmundo	unknown
@mariamentirasnj	org
@0056211002	unknown
@JSFashionista	human
@VivClymo	human
@MojaveNYC	human
@Twohungrymen	human
@kingdomofwench	human
@okamotoorimono	human
@AlTarf	human
@ChampagneChat	human
@FitnessRepublic	org
@caydge	human
@HellasTweets	human
@sproog50	human
@mirai1201	human
@MCBPendleton	human
@FoodBlogCT	org
@GreatMealIdeas	human
@SpottheBot	human
@095772085	unknown
@mygoodnessg	org
@PoweredUpLinda	human
@PancakeHouseSC	org
@ojiro_b	human
@PoweredUpSandra	human
@QueHacerNMadrid	org
@posetobehealth	unknown
@NeuvooPTNY	org
@AlxxMrttnz	unknown
@HKane14	human
@restaurantecafe	human
@Denver4Lunch	org
@FitCalENGLISH	org
@FrugalNavyWife	human
@DNM_SD_Dining	human
@KeepCltBoring	org
@MarryWannah	unknown
@cancerchronicle	unknown
@stacialau	human
@Kuro_Mike_Nuco	human
@RecipesGlobally	org
@PoweredUpGirl	org
@PrettiBoiRob	human
@FamilyLiveWell	org
@racism_radar	unknown
@PMF_NYC	org
@Rodamusemen	human
@where_waldo_at	unknown
@monnburan_	unknown
@nuit997	human
@Lifetastesgoood	org
@PCC	org
@retweetstreet	unknown
@HoustonTalkRad	human
@GrierMountain	human
@viniciusagudo	human
@bot75077780	unknown
@DJDemolition	unknown
@OnassisNetwork	unknown
@origamititi	human
@tripleohunni	unknown
@tripleoStorm	unknown
@bluebayholding	human
@GoldrauschEntS	human
@leejungand	human
@CochonDining	org
@runwaywalker	unknown
@FitFamProducts	unknown
@TURNTUP2DMAX	unknown
@zyp614	org
@TheTipToeFairy	human
@MyTravelLuck	human
@femalicious	unknown
@ZaffranRstrnt	human
@Chef_Jay	human
@peace_of_green	unknown
@phatkatkitty	unknown
@sofievwinkel	human
@hihidco	human
@asianmarketrd	human
@TalkRadBusiness	human
@foodieengineer	human
@CoachBeckMedia	unknown
@curryNOprince7_	unknown
@FoodMayhem	human
@AlfredMus	unknown
@0009708941	unknown
@CoriSueMorris	human
@PinningFiend	unknown
@SBs_huttstreet	org
@LosingWithJenny	org
@Hungry_Runner	org
@Portland4Lunch	org
@FoodOnSale	org
@phoebetime	human
@AmerDairyAssoc	org
@MirnaArtg	human
@FitnessRetweets	human
@bot09619973	unknown
@48hippo	human
@PoweredUpRadio	org
@cooksno7	org
@MLVNsetiawan	human
@tn_Vegetarian	unknown
@SalsaLive365	org
@yimeka	human
@TempoFoodDrink	org
@parisfind	human
@OutfitsFash	human
@mayqoo0116	human
@HiltonToronto	org
@YVRRetweet	org
@TuscanyCasino	human
@north_van	human
@hiromi_ohtani	human
@negio1826	human
@Crybaby_Joan	unknown
@maiphaithai	org
@RT_Sensation	human
@cocinitas_na	unknown
@zitakude_	unknown
@PecheNOLA	human
@TripleOMedia	unknown
@jaybeeshotdogs	human
@cecilcut	human
@LoveNerdMaggie	human
@kerigans	org
@HiromiMochinaga	human
@MangetoutGrill	org
@SAMADIJEDDAH	human
@LuisBron_	unknown
@bharatsharma001	unknown
@MMPNorCalRegion	human
@SunnybyAcecafe	human
@AlejandraAdms	unknown
@shjah2	human
@debthate	unknown
@bot79884775	unknown
@yutakaneokan	human
@HIRAKU_HPS	human
@laag5	human
@Phyksios	human
@ihatejoevany	human
@floatingkitch	human
@JeamyVll	unknown
@migueltrapito	unknown
@glassdoorsd	org
@TWDera	human
@SarabethBakery	org
@MarkossMiller	human
@oneshotcoffee	org
@KaisenDon_bot_	org
@luvodkalu	human
@2SPWilmington	org
@RGangEatery	org
@bot40402624	unknown
@MariaJimnez_	unknown
@AberconwyHouse	org
@MettalRyan	unknown
@LeydaAn	unknown
@delallofoods	org
@TheKitchenVixe1	human
@PolishCuisine	human
@lastcrumbcafe	org
@LauraPrc_	unknown
@UAEBrunch	human
@vlmoura_	unknown
@souskitchen	human
@bot29192938	unknown
@LiveLongRadio	human
@imtheweatherguy	human
@atyshakira	org
@Dirty1_	unknown
@Lizziemarie_22	human
@turinepi	org
@LaVerandaRoma	human
@jujubaystars	human
@LaAvenaQuaker	human
@GracielaChn	unknown
@instaGangnam	unknown
@GSBHauteCouture	human
@djchangg	human
@goodeatsmeets	org
@OneRainyWish	human
@denverfoodguy	org
@torako_o	human
@Himanshu5522	human
@covertress	org
@Kristin_406	unknown
@AshfordNetwork	human
@TwinkleMie	org
@oshiCurry_bot	org
@JuanCcln	unknown
@vivianyong92	human
@jonnwong1282	human
@ronaldyohann	human
@aft_bar	org
@danavento	org
@PinkSumoCT	org
@KingCallis	human
@KidcoKitchen	human
@hashtagmechelen	human
@ElizabethGarnet	human
@namasayasaya	human
@OnlineCDM2014	unknown
@CommonRemedies	human
@MIKESWIZZ	human
@rhondaberglas	unknown
@MartinPere_z	unknown
@Jerk312	org
@LUXBARChicago	org
@zyobusu234	unknown
@tour4ubot	org
@LiquidRestobar	human
@SnittyFitz	unknown
@NathaliaVlsq	unknown
@ChelsAmer	human
@PhoenixTalkRad	human
@yasue27	unknown
@Opa_Jamaica	org
@MayraRoa_	unknown
@tedadnan	human
@fanzofbarca	unknown
@Prawnographix	org
@EasyHomeMeals	org
@_OnlyTheVamps_	unknown
@FreeDinnerFor2	org
@RashmiUdaySingh	org
@n_x_z	human
@SasakiTime	human
@WatchSouthend	unknown
@Maryoumi25	human
@jiffyrecipe	human
@LEO_snacks	human
@cuccu	human
@InfuzionTulsa	org
@ashleythien	human
@AikaKamisono	human
@coupefeti	human
@FitnessReTweets	human
@ColleenAfan	unknown
@CuttersCrab	org
@RosaritoFish	org
@zyp1n	unknown
@rick_yakuza	human
@Dawn_Stines	human
@markmorillo	human
@808marv	human
@gran_tourismo	org
@RaiGulp	human
@LeeHillerLondon	human
@AngusSteakhouse	human
@Abi_GAMIRANDA	human
@creamssouthend	human
@1DougSimpson	human
@BoCaribbean	human
@growyourbiz101	human
@RobynsWorld	human
@OwnOurOwnMusic	human
@BrunchFr	human
@seductivestorm	human
@PerfectPizzaCam	org
@circlingsquare	human
@ooo_rkr	unknown
@bot52345097	unknown
@AveleyNetwork	org
@CoolStuff2Get	org
@RailYardHobo	human
@NashEatBeeps	org
@CoralKeers	human
@kisaragishow	human
@guttulus	human
@RoseCottageGirl	org
@meatloaf169	unknown
@RealTalk1Hiphop	org
@healthykids	org
@kien1tc	human
@mandipie4u	human
@PoweredUpMom	org
@DelectablyChic	org
@idumijet	human
@Wijnronde	human
@NirvanaNY346	human
@Photobug52	human
@Shumadinko	unknown
@Networkinleader	human
@papa_leos	org
@VanessaOneNOnly	human
@nine3quaters	human
@e_toile	unknown
@GetMyHealthyOn	org
@LCCotter	unknown
@HauteSucre	human
@EnQroo	org
@kinbus	human
@SH_nutrition	org
@hongkong1997	human
@ChiTalkRadio	org
@RelaxInFTL	org
@PLANET_P_EXO	human
@sa_kyou	org
@FoodtoEat	org
@mcnallyd	human
@chiarabiasi	human
@NYCE4LDeals	org
@marlinwoosley	human
@pichetong	human
@GalvnMari	unknown
@BeerRetweet	human
@rhousewynwood	org
@KevinPerelman	human
@CbusStreetFood	human
@DogTreatNews	human
@peva_zajot	human
@docsconz	human
@imgrecipes	org
@FreeHolidays_	human
@muzlia	human
@v_crooks	org
@DiabeticMedia	human
@Pitti_Immagine	org
@bangyongukk	human
@LuvieAngie	org
@LeedsReTweet	human
@JoselineZavl	unknown
@ComSenEss	org
@BOT58174310	unknown
@inspiredhandh	human
@yvettecollins1	human
@maria_manila	human
@highlowfooddnk	org
@nannndo_fsr	human
@zarstardesigns	human
@klaricervante	human
@D_Alefaio	human
@introbiz	org
@55tazy	org
@ParanormlSpirit	human
@Cheerios47	human
@Guillorysdeli	human
@BaconBaconSF	org
@goodhealth	org
@instamacau	unknown
@TalkAustinTexas	human
@ianlow32	org
@Meal_it	unknown
@babysumo	human
@How_To_Eat	org
@TEXT4SUCCESS	human
@LaurenNNixon	human
@Seller58	org
@shiyamsundar	unknown
@FSJakarta	org
@randommanctest	human
@WestsideFitLA	human
@aSFOTaxiCab	human
@edelsonhames	human
@DripnSip	org
@BeatrizVlzq	unknown
@80breakfasts	human
@Gossip_Gorilla	org
@mitaka_masudaya	human
@breakfastchild	human
@Jolitabrilliant	human
@sandro_santoni	human
@CapriItalianMSR	org
@TrickTreatOrPic	human
@Ritsukonam	human
@Do_4SeLF	human
@LuciaStlo	human
@becky_ying	human
@Kaliforness	human
@florathetty	human
@InstaSimferopol	human
@ZuhauseQuito	org
@pinkelephantu5u	human
@old1962	human
@CoffeeWithUs3	org
@mrsslurp	human
@kebird86	human
@HildaEstr09	human
@Grain_Bar	org
@tanakay1985	human
@iforicarus	human
@fottmeals	org
@JonnyExistence	org
@lunchtimeview	human
@ClevelandNewzer	unknown
@WritersUSA	human
@nineov	human
@tasteofphillyxo	human
@phycoinsc	org
@alat_pijat	human
@jlevinsonrd	org
@RedneckRag	human
@TedMarra	unknown
@mrsworththework	human
@TandCMiami	org
@1MandaBear	human
@Erin_Journey	human
@agneslaurens	human
@shawmainstreets	org
@superthaifood	org
@JeanneAndGaston	human
@rt2eatpro	human
@MissMarichu	human
@somahira	unknown
@No7HotSauceTO	org
@ADashofSanity	org
@ykm716	human
@Sonya4life1	human
@CandypantsDXB	org
@RelaxInParis	org
@CShopaholic	human
@et_peacehouse	org
@SanremoGram	unknown
@CoachsTalkRadio	unknown
@weatherbotman	unknown
@Besaws	org
@WappingMarket	org
@vivianivette4	human
@ArlnovK	human
@El_bon_menjar	human
@HarajukuDT	human
@koikashi_bot2	unknown
@OldFashRecipes	human
@bot96372140	unknown
@enmweather	org
@RelaxInCanada	org
@kun_morita	human
@SlimmingWorldNW	human
@thegraciouswife	org
@IcemoonPromo_SP	human
@satnightfoodies	org
@cleanandproper	human
@_FireIce	human
@_sarahdavies	human
@hyperjeppi	human
@MyEveningOut	human
@SUPERCUCHILLO	unknown
@mikeandsilver	org
@nescio75	human
@cassandrabianca	human
@slenderplate	human
@SheRocksFitness	unknown
@AnaizSanrego	unknown
@WeeklyTravel1	unknown
@cmcgeesdeli	org
@monikura1115	human
@tonkotsu_ganko	org
@ynot_1980	human
@rockNhousewife	unknown
@HussamAijaz	human
@ts00029021359	unknown
@indigomemoirs	unknown
@rubis0704	human
@hawthornsdeli	unknown
@LifesaBowl	human
@AlejndrJmnz	human
@miya_x2	human
@Raleigh4Lunch	org
@OldFaithfulGysr	human
@KurataD	human
@IceSupreme	org
@WilmsReTweet	org
@TravelDealsInt	human
@loversoulcafe	human
@GantShirley	org
@SchadenJake	org
@dhabbublogger	human
@Recipe4Living	org
@EatDrinkLucky	human
@Fox_Sera_Fox	unknown
@2spkennett	human
@yoshinani_	human
@courtneyfaye226	human
@ProntosGrill	org
@AustinTracyW	human
@Rorry_84	human
@kyroskoh2	human
@benibonnietta	human
@CoachMultiMedia	org
@Earthangel516	human
@HaleysHomemade	org
@Dallas4Lunch	org
@SixSistersStuff	org
@RomuloMayo	human
@JaimCrmnna	human
@kenmoo	human
@DavdRyss	human
@00032707711	unknown
@Lazardi	human
@PatronNYC	org
@AdventureYum	human
@MicheleDBeal	human
@043156874	unknown
@jchang587	human
@0084989904	unknown
@Genshere	unknown
@chunky_me	human
@Datruthh_	human
@RandomYerevan	unknown
@anneusm	human
@foonaReview	org
@gmr_vinyldigger	human
@NapoliCucina	org
@NewYorkRetweets	human
@deWildePIX	org
@My_Giveaway	org
@eko_dog	human
@FranklinDaily	unknown
@MarriRuizz	human
@SuperGreensGuru	org
@Bottlefork	org
@DianMrllss	human
@lifecarstyle	human
@Vanityz	org
@Amotekun1	human
@laatro	org
@itsRaynniere	org
@CookshopNY	org
@thehumblepig	human
@3jsb_tsuneha	human
@privilaze	unknown
@Sharvab	human
@Graineron	human
@DailyGawker	org
@MoopieHead3	human
@g_kohls	human
@DanielRmos	org
@thelatinkitchen	org
@ReoIAM	unknown
@nenekayo	human
@instaYaroslavl	human
@The_Determined1	human
@EssexBlog	unknown
@howardwong1	human
@ErnestoMach75	unknown
@lpyannie	human
@MrRobo2	unknown
@HouseOfHo	org
@becausestartup	human
@LittleRichBoys	org
@MastK	org
@BuffaloTalk	human
@adoctorandanurs	human
@moku_maneko	human
@aSH_N_Tea	human
@SFFDurham	org
@Perf_ume6420	human
@Adaptive_Slayer	human
@TheImperial577	org
@monicayenny87	human
@EnRouteGoa	org
@MerMadeNDaShade	human
@Newcast_le	unknown
@SSpoonfuls	human
@AvivaKanoff	human
@MKCaters	human
@siushun81	human
@Hotdogzandmac	org
@kimvoss	human
@chatorasden	org
@ShitSheEats	org
@ATSocialMediaUK	human
@simcom86	human
@irwan_ariffin	org
@Falafel_Junkie	human
@dawsonink	human
@CleanLeanEating	org
@CeliaCrmnaa	org
@AthleteTyler	human
@BiteFive5	org
@R77agaDelight	org
@CastlesCatering	human
@Data_Institute	human
@toddperrin	human
@LeandrJmnz	human
@SFFRaleigh	org
@NeuvooCsrNas	org
@junetanyp	human
@Cuisine_Lover	org
@savanrus	human
@Hungry_Uncle	org
@SaladeliaCafe	org
@mommye	human
@tokion17	org
@crossoverstyle	org
@GoalSetRadio	org
@GuantanameraNY	human
@FunLife4eva	human
@55lunch	human
@marutonn	human
@InstaTravel	unknown
@ChefBloem	human
@web01football	unknown
@RelaxInFlorida	org
@cooking_image	org
@NeuvooCsrAtl	org
@MoodsofFlorence	org
@cclounge	human
@mamato3blessing	human
@ParamourWayne	org
@lifenutrition	org
@keithpp	human
@wannatravel1	human
@instagramdubai	org
@JRNYCProperties	human
@chrisbaclig	human
@GeraldTuel	human
@gingerlyyours	human
@hashtagsavant	unknown
@namekudi	human
@Difamili_DF	human
@aarronlambo	human
@eviivo	human
@FitCalESPANOL	unknown
@ChicagoE4LDeals	org
@JoannVitali	org
@debpuchalla	human
@PureDecisions	human
@CopperFaceJacks	org
@MientrasCabos	human
@wine8guru	human
@AdalbertoRiz	human
@ariko418	human
@johandjayanto	org
@t_chef	unknown
@mehmehlamb	org
@AnaNiRibeiro	org
@RichardDavid_1	human
@thebridgecford	org
@JeanCardillo87	human
@HOUWeightLoss	human
@PhreePhood	org
@ADOTRADIO	human
@InstaSevastopol	human
@Piazzina	human
@donkey_cool	human
@RichardIsom72	human
@candybreak	human
@BarunS_Apple21	human
@amomontheside	human
@theburgernerd	human
@DeltaBess	human
@NDLoop	human
@Charmeandmore	human
@gaynycdad	human
@FlippedOutFood	human
@TheCuteCook	human
@Le_Brunch	org
@broombeck	human
@western_rice_bc	org
@stirthepots	human
@KrystalMartel	unknown
@TripDaddyEgypt	org
@Chucktown4Lunch	org
@NWAtruck	org
@shintaros	human
@Dineandwinebali	org
@jcsean0808	human
@aritaifwin	human
@SpikedStilettos	org
@ArtandSoulDC	org
@StefanW	org
@thelimerickpub	org
@barleycornnyc	org
@IlBuco_AV	org
@BroccoliGrowers	org
@WestEndRetro	human
@GracieJoes	org
@mspawn	human
@Ceci_NYC	human
@gourdonville	human
@HungryRabbitNYC	human
@StacieinAtlanta	human
@melaniehaeli185	human
@SelfieInstagram	unknown
@hookedonheat	human
@WOAPRadio	human
@blm03	human
@onlyyouhotels	org
@nottinbutaig	human
@tennesseecompan	human
@japanesefood	org
@butako45	human
@etiqhour	human
@MetroBrasserie_	org
@lantanacafe	org
@ohta198768	human
@laloterianyc	human
@Lunsjklubb	human
@SPRTG1	human
@ThrushAndSon	human
@bigniceburger	human
@ricette_infiore	human
@RealJerkToronto	human
@EnzosMarket	unknown
@mermaidtaverngu	human
@FevziyeSurmeli	human
@25_shanz	human
@RT2EAT	org
@theyumlist	org
@bruench_popup	org
@BubblyTalkRadio	human
@mojaprvasrpska	unknown
@JanaLake	human
@ManicomioCity	org
@ATSocialMediaRT	org
@antoniorealty	org
@joloperez	human
@ClassicFLL	unknown
@moe_nagoya	human
@VeggiesnDogs	unknown
@LelandMM	org
@RachelleGartman	human
@regramism	unknown
@NDetroits	org
@yasarsamanci	unknown
@andycalles	org
@WokingTalk	human
@Palomino_LA	org
@RahemaSW	human
@JJFoleysCafe	org
@AaronYariv	human
@AlvinZorDi	human
@SanJoseTalks	human
@rolandgonzales	human
@KetchingupTom	org
@ComeAndGetIt416	org
@d_gilbert_remax	unknown
@Petzanders	human
@nalync	human
@Love_Grub	human
@BakngInATornado	human
@cookeryatlas	human
@nakamura197851	unknown
@WestSussexTalk	org
@sdevarax	human
@eatatnanoosh	org
@feistyfoodie	human
@rekraPseW	org
@SouthLadyCooks	org
@PalominoIndy	org
@uru3sei	human
@prettygalbee	unknown
@theloulougirls	human
@ccelli	human
@JRMG83	human
@dorkingksa	human
@Brummie_Santa	unknown
@Tracyshaw1226	unknown
@hmiblog	human
@TruckSplendor	unknown
@minhao89	human
@SacWomensExpo	human
@theglobalfoodie	org
@TheDailyDishDC	org
@COW_ORKING	org
@YateleyTalk	human
@BracamonteTV	unknown
@movietortilla	unknown
@ifoodtv	org
@LabNoon	human
@williamenafox	human
@FAB2_KK	human
@Oh_Kale_Yeah	human
@IamMotivatedNow	human
@BASHEROHARI	unknown
@bizyo_gazou	unknown
@Dios_y_Janjo	human
@MRX_Robot	org
@TastyStreetFood	org
@EduardoCntr	unknown
@AlaskaRadio	human
@Sydneycool	org
@LocalYolkl	org
@wanwan023	human
@KitchanBathroom	human
@lift_behappy	unknown
@giorgiola77	human
@bittermutter	human
@FennsQuay	org
@MomMaven	human
@Tea_Grandad	org
@MamaMummyMum	human
@ochriscastro	human
@Sylvestermouse	human
@GCaraman	org
@StrongMamaBlog	human
@DIVINELUKgroup	human
@PierrePierreOKC	org
@gotolosethisfat	human
@LivinLovinSweet	human
@ManyMay	human
@trendydanie	human
@WorldOfClaire	human
@WhiteHart_Duff	org
@CRHealthBlog	human
@h0kag3s	human
@Delagalway	org
@halifaxns_rt	human
@elisatalk	human
@yuji29886	human
@stagetecture	org
@isokawa51	human
@ilrg13	unknown
@BaccosFineFoods	org
@piyawat	human
@staticmm_chi	human
@AdeleFaucher	human
@AleshaYepez	unknown
@ichino2010	human
@akgzul	human
@princessme820	human
@masacco	human
@pierreharley101	org
@BudoMedia	human
@thelocalpeasant	org
@craigroyle	org
@LMarkJOfficial	unknown
@lafavelabali	human
@anilapeter16	unknown
@HeriCer20	human
@BobBackwardsLA	human
@06Ry9	human
@TorchBistro	org
@mo_karena	human
@foodyfoody	human
@theabple	human
@FSMexico	org
@CNRkitchen	human
@LePeepB2B	org
@eatsmartbd	human
@raymondtan85	human
@CraftCocktail	org
@homemadelv	human
@amaino_sukisuki	unknown
@Anjuladevi	human
@hotelscenes	unknown
@KitchenSprout	human
@HaveSippy	human
@AinsworthPark	org
@CoRadilla	human
@nokosazu_gohan	unknown
@barossamum	human
@YuiCMMU11A	unknown
@travelguru3211	human
@pawenaporn	org
@JadeJadore	human
@benjamintull	human
@yuppiecheff	unknown
@flouronmyface2	org
@WaverleyTearoom	org
@MarceSandovalG	human
@sakra_orange	human
@BelgardKitchen	org
@JManMillerBug	org
@Mchesterretweet	org
@BillericayTalk	human
@RebecaMndz6	unknown
@ZACHTISDALESHOW	human
@foodhunterguide	org
@luoluo830	human
@MaryShabazz	human
@BabysBBsOC	org
@zealorganic	human
@GeorgeJones80	human
@ParentsofOMM	org
@apuliasocial	human
@trinamylovebar	human
@Mspowerbomb	human
@sonupsales	org
@jacquelineoross	human
@Gitanelondon	org
@ottawa_rt	human
@instacopacabana	human
@ShaniDixon	human
@gwendolinechen	human
@InstaVenice	unknown
@RealNutritionNY	org
@Manchesteris_	unknown
@SelveraWellness	org
@MelinJua	unknown
@FlawedEngineer	unknown
@LoveMyFoodApp	human
@cafesophies	human
@NilesPieCo	org
@obentoart	human
@chikyat1	human
@dentistmel	human
@carolynlgray	human
@PromenadeBarNYC	org
@piatto_shibuya	human
@PigandDuke	org
@2CookinMamas	org
@FlicksandFood	human
@BasingstokeTalk	human
@winnipeg_rt	human
@ImageOfPakistan	org
@nyadleeh	human
@khimbertha	human
@MOONCAFEhonmoku	org
@mezedc	org
@IDorofeyeva	human
@ScalesOnFire	human
@ahowtorecipe	human
@BonBonBreak	org
@CasavanaMiami	org
@HippyGiftShop	human
@madalmadal	human
@DCDreamTeam	org
@XxLuvIsBeautyxX	human
@kitchology	human
@BroadstairsTalk	org
@cucaflavor	human
@HeightsTavern	unknown
@MikeInTownCUN	human
@LifestyleSoln	org
@immaeatthatblog	human
@stepyeats	human
@ralphmara	human
@howbona	human
@Sukhothai_	org
@NadiahJaapar	human
@robcastrichella	org
@hikarinoma	human
@00001307791	unknown
@Duivelsei	org
@LissaGmz	unknown
@sign4baby	human
@GennyRom_	unknown
@si_kwok	human
@TommyGENIUS	human
@HalifaxAgain	human
@SGVekNZ	org
@bot02672857	unknown
@SoupCurryYellow	human
@vilijabart	human
@NZoulfikar	unknown
@laribione	human
@AJShannon	human
@Foodiechats	org
@celivyy	human
@RecipeforLife1	human
@rahajna	human
@tinocrane68	human
@bountifuleatery	unknown
@candypantsevent	human
@EdwinEVolve920	human
@kospleda	human
@megazrul	human
@CeruLondon	org
@NaturesBakery	human
@DennPz	unknown
@gastronovoyage	human
@PiconeFineFood	org
@chef_kantan	unknown
@HappyEggCoUSA	org
@yasuko_2010	human
@iamangelibas	human
@MoffettGeorgia	human
@lansdownespy	org
@DaNewYorkTimez	human
@iamtheshopking	unknown
@AldershotTalk	org
@BackBayHarrys	org
@HomemadeDelish	human
@YoYumTum	org
@kellymarie17	human
@MissLilysChat	org
@theSoupCup	human
@ichigo130615	human
@gustosemplicita	human
@Divin3r	human
@aberjp	human
@vigantracker	unknown
@WirelessMediaMX	org
@RollnLobster	human
@KattyVela3	unknown
@WorIdChampions	unknown
@Share4London	human
@lifestylings	human
@puranut	human
@awinfr1	human
@NutribulletUk	org
@CheltReTweet	org
@VallartaViejo	human
@elsbro	org
@yogajuicegirl	human
@chefbuckwheat	human
@dalealswirlbot	human
@ElComelon305	org
@briannaDua	unknown
@Cooking_a_storm	org
@Cariocabrixton	org
@FashStreetStyle	human
@dudeletseatt	human
@DIY_Repairing	org
@foodsbury	human
@VoyagesLive	human
@JennyHeredia34	unknown
@SuratFood	org
@PizzaHutJm	human
@jonathanchee315	human
@urfoodmedicine	human
@Baltimore4Lunch	org
@atwbp_blog	human
@PuleosGrille	human
@GeraRangel22	unknown
@idazrehab	unknown
@EatLikeULoveU	org
@richardrico6901	human
@LisaMercier88	human
@LauroSrnn	unknown
@ShellyRaihala	human
@PainDavignon	org
@cromerspnuts	org
@adrienchan	human
@jshflrz	human
@BabyBlomfield	human
@HealthyXpress	org
@LyndaYBaker	org
@yama_taka7	human
@BeachyIgor	human
@LetyMarn_	unknown
@MichelSt_4	unknown
@YumboxUK	human
@bogotawebradio	org
@ScottVelasquez	org
@HillHouseRock	unknown
@LoL_Akali_kbot	human
@artsavesyou	human
@organicmealscol	human
@okahiyobot	org
@NOLAFusion	human
@IggyboyB	human
@iamthegarysia	human
@carleyvrgs	unknown
@PaleoPornTV	human
@ken_ragsdale	human
@tgtbtf	human
@damian_emman	human
@Socialreykjavik	unknown
@spydermanuk	human
@BegNaim	org
@DJSIGHT	org
@cgeclectics	org
@Shopping4you	org
@Loveeveryone88	human
@SavoyBrasserie	org
@Xerendipity	human
@LA_Newzer	unknown
@chazii_n	human
@AnthonyFultz2	human
@SusnnGnzlz	unknown
@TiffanyVann4	human
@AlbanyTalkRadio	org
@FMInternetRadio	human
@allofmcr	org
@IndieFLL	org
@Austin4Lunch	org
@NinaResis	human
@IvansMeatsDeli	human
@maurobernoco	human
@hotel_la_pace	human
@AMagnificentMes	org
@SegafredoPbrk	human
@NeuvooTraSF	unknown
@ZiaraCstll	unknown
@Lilie_Maggiori	human
@jknakas1	human
@miyumiy31160410	human
@ThannizJim_	unknown
@NinaDetoxPills	human
@vieatnrun	org
@Oscarscafebar	org
@swagtreat	human
@DaughterEatery	org
@ActivewearUSA	org
@Work_It_Mom	org
@Kitchycooker	human
@MealsVegan	human
@DarinkaRs	unknown
@MooseBeSocial	human
@Clerkenwell_Boy	human
@bouchon_bakery	org
@kfcjamaica	org
@cookwithlisa	human
@thruherglass	human
@MarcoErmini_23	unknown
@LoisHottest	unknown
@Fabi_Btncrt	unknown
@quericavida	org
@VitalityNinja	human
@kobento_japan	org
@lovemygirls78	human
@Tysntny	human
@husmarried	org
@Rio_0120	human
@RoamPlate	org
@PotsdamCoop	org
@MichelleLKent	org
@sweeeeeetiePie	human
@ColumbusTalks	human
@kishiarora	human
@SomsakGaewkra	human
@coolcitycat	human
@ClubCabeza	human
@milkchocolat07	human
@egawa31	human
@lennym718	human
@reamol665	human
@Nashville4Lunch	org
@chocosdkadi	human
@ShitGrownupsSay	human
@AbbeygailWestle	human
@TheChesterNYC	unknown
@BoiseTalkRadio	org
@CoyoteCafeNM	org
@BizParkFoodies	human
@margaretu69	human
@WickamXari	human
@CodigoFoodie	human
@DunkyJP	org
@ZHANESSAG	human
@HotSandyBeaches	org
@pfac51	human
@UsagiYin	human
@AtlantaXPLRR	human
@JuanFragos	unknown
@VioleMrin	unknown
@Dutch_Farms	org
@HowardJh1988	human
@tomoru_n	human
@taisetu_zinnsei	unknown
@oqobatayoxes	human
@FoodTruckCity	org
@EatableMe	org
@joannekaien	human
@SavvyNStilettos	human
@AsDinner	unknown
@love_stones	human
@bohemian_bbq	human
@MaureenArnold10	human
@joel38jackson	human
@eureka0501	unknown
@dgbars	human
@mertscharlotte	org
@bibikpoh	org
@okfood_bot	human
@ManicomioSW3	org
@Blogghetti	human
@poutineparkas	human
@TRINICOOKS	org
@MalangTwitTwit	human
@KariLpz99	unknown
@rodelo_diana	human
@DistrictCommons	human
@kantan_oishii	unknown
@gadjfly	org
@EatGR1	org
@yang_sh_cn	human
@TheFoodPervert	human
@Liberotoyoka	human
@ScottySauce	human
@pomacious	human
@iauuu	human
@DinnerAm	unknown
@FIGHiiT	unknown
@tapandtrotter	org
@SenorBlanco1	org
@scullywally	human
@theneeds_food_	unknown
@CPAMobley	human
@LApicks	org
@ryouri7394	unknown
@rbrosemer	org
@KWSKAN	human
@weilei_food	org
@MaruTakeC	human
@cookinacurry	human
@ContestGnome	unknown
@Hits78FLL	org
@trendinghangout	org
@anacatal	human
@gohan_sekaiichi	unknown
@Chef_Gregorio	org
@RawPrescott	human
@jordy_sealey	human
@AsimZubair4	human
@kathyarvis	human
@ByHiking	human
@hachibayenri	human
@LatinaR2	human
@massicecco	human
@BrokenPurge	unknown
@laboulangeblog	human
@JamieDeRosa	human
@nm_edm	unknown
@thisisgorilla	org
@feri9690	human
@jamesmartin2001	human
@St_CataLeya	human
@GettingStamped	human
@NinaLaT	unknown
@bettycarolyn88	human
@Ainsworthnyc	org
@k_yamaya	human
@MINXDIVA247	human
@BLDBeverly	org
@TakeoMaruo	human
@lisboavida	human
@InstaSitges	org
@travelair283	human
@jknackstedt	human
@iamgiff	human
@DBmediamaven	human
@KimGrimmer85	human
@ArchdBanterbury	unknown
@rennaikagaku	unknown
@SchanzeBioEssen	org
@PalladiumFamily	org
@luztinney	human
@LaCabanarest	human
@_dinner	unknown
@bontomchef	human
@LayaliMiami	human
@rubenrainbow	org
@surasit_ton	human
@Adayslifecom	human
@paulmdugan	human
@SergioArjona	human
@homehacksblog	human
@mexigreece	human
@Shop_n_Dine	human
@SevilleQuarter	human
@dining_lan	human
@juicylife_j	human
@iamanonymous30	human
@WilsonAvans	human
@ConnieImage	human
@cathysmith0782	human
@CeciFranco_3	unknown
@JessicaRoque82	human
@rafelay	human
@BBW_SummerICE	human
@chef__anas	human
@MGonzalez90_	unknown
@gourmetologo	human
@nidalittle	unknown
@snootful	org
@RedkissesbyT	unknown
@youkai_whisper	unknown
@InstaZaya	human
@2guyslovefood	org
@Tiannas_Cafe	human
@Londonislovinit	human
@cook2go	unknown
@LeRichmondMtl	human
@TonbridgeTweets	human
@oneonelee	human
@glblfitwrldwide	human
@jeabchan	human
@GabyFauchon	org
@MarianaCls4	unknown
@luvnats	human
@IamThatAuthor	human
@VoodooVan	human
@onezae	org
@DA_B_EAST	human
@BobbyGree	human
@PlanetJennyATL	org
@SweetStoneCandy	human
@TheGablesCFord	org
@Businewss_Bot	human
@3treesmaa	human
@AdAtTube1	human
@TalkAboutBALI	org
@ILiveInEastVan	org
@Weddings4u2	unknown
@KoshariStreet	org
@brightlights72	org
@SUOMI_1	human
@AppleGreenLuna	human
@AFewHungryGirls	human
@_weightloss284	human
@rock_zo	human
@PapaJohnLincoln	human
@FrozenOIaf	human
@LesJacome_	unknown
@fukuyoken3daime	human
@ElCangrejo_Nice	human
@thesnugbar	org
@joeltv	human
@BINGBINGDELIGHT	human
@Tyrneathem	org
@BWEatBeeps	org
@MontrealRetweet	human
@BestRecipesMag	org
@ArqFelixVerbel	human
@saruomo	human
@ChristmasBinge	human
@PapaJohnsOmaha	org
@TweetYourLeeds	human
@TacoSec	human
@DashDietTips	org
@sexynomad	human
@RebekhaRegi	human
@MidVilleNY	human
@yossieyochie	human
@HIPMediaKits	org
@CityBizFB	org
@satorupic	human
@DinnerAs	unknown
@GarlicParsleys	human
@thelilhoneybee	unknown
@makuro48	human
@QueryCity	org
@UKHotelNetwork	unknown
@unhungry	org
@WSHRetweet	human
@BreakfastIsBest	org
@AppleIceInc	org
@TAYLORPETTYFER	human
@ueno__man	human
@jellycafe	org
@LoreSabin	unknown
@RateYourPeri	org
@LABrunchers	org
@SteaveJacobs	human
@chefmummytan	org
@hashtag_edjeff	human
@RenatoNieto08	unknown
@IrvnnGnzlz	unknown
@hkeithtan	human
@ArielsNYC	human
@shuchi82	human
@tomokos0918	human
@milsonng	org
@brunchear	org
@RyanIlahi	human
@Jus_Bone	human
@BrunchBurgh	org
@MonicaRosie23	human
@KimEllen119	human
@Ceiakitchenbar	org
@CiaoBabyBolton	org
@foodsinner	human
@trescondesas	org
@KickingWKelly	human
@UksRestaurants	org
@FashionBeyond40	human
@RecipeRT	org
@Skylifepromoja	org
@a_kathym	unknown
@Binksterb	org
@GroundedOttawa	org
@MaedbyMaggie	human
@minikosan777	human
@FarrellDanish	human
@Hillbilly_Chef_	human
@hal99670	human
@EatJogGlow	human
@DorysIil	unknown
@FitnessGuru96	human
@swagera1988	human
@Eemma_mu	unknown
@LiquidSand0	human
@FuegoCocina	org
@DoRhonda	unknown
@am_quite	human
@Bar_Picchi	human
@ja_melen	unknown
@MonetMMagat	human
@jackiebremont	unknown
@bitesforbabies	org
@raqooq5	human
@FoodNetwork_UK	org
@AbbeysKitchen	org
@Scottlipps	human
@gohan_de_genki	unknown
@Madeline3824	human
@britishbutcher	human
@at_Chambres	human
@angelcreatives	org
@satoru0	human
@YanethLuo	human
@TWlTTER_PH	unknown
@robfoodie	org
@atoms2bits	org
@fu_lotus	human
@PatrickJanesNC	org
@Lay_la_ozc	unknown
@GaslampTavern	org
@q_buen	unknown
@sexticles	human
@HillnTrees	human
@MarteyMoxie	human
@PuneFoodiez	human
@smiura3000	human
@fransisAlex	human
@wyldfamtravel	org
@amanda2581	human
@SergRomero_	unknown
@Gil_A_lex	unknown
@FirestonePublic	org
@OdieeCps	unknown
@foodtemple	org
@carl_settles	human
@SoonLeeNZ	human
@Veganawakening	human
@McDcentralPA	org
@carameldubai	org
@IgnacioPrado09	unknown
@DOSFoundation	human
@PCityGrill	human
@linastores	human
@SpikeMadam	human
@YorkReTweet	org
@iamhungryhungry	human
@BOTRicette	human
@BookTalkRadio	human
@philZENdia	human
@raysfoodblog	org
@TheMAYOBIRD	human
@whoahitsohjay	unknown
@Balliebeee	unknown
@TonyOnFood	human
@Ms_born2dance	human
@bmcoffeeshops	org
@magoricsilla	org
@haruo28	human
@Hideobaam	human
@ElwaysDowntown	org
@JorgeCdeLeon	human
@rangefish	org
@MoscowManezhka	unknown
@MangiaTV	org
@TheTipsyBoar	org
@WildPatriot	human
@Kathlee36744332	human
@SanDiegoNewsTdy	human
@ProvPizza	human
@CantinaBeal	human
@SanDiegoQuality	human
@dudeonyoutube	unknown
@chisasdiary	human
@picnicblogger	org
@BureaummD	human
@cHrIstInA_YY	human
@AydinOdyakmaz	human
@comfortablefood	org
@bobbysi2003	org
@uomm	org
@JellyUcafe	org
@Dshoppinglinks	human
@arwenvan	human
@DaianaLorenzato	human
@MaKaryl	unknown
@wrc_hidemi	human
@amyhampton90	human
@Blo0ondi	human
@PEIslandCanada	human
@AustinRideout	human
@milkfrostPublic	human
@DJMaRr429	org
@se7rain	unknown
@StDavesDiner	org
@FabFashionFix	human
@symmetry_fast	human
@mano_espresso	unknown
@ALWomenBloggers	org
@afronola	org
@Ccvv60o	human
@SgpConcierge	org
@ainoajimeneznav	unknown
@TheosTravel	org
@FUJIOMIYACHI	human
@Malankabe	human
@JayeRose13	human
@Gutscheinstadt	human
@PrincessHilda20	unknown
@ren_inside	human
@fireduptacos	org
@EmilyReviewsCom	human
@Daniel_Sansom	human
@allaboutcubby	human
@ediblesandiego	org
@BEE_HOUSE_SBY	human
@SomeofTheGirls	org
@MarinaCbra	unknown
@henryakuza	human
@GetDish	org
@jamiejoness19	human
@FrannieCaco	human
@FortWorthRadio	human
@UnilancersUK	unknown
@sherylwginae	org
@MommyTodayMag	human
@kinda_gay	human
@sumoneukno	human
@Fresh_Chefs	org
@NeuvooPTWas	org
@top_ukhotdeals	org
@Thedivascafe	org
@JessCording	human
@ChrisMuttoni	unknown
@TBY_you	org
@foreverfood06	human
@PinkyBusiness	unknown
@romeohkg	human
@azteca_cr07	human
@ontarioretweet	human
@redcoats	org
@LatinaR	human
@normuzammil	human
@weddingsches	human
@Mark_Dickenson	human
@Sunda	org
@t_hisashi	human
@Luistrujeque11	human
@Khushi_bhavsar	human
@HossanLeong	human
@omar_omarian	human
@EvelinJn_	unknown
@bijansbrooklyn	org
@soupsterfamily	org
@misspigpig	human
@PearlsBar	unknown
@beckalim	human
@cooleventsinfo	human
@BIJIN_ZUKAN	human
@DoolinDebi	human
@deals4dummies	human
@bakerstreetnyc	org
@Inner_Chef	human
@Auld_Triangle	org
@MSLMW	human
@MyLifesRecipes	org
@porridgelady	human
@NashExperience	human
@Gateway978	org
@TalkRadioVegas	human
@saskretweeter	org
@WholeFoodsNorCA	org
@TomiHendarto	human
@totallytucson	org
@CidHialeah	human
@_balesoto	human
@spookedlive	human
@bbqbus332	org
@IngridATSvocals	human
@CrossroadsDiner	org
@fundafeast	org
@EMMGroupInc	org
@LatinosHadleigh	human
@Only1Sihin	human
@ErikaErikabost	unknown
@thejohnlee	human
@ColomboWatch	unknown
@CHINA_BAD_KARMA	org
@jumpman209	human
@amiii703	human
@HillbillyTimes	human
@themarkettav	human
@JoLynneValerie	human
@Ken_leing	human
@DavidMcIntire24	human
@MariaMbort	human
@DelishDirection	org
@winetimesPT	org
@hoopLAblog	org
@jenmagee79	org
@GenieCooks	human
@Lawrence0123	human
@BostonE4LDeals	org
@Monica61	human
@JackelineRibs	unknown
@QUADRINIDOME	human
@Tribe_Fitness	org
@PreciousKidsGP	human
@yumandmore	human
@NormaPrr	unknown
@CUCOfirenze	org
@SundramX	human
@Buttercelli	org
@LeticiaLum01	unknown
@hollyclegg	human
@JJsBahrain	org
@SerendipitynSp	human
@tohru_nishimura	human
@UkrainePhoto	human
@ampof123	human
@JohnHikeForFood	unknown
@empiresteaknyc	org
@All4ServOnline	human
@CupcakeKaleChip	human
@FigTreeCafe	human
@giamsk	human
@luz_orchid	human
@7777pinkbear	human
@escargot71i	human
@de1law	human
@EsmeralBorboll	unknown
@krbeauty111	human
@delicious_beef	human
@TravelPlayApps	human
@instaipanema	human
@menchrufino	human
@EDucatilen	human
@Pizza_RT	human
@SelfHelpTalkRad	org
@Tata_Almeida	human
@kantan_okashi_r	unknown
@winetimesFR	human
@_LibraFlowerBom	human
@aresfip	human
@Radznanda	human
@CXAlert	human
@FreddyVlb	unknown
@lowcarbsteph	human
@Killuminati2k	org
@winetimesSE	org
@happymunchkeens	human
@In_The_Pantry	human
@naughteebits	org
@SallyRuhl	human
@Hits56FLL	human
@readapage_	human
@UmamiShopCanada	org
@MeUrioso	unknown
@NowOnPulse88	human
@LegacyDynasty	human
@wifiomisebot1	org
@DhabaLane	human
@FloridaRetweet	human
@DezDiam0nd	human
@HyattMainz	org
@LizMadri01	unknown
@tania_mauri	human
@KSKRestaurant	org
@SteveMignone	human
@randy_torres	human
@kenyawines	human
@rezanmeg	human
@BabboRistorante	org
@RELLEE_ATEAM	org
@estevanvillage	org
@HandbagsByDyana	org
@Wonderlusting_	human
@YadhiraSoles	human
@barbrix	org
@PanacheBakery	unknown
@danisdecadent	human
@50StatesofWine	human
@CraigBarachiel	human
@Bellarina_	human
@michal_marquis	human
@kahorisss	human
@tran_latoya	human
@ShumayaBANG	human
@gordysmarket66	human
@meytalraven	human
@thatsBetsyV	human
@WestportCB	org
@MSNcaLS	org
@yellowhuang	org
@nihonshu_bot	org
@joyuuuuu	human
@sicilianicreati	human
@TomsKitchens	org
@skeetie_777	human
@foodstinct	org
@radio501	human
@Cleveland4Lunch	org
@happymoonscafe	human
@furioustyler	human
@DirectCoupons	org
@azsamad	human
@JosephStreeter5	human
@slimmingworldKT	human
@BlueprintSF	org
@Avranyc	org
@puchongotswag	human
@ccommunee	human
@villandry_UK	org
@tokyo_g_info	unknown
@YEGFoodie	org
@BOMBFRESHCOCO	unknown
@AngemelbSPN	human
@PrimlaniKitchen	human
@nannamexico	org
@WIZARDTACKY92	org
@culinaryxchange	org
@AlbertoRocaltas	human
@hermann1959	human
@oomoribot	org
@dwiretnosari09	human
@KatyMarketFresh	org
@senegallife	org
@BilkirnMandar	human
@lucafex	human
@CassiusWatson	human
@InstaYalta	human
@NunoWrites	human
@LynnDMc	human
@elaineganmc	human
@DontGetLost03	human
@goofywelldone	human
@hayato19876	unknown
@live2eatntravel	human
@thebodycoach	org
@honeygrow	human
@sexykittiecat81	human
@SirElven	org
@CECCONIS	org
@babyhoneybunny	human
@SwineSouthern	org
@iamrunningthis	human
@Sartoria_Gusto	org
@pinakadalisay	human
@LeanLena101	human
@olivemagazine	org
@TasteTango	org
@MMMithaiwala	human
@FoodFlirting	org
@NajFierceness	unknown
@kamome2go_1986	unknown
@OneDIRECTlONews	org
@40aozora28	human
@AdaliGng	human
@check_coupon	org
@Lo_chua	human
@RobertoButs	human
@marcolino_blog	human
@zizo_westgate	human
@Renegade528	unknown
@kwistwine	human
@jisse_cobah	unknown
@Got2Run4Me	human
@_yaseru_bot_	unknown
@Adaptamed	org
@passthesushi	org
@akikon246	human
@aedeesomsak	org
@Tina_Molndal	human
@JoseVllV	unknown
@reghhernandez	human
@ruzlinmokhtar	human
@BiagiosOttawa	org
@ROSAL_CARMINA	unknown
@Luxury5StarHot	human
@BlissintheCity	org
@CookTheStory	org
@ChefSean1017	human
@TakeItAwayUVA	org
@Carol1MY	human
@winetimesCL	org
@ClactonNews	org
@SunnivaAnne	human
@nikohome1117	human
@HillHouseMedia	unknown
@MasaniMasaaki	human
@Dong2Woonie	unknown
@The_FBF_Inc	org
@joeblackbpl	human
@lizaCOOPEL	unknown
@thenameiskat	human
@sameerketkar	human
@papertrellapps	human
@ZoomEdita	human
@ChathamTweets	org
@yuuu33731	human
@GustavoAlvz_	human
@HamzahKent	human
@bymyboom	human
@GriceldaJrz	human
@Charlotte4Lunch	org
@SoleAgency	human
@celenasbakery	org
@vanilla_cake	human
@social_projects	human
@vitalchoice	human
@scenesfromtexas	unknown
@nickpagonisdc	human
@VictorsHale	human
@myberlinfashion	human
@ABOSTaxiCab	human
@MyWholeFoodLife	org
@MichelleXie3	human
@sanji_oryouri_k	unknown
@azteca_cr04	human
@ifthari	human
@therecipevideos	org
@leatherrebel72	human
@thejudylab	human
@SiTorrentera	unknown
@AlondraAva	org
@RubiosTweets	org
@GroceryBeeps	org
@paigeflamm	org
@hanskristoff	org
@nusound92fm	org
@makibeen	human
@monica_wibowo	human
@DaniellePayne83	human
@someltyblog	unknown
@SimonFernnd	unknown
@CubaLibrePHL	org
@hasanmufti	human
@bd_259	human
@KitConcoctions	human
@AblazeLife	unknown
@ErikGzm	human
@westcoasttavern	org
@divinacucina	human
@donnylaundry	org
@bllt13_lynn	human
@VallieLaGiraffe	unknown
@MarceloTrj	human
@PupTime	human
@gihusiga	org
@yummychooeats	org
@orne_pattison	unknown
@ari_bermudes	unknown
@BIGRFitness	human
@peekababy	human
@foodieebooks	human
@master_nataku	human
@InfoTacos	human
@horatiosdining	org
@KintonRamen	org
@2guyslovefood_2	unknown
@JorgeIvan21	human
@macroart	human
@GoWestGourmet	org
@VioletaMrtn	unknown
@geodip	org
@Jwhackers	human
@JhyPhoenix	human
@nutritiouseats	human
@BOT79013086	unknown
@LauraOinAK	human
@_fashioninsider	human
@MarielleSasaki	human
@Ra77maN	human
@villagepie	human
@papacurry	human
@AmandaSheldon91	human
@eccoocce39	human
@peasblog	org
@BomaRestaurant	org
@swmbch	human
@schatzyxxx	human
@NeuvooPTMTL	unknown
@Dani_Domingon_n	unknown
@YBSouthern	org
@SuperMissSue	org
@Gem_hernandez	unknown
@gohoubirannti11	human
@CarlosRmro_	human
@Garett07	human
@CaffeAngeluccis	unknown
@drinksfeedUS	org
@LeanneHealthyLi	human
@TheCreperieBTN	org
@PLAYPKM	human
@666annabella999	human
@MamaHollerCooks	org
@athomemoma	human
@andrewhaas20	human
@CrocesRest	human
@migueloner97er	human
@TheOfficeCode	org
@thejollypig	org
@FosterDonna38	human
@tuscanygram	org
@DespicableX	human
@__nikki_marie__	human
@CarinaSohaili	org
@IsabelMjrz	unknown
@FLIPSUSA	human
@chicolicokids	human
@Andrew_Hutapea	human
@rude___girl	human
@Sarah_onTour	human
@VeggieBeeps	org
@ivyleaguepix	human
@mkaalattar	human
@EricLn_	unknown
@ChelleT206	human
@ranata_aguirre	unknown
@ThriftyJinxy	org
@Maldolec_	unknown
@herbsaintdining	org
@alphacandybody	human
@SlurpTorino	human
@TheLionKitchen	human
@FTJunkie	human
@maddox_thinks	human
@BarnardCyrus	unknown
@SpringValleyKep	human
@flapi777	human
@_HugMeHayes	unknown
@Adaaliz	human
@TommyCoalFired	org
@VeryToriKaye	human
@BonVStockbridge	org
@thedealmatch	human
@anacolliton	human
@mariononewayy	human
@LifesABargain	org
@OtelKervansaray	human
@redstarbutiti	human
@Lyliane_M	human
@WorldWideVeggie	human
@tinylittlebows	human
@AndreaBrgs	unknown
@sffATL	org
@kubotamaneo	human
@gastroeconomy	org
@BarryMeacham1	unknown
@LisaGarci_	unknown
@boldskyliving	human
@MariaLuciaBakes	human
@kellystilwell	human
@ellenblogs	human
@THE_JoJoDancer	org
@fpereznyc	human
@Bahrain_Expats	human
@TurntUpFLL	unknown
@ElizaBhn	unknown
@ultrateg	org
@grownandhealthy	org
@drinksfeedUK	org
@MikeIsabellaDC	human
@LChadScott	human
@MissyVonMonroe	human
@TouhenbokuRamen	org
@Bar_Days	org
@JesusAlfr_	human
@azteca_cr05	unknown
@OsborneLydia1	unknown
@JuanRyns	unknown
@tasteofkingston	org
@lifestyleyyc	org
@amiamoaimi	human
@DbBynum	org
@sw33tnsexy	unknown
@HarrogtReTweet	org
@BostonTalkRadio	org
@OatMealsNY	human
@spitorswallow	human
@lodewijkhof	human
@TalkSantaFe	org
@deedaiyenh	human
@rowhouseharlem	org
@66Smokehouse	org
@TragicDreams13	unknown
@yourcanarywharf	org
@mohayaete	unknown
@HezziD	human
@JamieOliverCom	org
@otegaru_ryouri	unknown
@djchan7	human
@drinksfeedAO	human
@freefunkmusic	human
@playadelcarmenx	human
@SandwichBarNY	org
@FriendlyCityPE	org
@drinksfeedCG	org
@drinksfeedNG	org
@dookiexave	human
@AlejandroBrn	human
@winetimesIT	human
@fusion_passion	unknown
@HoppyBrewing	org
@neighborfood_uk	org
@TomsDartt	human
@eve_marie1958	human
@fittmd	human
@winetimesDE	human
@chilligourmets	human
@BrittanyYoungx	human
@mrothe23	human
@MientrasPlaya	org
@CjGonzales23	human
@izawa0816	human
@sliceofmylyfe	human
@KQqii	human
@JBraddockRD	human
@ManAcosta6	unknown
@JonoAdtran	human
@AnnOdame	human
@3nenZgumi	human
@denardolgastin	human
@yoga1988me	human
@MZJmvJ	human
@nonmanabu	human
@SoulFullComfort	org
@EatMoreFishRT	human
@HughRosario2	unknown
@AlexGGonzo	human
@timothydavid5	human
@mightymatcha	org
@yumikotam	human
@SimpleCater	org
@taZaCnC	org
@Rutuja31	unknown
@socialshart	human
@ArielThuta	human
@GVULT	human
@Dubagee	human
@DaveyDPat	human
@bettystalk1	human
@Chioez	human
@rommy_barrios	unknown
@ChaucersLdn	org
@AASquaredBlog	human
@KrinaPrttgl	human
@EastwoodTalk	human
@RubenAlgr	human
@hmcca	human
@TheHealthyApple	human
@BuffaloInABox	human
@MichelleBishop9	human
@MelDharmawan	human
@altair0731	human
@urBody_urLife	unknown
@foodienfabulous	human
@avelte2000	human
@TheDublinerNYC	org
@ingridcroce	human
@SoelasTweets	org
@InstaYoga	unknown
@PetroNeagu	org
@luloveshandmade	human
@feedsynbot	org
@beirut_life	org
@AudreyInW	human
@foodfables	human
@MilFamRadio	human
@verasburgers	org
@TheTruckstopPB	org
@xueerchongg	human
@chocolatemuimui	human
@RoyalHotelBath	org
@daehoonyom	human
@supermanav613	human
@NelsonDorthy1	unknown
@ComerFrancine	unknown
@VoKnows	human
@m1208mm	human
@HadleighTweets	unknown
@FIESTASTOTAKU	org
@aslynnmroberts	human
@nottinghilllife	org
@flabbergutsted	human
@YuriAhn	human
@SMW_intern	org
@SienaTavern	org
@TheHothouseCafe	org
@kitashokunnsps	human
@KuprosSacto	org
@FishTaleWinch	org
@blurboi	org
@UNIONKitchenTap	org
@ysuharto	human
@lamexicanaresto	org
@3812	human
@BenZoArt	human
@MyClubDetroit	human
@DangeloYee	unknown
@Hotelspaschers	org
@AwesomenessBot	human
@MommaTBlog	human
@Eweeezy	human
@cassava274	unknown
@BostonNewzer	unknown
@Rackorama	human
@afirah_yusoff	org
@AaronVal0	unknown
@nbtb0002	unknown
@matadorlounge	org
@SexyMoxieMama	human
@carrieverde	human
@tabehoudai_bot	org
@slclunches	human
@cbcsofra	human
@chillilab	org
@Chef_Webster	human
@SusieQpon	human
@ThrillistMiami	org
@MsXpat	human
@HootHospitality	human
@Etobicoke3	org
@BricksideFD	org
@ErikaTld	unknown
@drinksfeedES	human
@121FultonStreet	org
@love_aliaa	unknown
@SamsonShade	unknown
@KtchnHealsSoul	human
@darren_chin	human
@stellaslubbock	human
@DCastanuela	human
@JannyJeanne	human
@KathPenney	human
@bev_metallica	org
@KellyCCookbook	human
@AnEdibleMosaic	human
@justinpflynn13	human
@adineviscusi	org
@CrumVeronica	unknown
@SilverSpoonLDN	human
@DJCHAMZ	human
@mimi_puerto	human
@BrightSettings	org
@MustaKuu	human
@lunch_ikou	unknown
@Milanesedabere	human
@icon_mikey	human
@TriedandTasty	human
@SabrasRadio	human
@PrEtTy_RiCkYjPn	human
@FreekehFoods	human
@Shiki_syd	org
@CubaLibreDC	org
@gotminegetyour	human
@cleethorp_es	human
@jade_mellar	unknown
@DaniaMnts	unknown
@ThisMomCanCook	org
@iArrowApp	org
@PEREZM33	human
@sof_fernande	unknown
@nicosroom	org
@PeachyPalate	human
@Alien_Frequency	human
@QuebecRetweets	human
@RobertoVllar	unknown
@randallandaubin	human
@donchefbunny	org
@RJBailey	human
@SharonSvll	unknown
@joybauer	human
@adventuresof8	org
@xXx1337DrDre420	human
@Cafenuvo	unknown
@CindySilverRD	org
@indealsMCR	org
@derbypromo	org
@katana400ts	human
@ChesterReTweet	org
@LaughlinRD	human
@JourneyProducti	org
@604Headhunter	unknown
@IndiGoBistro	org
@BrunchBratNYC	human
@Reyaan82	human
@cucumos	org
@Garsia27	human
@ichangemymood	org
@YourDubai	human
@321mealplan	human
@VanEastVillage	org
@SonsofEssexNYC	human
@mianfaisal135	human
@Mother_Mission	org
@Mlesynuj	human
@kungfukoalalih	human
@NoraTakara	human
@SteviaAwink	human
@Thecrownsph	org
@TuitCarnivoro	unknown
@sonnys_hideaway	org
@MelissaBessReed	human
@blueplatediner	org
@EdukasiGizi	human
@TravelMemes	human
@theREALdjELITE	human
@SocialScranton	org
@tavaresgonalves	human
@lowcarbdiet2011	unknown
@Diokasso	human
@DJFlashpoint	human
@JobsWave	human
@AmandaSol01	unknown
@midwesternmoms	human
@nordianah_jusoh	human
@LovEJeRicO	human
@LIJL_Radio	unknown
@JoseWillim_	unknown
@fluentfluidity	human
@trendingtopicuk	human
@FabioDannyCafe	org
@tapanikung	human
@deauny	human
@NassauInn	org
@DailySoup365	human
@RealSuperPerry	human
@ravient	human
@hidaken	human
@travelworld373	human
@FloreVegan	org
@WORDUPTORONTO	org
@Gadaffi_PP	human
@Livehotels	org
@CafecitoBogota	org
@Khunnu_Dai	human
@SaraKitson	human
@zely_bus	unknown
@fujiko_f_toshio	human
@silly_sindy	human
@Kuroneko509	human
@pondoksariwangi	human
@DaleEstey	human
@yukifox	human
@ScenesfromEpcot	unknown
@agmhkg	org
@aryameir	org
@CrisFCLafratta	human
@MEMcD84	human
@JVerusSAnimusA	human
@DJ_MIO_	human
@iamJillS	human
@DaMinxy1	human
@MPCalamity	human
@EatBeeps	org
@xnlgt	human
@LeosConeyMI	org
@MassimoRest	org
@foodexplorersuk	org
@JonnyBlaze808	human
@iphone_forus	human
@PaxtonLandon	unknown
@SuperfoodMarkt	human
@sffCHS	org
@breakingbadmen	unknown
@KhloeBatts	unknown
@GirlsonBloorTO	org
@daddydan360	human
@OWNCAFE	human
@invstandsucceed	human
@joeaustinjoe	human
@Clairdelune1225	human
@Hungry_Catt	org
@drWilda	org
@Carrie_Oum	human
@AndreaTabler	human
@g3cyo89	org
@olduvai	human
@sffORL	org
@ShinoBree	human
@titaherawati	human
@drinksfeedBR	org
@eduard_podvalny	human
@LIQUICA	human
@RedneckFashun	human
@Kobonaty	org
@OMGitsSEDDIE	human
@thebarbecuemast	human
@MientrasCancun	human
@jvdjj	human
@MuddyLeek	human
@BBBmilpitas	org
@ElAztecaAtl	org
@ChateauCC	human
@KikoGym_time	human
@SuperGlueMom	human
@bicestervillage	org
@yamasiro	human
@BigGirlBlue	human
@whey2muscle	human
@olielo_travels	human
@TheNewClassy	human
@cute_couples24	unknown
@PapagayosBar	human
@Manolobar_be	human
@dave_moss	human
@vanessa_at_home	human
@SimpleRawLife_	human
@foodwineblessed	org
@trappfotos	human
@TheMagicWrap	org
@boxwoodtg	unknown
@ShelterPizza	unknown
@OilWineItaly	unknown
@Life_cocktail	org
@MarcosAlmn	unknown
@veziter	human
@brettdurrant	human
@kitchenrocknrol	org
@medamakurui	human
@ContactCard	human
@murasakimeg	human
@hidden_brighton	human
@orderinthekitch	org
@510medicIan	human
@boodythebest	org
@ThePalaceSoBe	org
@ShukorZ	human
@CAM2Go	human
@MARK_EATING	org
@endronv	human
@Staufftoy	human
@eltipicotoledo	org
@fon3m	human
@westsidefm	org
@RachelLCoppola	human
@HiltonUniversal	org
@Sexyfoodtrucks	org
@EEcigs	human
@RadnorHotel	org
@LVRYenikoy	human
@CorksAndKnives	org
@50slice	human
@Liu2qrenz	human
@JackSussek	human
@cessemi	human
@mm_munozz	unknown
@Go4YouDelivery	human
@EdwardHarding	human
@ThaxtedNetwork	org
@Mr_RICH_Tycoon	human
@KSilvaBanderas	human
@andi_kell	org
@MassisLebanese	org
@briantmarquis	human
@igofatlanta	org
@seang_seang86	human
@JulieFitzgeral	human
@sheryl_lbc	org
@Chayapa29	human
@FaCheaux	human
@Soup_n_Such	org
@ChicaWau	human
@DeltaBravo33	human
@Grazialight	human
@elvinaluv	human
@FastFood_TV	org
@_cxpz	unknown
@TieDyeTravels	org
@DineTO	human
@klvn10	unknown
@ssaiks2	org
@oym333	human
@archanaskitchen	org
@BIN36	org
@VisitBuckhead	human
@hrmhysk	human
@sparrow_tweets	human
@RM0_10	org
@twebeck	human
@PearsonFarmGA	org
@Dobboinaus	org
@2cleaverfoodies	human
@FrankCurry1989	human
@daveverzosa_	human
@thenewjessipaul	human
@Crazy4cars2	human
@aroii	human
@0375_kucucu	human
@TheTownhouse_	human
@barHappy_NYC	org
@foxnhoundspub	org
@GrandHeritageDh	org
@crazyforcrust	org
@thegoldentongs	org
@FemaleBloggerRT	human
@DeliciousShots	human
@HealinIrie	human
@PegCochran	human
@olivesanwine	human
@thespringmount6	human
@SardellisFL	org
@asideobacon	human
@adventuristaako	human
@tyottogu1	org
@Hisbenz	human
@SuperHitsMJH	unknown
@ParkerAndQuinn	human
@AnaMari10768876	human
@tasalinas	human
@DCE4LDeals	org
@kainklab	human
@miguel_sousa	human
@aky2chan	human
@aon9	human
@Alex_SBraga	unknown
@shecooksueat	org
@SydneyCaitlyn1	human
@BritneyMackenz2	human
@HeatherNatalie3	human
@MaLoranePena	human
@Muelx2	org
@KennedyIsabell1	human
@Adel_AJuarez	unknown
@roxAleman_	unknown
@1504ngel	human
@noreddies	org
@forlifex4	human
@ArieDJai	human
@MyTacoOle	org
@archiehd1793	human
@amanda_arm	human
@MarioAspiazu	org
@camogligram	human
@christar520	human
@cclarkebarbara	human
@fallautumn19	human
@Publiventapty	org
@Loews_Hotels	human
@AMI_Lamilla	unknown
@TotalHomeSupply	org
@holy_brunch	org
@goatchelsea	org
@TakeItFashion	unknown
@nontapila	human
@BURGERSNBOURBON	human
@CycyPretario	human
@kennyscott1952	human
@IzakayaDining	unknown
@PaolaTrinity1	human
@KellieCorreia	human
@KentLeeJoon	human
@DullesHiltonAir	org
@ToddTanaka	human
@TrainYouTrim	human
@urbankitchen	human
@prizewinner1984	human
@salladorez	human
@GilligansShack	human
@choco_town	human
@takoba_	human
@GlenmorganBar	org
@YingUllmann	human
@ValescaSiebelt	human
@ChowholicDoll	human
@Carmela1864	human
@BelfastDining	org
@HotelBlackfoot	human
@FartingLlama	human
@TheCity4Lunch	org
@KatlyneGiffard	human
@MeganMaya1	human
@_airking	human
@EvelinGtr	unknown
@ohhchocolat	org
@HillbillyGossip	human
@bboytruen	human
@pegcitylovely	human
@slcmamaz	unknown
@Ong_Arnon	human
@RelaxInBahamas	org
@StreetDots	org
@BeachNatalia	human
@SheffieldsBBQ	human
@e2go	org
@the_fat_badger	org
@healthyfunfood	org
@BWBrunchCHI	org
@elvineyo	human
@78chevyboi	human
@EatWellUK	org
@kingsfanone	human
@CiaoGuiseley	org
@sarasara0JH	human
@goodfoodfriends	org
@AlondraSrd	unknown
@kushigalu	org
@ga_ryu_com	human
@drinksfeedNL	org
@TheRealFitBlog	human
@desiredcharm	human
@bryanorl	human
@altheaKitty	unknown
@yanashu	human
@buffettfan1959	human
@MADRID_DF	human
@Eat_at_Claires	human
@mimsterfunkz	human
@SallyBarrett	human
@tukatha	human
@KrishnaMerdono	human
@USA_1001	unknown
@derzafanistori	human
@Mallsofworld	org
@jamkamali	human
@HunterLJohnson	human
@MunizMe	human
@YUUGAKemistri	org
@AbsolutMiami	human
@_ILoveShimsu	human
@CTSeth	human
@sugahplume	human
@yu_shelley	human
@sakura3yayo3	org
@etcPB	human
@BarraganEnergy_	human
@RoyaltyGuru	human
@QueenScarlett	human
@MisterNizam	human
@gordysguru	unknown
@NurulEylia	org
@justyniak	human
@CaliBaydotcom	org
@MarkESackett	human
@Couscous_Party	human
@coyo_uk	org
@Journey2Mecca	human
@AmnaKhalid86	human
@MarcusLeachFood	human
@pureeat	org
@_sdk	human
@BingeTube	unknown
@wataponf1_uk	org
@yankeedoodletap	human
@_oyomot	human
@Glamoos	human
@addy_fun	unknown
@gori2k9	unknown
@RubyVra	unknown
@Hatty823	human
@nelsonbarillas4	org
@PrimoGCsYQR	org
@GennesisRomoO	unknown
@LilLisaLoveXo	human
@DicedOnion	org
@PoweredUpWoman	human
@GiveawayExpress	org
@GayBathHouseLV	org
@Nwiguno	org
@EatGuidePDX	human
@Anilomr_	human
@TheGrand_ON	org
@Adnan_Z_Manjal	human
@cheplu	org
@bruhland2000	human
@Yoko1007	human
@Oceans11Abuja	human
@fvanaev	unknown
@RodJonesKJs	human
@RivistaNola	human
@AlvarezBT_	human
@MichelNilles	human
@TonicEast	org
@azreen_ariffin	human
@Milind1975	human
@Z_HUILI	human
@onlydresses	human
@jenniferhenry72	human
@MizGarfield	human
@tfasm	human
@nor_isa	human
@drinksfeedCA	org
@SotoErick_	org
@diegomrosales	human
@BeautiqueDining	human
@SameersEats	human
@mayuge_UK_bot	human
@frisca_caecilia	unknown
@lose20	org
@lasalachigwell	org
@HungryAsianRke	org
@dead_cockroach	human
@IndigoBeachMx	org
@GialloBlogs	human
@nutcaseinpoint	human
@BeStyle87	human
@Xennia79	org
@Findatopile	human
@GorhiAzam	org
@EliteSportsRD	human
@mkiosdeveloper	human
@AstroparkEu	human
@Mr_Food	human
@HonkyTonkNYC	org
@Melinda_B_	org
@drinksfeedIN	human
@thepfactorfoodc	org
@Q8path	human
@IamSUPERCHICKEN	human
@drugstoredivas	human
@taka719	human
@McFuzzleManchen	human
@SRSDT_AHA	human
@iamsalimali	human
@stef_antonio_	unknown
@afternoontease	org
@mtjic	org
@yoosaho	org
@MiamiE4LDeals	org
@MaldonTalk	human
@Kiyatw	human
@MakeUpTweeter	human
@BroJimmysMIA	human
@UniquesSTreats	org
@PerloTwitt	human
@cleaninggirl	human
@rsun0525	human
@kawaiinomnoms	human
@NYCpizzacafe	org
@itistist	human
@gdn_bot	unknown
@EpicSandwich	org
@chw131	human
@Kuaderno_Rosas	unknown
@BethsMogador4	org
@vegstateofmind	unknown
@UKStartupEvents	human
@raeMD	human
@Claudestar2012	human
@kerrymarie	human
@TAPAS_18	human
@hk_cl	human
@Cafepaninis	org
@realfoodsBev	org
@904eats	human
@UnVraiPancake	human
@Tampa4Lunch	org
@CatioucheLondon	human
@iMusicConcert	unknown
@SheldonJames20	human
@LauraSummer3	human
@mysouthend	org
@stacyroof	human
@emwx	unknown
@JennyMetamorfit	human
@revcornie	org
@PancakeWarrior_	human
@WatfordForYou	human
@invisiblejet	human
@KarinaTjda	unknown
@ATasteofWorld	human
@Amanda_At_Home	human
@tatsuki_421	unknown
@Eschelle	human
@AlonzoBer09	unknown
@marimarimick	human
@restauraceOBZOR	human
@iloveburgerslv	org
@aya_21382Xoxo	human
@SG2992	org
@ScottsBarGrill	org
@Deltas_in_Hfx	org
@restaurantzest	org
@OhOhRodson	org
@AmySessoms	human
@miwalatino	human
@savinsaidsimply	org
@PottersBarTalk	human
@yhazman	human
@ThomasMooreTave	org
@BlackChefWebTv	org
@ValentinTnr	unknown
@aMusingFoodie	human
@MelvinsJuice	human
@Asian_Rim	org
@jbeilouni	human
@MonicaPrad12	human
@CandyTol54	human
@PeacockGreen_	org
@dhsspa	org
@majapahitkid	human
@fitnessmomshell	org
@winebot11	org
@iamvipnw	human
@HelloFood_NG	org
@DailyQuestionB	org
@LeydiMonreal9	human
@aleksfrilles	human
@SaulMurr09	unknown
@DianaRivera8q	human
@kojaha	human
@IsabellasNYC	human
@KaricTweet	human
@JayPutera	org
@soulfullyE	human
@AndreHugosplace	human
@l0king4ananswer	org
@grandbabycake	human
@JudyReiser	human
@yunussuprihanto	org
@Germanplaces1	human
@rabi1217	human
@Friends_Pancake	human
@emmamaterialgal	unknown
@EKOLGURME	human
@laylaandchurch	human
@The_Manikinhead	human
@EatsAmazing	human
@HaNeul2010	human
@NOMSScom	human
@TriTipManTruck	org
@RealGoodYummiez	human
@EdenbridgeTalk	human
@alamillaHernan_	org
@doubutu_bot6	unknown
@YamilHonn	org
@Dressingleeloo	human
@ButtermilkTruck	org
@stevenjchamplin	unknown
@LazaroSrrn	unknown
@WG_Events	org
@harlequinfay666	human
@asanderson197	human
@GUAIZINE	org
@OurOrdinaryLife	human
@GreatDunmowTalk	org
@momsgoodeats	org
@DaisyHealthRD	human
@BikiniProjesi	org
@ebatomo_816	human
@sarahy0Leyva	human
@goddessified	human
@BlBOT3	unknown
@npecherski	human
@emix_momoka	human
@KayMaximus	human
@Tricepad	human
@doschinos	human
@island_on	unknown
@Prairie_House	org
@aliceluvaaron	human
@DuncanParsonage	human
@ZombieBinge	org
@The_Appraiser	org
@sitohangeaster	human
@fattysfoodfotos	human
@CecconisWH	org
@Young_AndHungry	unknown
@tnemgarf	human
@goatmilkjim	human
@premiumbot1	org
@RubiSolar7	human
@da_Wizrd	human
@GAYBYdedios	human
@hopbopstop	human
@AuntBeesRecipes	org
@brandyellen	human
@WokingRT	org
@SouthBranchChi	org
@trainsniffer	org
@dustybunsbistro	org
@NutritionRocks1	org
@g_is_lover	human
@SheBad77	human
@FeelFreetuRT	human
@StickAt_It	org
@TheGabels	human
@MyOrganic_Herbs	human
@hotpinkbooks	org
@hamjoeburg	human
@AdreanAragorn	human
@FatCatChicago	org
@RawMamaNature	human
@2Mamimam	human
@BobbySchwa	org
@KatieSchlientz	human
@EmmalineTsui	human
@cakephotosgo	human
@Lilyluk	human
@PuritansPride	human
@wellington_west	org
@HorseradishATL	org
@MilestonesCa	org
@moemi731	human
@127an	unknown
@armanique	human
@limitedlucy	human
@blastkat	org
@RhettEp	human
@_kaelGuzman	human
@ZombieTacTeam	org
@ShanMiaosan	org
@marchecanada	org
@FigTreeCafeLS	org
@Kiteretsu0915	human
@KenjiSam0716	human
@WilbertZmra	unknown
@GoyonoS	human
@PenelopesMCR	human
@FlintOKC	org
@Chef_Selection	human
@RelaxInRome	org
@BlackCuminPower	org
@MyGuitarPic	unknown
@duestrade	human
@brittsblurbs	human
@mybander	human
@ManningtreeTalk	human
@moringa_fr	human
@SMHealingArts	org
@NaturallyLupie	human
@brasseriemiami	org
@Uplike	org
@miguelsrodrigue	human
@WhatsOnWOW	org
@Veills	org
@ericiaociao	human
@IamEthelj	human
@blackgirlseatla	org
@SAT_Coacher	human
@ManuelCan9	unknown
@bobbywrahardjo	org
@iokepa	human
@NHBclothing	org
@daichi1127	human
@LuciaPrad9	unknown
@FurzedownTweets	human
@EvesLounge	org
@TheSnugGrafton	org
@ChocolyCafe	human
@We_Amplify_You	org
@maurodiloreto	human
@CrazyCoco1992	human
@cityofangels007	org
@MaxMinderen	human
@nimue59	human
@singerinkitchen	human
@DinaJ	human
@joyogude	human
@ItalyLuxeHotels	human
@optimistic_mama	human
@TheSnugTrumps	org
@UrMajesty_Sire	human
@RayanDkhilFLY	human
@YardHouse	org
@Mezon_CT	org
@chefkelcheung	human
@TurkishCenters	org
@direiellie	org
@GenesisVall2	unknown
@ChucksCafe	human
@dswettjr	human
@bestofthebrunch	org
@cutcatschicago	org
@AlexaHanstag	human
@valeriesee	org
@MaMu_iMa	human
@FabFood4All	org
@erneeesto	human
@CandidaJourney	human
@doodersrage	org
@ELITEFLYSOLES	human
@treatyourface	org
@somethewiser	human
@DSTPRL	human
@Le_Garrick	org
@Baramee	human
@SquareMeal	org
@CountyGeneral	org
@ponia_pon	unknown
@thebestofepsom	org
@GeovaniTrr	unknown
@Just2Sisters2	org
@NeuvooTraSD	unknown
@hintofgreens	human
@cbcmarketplace	human
@bloo88sheffield	human
@bonedbroth	human
@kwengchua	human
@maigizmo1208	human
@BOT73400798	unknown
@GirlFightingFit	human
@ornelga	human
@RecipesSwap	unknown
@Fabry99My	human
@inamarelina	human
@THN_Janus	human
@violetcriMEs	human
@THELOFTCOLUMBUS	org
@JoKiwiJo	unknown
@TravelBayou	org
@gdeo	human
@DiningOutSD	org
@alhalabiuae	org
@laptoplunches	unknown
@hsuchijr	human
@N_Y_C_C	org
@NeyowsNola	org
@uncoverdining	org
@AmazeWall	org
@DNM_LA_Dining	org
@phycyj	human
@TriciaJLibby	org
@eyepromo4u	org
@MelissaZino	human
@ChottoMatteSoho	org
@ParulZelezny	human
@tonalmoros	human
@BizFeedz	human
@Whoneedsacape	org
@Wanderz429	human
@ReddRatchet	human
@FindlayMark	human
@positive_kismet	human
@Whatley4	org
@JaesonVna	unknown
@hosiephoto	human
@ebay_to_tweets	org
@Mango1027	human
@SiFrew	human
@EarnestZackary	human
@kawanamiyuu	human
@Shockinglydlish	human
@eatyoga	org
@NaturalNews_SB	unknown
@Hirofumi_Endo	human
@frankc8	human
@Quepasakaren	org
@miaspaninobar	org
@PerkinAcker	human
@AdynVickie	human
@DeanaAberfa	human
@Robbie_Mick	human
@dizzybusyhungry	org
@Southern_Bell7	org
@squareonecafe	org
@CecilliaY	human
@thetoastcafe	org
@S15K	human
@bj_dorval	human
@kingofthe9	human
@tdera28	human
@kwanporny	human
@KHaunschmid	human
@MocaMami	unknown
@BeverlyH90	human
@happypopcorns	human
@HalfDoorBrewing	human
@kenchinn	human
@MindTheMunchies	unknown
@jeniibee	human
@OxTrailsApp	org
@EdibleCanada	org
@FoodSouthend	org
@THEnosyRosy	human
@ericaparedes	human
@xHeadHoncho	human
@DaffodilAbbi	human
@BamboozleLiving	human
@roytorphy09	human
@postipedia	org
@Montecito_TO	org
@irvinngariman	human
@EatLocalOrlando	org
@Nummymuffin	human
@ZeleneManton	human
@FreshiiPortland	human
@WhatscookingJim	org
@paninaro_in	human
@TheEatGuide	human
@whats4dinnerSA	org
@BLACK_eason	human
@melvinmaya	human
@justingan	human
@exparanoiaboss	human
@4CancerResearch	org
@SpoonfulFlavor	human
@ilprimopreston	org
@TheAtlasBar	org
@vickyjane88	human
@heidiapples	human
@Ang3LB3aR	human
@AndrSlggdd	unknown
@emericanlife	human
@andydhare	human
@joannalasmono	unknown
@AngelosOn8th	org
@RB_Rashi	human
@IowaHell	org
@Maja_SF	human
@twintrival	human
@unflowez88	org
@CompaniesOhio	human
@StyleAtHome	human
@taste_team	org
@yu_c_ka	human
@Mirimomo	human
@ikebukuroD_bot	org
@Southern_LovinB	org
@AwieMSugiono	org
@The1O1Legian	unknown
@azteca_crcr	human
@Kitkenneth	human
@AberdeenTavern	org
@Food4lovers	human
@beehouse_shibu	human
@maalramadani	human
@LAEatBeeps	human
@MaxeenDeniro	human
@DoubleHelixWine	org
@MesmerisedByYou	unknown
@savingdinner	human
@LetsPillowTalk	org
@Eveniency	human
@instagram_nepal	human
@CecconisMiami	org
@LOeufrier	org
@BySuzette	org
@4jengs	human
@Yeheshan	org
@ryejing	human
@CupcakeTimeGBG	org
@Iran_Style	org
@TheBrookInn	org
@caramelabudhabi	org
@kim_hoa	human
@popounpopon	human
@elywinebars	org
@Lucid_Serenity	human
@DesiJonesShop	org
@riscann	human
@Neighbourhood4	org
@cookingplanit	org
@leblogdekat	human
@joeywearfitness	unknown
@moderndayfreak	human
@garnishwlemon	human
@CavaFlamenco	org
@_ChuckD_	human
@KENTOdj	human
@RubenVidl	unknown
@TowersRotana	org
@CakeBakergo	human
@bestofprinceton	org
@sircleja	unknown
@TheEyesofaBoy	human
@Di_Va88	unknown
@astriddendauw	human
@DaBadestChickL	human
@daphnieduran	human
@miraicegurlz	human
@burusan14	human
@TTylerMclean	human
@DaKandiLady	org
@miminguyen	human
@milkandsugarcdf	org
@col84	human
@SECooking	human
@Joonnie_Centeno	human
@StellasEmpanada	org
@NorthEndGrill	org
@janssensmarket	human
@DonnaChaffins	human
@NutritionGoGo	human
@110sachiko	org
@D1Locker	human
@JanineFerko	org
@HolidayPage	human
@CornerKitchenNY	human
@Dannypasta01	human
@Bris_Fit	human
@matcha_uk	org
@weeatallthefood	org
@odettealabama	human
@MerlinaAlmendra	human
@GreatStoneFace	human
@wesustainearth	unknown
@OliviaPin9	unknown
@olufemi_PT	human
@Greta_Scacchi	human
@ArtistLR	human
@TuttiBreakfast	human
@Nontan1004	org
@MaxPga_	unknown
@IglooMediaBase	human
@shoosakoda	org
@ClassyMonkey1	human
@KiwiMagazine	org
@ChienNoirBistro	org
@astoriacremona1	human
@Kissmakeupblog	human
@AlndraCrmnna	unknown
@thebirdandbread	org
@TheNHausfrau	human
@Bunis_Malli	human
@chocolatchurros	human
@masterklep	human
@T______rex	human
@patoistoronto	human
@lourdesdonis	human
@WeardLoreene	human
@smithwollensky	org
@cakedecoratego	human
@BarFancyTO	org
@JazzeyqaAj	human
@thehangarsa	org
@Mallendrae	human
@1_ultraman	human
@carloseats	org
@grazeleeds	org
@jacja	human
@MelissaKalloo	human
@kkhing	human
@apiapihot	human
@GeeGeeWong	human
@NudeEspresso	org
@jak5356	org
@RyLouie1003	human
@enzoferrarifx60	human
@Veronica_Wendy	unknown
@pondipondis	human
@bazaarguide	unknown
@shellthings	human
@ChefCoyo	org
@RuzicaJerry	human
@PizzaCornerHI	human
@a_golfers_world	unknown
@Mantour2014	human
@SanCarlo_Group	org
@FigTreeCafeHill	org
@carminalance	human
@ChorltonRT	org
@JuanWilson14	human
@TheRedDrum	org
@inouekikakubiru	human
@BerkowitzAaron	human
@stefymannone96	human
@DnddndDndDnd	human
@AsyaYIMben	human
@eataustineat	org
@Confetti_Dreams	org
@RefeelMilano	org
@renka666	human
@Harbor_Point	org
@PHXStreetFood	org
@oztweetybird	unknown
@LePeepDenver	org
@HappyMeHealth	org
@MelisaAkgul	human
@aroundaboutbrit	org
@BACONMANia	human
@nazlannasir	human
@egginmyface	human
@TenBellsTavern	org
@b3n2ts	human
@CheshirePork	human
@tsushopper	unknown
@randomfoodimake	org
@maxdtonny	human
@dishofdailylife	human
@indealsLeeds	org
@khalidxmax	human
@abbylaneboston	human
@comfortcravings	org
@davalenciapaz	human
@cakerecipesgo	human
@ZonaRosaCoffee	org
@joigele	org
@gr8musicvenues	org
@HannaDmngzz	unknown
@GospelFLL	org
@ABustelli	org
@CyberAff	human
@InstaMariupol	human
@PaoGzmnn	unknown
@ellynatjohnardi	human
@MRUP2PAR	human
@AldacosStoneOak	org
@jimcroce	org
@riverdaleperk	human
@tazevents	org
@kupfi	human
@BfloTheatreDis	human
@yukari_dy	human
@skinnymomonline	human
@TwSurf	human
@Mr_Mercury_cat	unknown
@TheEpicureShop	human
@MonahansSeafood	org
@aprice_2012	human
@alejandrasteinu	human
@JayVagabond	human
@DougMcNish	human
@melaniepink90	human
@RitaWheater	org
@LaMexAlaska	org
@greatideas	org
@ReformDubai	org
@TheFlexitarian	human
@cabotcheese	org
@hikarin1113	human
@LondonCentWOT	org
@TheVillaItalian	org
@hobartscafe	org
@lauraelizabethj	human
@ButterfieldNYC	org
@TheLemonBowl	human
@sunqueen19	human
@AoJuria	human
@traffordents	org
@SophJohan	unknown
@lakeside_cafe	org
@GeorgiaRetweet	human
@CarriesExpKtchn	org
@GlugofOil	org
@JenniferCChan	human
@DrinkBunna	org
@vampvikinggirl	human
@DrBrentHunter	human
@SaharaClinic	org
@L_uisCochez	human
@MezcalSilencio	org
@MattWhiteley78	human
@harasu_onigiri	org
@SheillaSlayer	human
@SpicieFoodie	human
@meme8823	human
@saffronandspice	org
@EBhealthcoach	human
@KwonSummer	human
@heartlessjim	human
@FadzliNaqiah	human
@TaraArtist5883	human
@kidcokitchen	human
@transitionyte	org
@ubonkw	human
@PortlandGymRat	human
@AdvntrsinDinner	human
@lalorenarest	human
@TescoShopping	human
@NYCKING	org
@elodieinparis	org
@Anthonyhead13	human
@javier_kessler	human
@FoodieDiaries	human
@PIDP42	human
@dyenya116	human
@freakinDEEN	org
@rutherbjr	human
@CurryliciousATL	org
@Hellofa1	org
@imTheJessicat	human
@YMDeals	unknown
@amyriolo	org
@SmileforBrandon	human
@anniestow	human
@ilovezukkini	human
@Theresa4Steele	human
@IlkleyTweets	human
@GuelphBugle	org
@HarwichNews	human
@retroslim1980	human
@OriginalCafe11	human
@ERTourism	org
@MoralesJoye	unknown
@13Angels4u	human
@NovLim	human
@HomeWriters	unknown
@pany1galanis	human
@emvalencia	human
@LeaveDinner2Let	org
@LeBlogdeLili	human
@asyongllamas	human
@ivaniagsantos	human
@debililly	human
@HfxSeaportMrkt	human
@stylememaria	human
@HerbsNSpicesGal	human
@Chayaank	human
@TantilloFoods	org
@CafeTerraBlog	org
@elcamion_soho	org
@TheSnugStAlbans	org
@NoshDrinks	org
@kungxl	human
@ozcanozbek	human
@LaBirreria1516	human
@MTuekZz_	unknown
@jillyconjem	human
@javelinwarrior	human
@DonProtasio	human
@SandyFowler	human
@miraclesprings	org
@RelaxInVenice	org
@mymamasworld	human
@amnichols	org
@LorelaisLife	human
@japan_sayaka	human
@TheYumYumFoodie	human
@thebelgiancafe	org
@parmijiano	human
@Chocoralie	human
@GogomallHS	org
@ZenBox	human
@hindyg	human
@1starlight_Dec5	human
@havingfunsaving	org
@Supernova226nyc	org
@VANCITYsBEST	org
@emuemu030828	human
@thefruitxchange	human
@whangerchoi	human
@ToBeGorgeousAko	human
@jbunggay	human
@QT29	human
@FSVancouver	org
@of5415459524	human
@CynthyaZita	human
@BonVivantMC	org
@WWEPRINCESSDIVA	org
@MyTrainingEst	org
@TaraNoland	human
@JohnKitover	human
@kingsceasar105	human
@baliscenesnow	human
@RvD501	human
@elblogdesilvia	human
@swankychicfete	human
@UrbanListSyd	org
@VisitLahaina	org
@traceatx	org
@open_starmix	human
@nivensfood	org
@yolxi_happi	human
@misstaylertexas	org
@atasteofdawn	human
@T_Confidential	org
@gluten___free	org
@SCOOTERSITALIAN	human
@alicubi	human
@tacchyal	human
@sasarcola	org
@FoodieAboutTown	human
@mira_icegurlz	human
@gizitips	human
@MANUDESI	human
@TullieInn	org
@MichelleContin1	human
@RAPMAGHollande	human
@agimy01	human
@adkcornerstore	org
@Jaimarie13	human
@RalfMatheson	unknown
@porchrestaurant	org
@CoffeeGuy_	human
@KapnosDC	org
@Hashcapades	human
@udisglutenfree	org
@FutureBoston	human
@Nothingbutsnack	org
@sthlmsnation	org
@Short_OrdersNR	org
@OliveGonul	org
@Jujeeee	human
@AmishMarketTrib	org
@mainebeerco	human
@newlife0724	human
@iam_ysw	unknown
@themamamaven	human
@honeydayhoney	human
@littlebreakfast	org
@CardinalRuleTO	org
@breakfastbabes	org
@SculptMd	human
@tomoryoshka48	human
@StephanieEng	human
@TwoPeasandPod	human
@quiqup_app	org
@PizzaSpotting	human
@GolborneDeli	org
@SeraBan	human
@SheppertonTalk	org
@benscanteen	org
@CoachCorzo	org
@Rhill17Hill	human
@onlineclock	org
@BaconPDX	org
@GCMerchantCity	org
@_MDQPS2_	unknown
@offthemenu831	human
@ijyuuin2	unknown
@TheFarmhouseKC	org
@WayneHotel	org
@TryMeasure	human
@longboards	org
@HABANA_87	org
@cakestylego	human
@WuMingi	human
@halfandhalfstl	org
@theFSHKelowna	org
@LRC_D_Villa	unknown
@voiceBoksMedia	human
@FoodChannel	human
@psTristan	human
@trixerelixer	human
@bex_pix	human
@sweetgrassbeer	org
@joeymanuguid	human
@bRUNch_Running	human
@paige2page	human
@FrankysDeli	org
@pearlsokc	human
@GreatCoachRadio	human
@ChefDomCreates	org
@5bubles	human
@CharityNewsUK	human
@verypurple	human
@HowIPinchAPenny	unknown
@robustcoffee	human
@Onomahuna	org
@VictorianTrufls	human
@_french_touch	human
@sayupo11	human
@tartinegourmand	human
@shadiqhussein	human
@AdymPhilberta	human
@choco_rachelle	human
@JulioDuar54	unknown
@InstaNikolaev	unknown
@HealtyHabbits	human
@Shelbournebar	org
@LianaZamree	human
@thehungryhutch	human
@DartfordTweets	human
@aliveli66701032	human
@MiracleGuruGal	human
@BazaarGuideEat	unknown
@MrsPCuyugan	human
@RenateSimr	human
@TheSnugHertford	org
@VanoverLord	unknown
@KopiNYC	org
@xtreme23	human
@GermanCityGirl	human
@livefitgirl	human
@yellowroseatx	org
@OhioEggFarmers	org
@KitchenCraY	org
@californiabeans	org
@AdriFonsecaC	human
@kappuru_bot	org
@tranceradio1	human
@altanorum	human
@GanziToronto	org
@FoodieAffair	org
@swammer01	human
@SueSidzina	human
@Grill50Panama	org
@MTWFoodNTravel	human
@hmfoodjunkie	org
@_01	human
@ElCidRestaurant	org
@smith_smith09	human
@xistng	human
@tcgcardnews	human
@myonlyhope143	human
@FatMansCafe	org
@pineboook	human
@DINetworks	org
@MARLAsarris	human
@4sqaddict2046	human
@Garfunkels	org
@tracythealpaca	human
@JimminyMagee	human
@IamCardan	human
@KellySpencer_np	human
@MamboTeaHouse	org
@TuckersSA	org
@WheatgrassTammy	human
@prolinker	human
@yuuyuu0924	human
@OTPHOakBrook	org
@hayleyw1	human
@streetpicsnow	org
@reflylimasatu51	org
@graciousbakery	org
@VisitingAtl	unknown
@AdnyCeithin	human
@williamrmunoz	human
@stylishsarah	human
@iamtonico	human
@PacinosCafeBar	org
@toupsmeatery	org
@PizzaRockLV	org
@ronda0321	unknown
@SaveIndia_	human
@hutterdesign	human
@thisissmiths	human
@BestSpaHotels1	org
@MisterDennehy	org
@motohashiwine	human
@VictorLagunes54	unknown
@ArizonaRetweet	org
@HoSitDown	human
@MyNameIsRgina	human
@FinchandFifth	org
@WilzFoto	org
@TS_Lay	human
@HarlowNetwork	human
@Kangaskippy	human
@carousel925	human
@Cirrocumulus1	human
@CakeSchoolgo	human
@vipera005	human
@HandbagFash	human
@ShishaRetweet	human
@JuergensBakery	human
@MillennaLima	human
@PhillyTalkRadio	human
@kimnsin	human
@BrettDesroches	human
@LidiaPoet	human
@maclick	human
@shfqhzwn	human
@Charbelabouk	human
@twitt_doctor	unknown
@Jboor_binsalem	human
@Bottomzupnyc	unknown
@BreakfastwNick	human
@MissCapozzi	human
@bot64095799	unknown
@CountryFLL	unknown
@KublaiQ	human
@WestsideMommyLA	human
@SalavadorMo01	human
@carlo_goodlife	unknown
@superhan868	human
@DayCue9	human
@Jackygooson	human
@CafeOliverMad	human
@SameerNYC	human
@ounceAday	human
@goodboypastries	human
@JmmyBltn	human
@petravdhulst	human
@Jokedeb	human
@mlmleadsman	unknown
@KiranParry1	human
@ChoppsAmGrill	org
@Alonso1F	org
@theeruiflip	human
@TedsBULLETIN	org
@edibleinkpr	org
@oksanamar	human
@IncredibleEggs	org
@LvLEatBeeps	org
@arbues_m	human
@Marquez1793	human
@LiliaLlado01	human
@LuigiDiotaiuti	human
@IrmaGuar01	human
@NeuvooCsrUS	unknown
@SisterkayM	org
@MainLineHotels	human
@ManilaPiemonte	human
@CaribbeJan	human
@EatingHealthy7	human
@driscollsberry	org
@blakefalk95	unknown
@pbroo003	org
@Genepaul16	human
@SantosPhyllis	unknown
@littlebluepixel	human
@NutritionOliver	unknown
@hofftv	org
@cynsham	human
@dzarimvoint	human
@jeshgutierrez	human
@SimsXO	human
@randomtoons	human
@homemaderecipe3	human
@FitAndFabLiving	org
@myselfielike	human
@mffoods	human
@CarrotsNCake	org
@healthyfoodmag	human
@publicartfound	human
@BoltonReTweet	org
@Satcha	human
@CouponsInfo	human
@iwokeupfat101	human
@EngineCo28	org
@ChatChowTV	org
@RatihAyudia	human
@BrokenTeepee	human
@raytv	human
@Harryrockerz	human
@sizuokabot1	org
@AckermanWyligb	human
@Bull_Rolvenden	org
@CellPhone_Roxy	human
@nao_z_des	human
@Healthysisterss	human
@Cheap_eats	human
@DPixie808	human
@EllumBarBoston	unknown
@BulletTrain0025	org
@BrioItalian	org
@TripleOs	org
@KendalXi	human
@rebecca_wiles	human
@SaoriCpd	human
@EasyLunchboxes	human
@alotofrecipes	org
@wiudining	org
@customculinary	org
@kin_cafe	org
@karangwangi	human
@JTravelJournal	unknown
@MrTell_Me	human
@nrasile	human
@DenverEatBeeps	org
@HoustonToronto	org
@liannelow	human
@MariscosJalisco	human
@nicelegs	human
@nonbirdberry	human
@punkrockgoth	unknown
@stellaokc	org
@BiologischMax	org
@lycheeJUN	human
@aamirmazhar	org
@DIMARCO_ID	human
@BilafondLa	human
@MarlboroughTav	org
@LAUDT	human
@AustinAllergies	org
@pilgrim_base	human
@kirari__	org
@tomhiel	human
@sirboring	human
@WilmasPatio	org
@tastylanenyc	org
@grantstern	human
@daichan_kobe	human
@giuliagirardi_	human
@AdelineChen	human
@capgon0418	human
@MissLouMae	human
@EatPenneLFC	org
@LandryCherly	human
@unikday	unknown
@TrayDigga	human
@ferrerorocker	human
@AlexItsou	human
@missdanaalbasha	unknown
@sylvia_j285	unknown
@MissRebecca86	org
@stacyC85	human
@share_rt	human
@KombuchaGuruX	human
@hapihapigarden	human
@southernmomlove	human
@SnackItForward	human
@BistroJacquesSh	org
@jojobaroil	human
@TravelCaseDeals	human
@ABC84152323	unknown
@Store2DoorFL	human
@SavoryRoad	human
@christopherzeos	human
@scotty808	human
@clkchar	human
@kimtairi	human
@WaybackEVV	org
@miewaka_bot	org
@aamaziingsara	human
@CuisineCozumel	org
@BuzzzChomp	org
@sylviefoxbooks	human
@HealthyLifeMix	org
@Masami_k8	human
@LoreenLukee	human
@benllypolanco	human
@TheWeeklyPoach	org
@falmouthbaycafe	org
@JUANCVEGA	human
@itsacoolife	human
@annaponsalopez	human
@JuliesEatsTreat	org
@Antonios57	human
@boring_stick	human
@jazeitchi	human
@Guccikas	human
@ilhamnugroho_j	org
@brassaii	org
@TheTorchDoha	org
@ezpzmealz	org
@TheSnugHitchin	org
@edtuaz_02	human
@homefood_ca	org
@LesNoirsEtLeKFC	org
@theglenwoodatl	human
@srjf	human
@amelialing911	human
@ChrisGat	human
@RobyIsabella	unknown
@dillydondallie	human
@BruceLenart	human
@ActressDelaney	human
@CrystalWind	org
@MaxsHarvest	org
@falafelland	org
@dortmevsimyemek	human
@EatDeliElFaro	human
@ChesterVenegas	unknown
@AlejandroMren	unknown
@AlgernonVenegas	unknown
@kokoek9	human
@NicoleWasAliens	human
@frootjoos	human
@VijsRailway	org
@zivot12	org
@PrayApp	org
@NattakarnPop	human
@Essly	human
@MamacitaGarcia	human
@khanapina2007	human
@HappyGarda	org
@GoEpicurista	human
@SwankandSwine	org
@MesonRistorante	human
@PonderMadeleine	unknown
@joechen_16	unknown
@roundmenu	human
@DaxiMama	human
@TheOregonGrille	org
@enrilemoine	human
@HazMatHotSauce	org
@thedailymeal	human
@YallaYallaUK	org
@veolacurtin67	human
@jophie_saquitan	unknown
@PotheadPal	human
@mhmuzik	org
@frugalnutfree	human
@HowellsandHood	org
@NanaVitaC	human
@verenakocht	human
@DaMarcellaMid	org
@Sandraax5	human
@RicksCookhouse	org
@A2P2BRUNCH	org
@karmasushi	org
@juliatarmidi	human
@AgataKindlebook	human
@PureElla	org
@BleedingN	human
@aomzab	human
@CafecitoNYC	org
@berries_passion	human
@UptownTavernSD	org
@valelavale	human
@gogrit	org
@cheryltan88	human
@ComfortFinchley	human
@urbanpicnicirl	org
@gleneirichan	human
@DelAndHud	org
@AsianAdidasGirl	human
@1littleproject	human
@cereal4brekkie	org
@pjm_fitness	org
@mykopio	human
@Sprint2theTable	human
@yummly	org
@s_peach_blossom	human
@OnAirMemphis	human
@offzaz	human
@Sayah7428	human
@wenderella	human
@HAPPY_PINT	org
@Stelle_TCI	unknown
@1980Yohan	human
@thesavvykitchen	human
@YayPiglet	unknown
@Deenakakaya	human
@MusingsSAHM	unknown
@Omattieila	org
@AFrugalFriend	human
@PulidoEmily1	unknown
@kaflickinger74	human
@KOBE20100917	human
@lagata777	human
@DollarBourgeois	unknown
@JLOHCOOK	unknown
@brentdsmith	org
@secretfoodguy	human
@ebian_japan	human
@edmonton_rt	human
@topaustwines	org
@erick_mac1	human
@MikaJoi_	human
@MyPlateNow	human
@1Waterhouse	org
@LaPerlaKW	org
@longisland	org
@BuckheadAtNight	human
@KazantsevSergey	human
@LotMom	org
@11THSTREETCAFE	org
@HPFangirl71	human
@CoggeshallTalk	human
@CultureTrip	org
@QueenlyandConf	unknown
@FurnishMyWay	org
@Downtown_ACE	human
@itseasy2bVegan	org
@_melaniemay	human
@JFisherJewelry	org
@a2zcafe	org
@YourHealthyYear	human
@CleanSupperClub	human
@bangsarbabe	human
@TheSnugWycombe	org
@HollyxHawkes	human
@Artishah	human
@simplebites	org
@thaihouse	org
@JuviaMiami	org
@LCS_YK	human
@leticiazoetes	human
@bugsbunndo	human
@nannie_gonzalez	human
@SilverioSk	human
@Followback_RVS	unknown
@themamagames	human
@Fndmyfoodtruck	org
@CalvinKong35	human
@AbrahamKihn	human
@strawbeemochi	human
@Roppanista	org
@MyHomePayroll	human
@chefJeff808	org
@jpglicious	human
@suvirsaran	human
@akiraalways	human
@FoodFanatical	org
@JoyHabeehab	unknown
@TheChiquito	org
@UVicFood	org
@MrBrown7777777	org
@moonberry	human
@PhoenixE4LDeals	org
@RogerBrowns	org
@favorite__h	human
@goodbuysalltime	human
@Lisa03755	human
@BINGBING_BLOG	unknown
@VitalSaladBar	org
@PeterParker_PA	org
@farmfresh2uus	human
@bluntkrayon	human
@go_staugustine	org
@rawfoodrockz	org
@Tina32kaur	human
@halen_mor	unknown
@RALspecials	org
@GreatFoodCork	org
@genmarquez1845	human
@mypassion4food	org
@Djolapunch	human
@HrNelda	human
@bradmck65	human
@ishtar_	human
@BrumIsBrill	org
@chiayi444	human
@shu_rosaline	human
@meisafairy	org
@MMCORIA0222	human
@BriggebamWynth	human
@txtypeamom	human
@kitb	human
@Pianistmiri	human
@LohasTopStories	human
@therese_jan	org
@epicurina	org
@JassonBarrett	human
@WAMmommys	human
@LuthfiMY	human
@sinthavanarong	human
@BrothersinFood	org
@MrBuckleys	human
@LaurenPincusRD	human
@newspaperlady97	human
@RajendraRajwade	human
@Buen_Viaje8	org
@blckpeppr	org
@Orlando4Lunch	org
@_TryAboutTime	org
@thedrunkentomat	org
@MegaFoodieK	org
@W3STYLE	human
@umixxxxxxxxxx	unknown
@NataliaCbrra	unknown
@mimie1678	human
@thru_camera_eye	human
@Melolimparfaite	org
@foods_ideas	human
@Lingdui	human
@Slimwithjessica	human
@lucybishop2012	org
@Junior106	human
@kthhwtt	human
@HampshireTweets	org
@Whitney_Bond	human
@SR_Nutrition	org
@EsotericPhoenix	human
@TeresaTurner3	unknown
@BigEbaySales	human
@ChapelAToday	human
@MVESblog	human
@moemasri	org
@mmbusek	human
@CaffeRosa	human
@NavyTalkRadio	human
@fivethingsnow	org
@swanocean	human
@eripuu712	unknown
@AbdullahGAlAzem	human
@Crenese1	human
@NorthCapitolDC	human
@LEGGSBCN	human
@AlxGl_	org
@MJ_Jeff702	human
@laurenheart8864	unknown
@KijusMTCC	human
@chocoholic1118	human
@atlasespressoTO	org
@naughtyamerica	human
@VatySuvimol	human
@deaguilar88	human
@lovefood2much	human
@AndreaHackworth	human
@BrittniCeleste	human
@donjondemesa	human
@Handpickfood	unknown
@PIPSONLABREA	org
@SW3V	org
@AtPrototype	unknown
@emiiihae	human
@me_jennaa	unknown
@LittleRedWasp	org
@djfelix2020	human
@najibredzan	human
@AtlBizRetweet	org
@DeeeeBird	unknown
@dumbokitchen	org
@LaVieEnGreen	org
@Zoolsterr	org
@type_k	human
@bot48074855	unknown
@KMennerFineArt	human
@TempoUrban	org
@TheCraftySide	human
@tunisialife	human
@LunchboxDoodles	human
@JoeyWearUSA	unknown
@retweet4keeps	unknown
@MayaNoiles	unknown
@ingolstadtLife	human
@daryljfoskey	human
@hellokristi_x3	human
@ipetorres	human
@3000TfG	org
@ElitEater	org
@syofa_oslob	human
@ThatNinjaMega	human
@iogodfrey	human
@BlueBlairy22	human
@thecookingguy	human
@FoodKarmaBlog	org
@Insta_Lego	org
@elbow_fizzy	human
@justatevegan	org
@BridgetJaneGuru	human
@OscrGmn	org
@nicodjsg	human
@TellJonathan	human
@masterbrendan	human
@KatieYED	human
@hshtgmafia	unknown
@mohd_hinakhan	human
@omyers704	unknown
@chrillanw	human
@GCRiverboat	org
@StandinNext2God	org
@winetimesAR	unknown
@iitalian_food	human
@Eggface	org
@Appetite101	human
@LunchLouisville	human
@cibo_winebar	org
@LovePastaBlog	human
@BorderlineEnt	human
@DarrylQuon	human
@FreeBritishDVD	org
@kevinagustinus_	human
@its_me_kcee	human
@sho1923kno	human
@LittleAralejung	unknown
@Annette_Cicero	unknown
@alessiacanella	human
@WorshipTheDJ	human
@Sophiescardiff	human
@BlondLunchDiner	org
@houseofannie	human
@scenesfromhawai	human
@Giugizu	human
@spoonfednyc	org
@BeastChowDotCom	org
@MordisFoodTruck	org
@natsuz_	human
@a_muna	human
@TheWrapDarling	human
@LunchroomBE	org
@ILoveStMarys	human
@javaearthcafe	org
@KellenKleinfe	human
@PB_AleHouse	human
@msgbox74	org
@BegentleWellnes	org
@drinksfeed	org
@swaggnews_Can	org
@LaSalaBanus	org
@TrendTradeTech	human
@Red_Razz	human
@glenn_delmonte	human
@JaeInkk	unknown
@AmeerAlavy	human
@4SmartGirlz	human
@cakebossgo	human
@robbiebob44	human
@pidyuk	org
@TheCafeTweets	org
@Time1075_FM	human
@MrHaggarty	unknown
@acablecar	unknown
@AlabamaSentinal	human
@Empire_Grill	unknown
@yvoGUBAT	human
@hongstar_super	human
@eunicekong25	human
@TheLobosTruck	human
@makiron_sv	human
@ebayrt	org
@MO_HOTELS	org
@noeldistura	human
@Iam_KatNiss	unknown
@nakanihi	human
@akshayam21	human
@majajuhl	human
@louie_chua	human
@KimShimonishi	human
@RCageOxford	org
@inmyfacehole	human
@ICanCookThat	org
@Spyroman	human
@UnionGaslamp	org
@GotchaChihuahua	human
@choiYumiwww	human
@somuchfattitude	human
@TheTypical_Mom	human
@CourtyardResto	org
@greatpancakesmn	human
@MODEjohn	human
@adi7anand	human
@MadamFrugal	org
@superfinefeline	human
@eriiiiip6	human
@CY_MarriottPune	human
@yukatodo	human
@silverwolfstar7	org
@SUBWAYArabia	org
@Guacamole_Bot	human
@MobileBliss	org
@BrownieBoyBunny	human
@bot87615122	unknown
@trofnq	org
@djkane71	human
@AntoineLiagre1	human
@andrewmolen	human
@Girls_Book911	org
@naakamaruddin	human
@MariaBenardis	human
@YogaSharer	org
@HarwichTalk	human
@xtreme999	human
@casadecrews	human
@JonesShoreditch	org
@Feastinatray	human
@alvarezastrid	unknown
@melissachang7	human
@AMOSART	human
@DowntownHalifax	human
@school_image	org
@hiphopjewelry3	unknown
@smileymoet	human
@chubskulit	human
@whatchloecooked	org
@Coma_Cuisine	org
@ThankHoney	human
@nearlynativnash	human
@FolkestoneTalk	human
@RenoNY	human
@TerryScholl2	unknown
@MaudNicholas1	unknown
@SEscapades	human
@ajian130530	human
@cakeacademygo	human
@ShowMeTheYummy	org
@kfc	org
@Foodiemental	human
@meghna_mee	unknown
@susanopera	human
@Assembly_House	org
@TheFoggyGoggle	org
@i24carat	org
@FolarinF	human
@Munatycooking	human
@CRAFTbeeryvr	org
@shougen_kun	human
@shane_barker	human
@hiburdubai	org
@FoodRenegade	org
@CenterClubOC	org
@nataliahartanto	human
@Babe_KL	human
@IvyMFG	human
@BikangZhang	human
@rosselot_oxox	human
@RollMadrid	org
@Mi_silla_azul	human
@EarlsRibPalace	human
@mikyriccia	human
@Avohaus	org
@Caffe_Dolce	human
@filipemcmartins	human
@cooliphone6case	human
@coffeepodcork	org
@BacoyBoca	org
@YayaBells	human
@celeb_ur_Birth	org
@g4gary	human
@thekimiflight	human
@adamantgirl	human
@TheWayfarerNYC	human
@stoltenheim	human
@pamelavenbass	human
@ClaireKCreates	human
@Shell_Out	org
@CharitySharer	human
@timothyhe	org
@yummyeveryday	org
@RTChelt	org
@cuzin_logic	human
@UK_Hols	org
@kaew4444	human
@goodlifevan	human
@BoundaryChicago	org
@P_LBA	org
@WilliamLanegPOL	human
@kimberlyds1	human
@AllAboutAlish	human
@BBOY411	human
@itimaraioei	human
@2hungrypiglets	human
@CalebNeil2	unknown
@ButtonDownCafe	org
@patriciabyrd32	unknown
@goLadleNYC	human
@PaddockWoodTalk	human
@Patytrigp	human
@EDtv_zahidi	human
@CheilaReais	org
@JoseGnzalz_	unknown
@bupivaket	human
@MIAbites1	org
@konsumjunkie	human
@KoloheBoy	human
@sandiday1	human
@peruchitruck	org
@AlTarf05	human
@jenseigler	human
@vitaminmary	human
@100Montaditos_	org
@Tredwells	org
@ZullyIHernandez	human
@heide0505	human
@cakeartgo	human
@yogisonia	org
@NYCompanies	unknown
@Cocina_Marie	human
@vieaffreuse_fr	org
@wansyafiqasraf	human
@anniesnomsblog	human
@1LovEReY	human
@bot66193792	unknown
@NutrioliEsSalud	org
@PennCommonsDC	org
@RuthWhittlegB4S	human
@mamaglads	human
@tweetengage	human
@vintage1978	human
@j_akb2	unknown
@MzJuIcyR3d	human
@WellFedFood	org
@MayaTapas_Grill	org
@iamtherealbarry	human
@Destral	human
@RabbaFineFoods	org
@sijoypo	human
@SavorySweetLive	human
@jefesoriginal	org
@JFM713	human
@hokkaido_ziman	org
@BrunchLDN	org
@BunnyCates	human
@sewanin3	human
@secret_brunch	human
@AntonioSkeeters	org
@cleansimpleuk	human
@FoolsGoldNYC	org
@QuirkyPrincess	human
@JudyRobertsonyQ	human
@thinathinathina	org
@dressinglaurie2	human
@EatDrinkGarden	human
@fortcalgary	org
@bettyskitchen	human
@ctownchick1	human
@lindsays_list	human
@pittacrepeuk	org
@twiiitttr	unknown
@seventwofive	human
@FeedYourSoul2	human
@Tammileetips	org
@JacobJPhillips	human
@blogchronicles	human
@Rabbit_858	human
@XiangZhi1117	unknown
@NutritionistSH	human
@LivePeachyCom	unknown
@ModernOats	human
@jonsieNR	org
@MastermindCroy	org
@deniiarii	human
@InstaLefortovo	human
@fishpotjm	org
@CarolLpr	human
@SammyBAS	human
@LycheeSD	human
@grannymurfles	human
@LAXviernes	org
@DineAcadiana	human
@Cobblestone1837	org
@College__Cooks	org
@AnneSyawal	human
@fauselfie	human
@TheMiamiNews1	org
@nileauto	org
@kweekweek	org
@hautahbuhgee	human
@hazza_wazir	human
@Dickeys	org
@instaFORMULA1	unknown
@VedaEarthAlive	human
@CrispenSandwich	org
@Hanhonymous	human
@AmerigoTN	org
@HeartfortheHome	human
@WaterWayRealty	human
@sheikhusein	org
@FMoorePicBlog	org
@jmsquinata	human
@SassiIrene	human
@igarashinozomi	human
@fabioinitaly	human
@PortoVistaSD	org
@JoseAbdon	org
@khairulzamri	human
@martinkadelux	human
@BeaBasilCafe	human
@prosnation	human
@dcfrontpage	human
@PastryChefTracy	human
@Sudjenice	human
@AdriaensRuprech	human
@CHGOFoodScene	human
@fadoobaba	human
@MalikRizwanKha1	org
@BlackBiznessRNE	unknown
@CandyKid_store	org
@snaxtimeusa	human
@le5min	human
@LuxuryReview	org
@paleo_k	human
@5Recomendables	human
@BayAreaSeaLion	human
@vzaree	human
@TABridezilla	human
@vi_sports	human
@simply_suzzie	human
@jaz_quin	human
@robeRoxanne	human
@25trends	org
@tastytravails	human
@The_Jam_Tree	org
@mkrtaan	human
@2x2x2combo	org
@kelvinpz	human
@smartlynx_atg	unknown
@yimchaikorn	human
@gidehysag	human
@sweetiequeyd	human
@mikilito23	org
@plazacafesouth	org
@Fieza_Ismail	human
@HopScotchTavern	org
@Thereseisfun	unknown
@kristaleamd	human
@Rybarra13	human
@atchayamfoodbox	unknown
@darcysglasgow	human
@Chamochan	human
@ReserveOutDubai	human
@ZenzoLusengo	human
@CookingBudget	human
@FoodNetworkCA	org
@Tori2107	human
@SriKoduri	human
@Jimmys_Famous	org
@fulviagalbusera	human
@Arsheeda	human
@TRSOne_	org
@NM_devilsreject	human
@maisonMleb	human
@CLEFoodTrucks	org
@BoltBistro	org
@hiliaryscloset	human
@foodiewino712	unknown
@LolasDC	human
@wnkkny	human
@s_derizqy	human
@RedhillNetwork	human
@SocalPlane	human
@LauraLovingLife	human
@Nicole_Rymer	human
@SimsBBTeam	unknown
@ANNAKATO	human
@JANMUP2	unknown
@MarketaMakki	human
@DriedWorld	human
@JiaXinDa	human
@YuuKCamilan	human
@littlebitsofall	human
@50eggsinc	human
@eatloapp	org
@aiko767	human
@delisungourmet	org
@LyddNetworking	human
@GoodBellyDrink	human
@jimmy39tan	unknown
@AMildInterest	human
@collegefunyes	unknown
@messenger_tk	human
@turningclockbac	human
@javeriakhan96	human
@actiontravel_	human
@akuby	human
@MO_HKG	human
@MediumRareDC	org
@james32whitejw	human
@makunosuke	human
@shantiseatery	unknown
@arthur36verg	unknown
@WillieEllen1	unknown
@cheesestoresl	human
@luckydjauhari	human
@LoveThymeHoney	human
@babiesNstuff	org
@AmazingJediIAm	unknown
@ChaseChinPhotos	human
@thejohnvu	human
@SaudavelMeta	org
@JPKNPXXX	human
@Tapas24MTL	human
@Article14ATL	human
@AKBsexyPic	unknown
@PrimalGRITS	human
@AdeeRoKUO	org
@nievera	human
@londtree	unknown
@susiherself	human
@marybethnave	human
@DrGoodFood	human
@OmalleySchrader	unknown
@allenlenon	human
@speakinggolden	unknown
@TheJewellB	human
@RestoFavorito	human
@35NextYears	unknown
@weareloversIT	org
@socialsf	human
@SenorRichTycoon	human
@DarleneHammett1	unknown
@RoomFourDessert	human
@ps450nyc	org
@Americas_Table	org
@ChefHoward	human
@cheflazo	org
@SPARNI	org
@thedigipreneur	human
@sharifahrk	human
@juliana_minato	human
@agentsentral	org
@EatingBeagles	org
@NMBbot	unknown
@JFreygang	human
@Syahida_Azzalea	human
@honeygirlkitch	human
@rezboi39	human
@mynegosentro	org
@phatcatt730	human
@xtremebytes	human
@velzonly	human
@MaruMilch	unknown
@amychatwin	org
@RepCharlesNJ	human
@babymajigs	org
@ZahraAzZahir	unknown
@TheTeacupAttic	org
@roslana_06	human
@DeliverThurrock	human
@kunitachimania	human
@HalloweenBlur	org
@FRNutrition	org
@DiannMrttnz	unknown
@AKBmameneta	unknown
@almightytez	human
@hackerman132	unknown
@porkpackerpete	org
@BeckettsNYC	org
@irvinedda	unknown
@MaineGirl2	human
@KapnosTaverna	org
@eatingnola	human
@boniellos	human
@AKBdougaBot	unknown
@uselessbandaid	unknown
@TamraPhe	human
@ikhwanfiza	human
@thesainttavern	human
@LetsPlayiPOPZ	human
@GroceryBar	unknown
@corcioneangelo	human
@delilane	org
@fickleclowee	human
@portiaplacino	org
@ChicoteMad	human
@dazred	human
@L_MyLia	human
@us916us916	org
@JiaweiKnox	unknown
@gracehoeun	human
@TheParkViewCafe	org
@crizlai	org
@Yummie_Nation	org
@CornerBakery	org
@xlinklaux	human
@LorynLulu	human
@DonLucito	human
@SakuraAndSushi	org
@Mr_Ask_Why	human
@s60v02	human
@HowToBeInStyle	human
@cutieshankybaby	human
@DickenL	human
@HotBoxJA	org
@alainecvgarrel1	human
@EdificaMujer	human
@zahidahwahid	human
@muzaicdotcom	org
@womansfriendcom	human
@Saltydawg	human
@hotelstoryville	org
@Innovativebaker	human
@cdmstl	human
@MarioMorenoMoya	org
@cafestage	org
@DelAzizLondon	org
@Pro2Sungailiat	human
@WereParents	human
@HoneyGo_Lightly	human
@bluetaq	human
@whereelseph	org
@RealBaiLing	human
@MapaBeograda	human
@jonrecana	human
@vjpadgett	human
@Yunzi_iznuY	human
@meonil2	human
@myfoodfinds	human
@calgarydreamer	human
@AppzVentureInc	org
@marseillelife	org
@ParkAveTavrnNYC	human
@WaltyChef	org
@SweetTsFoodie	org
@AdreamCfashion	human
@MrBouvier08	human
@Zo_Boston	org
@fabioviviani	human
@PakTrendStats	org
@CamGaskarthReal	unknown
@xniquet	org
@ponimoe	human
@attaboyburgers	org
@avadrossi	human
@pennington34	human
@3ypol	org
@KOCHYOGA	human
@kubih	human
@SaraSaraOKC	org
@picpantry	org
@Blaqueer	human
@MasonDixonCafe	org
@MissOMoms	unknown
@KylieA1969	human
@wisequeen	human
@TadeoJmn	unknown
@O2OInvestments	human
@10thAveBurrito	org
@withaspin	org
@A_Kawin	human
@GaryGutierrez	human
@SouthendTalk	unknown
@pam_s	human
@BeautiqueInNYC	org
@Vivianapiace	human
@O2OConstruction	human
@ChefStefCandy	org
@LasulaBoutique	org
@kitchen_utensil	org
@JuliaFougstedt	human
@girlgonegrits	human
@foodilovenl	org
@christineispink	human
@vicstation	human
@doc_babi	unknown
@puntarellarossa	human
@Randwiches	org
@LizaGperry	human
@KaremelFirin	human
@Dean_Journalist	human
@LizBurnsA2	human
@textiff	human
@easymealsathome	org
@pinkyprincessca	human
@QSAYTHAT	human
@FazendaLeeds	unknown
@M_U_S_I_C_news	human
@CalliePippo	human
@SandwichyME	human
@anuskamoya	org
@okanagan_rt	human
@GuillermoRguez	human
@misskeymisskey	unknown
@BaffinsCatering	org
@Sandy_Warner_	human
@YeastNashville	org
@Priswawa	human
@kanayan06	human
@stupplebeen	human
@GETFRUITYCAFE	human
@Deliveroo	human
@Reel_Seafood_Co	org
@SALEH3311	human
@chloetomalin	unknown
@deitylady	unknown
@the_arcade_bot	org
@O2ODevelopment	human
@CicchettiLondon	unknown
@DaddiosPizza	org
@ITSDJCRAVE	human
@az_d18	human
@39Arisa	unknown
@PicknPay	org
@SoBeLIVE	org
@Jojomololo	human
@markhillary	human
@RockRecipes	org
@LasVegas_Newzer	unknown
@Angie_Daily	human
@francescakookt	human
@RollinfattiesNO	org
@wade1228	human
@crunchnpunch	unknown
@EatGuideSeattle	human
@PerfectPizzaStv	org
@deeb5	human
@PASupportServs	human
@jbboats	human
@itsjamierubio	human
@LoveBelizeanPDX	human
@Patrick50809510	unknown
@abbsmeister12	unknown
@MckeownFrancine	unknown
@DjStanB	org
@Freedible	org
@drinksfeedZA	human
@aroundjoy	human
@BluntWendi	unknown
@ik01i	org
@sanae37	human
@goatmilkstuff	human
@instatama	org
@KimLeeHungry	unknown
@ackey518	human
@Healtyrecipe	unknown
@SoutheysBistro	human
@TheKitchenEl	human
@Inspiredsoups	org
@kkhanpk	human
@UiraBio	human
@agibson2011	human
@yabibo_com	org
@masterranma	human
@curry_imbot	human
@GreenTeaCrew	human
@ValsGreenKitchn	human
@baob_bursa	org
@the5footer	human
@unice_tokyo	human
@NAAS_Co	human
@Maruneta	unknown
@FUN_with_a_G	human
@RotiGrill	org
@mst_toumynvg	human
@FRYoga	human
@gicvd	org
@BlakesNatural	org
@Nura_Imanishi	human
@s_tieka	human
@letsnomnom	human
@MadelinGarden	unknown
@sandwich_shack	org
@dookdik86	org
@angelobrain	human
@simonnexxjuilf1	human
@etrexetre	human
@jcjgPhotography	human
@TRFireGrill	org
@fuelledbytea	org
@PMorris153	human
@Raultvgonzalez	org
@bexxiiboo_92	human
@stace_johnston	human
@scrupulousgirl	human
@JeabPiyatida	human
@HeybridgeNews	org
@1ZoyaKhan	human
@ohsophiabrown	unknown
@LondonSWestWOT	org
@KokNystrom	human
@CityCenterMerid	unknown
@HEALTHBOXLONDON	unknown
@JDUBAKAGOAT	org
@LStylerCom	human
@Ireneccloset	human
@shontellyoga4U	org
@AsyrfBstmn	human
@RuralSocietyDC	org
@JeeYeoh	human
@KaliMarcum	human
@jaynerslo	org
@formerginge1	org
@realfoodsNB	org
@BRUNCHMADRID	org
@irecipeapp	human
@Biz_Hype	org
@TheUrbanDiner	org
@matayado	human
@DillanDiGi	human
@Dody006	human
@SofritoWP	org
@URAppHelp	org
@techarazi	org
@oakleyhall	human
@instapraying	org
@YAT_Cafe	org
@CaitPlusAte	org
@Prego_TO	org
@kawanparatha	org
@suppermixes	human
@Ris3ofDaKing	org
@sunshinesglow	org
@salfarinaruzlan	human
@natalyazzmarth1	human
@sanooksuksan	human
@EM_Cafe_MileEnd	human
@VenuesNJ	human
@Jenn_Go26	human
@foodtoglow	org
@nOph_Opii	human
@addspace1978	org
@bot78037754	unknown
@lesteralmanzar	human
@9w2cbl	human
@georgettaddwin1	human
@AlbanyGingerman	org
@Harish_Charan	org
@havana1957miami	human
@missingman1973	human
@TarynLouch	org
@KevinArrow	human
@TheRumKitchen	org
@jponce2487	human
@ChicagoBlackBus	human
@TartufoCcs	unknown
@3QCooks	human
@cy_eats	human
@JenniferEdlund	human
@Midtown_1015	human
@JitladaOnSunset	human
@PaigeGroupNY	human
@EatYolk	org
@obession1234	human
@TheFoodSpotter	human
@TheDamGrille	org
@TheMerlots	org
@Vincentx3Tan	human
@KrocksGrillePub	org
@brandon_seekins	human
@AlvarRock	org
@California_RT	human
@budzgaen	human
@RetweetingDoha	org
@TandemCoffeeSK1	org
@the_autistic_1	human
@DianaRambles	human
@scenesofireland	unknown
@batirol	human
@visi896fmmedan	human
@OTPourHouse	org
@smelicookie	human
@KathysSavings	human
@Didiletta	human
@WireLack	human
@StBarthsLife	org
@MyfatmeAnia	human
@aburke59	human
@Datruthh__	human
@BostonChefsNews	org
@MommyByNurture	org
@tinroofsandiego	human
@nevernoteating_	human
@Difwavelength	human
@herleenapahlavy	human
@VoyageurCafe	org
@thanyuu69	org
@AngeloTRobinson	human
@DJEliCrack	human
@BRCgastropub	human
@craa_crazy	human
@HeirloomVeg	org
@everylin1513	human
@CyclistMorris	human
@shongables	human
@HealhtunAdamna	human
@weiji_	human
@liszapparoli	human
@adamdy25	human
@VigorBuddy	human
@lyee91	human
@madewithlovemaz	org
@upliftingfam	org
@REDevelopNews	human
@MonicaPruett	human
@jKittenMia	unknown
@IRantIScream	human
@SamuraiSushiDSM	org
@PoliRooster	org
@saltgourmetfood	org
@chaddeesx	human
@nineyoii	org
@retrostopuk	org
@her_haggerston	org
@TheAceToronto	org
@fugu93	unknown
@reno7239	org
@Happy__Brunette	human
@osm_sushi	human
@RT2PROMO	org
@Yongyi38	human
@plattershare	org
@ZumbaFR	human
@DeltaBeausejour	human
@Love__Bites	org
@thatbaldchick	human
@NicoleJones2010	human
@roulichanz	human
@Im_Like_A_Ninja	human
@ikuetb	org
@lazyyeahee	human
@MEREiJwana	unknown
@ladyg2105	human
@OakTavernMiami	org
@Autosentro	human
@HungryWombat	org
@OHfoodtruckfind	org
@AlessandraSerr6	human
@LPPblogi	human
@morrison_imelda	human
@angel_anno3	unknown
@kodelaat	human
@an531	human
@DJTheSoo	human
@0oAlex	human
@RealHousemoms	human
@StreamReporter	org
@DJ_Goloso	unknown
@CARASPORT	human
@Simple_Dish	org
@mamarej18	human
@Sigjea	human
@FitnessTweetz	unknown
@Laura_LaRioja	human
@BlenderBabes	human
@CoachGFit	human
@HitTheDeals	org
@LAE4LDeals	org
@winZ_83	human
@PANNALIVERPOOL	human
@monderk	org
@therealgcl	human
@HaciendaNJ	org
@grazebath	org
@sflsg	human
@CoopStyle_com	org
@mizzepam	human
@SpeedyLVFoodie	human
@AlicePenzavalli	human
@JuztinTeoCK	org
@LaBoufferie	human
@honeyBirchtrees	human
@Messy_Kitchen	org
@IngatestoneTalk	org
@tapandbarrel	org
@tis_I_Di	human
@MiJosAustin	org
@Josehh_	unknown
@orangeheromama	human
@djkirkstate	human
@KubalVishal	human
@KrinersDiner	org
@FelipeGraham75	human
@NeuvooPTOtt	org
@icatuna	human
@ponkinpi	org
@Arderighi	human
@itsadamevans	human
@lucievd	human
@CookSingleNYC	human
@NakedChorizo1	human
@keytail74	human
@sharlenessruba1	human
@LucaP001	human
@STLVBLOG	unknown
@YJBae	human
@CityBizLondon	org
@melovillareal	human
@alfonso4711	human
@julianspvd	human
@agenciademusico	human
@shahingh	human
@yashikawa	human
@BaltoConcierge	human
@iwashmyhair	human
@chammyboy	human
@GoodTasteMV	org
@BonAppeDee	org
@meganmedellin	human
@ConnerCowgirl	human
@elbowroomsd	org
@DottyDishes	human
@Your_LuckyDay	unknown
@BackdropOttawa	org
@freshii	org
@PheobeLay	unknown
@nnatty	human
@Time_for_Suppa	org
@_murphsfamous	org
@pandagirl753	human
@FITaspire	human
@Cathya_Lychen99	human
@TSDebWright	unknown
@AlewifeNYC	human
@cork4lunch	org
@bennyman25	human
@instanv	human
@ferrysal1m	org
@JesseLWellness	human
@seane04	human
@GatheringKW	human
@SerapMermerci	human
@MusicBeeps	org
@MiguelJarrel	org
@EstherNg89	human
@Feelgd_Foodbk	org
@justa9url	human
@Beer0Cl0ck	human
@DKlutzBakery	unknown
@TlcChef	human
@Marche_TO	human
@InstaKirov	human
@itskelliwithani	human
@LloydEVB	human
@TheEarthDieter	human
@Cubanyc	org
@khun_niti	human
@afzalnazeri	human
@BlackUniGryphon	human
@Buneirerin	human
@sashadwd	org
@BrandePlotnick	human
@LittleEffi	human
@slipkind90	human
@DailyBread_	org
@DangerCupcake	human
@soosterling	unknown
@barbutonyc	org
@MasterofMobius	unknown
@Bistrozantenka	human
@MehtabCochrane	org
@Manchester_RT	human
@Rob_Haswell	human
@weis28	human
@cruelmrx	human
@cbckitchen	org
@newkindoffoodie	org
@PPL_VeganEats	org
@lomejordemadrid	human
@GracilAlvrz	human
@Deals_United	org
@baumtti	human
@sayabontan	human
@MizCupcake40	human
@thelastclass	org
@InstaPskov	human
@CotswoldsMedia	human
@ScoffsUK	org
@MSNArabia	human
@WalkerBros	org
@orfevre08	human
@NoeParedes31	unknown
@outspoken77	human
@Cleansediva	unknown
@DavidCrighton	org
@EppingTweets	human
@T4Vista	human
@vsubero	human
@mour	human
@azteca_cr08	human
@MiamiLunch	org
@zohuntersr	human
@lovesfashion321	human
@hiro_tarnya	human
@grims_by	human
@aclhandweaver	human
@PabloMor54	unknown
@rockenroll_04	human
@motivatefitchic	human
@crowdmuncher	org
@DNM_DC_Dining	org
@CamdenMarket	org
@MsAmyR	human
@Gilchan66	human
@_annisasatriana	human
@KrystalS	unknown
@Southsidebbqco	human
@kittyretweet	org
@RusskayaPolya	human
@guiltlessfoodie	human
@fatmatt5858	human
@blueforest2010	org
@harpalsokhi	human
@azutama_com	human
@pops_restaurant	org
@merlotmommy	human
@ceciledoll	unknown
@MisterCebuano	human
@ELECTRONIQUE80	human
@SommMunoz	human
@markdenholm	human
@RossitheRunner	human
@tinyatbrowning1	human
@GOGONxKRA	unknown
@yardilkley	org
@monicaokeefe	human
@johnxkevin	human
@spunkyrealdeal	human
@Auph	human
@Formula55	human
@getqardio	org
@yamanaito	human
@Selfie_Sharer	org
@TimGeorgeJr	human
@Bally2804	human
@RecipeRunner	human
@ispeak_sarcasms	org
@smileypizza	org
@MRREDDDOGG	human
@NutriFocusRD	org
@GatorsCafe	org
@favgirlcrush	unknown
@j0cey	human
@itstagd	org
@PricesCompareB	human
@deva_harron	human
@sharonstars	human
@FloydChaceLaval	unknown
@gabymenta	human
@2eatwellRD	org
@FLChefNicole	human
@estelledaviesjo	human
@marclene	human
@charmainec2011	org
@RunningFR	org
@Chloedamstra	unknown
@ImperatoreChico	human
@GDLK_Serg	org
@VumaFM	org
@10Best	human
@MilMomTalkRadio	human
@Oceangrillnyc	unknown
@TadeoDorant	unknown
@Farmstorevt	org
@stephlui	human
@HartsBakery	human
@TreReal	human
@thefelonsclub	human
@ShelterBrooklyn	org
@Gossip_Dawg	human
@larrys66diner	human
@sweetsenseAngel	human
@TheBRUHOMars	org
@JayGuevara82	human
@code_007	human
@kmbowsundy	human
@shugarysweets	human
@morning_6	human
@CeqArmanda	unknown
@brownguy_eats	human
@MSPuchalvert	human
@juleigh1976	human
@divinitysublime	unknown
@SweetSue_S	unknown
@Taitinger	human
@Jaimeangelesp	human
@thecoolpianist	human
@RyoichiZB	human
@XavierDamian2	unknown
@vanilla_organic	human
@ElementsLV	org
@CafeTal_	org
@NewsNoys	human
@chinfeu	human
@lamonaina	org
@Cornwallfoodie	human
@GitEmSteveDave	human
@yurmo	human
@CHEESEWERKS	org
@LOUISR4EVER	human
@JurnalTrading	unknown
@artkiddo	human
@palette6ppongi	org
@recipeland	org
@petapoulova	human
@californiagiant	human
@devindevasquez	human
@frenchfrylist	human
@haraline	human
@lermario	unknown
@toxickitten	org
@loudaconnoway	human
@NACHOLOPEZ35	human
@walterfantauzzi	human
@GinoLetsDoLunch	org
@kisstracy4	human
@ChunkyChickenIN	human
@PGHtrux	human
@SoboCafe	org
@SFE4LDeals	org
@FRSwimming	human
@grousemountain	org
@SeattleE4LDeals	org
@kodonakis	human
@Momables	org
@RosamondEmerso1	unknown
@iliscupcakes	org
@fooddeconl	org
@ImStillASH317	human
@minako2009	org
@meridiansour	human
@DallasE4LDeals	org
@finemenu	human
@Cakestreamgo	human
@RamonSant2	unknown
@strawbeefull	human
@samsrideapp	org
@esthernorine	human
@tanesj	human
@funkybrunchgva	unknown
@ItsYummi	human
@Nikki_Nies	human
@WynfieldChrist	human
@meals_uk	org
@ZanneSusuMoomoo	human
@honeyhargao	human
@specialforksndy	human
@EML22	human
@CarlosJubilee	human
@SwimmerHorner	human
@TravelifeMag	human
@GregAngel29	human
@chicagoqBBq	org
@Datz4Foodies	org
@Sdanitsa	human
@BiteStreetFood	org
@japanent	human
@PARENTandCHILD	human
@loisible	human
@michelleku	human
@VanUrbanWinery	org
@eo_restaurant	human
@REXARUBA	org
@bears6791	human
@_Beyla_	human
@BostonBloggerGG	unknown
@deezamora	org
@instagramhawaii	org
@SplashTabCases	unknown
@SanjeevKapoor	org
@SessionsPublic	human
@HungryGirl	human
@RanelaghLife	org
@Shiconthecheap	human
@TheSouthrnThing	human
@ImNickySummer	human
@elsielam	human
@KavielTEO	human
@ndreas12	human
@NicheSupermike	org
@WmBender	human
@cerealsmiamiam	human
@chmimichmimichm	human
@Sylviacaruso	human
@beatapevny	human
@TopTenned	unknown
@queenesther	human
@NeuvooHosTucson	org
@TheShedStudios	human
@BelindaBridget	human
@mokshacaffe	org
@MySpiceSage	org
@pinklovah	human
@ChoyToy915	org
@newsboy411	org
@Dallas_Foodie	org
@PamElanessa	human
@EasternTabletop	org
@MaternalSavvy	human
@RikDaddy	human
@bjsrestaurants	human
@Marines1994	unknown
@queen_rudy	human
@Curvatude	human
@ChloeOthenModel	human
@billysinn	org
@RickiHeller	human
@born2impress	human
@koimahakam	org
@fjmicforce	human
@BeckMultiMedia	human
@Orderit	org
@Vivamagazines	org
@AlabamaSentinel	org
@hhlluk	human
@PickyPalate	org
@frenglish	org
@bear_gloria	human
@dankuehn	human
@maharajmeister	human
@TheLuvingFather	human
@ivital_ivanov	human
@AppetiteDeluxe	human
@A_Karunaratne	human
@Spimubona	human
@LOKaLChicago	org
@Zhang_Hendy	org
@Bob__Toronja	unknown
@CommonGround_SC	org
@swetabhandari	human
@lulalounge	org
@lordzen021	org
@allroadshealthy	org
@conquer_nyc	human
@TheSmithNYC	org
@Cookbybook	human
@AdiSebastian5	human
@beckygio	org
@townfoundation	org
@BarbaraMont9	unknown
@CastleEc1	org
@IoannaKK	unknown
@PinkCorsets	human
@FRIDAMexCuisine	org
@Junior_Senior	human
@TangooNights	org
@AppetiteAndOS	human
@sweetzyrah	human
@pricedollaz	human
@riku_shiba	human
@RumblesCafe	org
@fiza_hussein	human
@IavnRod8	unknown
@GTAeventsinfo	human
@odyssey365	org
@JuicyLucySteak	org
@yeyecj07	human
@Catherine__Chen	human
@QoDelisa	human
@Qponque	org
@skyNrico	human
@DC_Sarah_DAPs	human
@seelaheart	human
@TorontoE4LDeals	org
@Energy_Drink	org
@audreyravenred	human
@GrahamWPhilips	unknown
@DillingersD	org
@the_ladi3s	human
@dkurky	human
@EstellesBar	unknown
@SweetStartWed	org
@ello_delboy	human
@MyKidsGuide	human
@zique	human
@olya_sandstrom	human
@MaryanneEleanor	unknown
@JoyceFarms	org
@MomToSprouts	org
@yongmei	human
@SangriaTapas	org
@StairWayKitchen	human
@JosefinaLosa	human
@tozu_wtbig	org
@MountSinaiRDs	org
@msw	human
@workitberk	human
@yogagirl4776	human
@KirstyLazzari	human
@Rondaddydo	human
@AlexenderDeLuca	human
@million_leads	human
@GerardoArr8	unknown
@frombecca	human
@GloriousFood66	org
@GayWeHo	org
@InstaHarajuku	human
@TheSquareCafe	org
@VOCLondon	org
@Terr_ChelseaFan	unknown
@LosRanchosSteak	human
@Vasco_and_Piero	org
@ChordFusco	human
@360Cookware	org
@HaloCoffeeCo	org
@TheHubLiverpool	org
@eddbbong	human
@MobiusNutrition	org
@opart11	human
@ma_r_ta	org
@anemoneusa	human
@dancemish	human
@fatty_wong	human
@latinhousegrill	human
@JmRocks22	human
@mononokin	human
@Janabananaky	human
@PortofinoAtl	org
@DoverTilford	human
@ye_ch	human
@esmesaysboo	human
@California_Comp	human
@togusachan	human
@ooopsididit	human
@chef_kendra	human
@therealtwizz	human
@CharlottesW5	human
@KhongRiverHouse	org
@chrischansaura	human
@TunTunMusic	unknown
@orbyss	human
@HealthyLIvingTM	human
@mai_shimoya	human
@RGroupie	human
@Dashy_Boy1989	org
@lynniebabyx3	human
@FearIessFlowers	org
@PrincesCasino	unknown
@bshaefit	human
@GaiaGionchetti	org
@LFCRestaurants	org
@roxannebamboat	human
@inlifeawareness	unknown
@Weidknecht	org
@_memex_	human
@ayapanda7	human
@767Beauty	org
@Secretsandsauce	org
@odouglass11	human
@delididsbury	org
@naplesillus	org
@GBsGrillLounge	human
@FrankieSportBar	unknown
@JAShoutOut	org
@travelera1988	human
@LocaVoMobi	human
@Joanpenfold	human
@JediWhiteleyIAm	unknown
@whphotos2013	org
@ekopilosopo	human
@punjabirocks17	human
@Mcmeloy	human
@AllStoresMall	human
@nooshies	human
@SamuelRmro	human
@MaTtErSmIsSy	human
@Louisiana_Rt	human
@johnnykrtz	human
@MagnoliaEmporia	human
@BestCoachRadio	human
@imMaikeruKeiji	unknown
@kyo1117	human
@chiwa_y	unknown
@clubcorp	org
@MrRon9	human
@MUATraciMoore	human
@ourwaytolove	unknown
@cherielianne	human
@sue_ummmpunk	human
@teefollowme	org
@meari16844909	human
@TheIceologist	org
@westeggcafe	org
@Area31Miami	org
@SoutheastMidwes	human
@goforbrunchldn	org
@ConnAustin1	unknown
@RecipesChat	human
@YUTA_SMZ	human
@tkuy	human
@Abbdii	human
@waldschratpower	human
@morrr_gannn	human
@BotaniKap	human
@dennissagita	human
@tforganizer	human
@BluestoneLane	org
@xtianburbano	human
@lunchatthearts	org
@Closnit2winit	human
@cynmack	human
@DanColk	org
@ate_today	human
@GiterDoneNews	human
@nagacchis	human
@anyapuu1119	human
@Gussyakasparky	human
@OnTheChoppingBd	human
@ThePickyDiva	human
@_rouxed	org
@mommacuisine	org
@DietNut_S	human
@KkimooK	human
@hai_anne	unknown
@pinkginghamom	human
@TonysBikeCafe	human
@eatgoodsupper	human
@StuffNItBurgers	human
@PescatoriLondon	org
@eggsnthings	org
@jenaspacio	org
@leckerbox	human
@ItsKisaStyle	org
@cdnrockies1	unknown
@yang_y_a_n_g	human
@CATWALKCOW	human
@donna28uy	human
@humblegrape	org
@BrooklynPhenom	org
@Darbys_In_Kits	org
@StFM947	org
@PersonalStyle_	human
@sarahsythong	human
@unimama34	human
@GaluCancun	org
@LourdesMadriaga	org
@izyuuuuun	human
@ItsPluggedIn	org
@ColleenLiehr	human
@FiveStarCreole	org
@Piperpenny	human
@miyu313love	unknown
@pamwattenbarger	human
@MichaelZhurba	human
@Cowbellmilk	human
@Brendietan	human
@JaianeDran	human
@michellefelt	org
@HacheBistro	human
@FoodTruckieLA	org
@theivydubai	org
@moks_g	human
@E_C_TYKA	unknown
@gust38delpilar	org
@EastEndCoop	org
@vardamirnation	human
@natali_Recipes	human
@agnesdeer	human
@bizzybunty	human
@jtopping008	unknown
@ducibell	human
@Slim_Sanity	human
@LJnjam	org
@robertgreblheo	human
@poccalilangel	human
@WinonasStmbt	org
@Serenity_TR	org
@GaleneLin	human
@joshdrake777	human
@thelittlewonder	org
@geoffrels	human
@JunNjan	org
@ARumblyTummy	human
@UrbanFLL	human
@DNM_Aus_Dining	human
@NotebkBlogairy	human
@reneebaude	human
@Jennifer4430	human
@Aaron_Gill	human
@Shereba99	human
@ChanelGirlTK	human
@janiqueel	human
@nana2204	human
@LOVEMMY777	human
@AMajORevolution	human
@BSchoolCook	human
@danielBosse	human
@BDTavern	org
@soniammribeiro	human
@anika__lee	unknown
@hashtagkotasolo	human
@AboutTimeMag	human
@CookingTheMusic	human
@IN2Jeff	human
@FitnessRetweetz	human
@FarehamNetwork	human
@ericbaranda	human
@Yoganomics	human
@JustPiddlinBlog	human
@AbbyEmpire	human
@Jdomjpe	human
@doguhanaco	human
@valeriebrett	human
@ChefCookbook	org
@MacKidSpfldMA	org
@JuliaMateian	human
@CheskaCity	human
@chefdehome	human
@coffeeandbrunch	human
@JadeAnna7	human
@F_Factor	org
@BCCafeFL	human
@cherascity	org
@findsfromyester	human
@QuibellPaul	human
@FreckledPast	human
@MomGlenz	org
@4jlessad	human
@MizzEmmaVW	org
@NiramayaD	human
@getitcooked	org
@OemahDjowo	org
@b_l_o_v_e	human
@pbillustrated	human
@HKLisaAnn	human
@RENZwitbenefits	human
@Jewelz95dj56	unknown
@SequoyaDaveen	human
@pineapple_bride	human
@redstarcoupons	human
@dstrktlondon	org
@sweetiepinkd	org
@Lobobrooklyn	human
@GripeO_Outreach	org
@ChefGuty	human
@AlvinArlln	human
@hijinksandhalos	human
@VocastRadioUI	human
@gullyjuice187	human
@188e76	human
@AdalbertoSldn	human
@LinxAtownPA	human
@BestNowDC	org
@the_money_man29	human
@JoeBraxtonTouch	human
@Mbd3ean	human
@goantolondon	human
@Beltwits	human
@LouiseHagger	human
@HappyBodyFood	org
@charmingdeal	human
@jgilgurd	human
@asideorderofham	unknown
@MyChefByRequest	org
@SA4Lunch	org
@FoodFash	org
@slitskuu	human
@juliusglauer	human
@JacobSrmn	human
@bjornsalsone	human
@marc_aldwin	unknown
@JvilleGrilling	org
@ARCOTEL_Camino	unknown
@randradeTur	human
@weiweiliao	human
@marksutton65	human
@merotCenaWade	human
@CafeConLecheTO	org
@BenMallie	human
@adrianbankz	org
@IchaMirza1	human
@ykatinka	human
@DFGrilleSM	org
@motoway	org
@oalgarin	human
@nina_hassan	human
@NowakDonaldson	unknown
@travel1988world	human
@boo1003	human
@MilTalkRadio	org
@Soon2beaMadden	human
@Antonio_perfect	human
@TunWellsFoodie	org
@DineTaverna	org
@OnIn_London	org
@tattooinspirati	unknown
@LilyForTomorrow	human
@damianpiasek	human
@duplexdiner	org
@InstaFerguson	human
@wynabella	human
@FRCyclist	human
@starstarnite	human
@JLinMei	human
@SaverioMacri	org
@TockysPitas	org
@uptnlouisville	org
@GTKrecipes	org
@VibinsCafe	org
@adele23	human
@lindaqfoster	human
@pure_cafe	org
@_Noumaan_	human
@MarbenResto	org
@ItsFoodChannel	unknown
@ChowBeeps	org
@OberoiGurgaon	org
@3BrothersPizzza	org
@Lynchiouz	human
@MariaVecchioF	human
@hannahkokoschka	human
@mildredstemple	org
@tjmitchell_83	human
@eldondo_ch	human
@TheScoutGuideNC	human
@shinjukuD_bot	org
@JAXvegetarian	org
@monetronchatoro	human
@FirdausHaridan	human
@tracyngn1010	unknown
@ayamstuffed	human
@midoripopcorn	human
@MadelynKaitlyn	human
@3Camigos	unknown
@cibobistroedm	org
@SavinaHeartland	unknown
@mohawkla	org
@Andrea_Chiara	human
@PeopleOFNOLA	human
@KptnCookApp	org
@MDOG_Manchester	human
@SavvyMomNYC	human
@GannetsInNewark	org
@mangeshnisal	human
@OldTownToronto	org
@orangeegurl	human
@Cancers_Curable	human
@SpiffUpLife	human
@DanielRdrgez	human
@KOIkemang	org
@KimberlyBarth	human
@carvossosat210	org
@PeterTeePee	human
@kriskamarie	human
@RussFemAlek	human
@RestoBarM	org
@SweetwaterChi	org
@jxcheww	unknown
@creativenature	org
@pailaodeh	human
@31Dallas	org
@995mu	org
@SarahKrisenherd	human
@tiggerskate17	human
@StephonB81	unknown
@MarcieMom	human
@andreaguijarroJ	human
@HealthBay247	org
@rak_pirat	unknown
@BruCrewLife	human
@PhotoPinoCom	human
@SuzyQHayes	human
@anupama_dreams	org
@kerimkoc	unknown
@caramelgroup	org
@hashiruzo_3193	human
@TheParisianEye	human
@tredallas	human
@BalCinRecipes	human
@NutritionLeslie	human
@EATVit	org
@johnnchang	human
@TheFoodieAffair	human
@metsi	human
@CltLatinaHeat	human
@MonaIsmail	human
@DosCaminos	org
@SAMUKASHIWAGI	org
@misteedawnw	org
@MaZaRuKunG	human
@GrimsbyUK	human
@krasotazdor	human
@__ekta__	human
@Libationnyc	human
@robindavidman	human
@FamieWLatib	human
@The_Daydreamer_	human
@GeorgiaValdez7	unknown
@DonatosRaleigh	human
@FoodBeforeLove	org
@BlueLobsterPDC	org
@ACommunityTable	human
@PSHodes	human
@HypnotiqNicki	unknown
@SandBookWich	human
@twohungryboys	human
@Jazzbro17	human
@eatgregeat	org
@7inluo	unknown
@bot72582175	unknown
@Southinkucanmom	human
@phyaboo	human
@ContentKitchn	human
@PilatesFR	org
@RecallsDirect	org
@DKMOONWALKER	human
@HuiXian5	unknown
@gbchefs	org
@Foodstylelb	human
@IscoK	human
@nitehawkcinema	org
@lespros_sugi	human
@newintownEvents	human
@breakfastcrmnls	human
@iArrowLite	unknown
@StClairWEats	org
@ayumin6316	org
@ryanmillan85	unknown
@oldstreetcollec	org
@Jocelyn93471404	unknown
@MW5A	human
@Deal_und_weg	human
@HarrisonResort	org
@kateminifie	human
@ebruleeee	human
@AutumnBlues	human
@MiracleCuresYou	org
@PinstripesBBB	org
@HaleyErika1	human
@HRHM_f	human
@AzminaNutrition	org
@StylishScores	org
@KitelOlanka	human
@Ibiza_ReTweet	org
@wee_eats	human
@inkmarksofsu	human
@tonysdartsaway	human
@LeucadiaChiro	human
@GirlGetALife	human
@FreeVegasGLists	human
@BostonBistro	org
@panakavai	unknown
@theluxelife	human
@JenieceYardley	human
@Peace_Islands	org
@HalsteadNetwork	human
@Annakisskiss	human
@LwLadawn	human
@Galapadish	org
@happyfudtripers	human
@HellthyJunkFood	human
@ichangemyfood	org
@RealRandomSam	human
@faithmalone001	human
@cosicosi_mark	unknown
@DonnaKnutson4	unknown
@RichMFNQuick	org
@DeathbedFood	org
@Shimin27	human
@KPbewelldoc	human
@OMGYumFoodBlog	unknown
@stef_abonkq	unknown
@blu3s	human
@GilbertSlgd	human
@FazendaLpool	org
@CeremonyBar	org
@rolliebolls	human
@Lillybeans420	org
@SophieGritti	human
@alecavo	human
@WindsorReTweet	org
@feedmeAustin	org
@Smolgram	unknown
@MagdaPenpicka	human
@molek	human
@Pinkbeauty01	human
@JUBJEEP	human
@Shammy_07	human
@BistroJacques	org
@celery_cupcakes	human
@NicoleJocelyn3	human
@AllCasseroles	org
@kathygossen	human
@alps1810	human
@LPQFR	human
@vincenzosplate	human
@Yukari_MYGS	human
@Yoon_Billy	human
@ardyey82	human
@JoyceanneHong	human
@TheStewedCow	org
@Barethisandthat	human
@yukifromTK	human
@fatgirlsfood	human
@IntoKindleBooks	org
@Fatburger_BH	org
@thehopeglasgow	human
@NitaApriyana	human
@Quito_Instagram	org
@laura36lee	human
@manneddemalata	unknown
@ladrorestaurant	org
@redfortlondon	org
@HerneBayTweets	org
@DressFash	org
@JamieLBGC	org
@thefitcookie	org
@SmizerC	human
@OficinaLatina_	org
@BrendaAutumn3	human
@vitacelii	human
@ikebukuro_ramen	human
@rokidoki	org
@Rule_Standrews	org
@DorseyJohnathan	unknown
@fotovelo	human
@MrsLauralicious	unknown
@EatNuttZo	human
@JoellaHren	human
@AngelaPeauty	human
@AustinTM_Homes	org
@FreeVegasGList	human
@TheCanterburyWA	org
@Rockit	org
@TupinambaDallas	org
@cristinajade	human
@iAn0nymous	human
@glutenfreesensi	human
@BabyGizmo	human
@PassionPoulet	human
@crossfitfansyes	unknown
@andreea_tina	human
@drunkenfoodies	org
@SolWaveHouse	org
@mintannzimlich1	human
@Min2Ren	unknown
@MarissaHanna3	human
@QuitoRT	human
@pilateslaurah	human
@LLatakia	human
@k20beast	org
@foodsyoucaneat	human
@CAFETERIAnyc	org
@anneskitchen	human
@BarZia612	org
@cerwin711	human
@prettytallchron	human
@Gone2DLand	human
@apriljharris	org
@jessa9876	human
@TendersTreats	org
@ImojeanAberthol	human
@ElissaM	human
@caffeinehot	human
@blogtolearn	org
@FerroBarker	unknown
@tonyadwilliams	human
@LondonKiLadki	human
@luella_terry	human
@ehm_milia	org
@dxp7	human
@JessicaStreiff	human
@juliannekcash	human
@hautesausage	org
@Lonchicuates	org
@Henrys_Tavern	human
@choms56	human
@lwpprincesses	human
@johnnapaula	human
@StockportOffers	human
@DietingForLife	org
@newbodi	org
@ClosetCooking	org
@Ebony_82	human
@shinwei1125	org
@nobreadnyc	human
@Bali_Deli	human
@TeedraDiora	human
@StephSForrer	human
@SKChgo	human
@VegasPhotog	unknown
@megshue	unknown
@foodtalkindia	org
@RestaurantFox	human
@PitaPlace	org
@EnnEhZack	human
@vickicarter80	human
@dreya8	human
@7okma2	human
@georgiabenjamin	human
@jellymalin	human
@goro_murata	human
@nightoutireland	human
@chieri225	human
@ponoponoshokudo	human
@KristinAndrene	human
@BalconDelZocalo	human
@rodkevo	human
@NYCRetweet	human
@jon_233	human
@Bambi_F1	human
@Route66Goa	human
@wroprest	unknown
@BossTalkBway	human
@urbangaygriot	human
@NLVIRGINIA	org
@FrankMullens	human
@ThePinesGolf	human
@TheLunchCritic	human
@cess_mouse	human
@shermmmm_	human
@33Cafe33bofa	org
@willyyilly	human
@CBB_K	human
@Cricket_WC	human
@ConroysIrishPub	human
@SARAHGSMILE	human
@otoko_ryouri_mo	unknown
@SnackSnarkBark	human
@bot06301176	unknown
@FatboysOttawa	org
@InstaAnapa	unknown
@shakitamccreary	unknown
@soguemoments	human
@MD_TownsendHTL	human
@ohmexicomiami	org
@RRC20101	org
@anneskitchentv	human
@ThisIsBurhan	human
@KRojasAca	unknown
@DarbysUrmston	org
@NightCityDream	human
@DNM_Atl_Dining	org
@FoodTVChannel	human
@Streetzine	org
@AdvBio	human
@ajatheeagle	human
@TheBrassDoor	human
@CropDusterPlane	human
@TheVerantGroup	org
@DietitianSherry	org
@MillieandMum86	unknown
@1800goodfood	org
@aerl83	human
@Marbella_Life	human
@fusaros	org
@cioconatsl	org
@quenchagency	org
@Anchor_GEN	unknown
@iAmRexach	human
@D_FashionSpace	human
@naaaoton	human
@marie_cabello	human
@Gdekupiti	human
@TheOfficePubTO	org
@lekker209	org
@VersallesStAndr	human
@RestoWeekBoston	human
@MrKao	human
@fernandosrod	unknown
@ACedarSpoon	org
@BBCoachAlex	human
@sp4zax	human
@PIGletventures	human
@earlsrestaurant	org
@shopblogsuk	org
@MaskedRiderW_CJ	org
@stephysramble	human
@CindyThomas4429	human
@misspickledplum	org
@Anayari78	human
@HipHopBinge	org
@hooomaaart	human
@THE_KEG_	human
@homo_milk	human
@RMLaCroix	human
@RyKanQi	human
@AlertTrade	org
@Flyersonar	human
@Wchestermasala	human
@craigieonmain	org
@SiouxFallsDJ	human
@unislim	org
@Zeagel	human
@ChooseFarmerOwn	unknown
@DovercourtTalk	human
@catewalk	human
@nutrishkitchen	human
@MustoeGadsby	human
@looknookhook	human
@Aka86405Chase	human
@SanSalvaje	org
@yolaulau	human
@DingleSkellig	org
@MSlimalicious	human
@visje32	org
@MckenzieSavann1	human
@hulascoop	human
@IAmLivinLavish	human
@FredericaFried	unknown
@CafeVia310	org
@KarenBurnsBooth	human
@Loyapremium	org
@revsully	human
@WannabeGuide	human
@SavaryIslandPie	org
@BrookinsWayne	unknown
@SimplyTammyCake	org
@Mfkroon	org
@OzPaleo	org
@caesy_hihi	human
@MaySafa	org
@allfivesenses	human
@ashdeling	human
@Misplaced_Brit	human
@BatDedeq	human
@LevinaAbgail	human
@Paula_CallMePMc	human
@AthertonBaking	human
@BDJPure80s	org
@BeachHill1	org
@LetchworthTalk	human
@silvychandra	org
@NJE4LDeals	org
@andimthedad	human
@andreaspassions	human
@PeculiarForest	human
@Anns_Life	human
@deenattparrott1	human
@vutcharaphol	human
@myproperties2u	human
@SportsLadyH	human
@tinun0054	human
@sapphiregypsy	human
@sunizout	human
@gettanvi	human
@MyMarketingFile	human
@koogmo	human
@captainmahalo	human
@arrowbubble	human
@ItsPaulJerec	unknown
@uberstevo	human
@MagnusWestmore1	unknown
@reppi__07	unknown
@curlydianne	human
@MitsInMy0ven	human
@kitchenbug	human
@nauticalchick1	org
@talesbyryan	human
@Aegisfoods	human
@Tejal_x	human
@tottori_shimane	org
@RestaurantEVOO	org
@MzMarieBaker	human
@Hits92FLL	unknown
@Attendantcafe	org
@CatchNY	org
@MidtownGirl	org
@pixelhazard	human
@FriNightCooking	org
@anemone_nari	human
@mytravellicious	human
@_Penelope	human
@LoveSYL	human
@wongtongwei	org
@JewStar7	human
@RoushMacAdam	unknown
@Panaderia_Pablo	org
@Bailmox	human
@FurtherFood	org
@JoYumdimsum	unknown
@CathieAruthur	human
@JulianaFredly	human
@SproutNatural	org
@MizzeLoveShoot	human
@TheProperPlate	human
@nycfattykat	org
@Mykiekiii	human
@allenweichen	human
@SwaeggOut	human
@hejlita	human
@IamAdrianH	human
@Jenniec565	unknown
@tjbasechrome	human
@AnamIdriss	human
@SandwichAmerica	human
@gollygoshkers	human
@SAVMARKET	human
@mpennow	human
@MandaPhenomenon	human
@yamasakit1989	unknown
@ValenciaZ	human
@Mandom5354	human
@BeGlam_	human
@LifesNiceDrinks	human
@AnaPeralta09_18	unknown
@LAFoodtrucklots	org
@kanako0011	human
@ziziadventures	human
@Rekhakakkar	human
@fer_schez	human
@me_in_TO	human
@shizscotthk	human
@sabahbot	human
@GCGreatYarmouth	org
@JerettErn	human
@RateARestaurant	org
@5kinds_of_rice	org
@dandy_fresh	org
@pisal_ros	human
@GastrotravelDK	org
@AshFoodfashion	human
@bongjchef	human
@Steph_Silvera	human
@Chrissyyyyxoxo	human
@akiryan_Na	human
@nadia_batley	unknown
@mizzlovelyguh	human
@calm_sabrina	human
@VegetarianMamma	human
@SoooCHELLY86	human
@ALISONFUSCO	human
@RaynOriginals	org
@McGreevysBoston	human
@Smolagram	human
@HypergrafSmith	human
@xSlimJimx	unknown
@Chhiiaaa	human
@IndianBistro	org
@marismithus	human
@B891_	human
@hellomeetjune	org
@TheWSHLobbyist	human
@_CoronaDelMar	human
@fitnfree	org
@JenPetersen_316	human
@sonyaalves	human
@chicsouffle	human
@DialogCafe1	org
@JalapenoMama	human
@CBTLKH	org
@CollyWolly	org
@FidanAslan35	unknown
@veganrecipehour	org
@tomils	unknown
@its_nur	human
@table1espresso	org
@downbeatbear	human
@khuntoru	human
@MSetitoff	org
@sometimeredhead	human
@davyyip	human
@Natbeesfashion	human
@AsrarAlnja7	human
@duranneto	human
@YSL1975	human
@WorcsReTweet	org
@UncleGussys	org
@xmisslaydeex	human
@glenngoulding	human
@Chaddyboink	human
@blazinhorse	human
@EverydayShopper	human
@homeandplate	human
@carobfrance	unknown
@cattycritic	human
@wongchuncheung	human
@LBSnell	human
@LibertyGroup	org
@em_lou_1976	human
@Margug	human
@momsandmunchkin	human
@Tokhastik	human
@Jax4Lunch	org
@DominiqueGoh	human
@swiftputney	human
@edenQED	human
@ALKAHOLIK728	human
@YarisKindra	human
@EazyTable	org
@YumchaAddict	org
@LosMochisNews	human
@LizaSalt	human
@BeachChick234	human
@GraceGotHealthy	human
@Richard63521162	human
@RapmagTV	org
@_gjagger77	human
@WhiteleyJa	human
@ClunyDistillery	human
@yarbr012	human
@Foodassion	human
@WzerTwiter	human
@MrCreatistic	unknown
@1234567Smiles	unknown
@CampbellCanada	human
@filipacouto	human
@Satelliteroomdc	org
@TheLordBinning	org
@paulieastridge	human
@ILoveMCR	org
@Live_Joy_Fully	human
@igersroma	human
@JKnowsGoodFood	org
@gemmabelleats	human
@KellyBechtel1	unknown
@PepFodder	org
@LeanMachineUSA	org
@Couturelove3	human
@QuornFoods	org
@A__Martin	human
@TheNicoleLantin	human
@laristoday	org
@Veggie_Indian	human
@Sibyasar	human
@Recipes2Nourish	human
@foodbully	org
@PromoNMotion	org
@6thstreetyogurt	org
@marcomariaconte	human
@Zayema407	unknown
@surreysunshine	org
@MomOfAllCapes	org
@TonyaTko	org
@TheTweetsOfMP	human
@TorontoIsHome	org
@gottaluvness69	human
@DrinkSvelte	org
@ninobasilio	unknown
@digievangelist	human
@MarinaYusoff	human
@ZainKanyon	human
@AdrianaBrcn	unknown
@CafeEnSeine	org
@tigre_e	org
@eddielimcs	human
@PuntinoGroup	org
@PaulHerrera__	unknown
@PoloClubDubai	org
@mi_cha33	human
@aijobrickell	unknown
@culinaryadvco	org
@LifeBoxFood	org
@kurisachi7	human
@AudreyMcClellan	human
@VisioneNotturna	human
@vhbalderas	human
@liuchuanfeng	org
@Lolarestaurante	human
@doingitforme2	human
@elenka29	human
@tommydeAlano	human
@185freeman	human
@JihelceeRecords	org
@pedrolucero33	human
@nolitabogota	org
@sensalihaa	human
@sujie627	human
@216Bot	org
@Escalante_go	human
@brghospitality	org
@Cookingzone1	human
@BotanicalBaker	org
@socceray419	human
@chedda313	human
@littlemissfunn	human
@djbastim	human
@BetterWeigh4You	human
@miz0521	org
@Ruth_Vlz	unknown
@schule963	org
@viewfromtheair	unknown
@KarlaMe58610146	human
@misschelsmangia	human
@spreadsny	human
@amanda_crofts	human
@Soulmatefood	org
@AbagaelBasalia	human
@MsKluender	human
@Jojoekittisak	human
@Duckonwheels	human
@bychkov_david	unknown
@Burger_Bakar	org
@MsBost83	human
@RaraPupun	human
@SouthernRecipe	human
@fredkwg2	human
@imKeiji	org
@livebettermagCA	org
@LaraJT_Photo	human
@RBcastro_	org
@4guad	human
@Becerra_LErnest	unknown
@olov_Larsson	human
@bob8791	human
@Trinemora71	human
@foodheartsoul	human
@LegendaryBlur	human
@nnr_non	human
@imMarjoriCortez	human
@ruthfloresca	human
@anitbh	human
@sachins50595	human
@SiNxxx526	human
@IAMBELLFIT	human
@HatfieldTalk	human
@JGumbosTN	org
@LesRoutiers	org
@CaitlynSydney1	human
@Travelteams	org
@retweetDetroit	org
@EemanTeoh	org
@RestauranThalia	org
@MoesenDwade	human
@instaufa	human
@M8oalat	human
@Nutella_Tasha	human
@ittipon6998109	human
@SarahJester	human
@SpamellaB	human
@shalnyong	human
@ainafizah	human
@LavenderDesign2	human
@ImperfectPaint	human
@alicekon	human
@foosye_ceo	org
@YorksCafeRYH	human
@EadignesZavana	human
@TheFoodie101	human
@Trae_tha_Truth	human
@_foodietarian	human
@giltrestaurant	org
@RayPajar	org
@MegzyCole	human
@joshbeckerman	human
@PSocarvalho	human
@czardgreat28	human
@Carolyn_Eliza	human
@AnthonyMaslow	human
@aquacotton	human
@seung329	human
@DEEP_N_STEEP	human
@jonasapproved	human
@deejayplaay	human
@MeridianFoods	org
@beArianai	unknown
@umeta_u	human
@EncoreBeachList	human
@youlandaqqmcco1	human
@chaos_ume	human
@ChungKristinas	human
@tapas_si	org
@KarineFerland	human
@beancounterau	org
@Mich_MadisonTV	human
@ColoriKitchen	org
@Sopros_Da_Alma	unknown
@RVTravelGuide	org
@iLoveS__	org
@ChocolateMax	human
@joedezzylove	human
@OuterSpiceit	org
@millykr	org
@takeabiteblog	org
@PynStrype	human
@aomits_u	human
@ArnoakaDude	human
@SweetRevengeNYC	org
@zoeluyeeeeza	human
@terrymajamaki	human
@LegendaryPearly	human
@rafaelovTimBeta	human
@BizLunchNetwork	unknown
@VeganGoodness	human
@foodhussy	org
@CosmosSouthside	org
@MannysGrill	org
@spur_themoments	org
@LegendaryPepper	human
@boccebar	unknown
@ricardocosty	human
@ken_ari_27	human
@Panda_Bubble	human
@TheBardGodstone	human
@leesoonho	human
@LydiaDowney	human
@samtph77	human
@LucySullivan888	human
@ManhattanNguyen	human
@guoxing_chen	human
@CineLight	human
@DuParsRestauran	org
@fragglefrog	human
@inglewoodhotel	org
@StockyReTweet	org
@WappingLee	human
@slvrdlphn	human
@Chez_hsieh	human
@FitWChris	org
@BlackDomonic	human
@jairoduquemusic	human
@TapasCielo	org
@CharlottaRBE	human
@CaitlinPeyton1	human
@FoodieInBrixton	unknown
@LaDnicheuse	human
@WestfallRoxana	unknown
@dannymoubbg	human
@A7laamGdeeda	human
@nenengocampo	human
@Suejeong_P	human
@chefsallyjane	human
@MrSteThompson	human
@KitchenChopper	human
@theprettyblog	human
@superMARKmo	human
@sav_ampersand	org
@uss_yoka	human
@cottagelajolla	org
@itsLin	human
@NegroniMVD	org
@goLadleLondon	human
@kalechocolate	human
@CafeAt36	org
@AFireStation	org
@marisachurchill	human
@bot82239236	unknown
@BrynnWJoachim	human
@FoodWineFine	human
@vicfarkas	unknown
@RudolphFoods	human
@Chicago_Picks	org
@SteveTayse	human
@monimoleskine	human
@ErieAHA	org
@TheatereLover	human
@horacion	human
@RedTorchGinger	org
@hughldridge	human
@cmo2cute	human
@iamFRANQ	human
@theoldbarracks_	org
@AbrielleAntwone	human
@BloomingdaleDC	org
@iamfelipa	human
@BOTYboutique	human
@samho26	human
@woquave	human
@ModernTik	org
@plrodriguez	org
@ScarletBrooms	org
@PennyRaffles	org
@LanoraWedora	unknown
@CammyBeluStrong	org
@IABC_CO	human
@SWEETLIFEofXONG	human
@OliviaMargaret	human
@PakCikStevenali	human
@ElbowSkipper	human
@passionbjx	human
@m_simeone	org
@MiteshTake	human
@royalemarketing	human
@RootCat	org
@CastelloCoffee	org
@LatinFLL	human
@lonbautista13	org
@febrina16	human
@RodrigoVcnt	unknown
@Alexand57880780	human
@AfricaRetweet	human
@InstaFTM	org
@Fashionfiesta21	org
@MarketAmway	unknown
@princess_chen	human
@meganwolfRD	human
@maskofowl_007	unknown
@dmackdaddy	human
@MMarizon1966	human
@modelmarketer	human
@yyzretweet	org
@mikhaelmingk	human
@vendicti	org
@rukidays	human
@PremiumFood_bot	human
@QuickNEasyfoods	org
@greenmissionmom	human
@hedihearts	org
@SAYUKIsvoice	human
@AbernethyButter	org
@KettaP	org
@ConcessionBIA	org
@langanslondon	org
@GSheffield	org
@RHOyalFlyness84	human
@FRTriathlon	human
@Tairyoindo	org
@itrosky	human
@she________	unknown
@mervintankw	human
@ADashofMeg	human
@NaturalFoodCpnM	org
@goingpotty	org
@millyminC	human
@ohmybambi	human
@AliciaSamaan	human
@LuvMyAuntieFlos	human
@mike_wieszcz	human
@winnieracer	human
@jaravin25042	human
@Dreamers_Lane	unknown
@THESERVINGSPOON	org
@ChefAriella	human
@interestingeat	org
@urobabe	human
@mandiipops	human
@cjzenarosa	human
@AfflatusPub	org
@luxytheory	human
@GheaNoviar	human
@AugustBoatwrig2	unknown
@KatieJ_A_C	human
@acadianathrifty	human
@MisterGreenwich	human
@AriasOmar	human
@takabonbon64	human
@FajardoSettles	unknown
@Killa_Dee_	human
@AdonnaStillman	human
@AblendanPenley	human
@TXGulfCoastShop	human
@catchoachuy	human
@whamscafe	human
@TradeRadioFm	human
@bot55014624	unknown
@Mudtooting	org
@Ipul_JKT48	unknown
@beberton	human
@patriciafitnez	human
@AmeIia	unknown
@ElCharrocfl	org
@Parisianavores	human
@TheGaztronome	org
@PCuanda	human
@SophieintheKitc	org
@Iamfoodiedoodie	human
@PitajMamu	org
@yukijamie	human
@AussieMumNetwor	org
@toprecipesland	human
@MyTravelBoektje	human
@famfunjournal	human
@DJMIKAnyc	human
@Lynndeeee	human
@HonestlyHealthy	human
@hotbeans0208	human
@ValCassies	unknown
@bluefinnyc	org
@peake_lauren	human
@CarveryKitchen	org
@ohsunnymornings	human
@SavingShepherd	org
@mySushilicious	org
@piaggioonwheels	org
@ilovegymheroes	org
@MagRahn	human
@AskSirStamford	human
@CasimiroEscobed	human
@ARedHeadedVegan	human
@msKitchenista	unknown
@sweets_addict_K	human
@ASHwoodfired	org
@mylifemyblog_z	human
@chairmantruck	org
@vanjulius	human
@Renesalas_	unknown
@mj_dolly	human
@TonyMcCuneMedia	human
@Fat_Mans_Cafe	org
@ItzLinz	human
@AbergavennyCnyc	human
@PpPaLiDa	unknown
@AdreaynaEllys	human
@cafe_MAO	org
@VictoriaAdria12	human
@AdrenaAnnisha	human
@RichardsPlaceFL	human
@KyleKONNECTED	human
@YongsukHur	human
@nniieecc	human
@Tony_Burdman	org
@RunEatRepeat	human
@GosportTalk	human
@Faisal_AlKetbi	human
@RTGoodMorning	unknown
@Ranjeeta_Kaur	org
@Gill_Manwaring	human
@sheenchew	human
@ElleganciaBlog	unknown
@nicmonks	org
@Yilvina44	human
@m4ttr1987	unknown
@ChefArtSmith	org
@fityak	human
@DeliverBasildon	human
@LideOliveira	human
@johnlth93	human
@sunsetgrown	org
@iron_vince	human
@Spydathedj	human
@CaroLInaFlyy	human
@jdilladaddy3	human
@snorlaxandra	human
@Poppyarn8	human
@MyraBev	human
@fromnytonc	human
@spiritbeckmedia	unknown
@DNM_SD_Bars	org
@Kinjal_91	human
@FitCakes	human
@StellaBoston	org
@LeftysGrille	org
@divasrunbling	human
@pizzasomm	human
@kyrapops	human
@thecooktwit	org
@TheBentoBuff	human
@ksophisticatedk	human
@ToulouseCafe	org
@KennyReynard	unknown
@ksaelen	human
@esciledaje	human
@Petfriend321	human
@joestyx22	human
@BornAChef	human
@reezal39	human
@BeulahMonie	org
@avatardriggs	human
@waldenfarmsuk	human
@potideanbard	human
@TatianaMarinC	human
@Detroit4Lunch	org
@2Me15	unknown
@chef_jimmy83	human
@HillsideFarmacy	org
@RodrigueMelvin	unknown
@TheRavenGlasgow	human
@chong_carol	human
@moncali	human
@KarloMaz	human
@PunchFoods	org
@HarlemFoodBar	human
@pitbastard	org
@Alittle_piece	human
@BirdAndGarden	human
@Billieroseblog	human
@CiaraCanCook	human
@Notes_Sojourns	human
@cafedov	unknown
@sprosveta	human
@ElishevahMonrad	human
@valerieperez853	unknown
@mcrconfidential	human
@CustServiceBox	human
@mzmiami77	human
@alisonlewis	human
@JustSayGourmet	org
@ABrieyanna	human
@luxuryeventsa	human
@EdenBurgerBar	org
@HollyStormEtsy	human
@Aiko9113	human
@VeganKings	unknown
@__Ecie	human
@freshgratedparm	org
@MammaGrazzis	org
@DirtyBonesLDN	org
@AngelesMgca	unknown
@thedarkcoffee	human
@AlbinaFitz1	human
@rkmangus	human
@BlueMountainBB	org
@BirdsOnTheBlog	human
@djmigat	human
@BLAS_Official_	unknown
@WaxEBuildup	human
@TasteAndTravelM	human
@SnapCustomPizza	org
@yuta20090309	human
@BloggyBarbie	human
@azteca_cr03	human
@JDawgBrooks	org
@amir200477	human
@m_i_c_h_a_e_la	unknown
@j_lifeisabitch	human
@SavorySavings	human
@difficultkind	human
@PeachesTruck	org
@rucabella	human
@EatingDirtSF	human
@iask_tw01	human
@TavolaBar1	org
@cookingchat	org
@BRAZlL2014	unknown
@theorchidd4	human
@MyThirtySpot	org
@MyNutrela	human
@RicardoValdrr	unknown
@rmwidjaja	human
@thisaeshaw	human
@kimberlyfisher1	human
@Japan0129	human
@n_skywalker	human
@andresmadrigalg	human
@triathleteliam	human
@ukiuki_Go	unknown
@Walter_Athow	org
@aaronandjulez	human
@AntonioVivs	unknown
@tfurca	human
@GeraldoTan	human
@focusgood	org
@EdgeSocialGrill	org
@SemiHealthNut	human
@JaneTham20	unknown
@DoughboysDublin	org
@LlevelysYsberin	human
@bigmommainnorma	human
@CrystalBayClub	org
@poe_rea	human
@time1066radio	org
@berjw69	human
@LuchaManchester	org
@EricToral1975	human
@traveltap1	human
@ChristineItUp	human
@AlexisRobbins	unknown
@MyChefMaggie	human
@WildOrchidTink	unknown
@Titofrez	human
@emkwan	human
@jangelina1213	human
@decorplanet	human
@fulfill_jp	human
@michaelmonks39	human
@curryNOprince	human
@nanelvisfan	human
@avocadopesto	human
@tomevansbkeys	human
@BoriosR	org
@castingqueenny	org
@shoheiyamamoto1	unknown
@Vinod_Cookware	org
@MoneyMediaInc	unknown
@TTT_Etsuko	human
@nessaporter	human
@TasteCheshire	org
@wainhead	human
@Nisa_DCB	human
@RaulCrvn	unknown
@DegThaiTruck	org
@danni_smit	human
@HerreraASamuel	unknown
@GMoney_29	human
@TrilliumDenver	unknown
@Guille598	org
@777samsara	human
@trevorogden	human
@EvangeFontana	human
@britpanther	human
@danielbrin1	org
@ppcdad	human
@SoGirlCitySwirl	human
@BentologyLiving	org
@OrhamZander	human
@ThisIsSunrise	org
@JorgeRda_	unknown
@allohayona	human
@katrina_dita	human
@tdoreena	human
@MeeeLyY	human
@IsaRM88	human
@Timbo_tha_Gr8	human
@windsorarms	human
@ThisMomsDelight	human
@diwinetaste	org
@foodblueprint1	unknown
@MiquellaAbrigai	human
@Billywizz1976	unknown
@DoubleQuicktime	org
@Tangerina_N16	org
@dorisknowslife	human
@ValeriaCatheri3	human
@peacedumpling	human
@Ami4levi	human
@pandrapon	human
@Fitnesslina	human
@astonishingIvi	human
@Gobious	human
@Cultiv8Hope	human
@TheGriddle1	org
@SilkenDiagonal	human
@Luis_chagoya363	unknown
@100Hoxton	org
@SaharWilliam	human
@melicioushoney	human
@devnijh	human
@4563photo	human
@andrealilwing	human
@theHeartMini	org
@L_A_Cafe	human
@BrookInnChef	human
@travelstates76	human
@RichmondBrunch	org
@stbartsbrewery	org
@nanasuleiman	human
@technomasters39	human
@NAomIENAomIE	unknown
@TastesofLizzyT	org
@Julie777	human
@GenoveseItalian	human
@Bravo_Italian	human
@friendfragrance	unknown
@chatarpa	human
@futhi_n	human
@brianfoonghc	human
@Fadzol	human
@ChefKamiRedd	human
@sainetnada	human
@purelamerica	human
@wanahfong	human
@urbandinertorre	human
@MarylandCompani	human
@MUSEcafe_LA	org
@miyuupepper	org
@SamuelTlvr	human
@vickyayles	human
@LunchAtSams	org
@sojunari	human
@BenderMiss	human
@academ_foto	human
@Graphito	human
@moochabout	org
@NDmedjooldates	human
@zeppy_kitchen	org
@TacianaYamilet	human
@jovee_lark	unknown
@checkoutfashion	human
@WMFoodJunkie	human
@ChiPublicHouse	org
@bot57922248	unknown
@TriciaWDC	human
@TyronPella	human
@MrStyleRAMedy	unknown
@wanwaifun	human
@The_Queen_Brie	org
@AlwayzDressed	human
@SergioQrga	unknown
@HernanOlvrs	human
@ZKurzeneva	human
@Sahadis	org
@EXPOgram2015	human
@thelunchreport	org
@Zisdeborahfavo1	unknown
@TheHangarTavern	unknown
@MathewsChang	unknown
@BoscoCafe	org
@messijessiblog	human
@wdesdeadentro	human
@WHOsheTHNKsheIS	unknown
@Lunch_BXD	org
@pamelaspunch	human
@HoneymoonGondol	org
@miyagifood_bot	human
@OrlandoE4L	org
@yamiandthegang	human
@LeoBas_to	unknown
@SupportChangeTo	unknown
@masamasa_054	human
@soppiekannu	human
@ReginaIsabella1	human
@ThePhoodStudio	org
@afoodobsession	org
@imbigq	human
@ForkedUpLA	org
@jaybilog	human
@OCFoodieGirl	human
@Oat0409	org
@LilyJulia5	human
@lpchef123	human
@RenzPaolo88	human
@resa_97	human
@marcpayan	human
@alyssavn	human
@Name_NTV	human
@royalslutness	org
@KlayPhotography	org
@ToddFarabee	human
@millzy_so_sweet	org
@nomnerd	human
@LABATTOIR_VAN	org
@LazaroPrad	unknown
@neilrubi	human
@arnaldo_jpa	org
@GR8FoodCartsPDX	human
@ABirkie	human
@roseytraveller	human
@tn_Recipes	human
@Drevander10	human
@BugglesSqueak	org
@Tavern29	human
@aiko6034	human
@Allrecipes	org
@USChuy	org
@BanyanTreeMcr	org
@DivineEnergy	org
@marySnoww_	human
@CaroliisBraga	human
@MadamTans	human
@yummy__1016	human
@sicks93	human
@Blagueusemode	org
@cafebigmouth	human
@WrigleyBBQ	org
@HighHeelsSophie	org
@rdv070681	human
@naomitweets10	human
@winterlikesnow	human
@TandoorChef	org
@kiaracruz84	human
@Ceci_jimenez4	unknown
@shigeki_w	unknown
@TheMacaronStore	org
@SeannyTiernan	human
@thatgoodfood	human
@AngeliqueCatin	human
@makiringgg	human
@NOLAMixn	org
@FraternityChef	human
@EatAtDeanes	human
@bot16094554	unknown
@Visteles	human
@Vegaswinechick	human
@Born2Winnnnn	human
@CleaverEast	org
@theonegodchose	human
@RecipesHub1	org
@MartinLovell23	human
@missBaiLing	human
@yunjeongx	org
@friA_7988	unknown
@OPDEITS	human
@BlackDressInspi	human
@KIWImagazine	org
@deqaqinuc	human
@KaftaShawarma	human
@LenaHershey	unknown
@nobmyzk	human
@ReevesZavrina	human
@SantosAnneBK	org
@onesavvysarah	unknown
@RicardoRjas_	unknown
@WellInspiration	org
@Vegaster702	human
@Catherineaero	human
@HeelsPassion	human
@GoGooTour	org
@Mia_Eliades	human
@kumiko_rosa	org
@aahna63	org
@BigSteveShow	human
@basileia86	human
@MealshareTeam	org
@teneraloca	org
@DianePhillipsIQ	human
@AsMomSeesIt	human
@SpringGardenRd	org
@UlisesRya	unknown
@eMoreMoneyForMe	human
@arbi2k	human
@TrulyNourished	org
@evolutiongrille	org
@FrancesGatesOf8	human
@AHAPhilly	org
@RalphieMelville	human
@nycstylecannoli	human
@Ali_TooTooGood	human
@iCHibogs	human
@WynnifredDorit	human
@MarcoErmini_13	human
@tKiTotnes	unknown
@lalospty	org
@ILoveSh03S	human
@samadhanam	human
@KelloggsZA	org
@notyet100	human
@latin_lagniappe	org
@ChefLou95	human
@bistrant	human
@AccaTillman	human
@BingeCast	org
@LoveCoffeeHour	org
@BenandJackSteak	human
@GlorinYrre	human
@AZgrabaplate	human
@lost_limey	human
@Caterine_Black	human
@Mizz_Jackson11	human
@shoesandheels_	human
@FoodTrucksNash	human
@ThePipsqueakery	org
@truonglenguyen	org
@kioumourino	org
@john_siracusa	human
@PoranRamen	org
@LoveyLoi	human
@NormasCafe	org
@fmalyda	human
@ActiveVeg	human
@oanhtra	human
@MelanieBrianna1	human
@GerganaSavova	human
@Lace9HandDrawn	human
@SUSHISAMBA	org
@SheratonPanama	human
@CandidsbyJo	human
@JulieDaniluk	human
@lovelysneha_	unknown
@NicksDeli	human
@lolrannieface	human
@MinasMiami	org
@TheReggaeChefs	org
@JambinosJoint	human
@Boopsyou	human
@n14chnz	human
@E_R_U_B_E_Y	org
@ThermoMummy	unknown
@UKBusinessRT	org
@RTChitre	human
@UnoSoloNoBasta	human
@XtremeCouponMom	org
@CoyoteCafe_	org
@YourethecureOH	human
@cfnfoodfight	org
@stevenbold	human
@TeveSzoli	unknown
@taylor40906	org
@yinsbear	human
@ZinaEleyn	human
@ninajazzy	human
@suelagoo	human
@nakedforsatan	org
@MsSacred	unknown
@SWeeTyy__pIE	human
@PuddingHoney	human
@kiranagarwalla	human
@aitibot11	org
@Wallys_custard	org
@CanarySquareJP	human
@nessfromvenus	unknown
@laceyanneramos	human
@Toledo_NYC	human
@dolce156vita	human
@SoyCafePhilly	human
@caffehardy	human
@Vanderbeeps	unknown
@SwankSouthern	org
@ramen_imbot	human
@inakaboat	human
@VitaSociale	human
@MileHighBecky	human
@jtrophy	human
@MarcosNav01	unknown
@BekYusupoff	human
@YamiletLaChrist	human
@piratefm	org
@PabloTird	unknown
@chiftf_125Clark	org
@andri_unank	human
@thegentsjournal	org
@BeccalynnYeard	human
@AtelierCreole	org
@foraplateful	human
@tigressqueen16	human
@LoneStarTacoBar	unknown
@lunabunny7	unknown
@2kidsandacoupon	human
@Kamatdubai	human
@BloggersBlvd	org
@AldrichZake	human
@ArabTopTweeps	unknown
@yukngobrol	human
@EmilSpanos	human
@EatsTheCapital	unknown
@BrianTothLA	human
@AaricOdwolfe	human
@jeremiah2007	human
@bot82476859	unknown
@ADashofMegnut	human
@NalouParis	human
@peanutbutter820	human
@yanz10	human
@ablogvoyage	human
@AboutThymeKE	org
@TuttoProntoTO	org
@IZerenity	human
@corleone_twitty	human
@NJS4EVER	human
@green_cafe	human
@ArturoZarg	unknown
@Anitaislove	human
@StayCloseToHome	org
@CozmoCafe	org
@AHADelaware	org
@JoseSPiano	human
@koh_chang_pics	org
@Dutchess_Roz	human
@charles4691	human
@hotel303	org
@Jaaanyuen	unknown
@LevynaDorette	human
@lechiclapin	unknown
@moor410	unknown
@unlmtdsmarttech	human
@NewYorkSnacks	org
@Carmenyee88	human
@Smp1508	org
@ArizonaCompanie	human
@falaj1	human
@jasondh153	unknown
@ajlaboo22	human
@RickMerlanNYC	unknown
@JennaSophie1	human
@negrilvillage	org
@MzThickMms	unknown
@segagdl	org
@AmerHeartYTown	human
@tcampbelllcsw	human
@ChefnolanJason	human
@HOBNOLA	org
@TheCeiliCottage	org
@cheli23	org
@Madelin13777642	human
@sugally	human
@MahSandwich	org
@Ving_	human
@Coruna42	human
@the51bar	org
@se_co	unknown
@AEAZY5	human
@anallievent	human
@bruinsfan1975	human
@LeroyTurkey	human
@LiveFitWithBrit	human
@ipominova	human
@GordaaBella	human
@brandonslattery	human
@Allaroundmomss	human
@RolandasPT4U	human
@DJEddieOne	human
@dee_downing	org
@JustAbarber	human
@brylee1889	human
@HanJessicaHan	unknown
@ranposan	human
@thuytranchau	human
@terry_pascoe	human
@dailymoist	org
@TAVERNPB	org
@shion_yn	human
@bennnwjk	human
@TotallyTerris	human
@JilliannaFlyta	human
@vegamot_rvk	org
@brazilchurrasco	human
@IbizaNewz	human
@ThaiNWok	org
@Myshine	org
@NCOUNTERAZ	org
@lfcvicki	human
@noj	human
@nycfat	human
@XJAPANbot	unknown
@PalateXposure	human
@satoshio521	unknown
@Despinas_Cafe	org
@BrianCalhoun	unknown
@ashrafnaserudin	human
@JohnnyFranklinn	human
@JanetLPerry	human
@mianmaro2012	unknown
@Dotielicious	human
@Ceeryus_Lee	human
@MsMarmitelover	org
@JoshRotter	org
@ThePrincess_EL	org
@RealCalifMilk	org
@JoanLuvfeelin	human
@DFGrilleDallas	org
@Humperdinks	org
@kensingtonYYC	human
@mgllazaro	human
@Exodus_Wellness	human
@lina_to_u	human
@_prettymom	human
@morewless	human
@instagramvegan	human
@areaskr	human
@YuleLaurraine	human
@NavaAr0n	human
@Rike_Winchester	human
@JoyAdventure	org
@Littled99	human
@oscardj0701	human
@UrbanSentiment	human
@NATSU_CRiB	human
@DiamondBurlesqu	human
@EatinN8	human
@Diddy186Davies	human
@JoelSolstice	human
@MariaKilgorefzg	human
@welovebudapest	human
@italiancookingb	human
@SimplyMcsteamy_	human
@YaseminFox	unknown
@eatwelldiehappy	org
@BrusCounter	org
@ryankubo	human
@FeiLongTran	human
@Dneufeld1978	org
@AekleyFarren	human
@TeohJennifer	human
@Sushsane	unknown
@GrinseStern	human
@peteharpham	human
@gourmetTalk_bot	org
@bluexmas47	human
@narinalouboutin	human
@franklyKathryn	human
@kieris13	human
@akiran_jp	unknown
@LinaliciousMcLo	human
@sharkyire	human
@PittsburghAHA	org
@agostinasaracco	org
@HealthDiabetic	unknown
@chestertweetsuk	org
@hikari08232000	human
@fablekitchen	org
@Blueracer2010	human
@AbagaleErn	human
@Janthinus	human
@bcperez	human
@DanielSanchezsl	human
@NoeUGarcia	human
@fitnessandfeta	human
@farmstarliving	human
@MichaliaYsgawy	human
@deliciouseveryd	human
@nobuuu0405	human
@KaminiPather	human
@bluewatergrill	org
@yum_burger	human
@Barn1Mk	human
@jkane893	human
@lopenavo	human
@blindmonkwpb	org
@EsquimaltToday	human
@polkadotbikinis	human
@websites4accomm	human
@EadlynZak	human
@MackenzieBritne	human
@LaloRqna	unknown
@SeasonsResto	human
@MuchAdoBlog	human
@oooootarieooooo	human
@JoseLee0okG	human
@azmituan	human
@daracooks	human
@dhasohot	human
@missjbaggins	human
@OnesTopAppSol	human
@DebReset	human
@mottocuisine	human
@SandyWYOoi	human
@ElkintheWoodsN1	org
@DENKIsnack	human
@AriFlyy	human
@OISHIMIRUKU	human
@therealalcutta	human
@beglutenfreeB	unknown
@thenewsyouneed	unknown
@livinghealthy93	human
@Livideyez	unknown
@RebekahAngela	human
@MugShotDiner	org
@used_cars_77	human
@AtomicaKingston	org
@rubyfoostimessq	unknown
@LittleGreyDress	human
@vintagevixen111	unknown
@SamiSkow	human
@Koolchevrolet	org
@OttawaSteak	org
@AckleyColby1	human
@elrinconmex	org
@rei_yang	human
@meeryon	human
@FoxandFiddle	org
@cookingspree	human
@SavingSense	human
@hunterslanding	human
@MadelineAlongi	human
@MarlaMeridith	org
@IchanMulyono	human
@homejobsusa1	human
@kouponkaren	human
@CleveQualityKix	org
@Vizien	human
@degroenekeuken	human
@clover_mamasan	human
@JasonBrittonrrs	unknown
@HoneybourneLine	human
@Meatwinery1	human
@pitapitmcr	org
@itskaystory	unknown
@WestGoshenDeli	human
@WoodbinesLIC	human
@PinocchioPH	org
@mariner_hove	human
@bijoupdx	org
@namibycandy	human
@CetGourmandises	org
@EdenaLow	human
@foodperdiem	org
@DowntownPizzaCo	unknown
@crustandcream	org
@DarrillXzavier	human
@ja00700	human
@raffietaffie	human
@bot73257224	unknown
@Bigeyespotbelly	human
@trendtradegroup	org
@Lordofthefries_	human
@matchboxdc	unknown
@what2london	org
@patrickboglosa	human
@AlbertoMnts	unknown
@FatExperiment	human
@jednc2	human
@DdoeDdoo	human
@Nkapchuk	human
@dice41093	human
@RubyZap	human
@nakirareizojr	human
@AngelDestiny11	human
@ItsNotHouItsMe	human
@kwangz	unknown
@MXCOnyc	org
@SandraRadav	human
@jazzyfemail	human
@blackcat8023051	human
@andryakayz	human
@WhatIEats	org
@JellyIvy	human
@RumZatSimplisio	org
@Lonardo_pantion	unknown
@SbiccaDelMar	org
@BoccadiBaccoNYC	org
@quietriot10	human
@Babyshowerandco	human
@etsomerset	unknown
@CookEatLeb	org
@tommygeemusic	human
@HashTagForLikes	human
@BullBearBar	org
@MultiGoldvideo	human
@HenrysATL	org
@Jojjosplace	human
@allenaaron274	human
@whereyatnola	human
@valentinasofo	human
@futurahomedecor	org
@wobcville	org
@fiminska	human
@originnorth	human
@Shinzu11	human
@The201Bryan	human
@HollandsCake	org
@Breakfast_Boys	org
@linevedy	human
@foodiesecrets	human
@JuliaLily3	human
@AngelSaki	human
@RomagnaMiaLFC	human
@kirklandsl	org
@airgotravel	org
@madrizmola	human
@RunningCinnamon	org
@SirakornO	human
@LaineyNuguid	org
@EatDeliverd	human
@pinasmuna	org
@JadeLDesigns	human
@LukaszZelezny	org
@LifestyleLauren	human
@youcanbhealthy	org
@areu4christ	org
@urbaneat	org
@thebrownstoner	org
@bloodychanel	org
@stardchiu	human
@TheNewModernMom	human
@RunwayChef	org
@SAITChartwells	org
@louise_stubbe	human
@SergioPrras	unknown
@tokyoexpressidn	human
@RosaElfe	human
@momoindependent	human
@Spectral_Illumi	human
@MissVanilla88	human
@jhundiane17	human
@cotefit81	unknown
@a1exus	human
@pinktaxiblogger	human
@ilovemynewyork	unknown
@classicbahceli	unknown
@fragrantfriend	human
@GFDougie	human
@blahnikbaker	human
@jameskim369	human
@DonateandGive	unknown
@Nana_LimMeiXian	human
@drdairy50	org
@greatist	human
@RaqueleStyles	human
@jasmeetarora	org
@neocco_lucky	unknown
@DoctorGOE	human
@WolfeOrdwald	human
@SecretAnne77	human
@join2manish	human
@ChowFoods	org
@La_Roma_Ottawa	org
@BullMarketFL	org
@donnars50	human
@ItadakiBoston	org
@Love_Redgage	human
@Chefbhasin	human
@vinny_wa	org
@micielomicielo	human
@hennasooq	org
@lawsonroberts	human
@ArtfulDodgeCafe	org
@waynemountan	unknown
@jannahcain	human
@kaysha	human
@FatsRestaurants	org
@JasuSade	human
@Halfway2Healthy	unknown
@TheTwistedSwede	org
@CarinosKuwait	org
@ComiendoenLA	human
@FieraExpoMilano	org
@T_S_U_B_A_S_A_2	human
@Justikanz	human
@MioAsmara	human
@FTLToday	org
@AdneyMidge	human
@CherlyXaviar	human
@WymanWilhelmeni	human
@zizi_ejayzi	human
@ArielPned	human
@Daalight	org
@LaFemmeEpicure	human
@theexchangewpg	org
@emilyjgoodman	human
@KatiPartanen	human
@snlz0	human
@corchowine	human
@HeartKentucky	human
@KimberRinaldi	human
@AmiraFoodsUK	org
@AngelicaAlmn	human
@ZombotZRA	org
@cucullapraline	org
@RealtyJcfrancis	human
@GamayunSummary	unknown
@Matt41John	unknown
@macdrap50	human
@zikinasarenica	org
@KylieJessica2	human
@nigi2nigi	human
@iamdanieldeleon	unknown
@ecjamesfm6	human
@365breakfast	org
@AdrianahGucci	unknown
@ChicagoJogger	org
@940116_	human
@connienovak29	human
@jessey2010	unknown
@ZeitounaKw	human
@AHA_WV	human
@VinifyItaly	org
@TomandSerg	org
@RealHeDi	human
@JoAnne_B_R	human
@marshmalloword	human
@atemple28	human
@elif_eker	human
@thesybpig	human
@Nourishment_Now	human
@tjpoisal	human
@ruhl_sally	human
@bostonceltics32	unknown
@mister_steven	human
@iamchazncharge	human
@lugto13	human
@NickiKinickie	human
@greycatsunite	human
@haolehawaii	org
@Guzmannelson5	human
@Anniek_Loves	human
@Lilli3Lillian	human
@DarioRmro	unknown
@DrFilo	human
@HorsingAroundLA	human
@dessertnowblog	human
@Jale_0PuntoCer0	org
@bsugarmama	human
@MSOM_MG	human
@MohamedToureUAE	human
@fullsupport4you	human
@ArmouriesGrille	org
@Northwest_DC	human
@TedeschiAlessia	human
@fluffbakery	unknown
@MaxVorontsevych	unknown
@99Crushes	org
@GingerVillage	org
@MountBx	human
@maga_neko	human
@heatselfie	human
@RK_BinHuwaidin	human
@YaDaChef	org
@WakemanZayne	human
@AbbagaelDomoni	human
@CatchaJob_ca	org
@thefoodietrax	org
@DinaLozowski	human
@KellyEmma2	human
@nialllsfirst	unknown
@mikeyvoon	org
@redplumfinefood	org
@nessylicious	human
@hockeygal4ever	human
@SimplySeedZ	org
@min_19	human
@linzgoeslocal	human
@CityliciousUK	org
@jay01022002	human
@MarijuanaUnions	human
@EpicureanDC	org
@DoveMangi	human
@KathrynDaniela1	human
@AshileeZak	human
@DingleHotel	org
@chefericarrouze	human
@Wep_Reborn	human
@MsPerfImperfecT	human
@MTLawlor311	unknown
@madamnica	human
@AyseMelikeTekin	unknown
@KurskiRacing	human
@ke3m0	human
@itzchristineee	human
@ploughstars	org
@JameseXari	human
@SoloRioja	human
@CincyAHA	org
@BavariaNYC	org
@foodiephotogLA	human
@Femme_Foodie	org
@lbro878	org
@JEWELZRUS	org
@FollowsummerGG	human
@WildWingCafeTN	org
@tan_archer	human
@FashionableHost	human
@AHACentralPA	org
@CheeseEatery	org
@welovecheshire	org
@A_LITO	human
@Culinaristico	org
@dougpickering	org
@MandK25	unknown
@edwinyuswandi	human
@MiddletownAHA	org
@babagrlshell	human
@Justin_Slaton	human
@SulwynAbOwen	human
@MWPhotoArtistry	human
@AbrigailHarley	human
@AmerHeartCanton	human
@Nanbantei_PH	org
@Dan_and_DeCarlo	human
@youngzoofry	human
@NinaDOdisho	human
@countyriverside	human
@alberto64	human
@AdalbeorhtBetia	human
@mish_fernandes	human
@fuckshane	human
@IndiaCanteen	human
@Sugar_Crissp	human
@Ramada_Dining	org
@fiorenzadowlin	human
@Gazebodubai	org
@CubanaGPT	human
@IcemoonPromo_DC	human
@ELRailway	org
@dakeough	human
@EllyahAbigale	human
@Giing_Koyz	human
@GravityGY	org
@MarcSjy	human
@CarmenciitaRuz	human
@soflafoodie1	human
@McDNYTriState	org
@PeppersatUptown	org
@venuslightmagic	org
@zee_skdr	org
@brunchosaurus	human
@AHAToledo	org
@GraceMi60400254	human
@mynameisErikaDC	human
@bobucuisine	org
@kennyclarencejr	human
@WineRetweet	human
@_Ortizhugo_	unknown
@AExpediter	org
@nasastyle	human
@Tanya_Janexx	human
@LoveBreadLondon	human
@deannam1972	human
@BeastIndustries	org
@MarketHouseAlty	human
@MsBettyBlanco	human
@Ilariaele	human
@EmporiumThai	org
@LimVnie	human
@SqueezeIn	org
@BaseraNYC	org
@RegularGuyNYC	human
@Goldie_Cheung	human
@BrandmarkEspana	human
@tonightsgf	human
@Giorgia_Kataria	unknown
@annscotttravels	human
@OrganicChats	human
@boogey215	human
@noenoegood	human
@plattertalk	org
@keruberosxx	human
@Toots_32	unknown
@DataGroupUSA	human
@azizie_ismail	human
@hollykyoung	human
@HuntingtunYetta	human
@cana64	human
@bruenjes_marc	human
@LaVillageDine	org
@EatAtRenees	org
@ambiguouspunk	org
@MaisonMG	unknown
@MarchKitchens	human
@hyesunny1022	human
@AprilClaxton	human
@inSURABAYAcity	org
@MandyJRoss	human
@GotchaEdoMex	human
@tgvaldes	human
@PROBIOSFlorence	human
@therealAaronL	human
@Pei_Stardlin	org
@IamAyaBabes	human
@PicNic_NZ	org
@marydevinat	human
@SYashmine	human
@cheatingwdinner	human
@CubanaTableview	human
@Lourdesmcn	human
@buffalo003	human
@CubanaLatino	org
@JETavares	human
@KafeneionYork	org
@IHOPHawaii	org
@PrettyFoodcom	human
@misstiffie	human
@zumescoffee	org
@LinyMullerka	unknown
@jeannekimmeyer	human
@normanvanaken	org
@TatesKitchen	human
@CattoniDeborah	org
@shibuyaD_bot	org
@rox005	human
@EHustleNY	human
@CresswellWyoh	human
@LIMER35	human
@carlys_creation	human
@neossou501	human
@hanjikurumi	human
@ImMissXyraaa	org
@GonzalezNannie	human
@BeningHidayah	human
@solerany	org
@KarenlyMic	unknown
@Onthethirty	human
@EricaTa02265302	human
@TamaraElbaz82	human
@ZachNews	human
@sara1117	human
@clubtraci	human
@4scrapinn	human
@PariThaipride	unknown
@Kippings2012	unknown
@hj77	human
@kishiyannn	human
@cryztalis	human
@livingsmartgirl	human
@WachyShamsi	human
@thelakeshotel12	org
@EdgeMiami	org
@leiann247	human
@flekswood	human
@KhaliyasMomNDad	human
@sakura_velayo	human
@kaskrut	human
@Good_Food_Store	org
@bborame	human
@_partytabz	human
@BournWyoh	human
@GotchaGto	human
@feraliaga	human
@elycanoro	human
@ChezLionel	human
@kyspeaks	human
@mrssarkazz	human
@bittersidesweet	human
@SouthGranville	org
@BolyardsMeat	org
@SammSid	org
@AlvinTjondro	human
@FearnleahAcker	human
@TakaKane26	human
@AshlynJenna	human
@NaturalFoodCpn1	org
@spaceking5000	human
@iapple_lover1	org
@OrientEast	human
@KarenFabr	unknown
@DoFoodBetter	org
@phuongiliciouss	human
@JJPantry	org
@tennischu	human
@TheNewLeafStore	human
@KarenCourtney14	human
@Kris234Kris	human
@WOMANOTERAS	unknown
@PoolsideStore	human
@SarahWCaron	human
@PuleosAlcoa	org
@naturebox	org
@beachbum_blonde	human
@Amandotrucker	human
@TridentGurgaon	human
@MikaylaAbigail1	human
@GotchaMerida_	human
@WymerDomicio	human
@friederichbruun	human
@PeacockGardenCG	org
@SummerHouseSM	org
@CubanaDurban	human
@BrookeLewisLA	human
@LigisVelasquez	human
@LoriannTedrick	human
@mariancastro	human
@koktucocina	org
@KinhoBadaro	human
@GLAMOURBBEY	human
@IRALAZAS	human
@Azteca_crr	human
@teycindy	human
@RumaSi	human
@helloimluce	unknown
@simpledog	human
@phineysfood	human
@sjsmaster	human
@michdas	org
@AaronCbrr	unknown
@RooftopLoungeLB	org
@Shah_Indra	human
@GianlucaDenotti	human
@DessertsByMe	unknown
@AumzZvitza	human
@bonkers4burpees	org
@zabalza_pl	human
@ZavrinaAnnalee	human
@Metkaf	human
@Notorious_MAX	human
@pantonemagenta	human
@goLadleChicago	human
@homeofepicure	org
@AlexandriaSofi2	human
@GrillitNash	org
@SFFNash	org
@Crims0nTid3r	human
@LaModaamiManera	human
@trebleinthekchn	human
@Villaazur	org
@GotchaTlaxcala	human
@SinclaireAcker	human
@InstaSharer	human
@BakingTrayCafe	human
@Designed2Eat	human
@Redrum72967	human
@marketstreat	org
@TheGroceryOHC	human
@CubanaClaremont	human
@eweisenhoff	human
@Rin_Kurana	human
@alohayoko	human
@Roberts_London	human
@KARLAS001	human
@DerrickZerenit	human
@DCTours_za	org
@Ragata80	human
@Giveaways4Mom	human
@AppleTreeCafeDP	human
@trashartkid	org
@iamtamanda	human
@SaraLynnBrown2	human
@FainaBrista	human
@_oaseiman	human
@loversindo	unknown
@JepoyOnairos	human
@junesushma	human
@InnerAthlete13	unknown
@boroughmarket	org
@AegelmaereBeac	human
@restobambu	org
@BakerByNature	human
@NoBarBrooklyn	org
@rinopontioso	human
@foodsvital	org
@TheFederalMia	org
@RockandReilly	org
@sakura__brown	human
@miguelangelfl	human
@notsofasttruck	org
@karrabozette	human
@saffrontrail	human
@lincolnroaddr	human
@LayneTricia	org
@tgrey913	org
@remytoo	human
@Irenewidiartha	human
@PS561	org
@TheSoBeTimes	org
@Vally85Giordano	org
@SylviaHappiness	org
@eileen019	human
@SehzadeTesbih	human
@twithaca	org
@materiel	human
@InstaTver	human
@HuilenDominguez	human
@nox126	human
@FraijoManda	human
@iamjackiesantos	human
@alanahmad81	human
@butcher_grill	org
@Ryan_del_Fierro	human
@npmestory	human
@11christin	human
@CassandraAlexi8	human
@CriterionBogota	human
@purabinaha	human
@goldengrahamgrl	human
@BiankonigliaS	human
@Suresh_THR	human
@caranijuan	unknown
@hotelessilken	human
@SierraLydia2	human
@Twanxin	unknown
@SpicyPerspectiv	org
@AthonyWalbrydge	human
@juicelynshos	human
@OrganicBurst	org
@TradinTraveler	human
@yumuniverse	human
@JamesSteen100	human
@AddisonAnnalea	human
@MakingUpVita	human
@AbigailMikayla1	human
@BigKitchenStore	human
@AlexiaMelissa2	human
@yingwang71	human
@trickscrisps	org
@PennysStMaarten	org
@CubanaMenlyn	human
@MariaSisci	org
@lastmomenntt	org
@AmiraFoodsUS	human
@emilyn17	human
@carlahkrueger	human
@LaPreferidaInc	human
@HenrettaTaneka	human
@rehdogg	human
@38honey	human
@ErrensKitchen	org
@Foodpub	org
@DOLMABAHCE1	org
@nyc_restaurant	human
@tolullah	human
@etcchefshane	human
@YouBrewMyTea	org
@missteasz	human
@YasamineDavami	human
@WhiskAffair	human
@pete_camargo	human
@Ibzrk81	human
@__twistedlogic	human
@VilisBlairAthol	org
@DundasWestBIA	org
@MMDRACO	human
@Papa_Charlies	org
@alatoolmuscat	org
@Arrozsal	human
@DownsDesigner	human
@MummyMmemories	human
@rehspeck	human
@TheWhetPalette	org
@morrisyiu	human
@ShelliBobbins	org
@MacCocktail	human
@S1A2L345	human
@benchwarmersatl	human
@Eatndrinkwithme	human
@DeadDollsHouse	org
@SaraElman	human
@AmadaPHL	human
@Instantly	org
@guruguru1971	human
@bistrowest1	org
@AHADayton	human
@MeghanChloe1	human
@mcogdill	human
@raff_sayn	human
@1008Luvdolphinz	unknown
@MyThai_Leeds	org
@CityBizNLondon	org
@reallifecomment	unknown
@THEBINGBING_COM	unknown
@zashikiwarashe	human
@into_yourcloset	human
@LICeats	org
@yienyienn	org
@chococap	human
@kwbentodiary	human
@CCtoMB	org
@TheBakingAddict	human
@MariaGiovannaFB	human
@TheBirdyBabe	human
@CrumbitF	human
@XxxGemgemxxx87	human
@GiterDoneGossip	human
@HaleHeartySoups	human
@sharibayer	org
@moonyloony1	human
@insurance34	unknown
@AHALehighValley	human
@SaraEve47136152	human
@YNBAR	human
@monty_007jp	human
@Stallonation	human
@Phannada	human
@JammiCho	org
@Houston4Lunch	org
@rakuenberry	human
@ryan_hummel	human
@LaMely87	human
@rachlgrl	human
@FrankieSwkedeh	human
@jjwarren97	human
@modpaleo	org
@canrie	human
@NikkiLA22	human
@DCMinute	org
@foodmantra	human
@cheer_1018	human
@aromacookery	human
@ChefExperiences	org
@cravecookclick	org
@2Harumin	human
@AIMexicoCity	human
@PanteaGroup	org
@SelfieTweety	org
@BriannaMelanie2	human
@the_cheel	org
@columbusheart	org
@Cubbycake	unknown
@YeomanEadda	human
@VeronicaSophia2	human
@vegassefie	human
@futbolgold	human
@JeanRoch	human
@EmeldaFidia	human
@mamasclubhouse	human
@CCarmen615	human
@Basquiat1981	unknown
@evonnieworld	human
@avagsalvatore	org
@Boab10	human
@CraftyDad	human
@mariishido	human
@TheLipstickNews	human
@SlimmerOndernem	human
@nylilly	human
@ETjiawi	org
@MckennaMarissa1	human
@bakinandeggschi	org
@caroelie	human
@SufiyanaSoul	human
@ma_ma0204	unknown
@garyspencerr	human
@wickedsynergy	human
@Zf9I1c12t	human
@aithingwang	human
@EatTheGlobeTeam	org
@GotchaAgs	human
@PhillyFoodPorn	org
@SandaAlexandra0	human
@BoulderLocavore	human
@LuVLyIzZaTi	human
@wannabehexe	human
@NorthWalesDirec	org
@PrinceEDGIE	human
@WynfridMellony	human
@LycaRadio1458	human
@goinginfo	unknown
@SausagefestLV	org
@herbertoflpool	org
@BreadTies	org
@AquaDesignGroup	human
@MisFydKrafts	org
@DaelYedda	human
@spongebob_cult	org
@Vn_Zhang	human
@MrPromosi	human
@SaraRose304	unknown
@SugarShip_LUNA	human
@GotchaMichoacan	human
@mirucookie	human
@20TenEatery	org
@MrErickVG	human
@FitOrganiX	org
@JassmynFoster	human
@azrinsunbae	human
@FadhilahRamdhni	human
@chitrasendhil	org
@cassiefromd	human
@weatherjunk	unknown
@TheBoulevardTN	org
@panfusine	org
@CuisineEvents	human
@Guide2Geneva	human
@yycretweet	human
@FamilyFoodTable	org
@DNM_DC_Bars	org
@HarryHHLam	human
@linneacovington	human
@GotchaTams	human
@DRey2531	org
@bnitty	org
@Fithealthyfabem	human
@LynRahaman	human
@SkylarRebecca	human
@KabobTrolley	org
@MikeG115	human
@FortuitousFoodi	org
@SushiCityUK	org
@TheGrandYork	org
@jillconyers	human
@lsin_yee	human
@OldHydePark	human
@BlessHerHeartYa	human
@MrsGlass	human
@CharliElizabeth	human
@PhatDaddy365	org
@KrystleKouture	human
@RiseGuide	human
@Excursionsharm	org
@krazynicegemini	human
@ItsFun2BeHappy	org
@andreadallara	human
@GotchaQueretaro	human
@lake_relax	human
@TheStubbornGoat	org
@localtablela	org
@LndOntRetweets	org
@AICcarpetcleani	human
@RICARDOSPLACE	human
@DiabeticConnect	human
@OKOWorld	org
@CiaoFlorentina	human
@veronica_vania	human
@gotfoodtrucks	org
@BaguettyJct	human
@Salon_Brixton	org
@Skullsilver810	unknown
@GotchaColima	human
@aboamal2008	human
@officialcflas	org
@B_SHRINE	human
@UlisesMnd	human
@lifeSTYLEofYou	human
@JuicyxDEW	human
@RedZoneBar	unknown
@ankurpatel62	human
@elite310	org
@AbbonyFitzSimon	human
@RosePetalsCafe	org
@RachelSMolina	human
@RachelAudrey2	human
@4NYorkshire	org
@ToDelishNBeyond	unknown
@SophiyAnjam	human
@deeeki	human
@Pari_Thaipride	org
@mbratz123	human
@tcrowley122	human
@michelecutiepie	human
@Tavernonmainct	org
@MiloBailSC	human
@Histerius	unknown
@cshell202	human
@Jets00007912	unknown
@ReniseSachiko	org
@Coffeeplusfood	org
@HeatherBoydWire	human
@daisy_fur	unknown
@SineaPies	org
@MsMaiii_	unknown
@vi_woo	org
@AlissaWryhta	human
@osm_food	org
@Slim_with_kris	human
@ForUsNaturals	human
@babykins	human
@davetaylorradio	human
@DoctorLuke92	human
@MaidstoneTalk	human
@Cookwitch	human
@erich13	human
@AjmZain	human
@hapatite	human
@nu_nutty	org
@garagaradio	human
@madelilah	human
@altrinchammkt	human
@AdrionaBearrocs	human
@DFGrille	org
@lafinguy	unknown
@SaInTBaLLZzZ	human
@HLADeals	org
@Ketchup_KSA	org
@TheMarkNorella	human
@MmFruitsblossom	human
@WolcottAbigale	human
@Minor_Goods	human
@EmilyHanstag	human
@shcraft	human
@okayamahirosima	human
@OngShiSheng	unknown
@NourishlyLiving	human
@ArtisticPhilip	human
@aidsmgfind	unknown
@keepinglifesane	human
@HKlinth	human
@fANNEtasticfood	human
@CentralParkNJ	org
@innerualchemy	org
@CurrywurstWatch	org
@GaigeYocey	human
@daaditsu	human
@simdiagalar	unknown
@MarCopyo	human
@IbShuggy	human
@faberling	human
@PetiteBoucheeHY	org
@RiverWyndeBandB	human
@Foodbeverageli	human
@RonG24	human
@Rachelous_	unknown
@ledawoqazale	human
@LifeCurrentsDeb	human
@MyTravelPal	unknown
@aerplane	human
@ZenobiaMohammed	human
@jellybean_star	human
@johnsteele69	human
@BazylZackary	human
@El_Mercado_	org
@iloverichies	org
@VitaminGuru69	unknown
@BxCh3apskat3	human
@edibleHI	org
@agirlandherfood	human
@megh4ppy	human
@RigoMar0	human
@NastyNick84	unknown
@_I_Heart_Food_	unknown
@Vitafrutabar	human
@CassidyKayla1	human
@BarnabasHuang	org
@TiendaLondon	unknown
@gohan_daisuki	human
@OCTOPI_DESIGNS	human
@gymtecky	human
@malpajbistro	org
@DoodlebugDoo	unknown
@chat2michelle	human
@yardcardiff	org
@eelain212	human
@adrwong	human
@AndyscafeNQY	org
@boomsygals	human
@FrammyTangel	human
@lilacreo	unknown
@bread_red	org
@MariahCarly2	human
@cookitlean	org
@LillianKatheri1	human
@travelworld838	human
@sebelpierone	unknown
@BraesBar	human
@ScatShitPiss	human
@zarfrancisco	human
@EvaThaDiva4real	human
@otopii0114	human
@BeautyBroker	org
@RidgewoodMarket	org
@AtyabTabkha	human
@DrewDallasD	human
@ClementineFoods	org
@dembul06	human
@CubanaStellies	human
@marvzjohn	human
@AdrenalijnaSamm	human
@jihanjauhar	human
@MargaretPerrys	human
@DBebookSoftware	unknown
@hellocookly	org
@TheBubbleRoom	org
@Cherrycheryl92	human
@GotchaNuevoLeon	human
@kurimamma	human
@radiostevebest	human
@AberfaTolman	human
@FairTradeFetish	human
@punchmedia	org
@shara_a	unknown
@bnicolelahue	human
@mrandmrsbrunch	org
@DuckandWaffle	org
@PatricksBeer	org
@TheBestLoop	org
@AmerHeartAkron	human
@ClevelandAHA	human
@IvociTasty	unknown
@KRod0519	human
@orange429	human
@1900HarcourtSt	human
@j_odr	human
@poppy_loves	human
@xxxmaripossa	org
@theyardmalton	org
@Passionat3truth	human
@IstanbulWoolton	org
@SandyHoyos8	unknown
@linchikwok	human
@wannawincompo	human
@narabot11	org
@MrClean242	human
@Da_Shyt_	human
@findingvegan	org
@leosfishbar	org
@Menchaca_glo	human
@AllanKlw	human
@DemareoJaymesha	human
@EatCleanFoods	human
@nanathetiger	human
@RArvesu	org
@MariaSanz	human
@Anglaisfoutu	unknown
@JoyceTiongson	human
@JordanBrittney1	human
