@aslami_yulia	unknown
@ReaganWu	human
@xiijeanjean	unknown
@jisarafael	org
@Rai_casting	human
@andrewchado	human
@VoR_Photography	human
@msomerswriter	human
@aideefrescas	human
@ljcreager	human
@j_jamiebeats	human
@nachobrambila1	human
@milossofia	human
@CrazyLadiee	human
@3taratops	human
@ricosinartha	org
@DonnyCG	unknown
@JoseArriech	human
@SeraDandW	org
@brittpitcher	human
@DQFitness	human
@555NABE	human
@martinallen72	human
@ColosseumNaples	unknown
@LunchingAbove	org
@jusblabbin	human
@CrispyCuban	org
@SigmundPretzel	org
@FriendlyMadrid	human
@Toronto_nian	org
@TheEarlofMarch	org
@zuhairsait	human
@MelinaSk4444	human
@x2j6j	human
@37minaj	org
@dashofdarling	human
@luanph0311	human
@LifeTagsLulu	human
@Maristella_K	human
@RSaborTipico	human
@NeuvooRedding	unknown
@gracegaven	human
@travisjmitchell	org
@TriaRose_Bayona	human
@Jameslevett	human
@broadwaychicago	human
@YayaRSA	human
@hiphopmp3	human
@xrikaax	org
@dangorman40	human
@Drowz	human
@mbhj	human
@BlueWaveSA	human
@goto_nada	human
@BloordaleCIA	org
@MattMusc	human
@ItsDaSituasian	human
@tazbisson	org
@McD_MidMissouri	org
@MelodyOnRepeat	human
@levitony3105	human
@Pet3rMatta	human
@lilianyap92	human
@SabeloMkabela	human
@bakingzen	human
@Organic__Wine	human
@NatlParksPhotos	org
@GiuDayLorDie	human
@SINGHSRIGA	org
@clemy95	human
@Gttilkeyhoney	org
@RunChiquitaRun	human
@PhantomGourmet	org
@SportsFoodAlex	human
@littlechef1987	org
@queenachan	human
@nandeyasa	human
@nutrisecrets	human
@jlaz7890	human
@ajclementine	human
@DonaldTinney	human
@ytjin106	human
@ericabrooks	human
@WondersSchagen_	org
@longhorn_london	org
@zakitom99	unknown
@sandramontaner	unknown
@Bernard_Sims	human
@rymndb	human
@sashagirl01	human
@blckspottdzebra	human
@CageFreeEggs	org
@WAVEJourney	human
@CathyToland	human
@DrPraegers	org
@beenadrah	human
@claudiusarahn	human
@ChicNeverland	human
@MyTVXQJYJSJGD	org
@46Sanitonbiz	unknown
@tpc806	org
@shrinkingsingle	org
@conviviochester	org
@Mystik808	human
@maelynnbacchus	human
@Tw33dler	org
@katz_emma	human
@KeepinUpWKrista	human
@fabiokalo	human
@BartonsBites	human
@soindtejas	human
@aiiciiabananana	human
@FollowbackRadar	unknown
@Nahomprettyboy	human
@HalfHerSize	human
@Reserve_BOS	org
@_hjn	human
@itoarimon	human
@fRisanWorld	human
@annietychang	human
@KeythaRenee	unknown
@leonardkl	human
@Vakseen	org
@01mikim19	human
@MissEmeraldpost	org
@bdotharrison	human
@EmmanuellaGrace	human
@onetwoninety	unknown
@Ruby_ly_Hazza	human
@NuriaMP_	human
@neesthai	human
@dennisactor	human
@lilalashea	unknown
@etre_radieuse	human
@MissDadahV	human
@Svafoods	org
@EddieTan85	unknown
@Belthain	human
@KavaCafeBicton	human
@aleeyaithnin	human
@Sophieluxe	org
@RomulusRemus648	unknown
@EmmaSamuelsRD	human
@Android_Sim	human
@rjailapez	human
@Sofamilyonline	human
@onlongCPT	org
@FlourandFancy	human
@hazarry	human
@WingsArmyUS	human
@CITYLONDONMEDIA	unknown
@Love_MiaNicole	unknown
@Nexpest	human
@Cuisineetmets	org
@lyle_25	human
@aireenayusoff	unknown
@ZeitgeistVienna	human
@Tundragear	org
@humblesoul26	human
@stillwater_tas	org
@DFECTofROCK	human
@caroleannmarie	human
@robinthomas1	human
@AuthorJMG	human
@mlacebuche	human
@Elise_HuiRu	human
@RAMWdc	org
@LandLoveMag	org
@DannyFlitney	org
@Phoodieur	org
@MinuteManSG	org
@angelluis333	human
@meentb	human
@CafeLazyBean	org
@marie_vilchis	human
@sayopi343	human
@VanCalebs	human
@ChrisWhaleyRSCC	human
@KathaMertens	human
@Naturally_MDFS	human
@golocodisco	org
@InAllYouDoMommi	human
@Codered_82	human
@caseytraverse	human
@jennifer_sikora	human
@herbalosophy101	unknown
@AusOffers	org
@JamesRRubec	human
@kraygkulik	human
@piggy091385	org
@BookChang	org
@DoriMarlin	human
@veronikaregus	unknown
@Sergio_Alejo	human
@FlyingFoodieNL	human
@_KaliforniaGurl	org
@Trade_Snipers	human
@popgemtweets	org
@SundayDT	org
@hafizin91	unknown
@Beautynewzflash	unknown
@King_Cairo	human
@LinaAasHelseth	human
@HoltonCaron	unknown
@bhabyogurt	org
@munekita22	human
@NthleeVirginia	human
@MMonicaNovo	human
@CinnamonCi	human
@redeyedsaya	unknown
@WhitefriarGrill	org
@CastingRT	org
@tanodaman	org
@AYOKATELIN	human
@priskipris	human
@chernhin	human
@rosa_v6411	unknown
@ALabonne	human
@felixdrt4	human
@hayleyunderdown	human
@TrixieDelaaCruz	unknown
@FredysTucan	org
@TheEdgbaston	org
@TheBluePigMcr	org
@atomickatz	org
@localfoodz	org
@BlueMonie	human
@yorman_leonardo	human
@Omaridalphamale	human
@music24seven1	human
@RosseTime	human
@iklash	human
@SheSmiles01	human
@DeriuGd	human
@br96118	unknown
@DualitLtd	org
@hlthygrocerygrl	org
@dododilly	org
@iamprater	unknown
@sethphon	unknown
@shiva_tina	human
@gnomemorgan	human
@taftmuseum	org
@NoButFoRealTho	human
@FruityFootprint	org
@DavidBaarschers	human
@sianny_t9	human
@LoverBirmingham	human
@CulinArtEating	org
@gourmetcompany	org
@PhotoMonk3y	human
@celerynthecity	human
@fanofpjpants	unknown
@MESilber1	human
@Chefdly	human
@MissMelanieD	human
@ronaldavid285	human
@intellichick	human
@TheQuiffOfZayn	org
@nancyariasvilla	human
@designsbyvictor	unknown
@DieselEskisehir	human
@ChamoGollo	human
@1hourhotwater	org
@icedogyo	unknown
@wooddytang	human
@Flight191SneilA	unknown
@MissLHarvey	human
@nclfrk799	unknown
@HistoricPearl	human
@BabblingBandit	human
@JuntoBYOB	org
@karyllanne	human
@Farahhness	unknown
@AGSouthern	human
@ATLEatsNTweets	human
@PickeringTC	org
@HarrietThoy	human
@Zoe_Hirst	human
@BonnieLouLane	human
@caochocolates	org
@FanniFanFanX	human
@Coe_Smith	human
@rosadibah	unknown
@KavitaBhuyan	org
@BabyNiggaChris	human
@lautasella	human
@TitianPrincess2	human
@BayuWaramusdian	human
@JUANMANUELPHOTO	human
@stupideyed	human
@LaProvencefrenc	human
@HajarSaarani	human
@SuciAmjusfa	unknown
@lifesoulcool	human
@iamfranzdude	org
@__enygma1314	human
@SexyRose4000	unknown
@traceygillinder	human
@daniellatingzon	human
@TaqueriaArandas	org
@oscarmvalbuena	human
@ChocolaRibbon	org
@_ItsMeHollywood	human
@youngkwak	human
@AccyNookii	org
@RestProp	org
@PlymGreengrocer	unknown
@Kaka_190	unknown
@NoVADining	org
@Housewild	human
@kelanabykayla	human
@JoaniesDelights	human
@DioelenaMaria	human
@saraohman	human
@vilnius_bot	unknown
@bmfjab00	human
@erickeriande	human
@GourmetMale	org
@mommysnippets	human
@cassidl	human
@KerenSerrano	unknown
@LosTweens	human
@webccp_com	org
@LeTortediMichy	human
@fromtheleftseat	human
@Billcdadon	human
@ZarinaRahiman	unknown
@OtheSafrizal	human
@JasonMyersPhoto	human
@NeuvooHosCal	org
@gtphilup	human
@HappyRandy	human
@texasnate	human
@NewConservator1	human
@markcunanan5	human
@80raw20paleo	org
@dailydelicious	human
@Antoniojosegc21	human
@mei_bear	unknown
@jstefra93	human
@titakartika95	human
@MosherAJG	human
@WSBarleymow	org
@marmaruy	human
@VirginiaLoverUS	org
@flaxvega	human
@TheFnKPodcast	org
@fchud84	human
@DikaaDiki	human
@Coolmon2009	org
@herbivoretri	human
@chinookbyway	unknown
@IamfancyRON	human
@ImBowToxic	human
@nicolec26	human
@karyn_natalie	unknown
@AppyBistro	human
@inafefi	human
@LoveyChelsea	human
@kidsark	human
@robbyawalludin	human
@blessantillan	human
@allanahmorrill	human
@Joleneeex3	human
@JK13	human
@manikcycle	human
@Nigeblue	human
@ericarobles	human
@SPKwomenshealth	human
@shellymccatty	human
@ChefTizzard	org
@Steve_the_Chef	human
@Frugal_Fitness	human
@TheeOddOwl	org
@fantasiosa20	human
@buby1381	human
@vicki_mellard91	human
@gmacch	human
@ymmfan	unknown
@DJ_HERI	human
@christinel33	human
@LeonardTT1	human
@Cesarina_Leite	human
@ij_Pod	org
@_NI_KO_	human
@ailcua	human
@electru	human
@Pan_Comido	org
@MrTitoMosquito	human
@DoRightEvents	org
@MariaPerezz	unknown
@bioluminate	human
@treasuretroveco	org
@paulferreri	human
@latinafoodiechr	human
@CTMacUser	human
@gloverjolene80	human
@resti_anisa	human
@LowBrau916	org
@fashioncapital1	human
@missdeety	org
@hudsontrackstar	human
@TEAMSOLID	human
@XtremaCookware	org
@annemarie6868	human
@sedpak	human
@foreverttao	human
@1fabulousfoodie	org
@Gabriella_iris_	human
@AlwayzNThought	org
@ddsslind	human
@moyoyo224	human
@TalulasDTAP	org
@ElbertineWulf	human
@ChezBillySud	org
@riechiel	human
@HotelMenageOC	org
@AllissaByGrace	human
@ScrumptiousFlav	org
@kangwenjin	human
@ElwanGl	unknown
@AmniAfzal	human
@Domicharpentier	human
@IllMakeItMyself	human
@czar09	human
@noems90	unknown
@vidthekid82	human
@BindiaBistro	org
@RedStixsnyc	human
@ElliottMiller	human
@NicksGroup_	org
@fatcatnluckydog	human
@jenphant	human
@Georges_Worsley	org
@MicheleW84	human
@yarengnydn	unknown
@Jason_Squires	human
@Alexmugal	human
@pipit_dejollie	human
@AmbssOfficial	human
@nasseralduaij	human
@colegenaw	human
@baran_tan	human
@farizulhafiz	human
@adelene0809	unknown
@Poppyhedgehogs	human
@Levisaponte	unknown
@AlHallabUAE	human
@mahottama	org
@OtleyRetweets	human
@3xquisit3Ch1ca	human
@suhail_uz	human
@Joaux04	human
@theSnacksta	human
@GinaPulisciano	human
@ullyKuma	org
@VictoriaAnnLife	human
@doc_anton	human
@TerraceCafeLLC	org
@MariiaCimorelli	unknown
@HazmiLuFFti	unknown
@ChellezSoFly	org
@haute_lifestyle	org
@latenightlondon	org
@kekefabulous	human
@D_Sal	human
@laurenjean23	human
@JackPMartin1	human
@myalpal	org
@WTEGgirlSeattle	unknown
@Alanamak	human
@OfficialJashael	org
@missleeleelulu	human
@RominaBond	human
@LeRivageNYC	org
@jamforbrunch	org
@Taptrip	human
@xiyingwee	org
@Alex_Varnum	human
@FridayProGroup	human
@meggie_0125	unknown
@BrainfeedMe	human
@ilterrazzoicj	org
@Hey_Its_Tarrah	human
@dbenoit48	human
@eluebkeman	human
@Howtobefit	human
@foodtruckarmy	org
@BarbieSwagoo	human
@Brianja1105	human
@Nextdoorganics	org
@ahintoflifeblog	human
@BabyChubChub	human
@Smya_pm2	human
@mazzarellotata	human
@tam_hobby	org
@_mickey13	human
@BCBSND	org
@jongumi	human
@pharaoh010081	human
@marianmanzano52	human
@station2rva	org
@gulfseafoodgirl	human
@SouthernhayHome	org
@Tiaraqua	human
@WestSydUVNIR	human
@Lap_ItUp	org
@Natoni10	human
@Nourishmagoz	human
@Martha_Bourke	human
@malagafoodie	org
@jerichoasuncion	human
@ChampionRocka	human
@amirulaqmal92	human
@MikePuckettDDM	org
@mariamkazmi1	unknown
@mdDeerParkHotel	human
@MarilynDenisCTV	human
@kingtungsten	human
@ygyeevana	unknown
@jennweatherhead	human
@SGenevieve_	human
@thatsthekey	human
@Turn2Fitness	unknown
@juners0123	human
@alarriola	human
@LittleAngel_99	human
@pimp4lifebaby	human
@poulina95	human
@FilmEksis	human
@ivanhenares	human
@carolinef75	human
@infamouslizzard	unknown
@bitesizeplays	org
@lagallinara	human
@lottamailis	human
@blukas	human
@doukanresto	org
@Gabiis69	human
@OrlaithBoylan	human
@the_ricco	org
@Nupur_Ghosh	human
@MomsLoveCoffee	org
@rebeccakellyw	human
@PracticalMoney	org
@styleZbyMYKAL	human
@Jaduwitch	unknown
@p2bbistro	org
@honestynikah	unknown
@antp1229	human
@TopShelfClothes	org
@NeuvooFinChi	org
@krisbustos	org
@lms_0609	human
@Khatoon_Moosa	human
@samandreacchi	human
@scottcralley	org
@MarvelousStuff	human
@chriscendo38	human
@UoS_Salfood	org
@CookRestaurant	org
@IvyMarketGrill	human
@VipDigitalpics	org
@TheWayI_am	unknown
@cmore_interieur	human
@YoureWelcomeSav	human
@stevejatmiko	human
@nui_be	human
@DevineMissKitty	human
@SerhatSerbes	human
@HYPEINGHAM	human
@TingTingLove89	unknown
@NYBagelCafeDeli	org
@HopcottFarms	org
@mboschnl	human
@CorreyHope	human
@NunoCMartins	human
@KimHeadlee	human
@PacyVictoria	unknown
@RusllyM	human
@94serenaG	human
@jacoder	org
@jaqualharris	unknown
@CatsAndVerbs	org
@Blaxtar7	human
@n_non	human
@eCRAFTic	human
@redemptionbar	org
@AllMommyWants	human
@InkedUP_Marley	unknown
@annisa_yd	unknown
@PrimmaDonna90	human
@fotoboi5	human
@cathville	human
@Davanti_Enoteca	org
@NanBallet	unknown
@castroreyrobert	human
@myra_musyie	human
@SummerDiorMUA	human
@charleneajose	human
@xoshersherxo	unknown
@FoodsmartNL	human
@stinkncute	human
@dickskitchen	org
@Babyz_Nicole	human
@BrendaCollins45	unknown
@lamj	org
@AllSportsTours	human
@hessayks	human
@jiroxiii	human
@NeuvooChesterUS	unknown
@Kris_Smith_01	human
@Caleb_Ready	unknown
@faisals	org
@Jasmine_3318	human
@mycitymylondon	human
@fendy_wongso	org
@yougenkyou_	human
@RMNKhalil	human
@deebritt123	human
@uncfaery	human
@Japanesey19	human
@misslarajones	unknown
@strzalapatryk	human
@ion_b_carin	org
@LloydsSolihull	human
@WiseGuyPC	human
@glsmothers	org
@itsJOR_G	unknown
@Hruod_Berth	human
@yummeyinmytumme	unknown
@spacedogsradio	human
@nehaw24	human
@IsmaelIsmael016	human
@terriellenb	human
@WonderTrotterJo	human
@BeVillagers	human
@Nellathebest777	human
@carolelynngill	human
@hey_soph	human
@Mj83Mj	human
@Nateleek	human
@LucyLouHarvey	human
@cafe_le_rue	org
@Easycooking321	unknown
@nirachan25	human
@KC_JusMe	human
@Syke4415	human
@kvarter5	human
@ceci91107	human
@thepark_ufford	org
@A_WAH_Mom	human
@heroinstitute	human
@dreizit	human
@burgerburgernyc	org
@littlestar4me	human
@laupjv	human
@amelia_falco	human
@TheeMADDiva	human
@Brass_ButtonsC	human
@JasonWilliams86	human
@spicey_trini	unknown
@NeuvooHosNas	unknown
@ponsfordsales	human
@tomlincathy	human
@retroralph	human
@moochapo7	human
@StrawberrySG1	human
@NeuvooMiami	org
@Tate_EA	unknown
@nhavinha	human
@Samus9989	org
@boyswearnyc	human
@Absence2K	human
@mitolicatering	human
@BlondeYas	human
@asfp	human
@pinetahoteljesi	human
@Chrissan_Isan	org
@HassanRadzak	human
@anis_zuhaida	human
@MasterGuilson	human
@athirahsahimin	unknown
@LBMnE	org
@rivale10	org
@AbbyParkMilton	org
@zyozyo_neigen	unknown
@coralsncognacs	human
@martinmr12	human
@TCBYjax	org
@almondlovemty	human
@sworrd2	org
@Amelia_Austin	human
@DeniseFarr4	human
@RampantRooster	org
@RubyMaleniee	unknown
@BeijingTrus	human
@HealthyDelish	human
@ShyFyy	human
@jean_mao	human
@marialandootank	human
@Suzannahlou	unknown
@Shaunda09	org
@melodyshen95	human
@amorgan0407	human
@jraekills	unknown
@PlumsTweets	org
@Thepaperhheart	unknown
@oks_pr	human
@RPGOnlineGame	unknown
@lyannechanlove	human
@leecalanog	human
@glam_vanity	human
@applekat	unknown
@Lena_enxin	human
@damonwillwin	human
@rooo7alro7	human
@AskMissE	human
@iOnGville	org
@chillijamfood	human
@TOPMIXTHESHOPPE	org
@storky3091	human
@rowanrowrowan	human
@airenereva	human
@marcuskael	unknown
@dottedhalfnote	human
@djsugarpdx	human
@shauntaex	human
@amzie_baby	human
@YogurtYoka	org
@BettyFMelton	human
@mirotic1007	human
@panda84	org
@Jill_Fontes	human
@RestoLiliCo	org
@alahnaax	org
@grosvenorW7	org
@AyienHamie	human
@ROXXGOLDSTEIN	org
@Life0faStranger	human
@orujao_h	human
@GungdeSadhaka	human
@claudiaverboom	human
@xxxgrd	human
@LolaLoMCR	org
@felipemouras	human
@PaulaJoans	human
@__z_o__	human
@TamaleHouseEast	org
@OwenChang	human
@BwicktigerBarb	human
@Andanada141	org
@dafnealonso301	human
@joycesumatra94	human
@warewolf999	human
@sheridarby	human
@RiversideBray	org
@ttt6993_1	human
@cykim1115	human
@Perfect_Candid	human
@KatcHeLL	human
@ElVaqueroLondon	org
@droodlebug	human
@_Fraeulein	human
@opiesofea	human
@liyanahanis	unknown
@mossymaze	human
@JenniferGrty	human
@swjwheels	human
@Bamberg22	human
@cka757	human
@tan_oline	unknown
@kujung1	human
@LeCochonNoir	human
@louthechef	human
@TheKandyShoppe	org
@krevetkaeu	human
@KayChong8	human
@daringlyelite	human
@LibbyShootsFood	human
@M_LaFraise	human
@Jan3Evans	human
@hmmarkka	unknown
@tcrfm	org
@cherrieberry81	human
@birdsaplenty	human
@FHafeez90	human
@t_muehlbauer	human
@Romeo72	org
@NeuvooAdmUK	unknown
@BreakForLunch	org
@AbingdonFood	org
@Mdmcheeese	human
@Manchild29	human
@MRLAVALAND	human
@ericagar	human
@alice_piccolo	human
@jemstrcom	unknown
@langsnutri	human
@GiAnna_Wyatt	human
@EnatLounge	org
@kalpikawijaya	human
@chardawnCD	human
@TheParksFitness	org
@SpoonThess	human
@Iam_AStar	unknown
@kkim2305	human
@myhuangnana	human
@Tropical_Omero	human
@rahmabahry	unknown
@jennifercassada	human
@lynetteajeng	unknown
@HeavenlyGourmet	org
@1GTTV	human
@zrayburton	human
@apurva_27	human
@kas360	human
@NinitoDos	human
@thedakotatavern	org
@GovernorSuites	org
@deluxmultimedia	human
@chanelmonamour	unknown
@HIXSelfridges	unknown
@sara_ahsan_92	human
@marianoposst	human
@rolandobluprint	human
@Rikkerbell	human
@Scandalous2NY	org
@thisgreyarea	human
@Fashionist27	unknown
@francytjahjono	org
@RobertEarl2	human
@HasryRahim	unknown
@ctaleggio	human
@TiffanyBiscuits	human
@ItsJustinJeez	human
@team_ayu52ct	human
@sweetythine	human
@artshackmadrid	org
@asteifer	human
@josephalvaro	human
@BaconGuRoux	org
@raymundsdaling	human
@miziobuonamici	human
@_Karmacita	human
@daniinhoerick	unknown
@mishfit23	org
@jaolingz	human
@Lossiebar	org
@turkandbean	human
@luislaya	unknown
@imaihana726	unknown
@Rb_neneria06	human
@Daanieel24	human
@TharakaSamman	human
@LosAlisosApts	org
@RavenSaveHou	unknown
@Masjidah757	human
@anewmanCG	human
@srhmax	unknown
@LiveBetsOnline	unknown
@ipasticcidiluna	human
@thehotshotz	org
@MsMirandaLoy	human
@capricciocafect	org
@zucknet	unknown
@Nicgalang	human
@TriviTriv	human
@JenCGronde	human
@DomeProduce	org
@trky	human
@AhmedImraan	human
@LudoGabriele	human
@BISHART	human
@youaphoto	human
@BrightonTimeOut	unknown
@colin_stt	human
@444hen	unknown
@Amandrogibss	human
@kandyredder	human
@lisa0521	unknown
@RoyceLA	human
@CupKei	human
@Gregor_SALIGIA	unknown
@mryz	human
@smallvillendez	unknown
@Dawnlmanning	human
@HeyThereItsMoJo	unknown
@HaberdasherStd	org
@KarineIdrissi	human
@mjswaterfront	org
@snipaux	human
@LalithaTaylor	human
@paleoeffect	org
@m_broxton	human
@Infinitekiss24	org
@5HorsesSouth	human
@Annasulan	human
@R1ChSy	human
@sarahlee1327	human
@eloyza_14	human
@answorld	human
@LaylaCorteezy	human
@widyaputriariya	human
@imglad8	unknown
@TorillsTable	human
@TheElmbridgeMag	org
@Mariah_Blandina	human
@kalpanamalviya	human
@GeorginaDurrant	org
@maricarjagger	human
@PaigeNoelActres	human
@tyrone	human
@s2_0u0_s2	unknown
@jaimejvn	human
@EvoLiciouskills	human
@ErinBBerry12	org
@liiiindaacakes	human
@itsmeNins7	human
@GWI_NINJA	unknown
@moon_natz	human
@BIGREDNO1	human
@_MoetKisses_	human
@sivenbring	human
@pixidust001	human
@uberbutch	human
@Cesarcuero4stri	human
@le_chaletLeeds	org
@jrobertomar	unknown
@Ify_Okafor	unknown
@luigi_bramato	human
@Kelsey_Lifts	human
@raashils	human
@u_1207	human
@gogo22442	unknown
@kafemicasa	human
@KatRyziewicz	human
@MamouniaLounge	org
@im_yoshie	human
@M2M_nutri_cook	org
@cesaremontedoro	human
@NGQuarter	org
@TarpysRoadhouse	org
@CuteSophiaLoren	human
@Society_Sense	human
@cover2austin	org
@poizenisxkandee	human
@Ale_Venuto	org
@tecladolaranja	human
@mikkatsai	human
@AsiaBagoes	org
@1023ny_cak	human
@fanzelforever86	human
@LauraVivify	unknown
@giftafeast	org
@_KariLove	unknown
@AuthorAniDark	human
@TheSSCollection	human
@EdwardsofConwy	human
@jlynneda	human
@PortoBay	human
@amanirefaat2	human
@valentiinus	unknown
@HAKANKAKIZ	human
@Pokatiam	org
@CelebToday1	unknown
@L37hoe	unknown
@Andrea_HerRu	human
@TweetieMOMster7	human
@SylviaTamsir	human
@BongoPeet	human
@billsnyc	unknown
@ViBE_ub_apple4	human
@TheOfficeSC	org
@barbellitafit	unknown
@altcuisine	human
@anjlishah09	org
@TCAprGCC	org
@DavidGully1	human
@artface	org
@crobins72ca	human
@rixbajns	human
@Thrillist	human
@MissandChic	org
@emmadesailly	human
@MariaCaleGaspar	human
@mrsjenvarga	human
@weirujun1	human
@beboldbebright	human
@CazR1chards	org
@_saya69_	human
@djsacc	human
@princedjc	org
@fashoholicme	org
@ReneNajmi	human
@lumin8	human
@Ramen_Ya_AMS	org
@LuckyRob99	org
@heldenunterwegs	human
@fizzyhelen	human
@Fitness1nutri	org
@Charis_irene	human
@F3RG_	human
@lydopinions	human
@LaCriollaInc	org
@YevoNutrition	org
@susieqtpies	human
@berzerkeley	human
@complot212	org
@LindaBlocklund	human
@atayob	human
@thegrillingreek	org
@IndigoBeautySJ	org
@ProjectSupermum	human
@iameLvi	unknown
@E_Foster	human
@meboxmedia	org
@SaMadalena	human
@IsMaikoduck	human
@Alizetje	human
@JadiPRP	human
@DeNachtegaal	human
@GeetMaha	human
@YardOnTheEdge	human
@mayo_mayonesa	human
@Gemslchandler	human
@mylovehandles	human
@itosiEDISON	human
@SgleMomSuperMom	unknown
@syunkichi1112	human
@sarahsyee	human
@distydila	human
@ResourcesQueen	human
@TheDandyLifeslb	human
@kuran_heroine	human
@marcvetri	org
@RafeBraswell	unknown
@yo0we3	human
@Cheriseeee_	human
@roadsterrobert	human
@london_foodies	human
@Dubgirl4life	org
@Mariafe_D	human
@kaloocapri	human
@BryanAltin	human
@WholesaleMBA	human
@UrchinAmber	human
@growfoodself	unknown
@NicoMaren	org
@abreadaffair	org
@CayoD	human
@SeatsForTwo	human
@anuppandey	human
@LovelyLexi86	human
@RemmyFire777	human
@Keyyyyy	unknown
@Clecle_B	human
@seanrayvoiles	unknown
@trivorpasta	human
@SandraBacci	human
@atsumimncooking	human
@Eccentric_Soul_	human
@TanteMarie	org
@love_life0908	human
@drsweetiebelle	human
@MimIdeas14	org
@_SaraGheri_	unknown
@greenpiedenver	human
@k4vierhouten	org
@alt_0711	human
@_madhvi	human
@SuMxxxA	human
@jopetgc	human
@SansziePanzie	human
@TJByrnesBar	org
@sbrand_5460	org
@MaSNizAaZiZ_CR7	human
@Mskerrybby	human
@mcalm27	human
@PaulOosten	human
@FindMyCaterer	org
@Grasshopper_Inn	org
@derekwalton88	human
@ruthgreene	human
@scentofpetals	unknown
@ZoeKorneyeva	human
@citra_cristia	unknown
@ViBE_ub_cherry	human
@maldaudal	unknown
@MissAmandaB	human
@fraeulein_mag	human
@Disildoforus	unknown
@kasthuri_24	human
@AmazonJunkieez	human
@NatcaRatulangi	human
@Lglwry	human
@SuhairahDino	unknown
@julyanasiong1	human
@LauraTytgat1	human
@ChoiSooRyy	org
@gypsydietitian	human
@joannesoawesome	human
@24k	human
@saskiaisblank	human
@PaletaChico	human
@chunnayaaa	unknown
@lacostenauk	org
@etkotite	human
@sacana456	human
@aly3360	human
@rockwallharbor	human
@Imso_Driven	org
@HollyHoodIS2RAW	human
@2ndBrunch	human
@Jackyau87	human
@luciannesoley	human
@hikachu_k	human
@eatQuickr	human
@GLUTEN_ZERO	unknown
@angiegama	human
@hapiko_happy	human
@chef_timothy	human
@VinTwits	human
@little_foot2	org
@balanceoffood	org
@Alan_S_Morrison	human
@annemariepostma	human
@BinZuhair	human
@arrayofthoughts	human
@BklynPorridgeCo	org
@OKLM_RT	unknown
@turnipseeds	human
@crozzare	unknown
@martuzzaa	human
@I_amMirza	unknown
@RosalindeD	human
@TundeDelucca	human
@stampziixq	org
@Lilyvia	human
@Cornflake101	org
@sineaddubeau	human
@vanessabolosier	human
@travelingfish	human
@KarlitoP	human
@alifeqram	human
@Shawn_TRUKFIT	org
@Arpasiri_kafair	human
@Morgan_Giovi	human
@johnaagnew	human
@EasyWayInc	org
@scubafly	human
@edmund_lah	human
@rickyherdians	human
@GnLsPAnMA	human
@clintcrockett	human
@tracychambersvi	human
@sunnysideburger	human
@Rachuchel89	human
@LeedsSpireite	human
@socialvoom	human
@barbiefungirl	human
@zeroness81	unknown
@bmaisuria	human
@EnrichExceed	human
@rodyhague	human
@renatacastro	human
@heykatelauren	human
@myKamdora	human
@Rukkicious	human
@brillianti	human
@AwSookiSOOKI_Ni	human
@RDirectory_SA	unknown
@CynleeF	human
@freshnewleaf	human
@jamarie	human
@Gspearsamy	human
@Claraniee	org
@cediva	human
@filthteenyc	org
@Mini_Kabob	org
@ArtcaffeKenya	org
@NY_Now	human
@dearbushwick	org
@2iO	human
@drsalsamx	human
@LilPiggyTweets	human
@balazsgal	human
@MinaPaasche	human
@francexcastyle	human
@t0inky	human
@Sol_Breads	human
@brandonia33	human
@sherlyshu	org
@pursueitall	human
@Bynbyn_87	unknown
@maekawanami	human
@FMKCatering	org
@rvanderwalde	human
@norsamin	org
@RawleAFraser	human
@okypalalungan	human
@dedukdalf	org
@MattitosTexMex	org
@tittapitman	org
@DoubleTreeAMSCS	human
@Jennifer_625	human
@JAY_MATH_	human
@MattRichards87	human
@CarrieBradshoes	human
@angelin_pamela	human
@buxedaj	human
@HammNjammNjamm	human
@UFO_CTV	unknown
@MSGINGERBUSH	human
@skpromix	human
@Footstar01	human
@KathTeaChin	human
@V0ID456	human
@KenarryIdeas	org
@JerzOliveria	human
@SheratonDammam	org
@APLPHOTOGRAPHY	human
@IronwillKids	org
@matpaabordet	human
@novikastefani	human
@MOMsOrganicMrkt	org
@micoo0204_738	org
@GillyOagain	unknown
@JoysHomeEducate	unknown
@bomberrider	human
@stripuu	human
@tacohuts	human
@jamessalt	human
@skokwbokblog	human
@koulxCoast	human
@yevgenromanenko	human
@earnesteats	org
@Crepaway	org
@JoaoPatricio30	human
@pepamalolientee	human
@TNQRestaurant	human
@magic_pub	human
@AniqueIskandar	human
@SelenHurbas	human
@teppy7869	unknown
@FoodFromEden	human
@303_Magazine	human
@easychic_JMS	unknown
@TupaTaruna	human
@b_dal90	unknown
@N_K04	unknown
@liiisaaaxoxo	org
@Cilla001	human
@herblish	human
@constancioooo	human
@ShireenLouw	human
@swo2212	human
@minorusatake	human
@TackerKiRashi	unknown
@RetroJeansCo	human
@bjsettantuno	human
@njsredbutterfly	human
@diegodemiparati	human
@Alex_livingNOTW	org
@kaziii777	human
@lexigoodman	human
@DebHendrix2	org
@SyrineLover	human
@BrookfieldPLNY	org
@staceyannewhite	human
@crohead	human
@ElmyAzmy	human
@FullaOstra	human
@SavoryNothings	human
@BiscuitLoveNash	human
@VanguardPeejei	human
@karntna_bua	human
@FishNribs	human
@jisampedro	org
@hypened	org
@wanteng_	human
@azahirr	human
@Thayas_208	human
@ccfashion_by_cc	org
@krisgoldmanfit	human
@MelissaLitwakRD	human
@nandemodiary	human
@RikrdoBulnes77	unknown
@BardstownMammys	org
@MeetCasey	human
@cmsparkman	human
@_NemoO	human
@Purttyy_kittyy	human
@nosebagni	unknown
@TyffanyFaith	human
@scalelessfitmom	human
@Oseiasmasso	human
@trAKi_mieRIGA	org
@TeeElleBee	unknown
@IlGustoJeddah	org
@YouGotSquared	human
@owlandowlet	org
@PrincessA_O	human
@pazuzushot	human
@ThpHeroxipei	unknown
@dstroyco	human
@curvyinshape	human
@AfropolitanMom	human
@shion1113	unknown
@BakerandSpiceME	human
@aTanPicasso	unknown
@CaroleWesterman	human
@FourCornersRock	org
@ironmanV13	human
@tastyrabbitcafe	org
@TheOrchidMumbai	human
@designbyjorge	human
@WhiteRoomSupper	human
@GREGG_WADLEY	human
@chunkitck	human
@suzysocialwork	unknown
@RachaelHoang	unknown
@plajazz	human
@KitchenManual	human
@travel_capture	human
@bemnage	org
@AndrewBrisch	human
@IamStoneShek	human
@mrgreek	org
@MandyMycock	human
@hashtagfinn	human
@parlouryaletown	org
@NFUCountryside	human
@SunshineDadBlog	human
@FlorenceMKoenig	org
@CulpadaConfesso	human
@Haeo_1	human
@UrbanCafeFoodie	org
@MJsKafe	org
@KevBurrell	human
@Basepoint_Weym	human
@GemmaaLeigh	human
@AmazonSaving02	human
@Venussbay	org
@raiisthename	human
@rickerwins	org
@aish29ahmad	human
@_AbigailsParty	human
@tweetan87	human
@suprgirl83	human
@LaussMG	human
@hugobettenc	unknown
@MissSarah1993	human
@MNFirdha	human
@fkmnbyk	human
@twinkegs	human
@HeathVintage88	human
@littlebakeblog	human
@TWCNewsCNY	org
@LMUHospitality	human
@TheDecorGirl	human
@yiling2232	human
@yukoxiin	human
@CharFlorida	human
@Conti_Masr	unknown
@yagizefe	human
@187KLLNPGS_	org
@chriswpreston	human
@Na2_518	human
@_manZzup_	human
@SheaSonia	human
@cHacHaLuzuriaga	human
@internetmark123	human
@juagarci	human
@BowerySt	org
@2_Much4_1	human
@emily_smilelife	unknown
@cafeParisLondon	human
@OracleReading	human
@FreshgoLtd	org
@Clove_London	human
@PAloverUSA	human
@vinomujeres	human
@sayuriela	human
@thanapol_ch	human
@MatiasPasqual	human
@ibnumudhoffar	human
@Sweatwithbec	org
@Nehasbeautyspot	unknown
@Nanatin7trance	human
@ReviSulaiman	human
@JapesLDN	human
@jesussa16094619	human
@Satish_Gautam61	unknown
@GheAmarta	human
@CindyzxcSiaoLah	unknown
@tessoudali	human
@serenescenes	unknown
@FfionasNotes	org
@stylingspy	org
@DassieGirl1	human
@lesglories	human
@balladofadove	human
@Russkie_Zametki	human
@a0923530	human
@nourishedbytiff	human
@smarttimp	human
@AmbitiousGirl0	unknown
@TeaLoz	org
@LoaizaCL	org
@marriedNcooking	human
@KevinBergese	human
@JonPascual1	human
@lammified	human
@Lulukwindarati	human
@EatCheap	org
@56stjames	org
@syaoriiiiin	human
@TheTealWarrior	org
@Maggiehumphreys	unknown
@mkt_725	human
@1A2PP	human
@Recipe4Gluttony	org
@carrsd	human
@samsamasma	org
@I_k7654	unknown
@MyLuxuryExp	human
@nicolejauregui	human
@BalladOf	org
@wespermee	human
@BiggerThen_LIFE	unknown
@FreeReinHD	unknown
@DesignItVintage	human
@trufflesquare	org
@caskettcoffee	human
@Crushh_blog	human
@deebee_vip	human
@iLLMiZZ413	human
@ClaireRDXB	human
@KellyLynn444	human
@StefaniaGiglio_	human
@ChenyanSeah	unknown
@PINKIEAPPLENOSE	unknown
@brixcornercopia	org
@bluebosphorus	human
@wannadzirah90	human
@DricoPires	unknown
@KKozuway	unknown
@hamausagi888	unknown
@nnogali	human
@buppha_uk	unknown
@JessLoveYoung	human
@TheFamishedFox	unknown
@matsumotter	org
@rantinghagg	human
@Leo_Jauhari	human
@Crystalyoong5	human
@matbest74	human
@DawnMacchione	unknown
@_valencia92	human
@sstng	human
@tomas71pch	unknown
@pizza_eaterer	human
@CaffeNostra	human
@honeylizious	human
@fiscalbenet	human
@BlacknesT__Tan	human
@TeamDBAH	org
@lil_lam	unknown
@Jbelihay	human
@DNM_SF_Travel	org
@MetaPhysiques	human
@Gordon_Biersch	org
@MC4Natasha	unknown
@anointedheels	human
@daviselijah646	human
@aliciaa_aa	unknown
@yeeyang90	unknown
@yasmeencafe	org
@RofilMaeMRillo	human
@JenEDX	human
@perfectdraftbbq	human
@BrassUnion	org
@maasa_05	human
@katelcliff22	human
@DanceHubMargate	org
@LSCharlotte	human
@spotlightgear	org
@rnavyjpngirl	unknown
@gilliee_bean	unknown
@Rockstar_Gudrun	human
@AubergeWillow	org
@Delizios	org
@the3hungrymen	human
@THEBOY_yutee	human
@passey_lee	human
@yum_yum_yu	org
@Miz_Cd	human
@soksabbai	org
@SynnoveAmundsen	human
@jataylor84	human
@Telle_BooBoo	unknown
@Cbridge1978	human
@scottered	org
@kenpo_slice	human
@NoelVasquez	human
@ZenMonkeyTweets	org
@DjCalculus	unknown
@TimHawk7	human
@rnkfoods	org
@Yvonnewake_	human
@giulygi	human
@MoZZen21	unknown
@JennyPadura	human
@Cbp8Cindy	human
@brandon__logan	human
@AngelaASOT	unknown
@NipaZas	human
@Podgorkina	human
@Britt21_	human
@ballboy79	human
@donnamaerizando	human
@SOLEXO36	human
@TPY_nl	human
@GodofSincereAce	human
@RaeFoods	org
@NancyAnnLoiy	human
@cecilia_sayshe	human
@LifeWMyLittles	human
@iwandjani	unknown
@DesireeNicchi	human
@stevenshawnyc	human
@FlorinCong7	human
@TheFoodieHub	org
@lkperham	human
@refresh_daemon	human
@angel_163	human
@JcookieK	unknown
@Aahna	org
@krishalyn_	human
@Nindi_cut3	human
@HorizonsHalifax	org
@bran_1991	human
@SamesCarolyn	human
@xblacktreacle	human
@blitzzement	human
@emma_dami	human
@Kimck5	human
@VillagTavern	org
@OhayoOkasan	human
@ScoopWhoop	org
@jeanne127	human
@LucasCSmith	human
@AmarSotomayor	human
@sitiAmsabtu	human
@modavie	human
@panblogchisato	human
@ParishCafe1	org
@catgottwit	org
@ISarahTakeYou	unknown
@Hoo14hallelujah	human
@maxinepark	human
@simpleloanmod	unknown
@nextart_it	human
@lothusag	unknown
@lizziwilkinson	human
@Bozzuto	org
@CalumFalconer	human
@Scott_Whannel94	human
@A_petretzikis	human
@_ITSMELB	human
@AffiliatesOR	org
@ashersherwin	human
@VinaChiubbiezt	org
@dietxprt	human
@TheClassyItGirl	human
@blogpoidsplume	human
@cheekytzatziki	human
@Franklyimfrank	human
@VilladelPalmarL	org
@karine_ewart	human
@OfficialBhunt	human
@adRIaN_aRdIaN	human
@NatalieMac84	human
@ENT_CT	human
@nastyowner12	human
@harboreast	org
@team_burroughs	human
@bennystst	org
@PrettyFavorites	human
@todonen	human
@Garcon_Femme	human
@TheDutchMiami	org
@CorkForkPassprt	human
@KimberlyHeckman	human
@raleighhapp	human
@BrittanieR3n33	human
@saniebangedz	human
@KaleandCocoa	org
@KristiLloyd1926	human
@halfpint204	human
@geodarwinism	unknown
@HannahR1107	human
@lamblove82	human
@jann_bam	human
@angelasurgenor1	human
@steph_chandra19	human
@RjG718	human
@prairiegirlitc	human
@cynthiaIDKWIB	human
@Sanjit7	org
@RBEhotels	org
@PhilMyTummy	org
@Toast_Original	human
@wtfsimonsingh	human
@IntlSpark	human
@buzzinh	human
@epicuriumfoods	org
@BillNigh	human
@HouseOfFadesLux	unknown
@midlandsfooty	org
@hawaiiancafe123	human
@newleaf_fitness	human
@Iolibee	unknown
@MacaronsBubbly	human
@pedrocrisp	human
@supirozuroppSHe	human
@BabuBeg	human
@recipeworldwide	human
@anisamacadame	unknown
@CynMore765	unknown
@CroweBaby	org
@Darlingtonmonth	human
@anindyawidhap	org
@SammLibs	human
@yasemiinn_	human
@PinkleRae04	human
@djunisan	org
@_Naomi_Elle	unknown
@LadieParty	human
@m_oyaaaan	unknown
@KendrasTreats	human
@thetellyhope	human
@alendria864	org
@SeminyakItalian	human
@welcomemag	org
@foodcation_2015	unknown
@AkoMaylanon	human
@BarrhavenBlog	org
@sty_licious	org
@MohdRedzaKasim	human
@Dehviant	unknown
@Shayfana	human
@olibistrocafe	org
@debsmikdav1	human
@DiningSocially	org
@SulaWineFest	unknown
@WineMktg	org
@nolasnacks	org
@CulinaryCraft	human
@Nuevalor	human
@vosjedriesprong	human
@Jc_Valladolid	human
@JuicysBack	unknown
@Julian_Potato	human
@frubite	human
@Emmaleewalpole	human
@east_goddess	human
@jodiejoy03	human
@miss_claire8319	human
@SuperAndrea	human
@annbritton	human
@KofifiFM_972	human
@SoaresAnaRita	human
@BeAreKay	human
@BWChophouse	org
@cheryl7003	human
@charlotteatkl91	human
@YakitoriSake	org
@ekafetrisia	org
@Limitless_book	org
@Echiyeee_	human
@waterfrontbar	human
@iLoveFOLA	human
@CheffYunus	unknown
@Vaishubhoir	human
@Minerva9825455	unknown
@Beauforthouse	org
@FSLasVegas	org
@RickLavaL	human
@elcafedelletres	human
@loseweightfasst	unknown
@Ayjay_Xx	human
@SurinderV1989	human
@doriegreenspan	human
@davintjen	human
@virdanaa	org
@HKozn	human
@CauliRiceTweets	human
@whychristine	human
@HolyGuacamole_x	human
@TCFit_Lifestyle	human
@barrybazzabazF1	human
@ReenaButani	human
@CamejoHector	org
@lionsaysrawwr	human
@yuca_hayashi	human
@Priss_E_1	human
@girlybrittani	org
@BettyXiaoGui	human
@jame_18	human
@Marcuscito	human
@Vidant_Health	human
@LyveV	human
@dianasari2013	unknown
@oliviercorizzi	unknown
@FineTique	unknown
@MeganCharli	human
@LucioA	human
@BossyBootsCafe	org
@Chizzlewit	human
@IAMDJJUNKY	human
@zeppy_chelsea	human
@kevinshapouri	human
@nejatbrohi	unknown
@Pilis_Rossi93	unknown
@alucard31	org
@keyvan	org
@qn_npqu_up	human
@IloveBquilla	human
@ayan00000n	human
@ChicagoCut	org
@burwellitltd	human
@TheNoshCafe	org
@vegboxer	unknown
@bukscambridge	human
@samdavies94	human
@lischa_naiyaka	org
@septembergilda	human
@acc_stylish	human
@pcboy4life	unknown
@sharonjeannette	human
@thetitep	human
@PetitParisEst	human
@LanyMihajlovic	unknown
@CANBusiness1	org
@Luivuittondon24	human
@OwlZoumer	human
@tsukekun13	human
@Crystalann617	human
@hensensho	human
@cappuccchino	unknown
@pompeyam	human
@COSMermaid	human
@JordansCereals	human
@jularee	human
@GluttonySquared	human
@merangelina	human
@AmitaShinaj	human
@TuscolaPantry	org
@PFFUSA	human
@SLhealth_beauty	human
@StopandShop	org
@kr_iyer	human
@NoshDrinksIRL	org
@LucySpain	human
@Catherine212	human
@DirectorioModa	human
@TillieModel	human
@PastorFrankJWC	human
@slackshoagie	org
@kayleesnaily	human
@AustralasiaMcr	human
@bradatslice	human
@Ladywithhat19	human
@joanyean	human
@fleurduluxe	human
@ca_puccinoMI	org
@HonigkeksBlog	human
@GetOFFMYTISH	human
@PickleandRye	org
@poelterpuschen_	org
@Da_Floyd	human
@CandyIanna	unknown
@laurameldrumx	human
@Haloo_1	unknown
@Pogbooom	unknown
@TbleforSeven	human
@RisingSign	org
@Hudsoncanola	org
@CherryPieLane	human
@Chris___Malone	human
@Ms_ToniJones	org
@melissakeppens	human
@0Lix8	human
@drh_Sagara	human
@GpParrucchieri	org
@MeetSELECT	org
@PureMax	human
@ForkITTreadmill	human
@DenzelvonDeira	human
@alinishMEaddict	human
@SmokinsteinFood	human
@lattegirl03	human
@NanyangCuisine	human
@Gabrielmeds	human
@SileSkelley	org
@chipmunkbabiie	human
@j_nicole_91	human
@MsV954	human
@bman1595	human
@FoodEssex	org
@realfoodrk	org
@NatzNuttynat55	human
@foodfactsnews	org
@OfficialDJDio	human
@naomijbryant	human
@hideawaylive	human
@henrYFoto	human
@baltazar1234	human
@brunchcityblog	human
@ktkitchnjournal	human
@DenverTM_Homes	org
@fadilov	human
@PerkyMessenger	org
@jdyshrky	human
@IndrawanAsnadi	human
@FrancissOrtega	human
@hoko_c	human
@mohitnegi724	human
@NeuvooBlooming	org
@MixedUpBurgers	org
@dramarinasantos	human
@ChangoNaNas	human
@ahfugs	human
@Pandelela_R	org
@ChefShaunBrian	human
@phoebehywong	human
@thgalishere	unknown
@SandersBoston	human
@IAMNedin	human
@CaphePho	org
@IntentionalAB	human
@Strell_Star	human
@citypantry	org
@uchanishere	human
@rbbrmlk	unknown
@Aidayespica27	human
@kris10mahoney	human
@claysnails	human
@CEOofTHEvip	human
@red_carnation	org
@garylimoge	human
@starwarsitalia	human
@JoRcH__	org
@deboslaan	human
@colinmill	human
@MorganIonephoto	human
@KZphotograph	human
@steffimitangie	unknown
@MyLOVEMyALL	human
@Cube2485	human
@BasilioIsaias	unknown
@kmabel_lopez	human
@ChoxTheMuse	human
@XYourSizeFoods	org
@OuterspaceJ	human
@NadiaCxx	human
@ClarethaViets	org
@SindarElf	unknown
@J28sandwichbar	org
@perkyjerky	human
@stubbsbbqsauce	human
@MillerMeThis	human
@beinspiredsf	human
@BrandyLGrant	human
@SMW_86	unknown
@Addmorebutter	org
@marianna981	human
@Schwezta2013	unknown
@Lovebiancx	human
@superhirro	human
@AjaNoodle	org
@BellyAcres901	human
@FlawlessDutchie	human
@foodeebuddee	org
@StephAlvarenga	human
@imashiteru	human
@TheCookinator	human
@Taugie06	human
@WTGandolfosDeli	human
@moffphotography	human
@CodyGSK	human
@makadi	human
@ExtrifitUK	org
@HavenGastropub	org
@IsaiahInsomnia	unknown
@ashchanwrx	org
@ajiscullens	unknown
@levonshaw	human
@Yogilation	human
@ClearlyOrganic	human
@SonjaLew	unknown
@olivierjodun	human
@mytriptofitness	org
@1040girl	human
@kyleearoe	unknown
@Midence_rocker	human
@ThomasSartori	human
@lenubienne	human
@ExcaliburDGreat	human
@haoleetw	unknown
@irfanhanifpeng	unknown
@queen_mdk	unknown
@RlynAmien	org
@aoifedowd	human
@MirjanaJesensek	human
@MondrianLDN	human
@maeisthenewblak	unknown
@sgmaddoxjr	human
@carrieste	human
@WORRODRoger	human
@divafamitalia	human
@bressingham_s_g	org
@ExtremeCaution	unknown
@mscijihenderson	unknown
@bethgatrell	human
@PaganParent	human
@inspocafe	org
@juaiomar	human
@skinnychickscb	org
@AnnelChoice	human
@Jaquool	human
@Chee83	human
@britinboise	org
@freshlyROC	unknown
@katemoving	human
@carilynp	human
@jackie086	human
@BuffBurgerTX	org
@kazu51528199	human
@GetMasterCook	org
@ChRiStEhN	unknown
@DoradoBoston	org
@jennifer_elena	human
@pieminister	org
@missnatray	human
@balanceupnorth	human
@idol_era	unknown
@JEYnoname	human
@margoakosin	org
@curiousmanor	org
@marchempls	org
@JoelHavermans	org
@ElyxYak	human
@marluisfer	human
@BlogDeLaBlonde	org
@DonVin_Fitz	org
@stavroz1	unknown
@terrigilligan90	human
@alajmi16	unknown
@XiiaoBae	human
@cooklikehell	human
@khamidson	human
@TastingToasting	human
@AuroraNJose	org
@styledlady4ever	human
@chrisel96	human
@missesironman1	unknown
@_KIDArinda	unknown
@mermaidfiles	human
@nganhaleng	human
@BoydensKitchen	org
@foreverdreamer6	human
@jayridzwan	human
@sixabpacks	org
@bullislington	org
@halofest2012	human
@ronpecho1	human
@jenniferrluna	human
@FredsHouse_Rest	org
@SingaporeSAGG	org
@CoffeeCornerBS	org
@susinideni	human
@2014Trionf	human
@chiqchoq	human
@wrestletopia	human
@AlisonTT	human
@pipelettes_time	org
@active5eiko	human
@ecooke22	human
@LifestyleAsiaHK	human
@FatLoss_Fun	org
@FinePristine	org
@ChimaPhilly	org
@GlamDollAloha	human
@iMeeMz_	human
@BabycakesTruck	org
@Milideasmilproy	human
@mariaacquaroli	human
@TonteriaExpress	org
@jessicapalmer05	human
@TheLalitHotels	unknown
@5awalh	unknown
@BryanMPoynter	human
@JMCBSL	unknown
@geraluy	human
@Maja_Ena	human
@seanisto	human
@annanagata	human
@_ProfessorX	human
@ArifahAzhar	org
@wentries	human
@DrumminDave3	human
@pilsenjla	org
@everyday_monday	human
@yuriyuri610	human
@MikichaanM	human
@TheClassyDish	human
@kireinaame	human
@Whats2Hot	org
@jg_tu	human
@AQUA_BLU3	human
@bakeritablog	human
@ChantelleYA20	human
@StandardbrewStl	org
@AldynaDamping	human
@hoeadrian	human
@LouiseEtsy	human
@SandbarRum	human
@ginandcrumpets	org
@Borealia_TO	unknown
@nushwik	human
@inadurante	unknown
@YourMelaka	human
@1stStepFatLoss	human
@misaasim3366	human
@TheCateringCos	human
@HashtagEDiT	unknown
@LBannister33	human
@LMarusyak	unknown
@marinabaysands	org
@leanixkim16	human
@LivMonde	human
@HGRestaurantBA	org
@Young_Nard_	org
@aSEATAxiCab	human
@marc_noda	human
@AlkalineWellnes	human
@mamanpourlavie	org
@j4dec24	human
@aleahling	unknown
@happyjustrocks	human
@jessythejokerJ	human
@Gourmandiseries	human
@mariabond305	unknown
@DABrainchild1	human
@pinja_k	human
@frankster304	org
@ivyboom	unknown
@JWilsonPix	human
@nosh121	human
@NachoMamasMD	org
@PaMesnil	human
@MsNicoleShakes	org
@ines142	human
@amkawo	human
@rastaroy510	human
@monic_item	human
@KingNoodleBK	human
@charityshares	human
@TheLeopardInn	org
@streetsupercars	org
@momoko_sakai31	human
@jchocalisty	org
@b_flywall	human
@EscaldaDesign	human
@AppRatChaDa	human
@GeekMatt	human
@RiseShineLV	org
@Diamond_Dall	unknown
@rozyjoe	unknown
@rurun_yaffa	human
@ShopZiff	human
@codenamemax	human
@emmaluckett	human
@verbaldiarrhea2	human
@MandHBakeryUK	human
@sheinasteaks	human
@UnionMarketDC	human
@IAmBespokenFor	human
@Goldlogitech	human
@tiffffffffff	human
@Carissa605	unknown
@HashSELFIE	unknown
@yuew_echo	human
@AUTHENTICMARCIO	unknown
@RioRioCantina	org
@AWineHotels	human
@SwamiInsane	unknown
@eviovie	unknown
@lorettafit	org
@WiseGalSophie	human
@J0HNNY3T3ARS69	human
@FIGSANTAMONICA	human
@meals_ladbroke	org
@librastar76	human
@MoatTeaRooms	org
@alexrome8	human
@tick37775	human
@ICanChicThat	human
@esantamaria	human
@SunnycoastKlips	human
@NYCJesi	human
@OakWFKitchen	org
@GPfood	org
@beggatwins	human
@priskanatasha	human
@Dezreyswag	human
@EagleMtHouse	org
@RelishMagazine	human
@franks012	human
@MandiliciousGCC	org
@kScottXR	human
@LenaEatsWorld	human
@dave1922pope	unknown
@TommyCar2	human
@HedwigeLewis	human
@SquiffyAlto	org
@JephiSTheName	human
@BerangereBee	org
@LaunaRissadia	human
@madgesgaff	org
@labandoleraa	human
@ImadElie	human
@VDewKnights	human
@karlaloo	human
@Eat_The_Street	human
@chilipastetour	org
@MsWebb1980	unknown
@BennyContoh	human
@blueorangepink	human
@mutty1112	human
@RestaurantJS	org
@fabuliciusfoody	org
@Becca_lacy	human
@syahermann	human
@ExtraordinaryOX	unknown
@alanabbyrne	human
@anjelikamapili	human
@Apollo_Retail	unknown
@FredPlayBass	human
@JYangSheep	human
@LePetitMoineau	human
@Scotiafood	org
@mariaGia_1	human
@iamketshii	unknown
@_plyre	human
@Agaa_ta	human
@grizzkuklinski	human
@realadvicegal	human
@Revofhope	human
@MundoSinFin	org
@DaveGracianoT	human
@Sheraton_Luxor	unknown
@HollyDayzTravel	human
@ideyarestaurant	org
@stephy_2010_h	human
@ipshkg	human
@erikamari13	human
@Natasha_Allia	org
@Louisagreeff	human
@GovindasToronto	org
@FlawlessAura	human
@tonydubravec	human
@MissZee22	human
@viscountpaul	human
@Hacsta	human
@mentaryputri1	human
@choose_Belle	human
@Seissa34	unknown
@Jenniferly1202	human
@abbbylam	human
@yukayokokawa	human
@SubahAhmed	human
@MrBacardi78	human
@JLClaytonBooks	human
@ChrisDietzel	org
@FetishSix	human
@walk_japan	human
@Alexxxandraaa17	human
@SilverSuitesRes	human
@SophieAddo	human
@RushnaWB	human
@crema	human
@ABRecipes	human
@TinELF	human
@grasset_diego	human
@PatLFiacco	human
@JuliankateM	human
@thejwills	human
@FitTipMadness	unknown
@HVNDS0ME_HER0	human
@teeasi	human
@J_A_S_M_I_N_E_	human
@eatwithellen	human
@Brrrody	unknown
@IrynnBianca	unknown
@atok_fairuz	human
@KarlisMD	human
@WendellFR	org
@super_br3akfast	human
@Reeses89	human
@theritebite	org
@midtownjakarta	human
@anitadobre	human
@ShintaPrisc	human
@MMTavolaro	human
@SureenaMHassan	org
@slimfityouwraps	human
@paul_cude	human
@rosat1ons	unknown
@A1ExtraChedder	org
@STEVEN_L_RICHTE	human
@HenRestaurant	human
@RosyDecosta	human
@DjFar	human
@nunu_lisa	unknown
@GastroSolutions	human
@PaLiiDa	human
@DayummDhaddy_L	human
@BatchMiami	org
@SeverinoPasta	org
@TheWill_ofMan	human
@TheNoisyLobster	org
@derekvsLP	org
@RadissonBluLive	org
@WorldNetHGT	org
@pDekLay	human
@LindaKatzHealth	human
@Californiachi1	human
@saysay082412	human
@DethroneJustinB	unknown
@ChevonneMUAHH	org
@UneMaalienne_	human
@tweetingkenny	human
@chiabiaseed	human
@ShakeItOffZumba	human
@brainsnorts	human
@Delrayman2	human
@Ryz_b2utyAngels	human
@rfif_inc	org
@lobbyonyork	unknown
@izzyerskine	human
@WolfhartHosting	human
@I_AM_THETURNUPP	human
@1boleynboy	human
@ErnieTsu	org
@tx_rangersgirl	human
@masterchefresto	org
@urbanfaerie	human
@DubLuvTuning	human
@bastiiakarayzen	human
@msjallday3	org
@LeilaJeha	human
@HotToddiVirtual	unknown
@KaishaVega	human
@gowithyourgut1	unknown
@AliWakil	unknown
@lotpineda	human
@Vaany1992	human
@francisterrado	human
@ChiTownBrunch	human
@schuhart_drs	human
@Fatema_Omar_85	org
@GiddyPrincess	human
@foxyfleet	human
@iec1968	human
@sgarza1016	human
@AmmaraJunaidy	human
@alexplam97	human
@barbylasdinner	human
@APoselenzny	human
@DualitSA	org
@peelandstone	org
@AmirahZin	human
@luca_seme	human
@ReggaeBrit	org
@karla8852	human
@DavesDMDImages	human
@hellokimmeeehhh	unknown
@rosababy	human
@carlailmioblog	unknown
@mamachell	human
@PeanutButterCo	org
@ABaudelairesty	human
@jonelledavis	human
@minowha	unknown
@realwildent	human
@WhoopAss	human
@BarrenHillTav	org
@MJFakhereddin	org
@TRIBEfoodie	org
@pricessyien95	human
@Woga_Castellana	unknown
@hitonss	human
@angelannr	human
@OnlyGurl84	human
@SuaMaestade	human
@Tomotyaaahn	unknown
@sandwich_forall	human
@408Sancho	human
@jossystash	human
@BongosCubanCafe	org
@_10moca	unknown
@DonnafugataWine	org
@jwzzzz832	human
@lifeissofab	human
@iamvercyn	human
@thatrecipe	org
@knifefork_	org
@LuNeYTuNeZBJ	human
@SyafaTeeya	human
@LuigiVacca	org
@Style_Dock	human
@FitznBitz	human
@CoppersmithBos	org
@jarvisjadz	human
@SeriBerry87	human
@joyride_ridge	human
@NassLeDz	human
@pldanforth	unknown
@twentysomethin5	unknown
@TOparent	human
@brandy_dawson	human
@ateppitan07	human
@GREENTHUMB415	human
@ThePineAthens	org
@lumam73	human
@DanielTolson1	human
@AmandaZipsItUp	human
@DaviesAmie	human
@foodgroup2243	unknown
@oOButtr_FlyOo	org
@GiovanniAttena	human
@coocooforcookin	org
@Stv619	human
@Skhetch	org
@unionstbrewers	org
@HotSpot_NotSpot	org
@adrisanz88	human
@amberromaniuk	human
@ramadanrecipesL	org
@DaniellaGalbra1	unknown
@IdahoDairy	org
@Ty_baby88j	human
@GraceAmazin	human
@refreshment_aya	human
@marhabasomi	human
@mandalaya	human
@SDeppermann	human
@ndanbondansw	human
@Shrymix07	unknown
@tweeterellaah	human
@RockyTears	human
@gogogogourmet	human
@petsadoption738	org
@MrsTippler	human
@monskinsmons	human
@weedandglitter	human
@Nikelz3	human
@drewski95	human
@CharlotteSuen	human
@catafhernandez	human
@ClearcutRecruit	human
@keith_205	human
@jdblundell	human
@rsbrandt44	human
@F1710Lynx	unknown
@SaraKateWhite	human
@junction_bia	human
@Mizukitty3333	human
@jencenaofficial	human
@ivebeenontherun	human
@chandra0401	human
@ronz_nongky	human
@nanari18	human
@Solloveswine	human
@joyceikong	human
@chibicrape	human
@classicfreshfds	org
@montano	org
@Kine_Myhre	unknown
@noonandkabab	human
@ModelMichceal	human
@MoseSmSalazaR	human
@FoodSpaceThai	human
@mualisawilson	human
@SmilingGoatSpro	org
@ladychef_	unknown
@becausegoodfood	org
@DawnSeawright1	human
@PRVouchers	org
@AbraCaBling	org
@WaseemIS	org
@XiaoMessy	human
@heyhye_Jinny	unknown
@KDOTBOSS305	human
@myreenO	unknown
@TownAndChamber	human
@EmilyMcGray	unknown
@stopmycraving	org
@TheShantiSocial	human
@OLiVESnyc	unknown
@leggypeggyOZ	human
@AmareshMisraFC	human
@SicilianForks	human
@djdaledaniels	human
@toomokko	human
@Brandi_SykesTW	org
@franjcq1	org
@InterParkCHI	human
@nvdben	human
@SaraPite	human
@mcigerova	human
@cookcraftlove01	human
@thedruidpub	org
@ReginesBritExp	human
@buddhagunzBKNY	human
@Sursonique	human
@Hiptopgirls	org
@myhl22	human
@linn_oo_oo	unknown
@TajukTekno	human
@music_xxx39	unknown
@tatyta_83	human
@SanoChef	org
@Barbiexxxr1sa	human
@DanAngelone	human
@gianishlilloo	human
@F1L1PStarCZ	human
@GoldenRoadPub	human
@meetmeinparee	human
@KayeCaren	human
@220boy	human
@TheHotelCulture	org
@FatGayVegan	human
@marcusfpj	human
@jasminisrad	human
@KusmiTeaUS	human
@bboygermy	human
@TtKayleigh	human
@oliqhubiel88	human
@raybouk	human
@Lorna_Sheehan	org
@DeanAndDeLuca	human
@ADRIANNAPSS	human
@KishFish	human
@Allencm27	human
@AmienaDavids	human
@Lexie_Official	human
@RabihLaz	human
@GabbardJarod	unknown
@mesijesi5	unknown
@jessieRKlover	human
@nicollejamela	human
@Shaman_Tito	human
@ArkansasRecord	human
@naybellaev	human
@Evelyne_jansen	human
@allohcansay	org
@curligirlibabe	human
@FDLeagueOne	org
@elisamonnanni	human
@itsKimmD	unknown
@iBsg_	human
@YoChinaonline	org
@Ms_Serena_2you	unknown
@porkbellystudio	human
@johnniegold	human
@jdhcebu	human
@eldorado51	unknown
@reipipi51em	unknown
@IrvFabor	human
@ghaatidancer	human
@wengie	human
@patdurr	human
@SuperMario_IE	human
@Alpro_NL	human
@JohaRabino	org
@momo_1101992	unknown
@__BeLcikaLi35__	human
@mohantytulasi	human
@FlsvhC	unknown
@ItsJustMeHD	human
@El_Voceras	human
@susanmurphyinc	human
@KrystanMartens	human
@AinsworthVegas	org
@VickFidel	human
@DithaHere	human
@PiccoloWanstead	human
@iloveHardal	human
@Kazuu01	human
@ArrianeYagami	human
@PallaviSingbal	human
@RailwaySW4	human
@themommysreview	human
@MuskelaufbauBB	human
@power316_radio	org
@annavardi7	human
@TheUnited_Belg	unknown
@Pinktruck_Ryu	human
@mybellys	org
@BucheeryMarwan	human
@mellokittv	human
@FrancoValenz	unknown
@Skitty_Meow1	human
@everydaytourist	human
@gabethebabexxx	unknown
@Bossza610	human
@MotherBearsBLM	org
@iheartkeenwah	org
@SOABS	human
@artfulretro	human
@jacp08	human
@mvheerden	human
@Pilita_Nava	org
@mandalynn_86	human
@ForumSheffield	human
@TheDanceGrad	human
@TheMoimoi	org
@martyssima78	human
@MediaChanel	org
@HotelBethlehem	org
@Healthisallind	human
@Leonardo_vill	human
@raeganjei	human
@jessandunnotis	human
@JCiccanti	human
@MyRaysSunshine	human
@180diy	human
@ErniesEpicFood	human
@onbeingalaura	human
@dxman830	human
@Im_PradeepKumar	human
@fiddlegal2u	org
@faroskebap	human
@FullcircleVEGAN	human
@Sp3nc3r4	unknown
@guerillakitschn	human
@johndumlao1993	unknown
@maryjanemmm	human
@GrillHouseBanus	org
@officialChiki	human
@NkemEjoh	org
@EmbassySuitesMD	org
@AkbarLawson	unknown
@joe_maino	human
@NoDucksGiven	unknown
@RogierBeckers	human
@CuzznMikey10	human
@itsmeChiMae	human
@UniquelyYourDes	unknown
@Alvin_Tanggara	human
@GerberGroup	org
@emilyoliviatapp	human
@MalangPos	human
@akibetsuaka	human
@aybikeyamancan	human
@sweetlifebake	human
@JaniceOoi58	human
@Raymond_Widjaja	human
@JadeO_Gib	human
@ColinMasefield	human
@Dugataki	human
@sarabozich	org
@UptownSocialNYC	org
@shezanali	human
@blueplateTO	human
@NextActPub	human
@tomomogg	human
@JPsuperstars	unknown
@DrCatriseAustin	human
@barcelona200	human
@KarmaTatdDredHd	unknown
@RakhiDcosta	human
@HeirToTheOcean	human
@Eat2Live4U	human
@evanvar	human
@SanaeEmily	human
@HotelSorbonne	human
@claudiasaurrr	human
@ernestsubirana1	human
@stescuotto	org
@Snooker_O	human
@luisdeleon90	unknown
@GuedezSA	human
@CheemasNYC	human
@propersausages	human
@david_ranucci	human
@Anitasbbeauty	human
@LauraReed1993	human
@limelight30	human
@SJConsulting_CA	human
@TitanTexan	human
@SashaDiBiase	unknown
@elingedesherk	human
@MeynardJoseph	human
@eighty3memphis	org
@akinsoul	human
@irfanfatchu	org
@pedrorfitness	human
@sandidevenny	human
@LisaTamburini	human
@Bru_Ibarra	unknown
@ChefinHeelz	human
@saffron_lilian	unknown
@DuyenTu	human
@annjaimi	human
@HPrunay	human
@yhen_gonzales	org
@FairmontWhistlr	org
@HalifaxCorp	org
@ABrownAround	human
@gonzaloxx	human
@MasterGio	human
@backpackovalija	human
@MercerBarcelona	org
@Giankrlo21	human
@SHARPE96	human
@LouvreHotelsUK	org
@LullabyForPies	human
@GossipGorilla_	org
@EkeneMyke	human
@main_Kamli	unknown
@ayomiprahyang	human
@MelissaSelenaMS	human
@JavierAvilaEven	unknown
@DavideIacobone	human
@natashapurkis	org
@bontagx	human
@MeloncinoSA	org
@bloggymery	human
@defineacelara	unknown
@servemenow	org
@giusy_faienza	human
@iamswam	org
@beviani12	human
@amodelintheknow	human
@LisaThomasFit	human
@CatholicFoodie	human
@MzPiink	human
@AAlmardawi	human
@AKnitInTime	human
@ParishCafe2	org
@cynthiasassi	human
@SaucerSugarLand	human
@AngelWelshpool1	human
@kawassan	human
@BeaconMe	org
@obrienisomine	unknown
@VictorManibo	human
@MiloFotografia	human
@danixinhahhh	human
@dougshaw1	org
@Terryhillsny	human
@aliceinqueens	human
@funes_gabriela	org
@83TBird	org
@OfficialYunLiu	human
@vynznograles	human
@ColvinPepsi4me	human
@HamlinCorner	org
@Hend119	human
@nattapatpn	unknown
@Brohawk00	human
@Lv_jj	human
@WilliamAbreuFit	unknown
@NamuKini	human
@MandySexyDavis	unknown
@meannaree	unknown
@BestofMemphis	org
@DaveFarri84	human
@missbabbitt	org
@SuperEfXO	unknown
@sustainableorph	org
@mayuge_chan	human
@trephene	human
@HealthyGirl_NYC	unknown
@cazziieglamour	human
@erikazucca	human
@HeidiLenya	human
@katamomi_member	human
@miakoo	human
@Holly_Pena	human
@GailScottModel	human
@stiva_teo	human
@traycee30	human
@manokaaaah	human
@FairWeatherFood	org
@JorgRestaurant	human
@Geggepower	unknown
@mikecentola	human
@HausofBase	human
@leo_capitulo	human
@LucyJHamilton	human
@djcrocy	human
@rarecow	org
@jengjess	human
@SteveYongCC	human
@oogaababy	org
@iBill_iBill	unknown
@TOundrgroundmkt	org
@FoodintheFour05	org
@Richiegoleft	human
@ElwoodsBBQ	org
@eatatpurslane	human
@JanPhiS	human
@NissyBunique	human
@emilykwan87	unknown
@shadowradow1983	human
@jcskipp	human
@SaranyuKoo	human
@FoodiePages	human
@CaveRosie	human
@cafe_claremont	human
@MadebyMolu	human
@sdtheking	human
@reikacocochan	human
@Fashpash86	human
@RobertWKuypers	human
@hanbananamiller	human
@TheTerminalPub	org
@01koji10	human
@Rossy__RORO	human
@clee21	human
@irah_tan	org
@aqchiu	human
@ABCVegan	org
@Marycolle_23	unknown
@anna_c_jones	unknown
@wildtruza	human
@MattRestauro	unknown
@FinnegansTysons	human
@jevyca	unknown
@Bebelesprivat	human
@Mariezamboli	human
@pungkilicious	human
@shakeb27	human
@Born_to_be_blue	human
@pepesaya	org
@Abhilash_lr	human
@tiennyingg	unknown
@ohsogoodOT	org
@sebas_tian2	human
@pobhotels	org
@Albertine3760	unknown
@XxSexyBoiSwaGxX	human
@travelbytez	org
@45mog	human
@nbjune	human
@ayatpetak	org
@c1int0n	human
@blackpennyWC2	human
@BigBowlBuzz	org
@LaurynBodden	org
@MizDurie	human
@WestmontBagel	org
@Innatgrinshill	org
@HannahBland	unknown
@MrJ_____	human
@tcklme_adidas	unknown
@asc07	org
@CoffretGourmet	human
@Aum_Anchi	human
@BlackBearDiner	org
@kristyleighper	human
@KTG_	human
@MissaugaMomShow	unknown
@mommysfabfinds	human
@martinatufo	human
@vonney1m	human
@heidos777	human
@RubberSealIt	org
@ApoloOhno	human
@ChicDisheveled	human
@HammerEmma	org
@518West	org
@PaleoNetwork	human
@PikeHerc	human
@wwsophiesay	org
@Sumayya_RAK	unknown
@crush_the_blog	human
@DayTripperYeahh	human
@oluwajenas	human
@kezzy999	human
@angkulitmokc	human
@RoxyDellamorte	human
@HippyFlowerLady	human
@NilErHan1	human
@Nauth24	human
@blondeazy	human
@FatouJrs	human
@raineyangel	unknown
@LePetitEtagere	human
@Music2Mma_denny	unknown
@labob1950	human
@RajaNasserEldin	human
@xiiao_tong	human
@jmtysymt	human
@Alexcloset	human
@adeliapoelkadot	human
@ASBeeTheBest	unknown
@anchor11	org
@kaylabsyooou	human
@princessenaya	human
@leidgratuito	human
@mr_cleaner	human
@ButanecoKitchen	human
@gilberuto	org
@Elofancy	org
@yspphotography	org
@byonutrition	human
@aQuiLa_aLtaiR	human
@LuxuryPartner	org
@MirtaMargaglio	human
@JasmineLee0810	human
@BlackandGold_KC	human
@TheDolHouse	org
@amandaisabelynn	unknown
@kitchisbest	human
@yrteng	unknown
@albertblog	human
@hdo227	unknown
@akusia88	human
@oXYGenFinancial	human
@DenversBest	org
@remaciel11	human
@bigtone76	human
@yesCire	org
@SiriKirtan	org
@mykuyam	org
@yixuansailou	human
@FitnStyleMag	human
@Utopian_fantasy	human
@chibimikan69	human
@CenasTrueFan	human
@kenjai_hot	human
@KindredKitchn	org
@mar1	unknown
@kei_kyuuketsuki	human
@batrentham	human
@vahuntergather	org
@Peet_Rothwell	human
@MorganSpiked	human
@baishismail	human
@depth_dreamie	org
@cusidore	human
@Speedtrader24	human
@WhileSh4nSleeps	human
@THSZone	human
@twobitvision	human
@FocusParenting	human
@TheHealth_IT	human
@Ms_Zane	unknown
@iamilwilly	human
@BeesanSartawi	human
@BrickyardWS	human
@Pressi_Gift	org
@DINE831	org
@CorsicaShop	org
@DaviosAtlanta	human
@GreekIslandsPly	org
@TheRealStupeedo	org
@_exoticarabian	human
@irene_dagati	human
@nopi_akbar	human
@ARTPOP_Mitch	unknown
@BellaCraftsQ	human
@gatoluv14	human
@animemanga4all	human
@dzwey	human
@its_deckerr	unknown
@thinkthinkmay	human
@GUNHEEVAN	unknown
@La_mardee	human
@nickonneRRT	org
@insomniaalways	org
@TheMagicCook	org
@jojosaguin	human
@donnah_02	human
@Ah_oh_ee	human
@JavierVazquezQu	human
@sherwinsu	human
@Fileena	human
@irinadarina1	human
@Bron_Cook	org
@ben_streets	human
@warniharnidah	human
@Pako_Con_K	human
@andriezzo	human
@jkdimagery	human
@iuliacirstea	org
@BlondeBarbie47	human
@StephHaynes2	human
@miamiyogis	org
@PebblesLabsYou	human
@Railroadhackney	org
@BlueNoona_14	unknown
@kaceyaai25	human
@mindmint13	human
@dominicrevaldi	human
@frankjbr	human
@Jess_Sick_AHHH	human
@April_Snyder	human
@eLLy7977	human
@zdenekwognar	human
@jessica_crane	human
@BicycleSeb	human
@alacek24	human
@sena_nkjm	unknown
@MooliAlBarout	human
@_Paosy_	human
@Shoko_LA_te	unknown
@RenatoAlemao	human
@philly2night	org
@judiii	unknown
@JimmyFerdianto	human
@lovingutoo	human
@snd1981snd	human
@lorenzo_cafebar	org
@flame_bar	human
@isroiyatul	unknown
@EatNorthCounty	human
@DimitraRana	human
@Kym___	unknown
@ahytts	human
@Evina_J	org
@20YH	org
@DrLLefkowitz	human
@Artisan_SF	org
@__Nikii	human
@skychaa2410	human
@RoastVictoria	human
@ChangosBurrito	org
@BanburyShopping	org
@AakilaIsmail	unknown
@SteakExpert	human
@WeAreBABTA	human
@BrendenMellens	human
@momo52190	human
@BenStarkHH	human
@BlueStar_yyc	org
@fibs_fil	org
@AliLevineDesign	human
@ZahraBadalbeyli	human
@CoutureFane	unknown
@LangleyFilmbox	org
@WUK_LOVEFOREVER	org
@FeghalyJoelle	human
@HugsForNoah	org
@DNM_SD_well	org
@Mariapura	human
@DorodiPastry	human
@katscurries	org
@pheliphelps	human
@BPandtheFrog	human
@DiwanAlSultanJo	human
@toktokhae03	human
@1millionwomen	org
@zoeskeet	human
@iamhakme	human
@i_am_seph	human
@DJJDAWG	human
@alicemylne	human
@tensyotenko	human
@cyongwee	org
@FLRealtorLisa	unknown
@MichaelleParris	human
@magnus_bean	org
@Mookaveli	human
@NextDoorKitchen	org
@JadePethel	human
@clairemilleruk	human
@kanelinzi	human
@TingbellaTing	human
@thesirengroup	org
@christybibi	human
@sugarjunction	org
@aloap2012	human
@jcruanop	human
@gakudaidai	human
@SimoneHameister	human
@ILoveBali4ever	human
@Hoshnasi	human
@PrincesRisa	human
@TucuAlex	human
@Anie_Amir	human
@jrwalters	org
@Reggiee_SWAGG	unknown
@NarimanMakeup	human
@cyu888	human
@Bsteak_grill	human
@LaChatr	human
@SWcrucialitySW	unknown
@radiometricx	human
@ohMYKcutiepie	human
@PeggyJohnson7	human
@slawsa	org
@Jessicaramelos	org
@Pbaskyte	human
@FriedaNIKI	human
@CasaManita	org
@aquinoallan	human
@CrowningGifts	unknown
@CicchettiMcr	org
@vinasatisfies	human
@Tech_Sharer	org
@AlexGritts	human
@youngjimster	org
@VonzellSolomon	human
@popinopka	human
@mojamonsteress	unknown
@MrAyeDee	human
@dhiin	human
@bot18166545	unknown
@SignoraWare	org
@MiccosukeeR_G	human
@Maila_Hoshi	human
@LulaSalvatore	human
@Petspoint1	human
@clarystaline	human
@Mikuru_Hirai	org
@bikramglow	org
@Binghams_PA	human
@floridayogis	org
@_GabrielaReyes_	unknown
@IvanTeo_GB	human
@MattmanM	human
@tjignacio	human
@NHafawati	org
@AvantSeine	org
@racheldjukic	human
@inspira	human
@StefanyJahed	unknown
@ashlyferg	human
@Tuxy369	human
@KubilaySakarya	human
@amnareza071611	human
@CatheJackson	human
@gen00ful	human
@lerikaavseeva	human
@StefSnider	human
@FanG_Kiz	human
@yummscrum	unknown
@indaaindi	human
@HENRILEWORM	org
@control_rod	human
@gabotengohambre	unknown
@l2Dea	human
@VlnVldz	human
@mrjobright	org
@happymayk	human
@VillageButcher1	org
@ale_antares	human
@sonomahouston	org
@Lynsey_Udy86	human
@JuvyJewels	unknown
@tugcebeste	human
@cecidesignworld	human
@Jess1995x	unknown
@ParasJules	unknown
@Cameron_200694	human
@XiiaoKitty98	unknown
@WineCrew	org
@asakusa_hostel	org
@riofransiscus	org
@ladylujewels	human
@millanwar	human
@themadorange	human
@Sc_LvS	human
@JINGWENx	human
@Tuism	human
@marksahagun	human
@MissGoNuts	org
@HinderGareth	human
@heartykitchen	unknown
@Bitany1989	human
@007rebs	human
@Gingermommy	human
@beckeeeee	human
@marcerolon	human
@RuSoNu	org
@WanHo73	human
@NikkiBeachStTro	human
@roseganzon	human
@adinavlad	org
@belvederecafe	human
@CaroleCcochrane	human
@kvicroy	human
@Kassiani_cheir	human
@GeniiGeniiGenii	human
@im_kharia	human
@Walsh11Della	human
@thegreenfisch	human
@JmztAwesome	unknown
@TripSaversClub	human
@SelvaArr95	human
@luisficarpediem	human
@zarni_htet	human
@LHMKALAR	human
@alisonong	unknown
@belimov	human
@ladycherrycake	human
@sezerberkant	human
@camoooon87	human
@cyprusbiz	org
@Dinalisha	human
@Coco_Sometimes	human
@BocaLocaPR	org
@FindLawLP	human
@mika_qiao	human
@Wicked_Temple	org
@Stephanus_SNR	org
@Eatsporkjew	org
@MrJaimeRuiz	human
@justsayheyrey	human
@ForeverPainting	human
@TheSituation_R	org
@M_Patoula	human
@ramosxxvii	unknown
@Jiamin921	human
@LPQNY	org
@arsheenlovesyg	human
@pow_45	human
@coldtexan1	human
@joyNyu	human
@g_panozzo	human
@ontomywardrobe	human
@EileneMACHINE	human
@TheVEatery	human
@freshhN_	human
@marzkristine	org
@iamfififriendly	human
@tripsSYDNEY	unknown
@LoriODay	human
@adathakkar	human
@GS3973	human
@trataapp	human
@TavernaFtWorth	org
@hushcoffee	org
@AdvocateALGH	org
@jisod	human
@pixiebattleship	human
@DJS_Education	human
@mattlynhamphoto	human
@Emzzyy96	org
@ceha911	human
@RecipeRighter	human
@ohoherik	human
@CarletonDining	human
@R1CarvajaL	org
@CatalinaTang	org
@vivian_tenorio	human
@ManateeSP	unknown
@lacomidanais	org
@jannisswerman	human
@kalico357	human
@FrenchCrea_HK	human
@FoodCabbie	human
@WestinAbuDhabi	human
@singleserving	human
@findrahuljain	human
@sorachichi	human
@renanbarco	human
@libraryalehouse	org
@Ayuchii	org
@RawVeganQueen_	human
@mozelladesigns	human
@noydi18	human
@SomasraySoma	human
@AnaPeraltaDelR	human
@fumikato21	human
@PaesanosSA	org
@The_Conqueress	human
@StreetTreatsWa	human
@MihciMira	human
@agandik	human
@TheHangingBrain	human
@liviahasegawa	human
@sadamtweety	human
@butterflytassy	human
@DJWHAT	human
@eaaaa__	unknown
@maya_nehme	org
@LouCoons	unknown
@facktwiter	human
@ImTheOne04	human
@goegori	human
@AMEC10	human
@Sodamnlovelyx3	human
@Bronwyn_UTS	human
@AqeelAbdulreda	human
@HiramTheodore	unknown
@FourFlintHill	org
@MeatballRoomFL	human
@kristinedeala18	human
@xjellyxpiex	human
@lmttrr	org
@MyrkaCamacho	org
@MichaelColpean	human
@JaredRonis	human
@robert_lui	human
@OnceUponStorage	human
@iamLhen_II	human
@emmz_s	human
@finessekitchen	human
@boutique4child	org
@DSAndino	org
@leo_zhop	human
@isaevane	human
@alosiriany	human
@willis32100	org
@funny_image1	unknown
@NatsCunningham	human
@LoudrickMP	human
@Sicnis	human
@JenLuvsReviews	human
@ChefRicci	human
@rachaeldickhute	human
@Shelikeslace	human
@LeeMacGregorPR	human
@KcKvon	human
@gcpawelec	human
@AnnabelJZ	human
@Granite_CentInn	org
@iamstillKarlie	human
@lindseydholland	human
@Kelly_Love_com	human
@ewnassar	human
@msforbes500	human
@JerwelDePerio	human
@WillDRoberts	human
@reveenvert	human
@TheHeronNY	org
@irfanpabaney	org
@hviewfarms	org
@laughing_attack	human
@visekrunao	human
@claalpz_	unknown
@Amaze_Gracie	unknown
@Cocositalian	org
@liucheche	unknown
@tjoemusic	human
@freddyakl	human
@interra_arqteca	org
@theseemasarkar	human
@Awkward_Guitar	human
@SantaMonica2Day	human
@Ricardoowlw	org
@ElTaco2D	org
@Charmed_Jhess	human
@burtmay	human
@i_am_nyao	human
@ayunchan46	human
@chutneyoverrice	unknown
@k8mercs	human
@SzBarbie_	human
@AlchemyEgypt	org
@mayocoyo	org
@copperpkitchen	human
@Yuda_Galis	human
@CloriZardi	human
@capital_choice	org
@GdGlcarm1	human
@AirbrushDAISUKE	human
@Haleycairo	human
@AnnaAm79	human
@FiREiCEBoston	human
@rizale	human
@DombeyaWine	org
@SAVORnatural	org
@Ch4mWow	human
@TheFatManDiary	human
@Smuuurfette	human
@blonde_traveler	human
@rememberedtales	org
@HitzAlex	human
@MiezaAbdRahman	unknown
@faisal_shooter	human
@unspoken_aaron	human
@ManuelaCremer	human
@MabsBabs	org
@RackhouseWW	org
@JCMulaSanchez	human
@PellaGrey	unknown
@Ankitchomal	human
@Mich1gan_fAn	human
@AnyaTrent	human
@miaodou1	org
@saniaskitchen	human
@nielizm	human
@TheSammidc	human
@jawanalfadel	human
@BigbossMarina	human
@NayalyaRussia	human
@PanicoCristiano	human
@whitgetitwhit	human
@lovesuitung	human
@VaishnaviSavant	human
@medictom	human
@cheese_grill	org
@MattOPhotograph	human
@Delaware_DHSS	human
@Traumagirl69	human
@zoltandulac	human
@Lezzang	unknown
@MarnusBotha8	org
@BreslowPartners	org
@beachbumm7879	human
@amusenj	org
@BrunchBiddies	org
@DFuschia	org
@Okuma1014	human
@ChampionsYacht	human
@TheAcornWarrior	human
@MKPUSA	org
@CatbCafe	human
@youngblood_jo	human
@LewisShine	human
@abi_short	unknown
@juliesourisa	unknown
@qatarday	human
@Noufaljurais	human
@ukoptimist	human
@illusionsmadras	org
@wifeyyoung	human
@emilyoyoung	human
@dyaluo7_m8lol	unknown
@Pantreze	org
@PorcupineThe	org
@MichigoID	org
@cleaneatingandi	human
@ikarezza	human
@ChrissPap	human
@debbierae9	human
@kgodaigafd	human
@spsellshouses	human
@AStyleDbyBanke	human
@ALittletouchofC	org
@CavemanDietsRvw	org
@dad_youtube	human
@ginggell	human
@EUROPABRISTOL	org
@HughHammersley	org
@hippiemodelchic	human
@kogdisagads	human
@Superica	human
@AlixPompidou	human
@GisselleAristy	unknown
@dana_huskova	human
@TravelLaughLove	human
@JNRadio1	human
@diostardumpling	human
@Delahayef55	human
@ChararatNoMore	human
@ULalum06	human
@foxy_1882	human
@_BeardedChef_	human
@IlluminatiTaco	org
@rizqibochil	human
@MsOriginalMills	unknown
@Lilli_Bit	human
@angelinebailey	human
@RWygand	human
@ogsDpogs	human
@alexkhemical	human
@yuup_1966	human
@lollip0pkittie	human
@romanhavel	human
@Samusart	human
@SylviaTan04	human
@nanasalbri	unknown
@puterietasha	human
@solene_ulrich	human
@CPSLNYC	org
@IntoGlamWrexham	human
@Plumsterbunny	human
@MARISADICICCO	human
@evon_nana	human
@forsythparkinn	org
@gobindvashdev	human
@IndeBlueNJ	human
@kozak_judy	human
@BenADamnFool	human
@hodori_la	org
@ihaitian_	unknown
@SnapChatUsersUK	human
@renorunks	human
@kevinpinguk	unknown
@berty2001	human
@Joseph_Amos	human
@NinoScoma	human
@TomDeeCee	human
@DianeKarell	human
@ShAwNa_MaYe	org
@r8rvc	unknown
@deathlydarklord	org
@FourEyesVal	unknown
@famigami	org
@xavie22	human
@BuenosParaTi	human
@HEB_mexico	human
@TeensTurnGreen	unknown
@_missdv_	human
@survivalsite	org
@i_sssa	human
@Ysonut	org
@B2B_strategy	org
@Glasgowfoodgeek	human
@CommunitOurs	human
@db3Bolton	org
@Khakhaii22	unknown
@Farm_Network	org
@marroccoshove	org
@BargerAutry	unknown
@cheriacherra	human
@_eternityhope	unknown
@Laura_Landscape	human
@grill_go	org
@iTFactorAgency	org
@bethannyputri	human
@OperaBarSydney	org
@tacapii	human
@drCarillo	human
@shin20709	unknown
@DaStormy	human
@grayle	human
@mattdewitt	human
@chefbradmiller	human
@TuckersOnTrack	org
@Subway_BC	org
@shalikaa	human
@kmmetzger	unknown
@neropietzky	human
@BBLaPetitePrune	org
@EatMyGranola	human
@PeggyVDW	human
@claudiamagas	unknown
@nakedeating	org
@Craftinomicon	human
@beautynbullets	org
@eTuesdays	human
@trishakarla	org
@JennMedina92	unknown
@kaili086	human
@bottie_	org
@HighLodgeSS	org
@EnggYousuf	human
@GreggyKrueger	human
@VanessaMolina15	human
@LadyLilloth	human
@theskinnybib	org
@Samykomo	human
@taxisvw	human
@CoryPaulMartin	human
@dariobt	human
@IronHillWC	org
@doranekoya	unknown
@abrhollister08	human
@Restaurant1539	human
@LaurenAgiusxx	human
@talktovic	human
@ken662004	human
@LeMeridienPune	org
@_iTammy	human
@micorjune	human
@AmaniBarKitchen	human
@Browns_Hotel	org
@ibPMS247	human
@Fabien_Nguyen	human
@32augusts	org
@renaechizen	human
@BronCoreFitness	org
@mooshfruit	org
@dieyAnnAmin	human
@OctavioMdr	unknown
@TaaDixon	human
@falloguzman	org
@LAMuscle	human
@SweetyPieSummer	org
@Funkstir84	human
@emsontheroad	human
@7oh7oh	unknown
@masalasomtum	unknown
@wuxizyselucory	unknown
@AliathonVillage	org
@EmeraldRoss12	human
@iAmKristoffe	human
@anime_oe92r	unknown
@CordenGemma	unknown
@grappledapp	human
@silvertigo	human
@FoundationRoom	org
@JoshuaCrespo	human
@putrinurnadia	human
@SimonJOwen	human
@OCTOPIZZO	org
@lelly___	human
@mia_spice	human
@ureverydayfish	org
@koalaghana	org
@lorena_villalon	human
@kingsnake172	human
@notthattame	human
@pkitchenstories	org
@gee_ca	human
@Nicholai_Suzuki	human
@GPT_Magana	human
@arbiliciousness	human
@JolieE1928687	human
@QinYingisMe	org
@walkandhog	org
@AlbionsOven	unknown
@BintKhana	org
@dillidikudii	human
@NattyFu	human
@gemmmy1	human
@cc_schi	unknown
@MrFeiTangYuan	unknown
@JohnnieCabral	human
@DetikaDwiPutri	org
@healthyplanet	org
@erewhonorganic	org
@fizakamarudin	unknown
@Ledelse_as	unknown
@kailibisson	human
@AyumiZachery	human
@osciantonio	human
@Super_HZY	human
@Merry_Bunny	human
@AaronActivat	human
@GourmetFoodES	human
@paolostella	human
@BetBelieveFit	human
@SwichItUp	org
@RomanWayHotel	org
@CopperCellar	org
@MamasSecretTwit	org
@CAllaire22	human
@ilia_7402	human
@EmmanuelleM06	human
@shannonbryana	human
@stzness	unknown
@ValdezCandice	human
@JakielMirka	human
@tamara_massey	human
@lexygarforth	org
@MatchPubLangley	org
@iKoodi	unknown
@SookiePark	human
@susantiaristiya	human
@Chamik013	human
@NickoIzzo	human
@_ellnisaa	unknown
@sndramatel	human
@DJMister_C	human
@redstorm_suave	human
@ElainesCM	org
@GreenRebelResto	org
@ashb0i	human
@shenella4	unknown
@Samantha_M725	human
@JillieBeanBaby	human
@nabihahd	human
@KaanapaliMaui	human
@planetofgori	human
@hashpune	org
@allysaluna	unknown
@CitizensVegas	org
@ThisIsSloane	human
@Monica_Peach	unknown
@HippoChiisu	human
@redbricktown	org
@CallMeJhera	human
@landoflove20	human
@sawatzky	human
@Johnlamb79	human
@__KayM__	human
@SueInge	human
@OUATEmmaSwan	human
@Ekadisorn	human
@me_too	human
@brunchmewhiston	org
@Quellheurestil1	org
@11esc	org
@SadieLosAngeles	human
@ReallySEENatIUP	human
@Lamarie85	human
@MimiShanz	human
@LauraDS_91	human
@itsmeGT08	human
@crimsonlawyer	human
@sandyessex	human
@RirinRiiin	org
@ArmaniAquaHK	org
@Reedus_AnA	org
@Bricklanecork	human
@LovelyDutchie	human
@sakooo___	unknown
@TacoDelMarShore	human
@3rdAlarm69	unknown
@iheartmiami305	human
@titiekoktaviany	human
@like_a_boss_914	human
@tlee351	human
@djacobharris	human
@AuntyEz194	human
@TheThreeOaksGX	org
@DNM_Mia_Bars	org
@hEaL_mi	human
@DaniThomas	human
@CoppiBelfast	org
@aoifeduffy96	human
@SUE_412	human
@BarunSobtiRTs	human
@LitaStarr	org
@JustineChanRD	org
@dzekkho	human
@DaniielDD	human
@Cantwitts	human
@serenademysoul	human
@Tuba_mtn	human
@yelplondon	human
@EndolyneJoes	org
@PhilipsDees	unknown
@simple8job	human
@djeloy	human
@homemade	org
@RealMrsElias	human
@vesma	human
@SuburbanMomClub	human
@troodis	human
@honeylotusroom	human
@craftycoinblog	human
@mshelenna	human
@dbBistroMiami	org
@blanqeada9	unknown
@abruzzo4foodies	human
@KurobutaLondon	human
@CeallaighO	human
@garlicrocks	org
@lotteduncan	human
@lilwhitekitchen	human
@BelleCampagne	human
@chiumonster	human
@PicsNFlics	org
@TheDanaLaVoix	human
@AmicusAppleAbdn	human
@TheGuildfordMag	org
@TheMalingRoom	org
@ayyy_31	human
@jemalak	human
@FamChildTrust	org
@Qnitta	human
@DinkyKt	human
@Pjlikethis	human
@Ric_coba	human
@AmSongseree	human
@shun_reduction	human
@ritchiemakeup	org
@MJCRAZE1	human
@ashgosu	human
@cintraerick	human
@thegeekykittyx	human
@TomsFarms	human
@cerealsensation	human
@myPelham	human
@ovg84	human
@ELMENEO	human
@karinakarina2	human
@hectorsmariscos	org
@search8engine	human
@EvelynnMillingt	human
@gordyandpaula	human
@sabrinawst	human
@Jabulile_MM	human
@ScoffersKitchen	org
@Luisa_fernandas	human
@wordofmouseza	human
@StreetKingsGFT	org
@NickRoza	org
@louise_sk	human
@NesmithMcmichae	unknown
@oung302	human
@ftbletsas	org
@Sabrosia	human
@jessthrock	human
@Sy_Brighton	unknown
@HawaiisBestBars	org
@fiankidd	human
@aidaruna	human
@_x_chihi_x_	human
@zambuni	org
@JFKRetweet	org
@JolijnPelgrum	human
@PocongGenit	human
@DanielT81305153	human
@fitinthemiddle	org
@in_adaz	human
@Trina__D	human
@OwlThistlePub	human
@nanalurvekiki	human
@CPHGoodFood	org
@monamielamode	human
@tashglynn	human
@JumalaTuoni	human
@adibahnoor	human
@smaddhi	human
@camisanchezL	human
@Buythisbox	human
@ShadiyahLim	human
@JessicaGraceW	human
@betsysoncorner	org
@DarioGriffin	human
@thisizdrastic	human
@waretbenz	human
@NoirW1	org
@vickys_se	human
@iVaughnMack	org
@LynnConnor45	human
@TheBaronMAIN	human
@HHH_Dave	unknown
@stephannietandy	human
@casafuegousaque	human
@daughntolentino	unknown
@_traceyleigh	human
@caspar_jones	unknown
@Bricett1	human
@francissism	unknown
@eimaj_j	human
@mcan2	human
@yykyU	human
@tyronicwriter	human
@_eurekajeye	human
@stepgreco	unknown
@Ketvit	org
@ellynntheheels	org
@GetSmartWork	human
@loucookes	human
@thegabrielafano	human
@AndySimNY	unknown
@GastroBerni	human
@fineindianfood	org
@hiphealthychick	human
@GreenDivaMeg	human
@KatPChef	human
@bebsaragon24	human
@Aapili	human
@wahboy	human
@blacbutterflii	human
@iamthebran89	human
@bdcoffeehouse	org
@JBG_rio4	org
@Perzabaljr	org
@TomomiFilm	human
@RanggaSamiaji	human
@Bla_ckwell	human
@SafeeraSarjoo	human
@jaclynsy	unknown
@themrchild	human
@CarolynOrdonez	human
@Rocklisah	human
@justmimieating	human
@RoyaCafe	org
@Edin_Larder	unknown
@RecoPayne	human
@M1zzTammy	human
@nightnursejapan	human
@atrf3	org
@aribabaJ	human
@kii_nail	human
@NormaJeaneBaby	human
@ALEJA_STAR1	human
@denizberdn	human
@muktibaddri	human
@flojoeasydetox	human
@chaliangle	human
@Hudspecialisten	human
@morningswithjj	human
@TRUEhungry	human
@klyuen	human
@joanney79	unknown
@Dyamdoll	unknown
@andrewhpurcell	human
@LynneMcVeigh	human
@wawaisaac	human
@tsmoothieusa	unknown
@hapsarijayanti	human
@EatAtTapasAdela	org
@ryankopinsky	human
@DeekDuke	org
@eltonny24	unknown
@bone_raissa	human
@iwcauburn	org
@SmileAtMacy	human
@FargoVillage	org
@Superprincessjo	human
@SyamsulA_Smith	unknown
@JDu1986	human
@annetweeety	human
@PrncessTik	human
@nagesh_kintali	org
@MomSpark	human
@cococroxley	unknown
@VictorSanchez99	human
@Lot_FAnl	human
@LambruscoDays	unknown
@TheJeffreyMan	unknown
@RealGeekDad	human
@zazaAzmy	human
@thisisAerishxx	human
@kppetitmutu	human
@EloiseSGMueller	human
@sapphirezasset	human
@ankitajain0911	human
@ThaiSmileRM	org
@SmatharuPhotos	human
@we_are_x__	unknown
@AlishaHenrie	human
@julianar27	human
@VideoBinge	human
@ieatforfun	org
@Ambiershyll	human
@ViBE_ub_grape10	human
@chiachang1017	human
@SahaleSnacks	human
@JoeDuley	human
@eatQBBQ	human
@Raider_Moy	human
@Krystallee26	human
@IamNikkoJohn	human
@BayahSabran	human
@joelh90	org
@Shanmar	human
@Honggist	unknown
@CliCkNatasha	unknown
@elviiiux	unknown
@shariline	human
@iamalpha19	unknown
@earlsdenver	org
@KeeleyPowell	human
@Lupa_Osteria	org
@hyunne	human
@ResidenceInn	org
@_DeadlyDiva	human
@krissipos	unknown
@chefjonathanc	human
@Therealbosstalk	human
@ozm1lk	human
@niallradford	human
@XxAmyxPopxX	human
@sweet_honning	unknown
@JHOJUSA	human
@MandyGiltjes	human
@flute528	unknown
@yanvil	human
@ROSHY_BLESSED	human
@amarfoto	human
@AnthonyTaccetta	human
@TuttyTobia	human
@JoylimJX	human
@NavneetBrar_nav	org
@junebahe	human
@Holsie	org
@lorhamer	human
@jmunsta	human
@moeblacGA	human
@RoxTremblay26	human
@EvaBayer	human
@Liapaws	human
@misspikkumyy	human
@prettyLush13	human
@FairfieldHotels	org
@JAZZ_SHOESDANCE	human
@trixileaxx	human
@jboogribs	human
@jeangrei24	human
@kindcarer	human
@leahsheps	unknown
@haruka176	human
@klutzbakery	unknown
@Vitoko__	human
@gail_dizon	org
@sarainemacaraeg	human
@reginachow_sg	human
@alfieyuan_	human
@darkdjinn53	human
@Stanford9810	unknown
@USHGNYC	org
@xxREMILEYxx	unknown
@TiborHamori	human
@thedarkestred	human
@HenzLim	human
@Bestlaminate	human
@emoria	human
@noorakma_my	unknown
@Alexis_laney	human
@guaranastore	human
@pattiphillips	org
@FocacciaFiorent	org
@gossipshionista	human
@NiaPeter	human
@blaze420711	human
@soontobewebb	human
@independntLeeds	human
@crazygamecock	human
@ggsbistrolaguna	human
@eMazingMountPro	human
@miammiamyum	human
@KedsHasenfus	human
@Ezra1608	human
@RyanGabbart	human
@MalaysiaWales	unknown
@Cititourcom	human
@rbolton_88	human
@loadstodote	human
@CoreMotivation	org
@whatnowandwhy	unknown
@demistelly	human
@The_Wolf_Of_WV	human
@PureandSimple89	human
@NasrulKami	org
@VicInnSparks	org
@Sazingg	org
@ninjinloves	unknown
@cityMladyP	org
@Lunchesby1HM2	unknown
@mercedeztwm16	human
@hadi_hagemaru	unknown
@KaraMulder	human
@androideer69	human
@kiretoce	human
@rendyysp	human
@prankstr_8	human
@KrolaCastellano	human
@Ascotlounge	org
@violet_rose_1	human
@BellyNBao	org
@Laomatik	org
@klumziekel	human
@dinacheyko	unknown
@Shantifairy	human
@NatashaBedward	human
@TheHenleyHouse	org
@grace_liuu	human
@sweluhu	org
@miltongferraz	human
@kel_hk22	human
@Skinny_Chan	human
@debra_1390	org
@elainlee92	human
@wenzii0410	unknown
@RaymondTan1987	human
@GMontato	org
@manueven	human
@MyBeautifulAir	human
@DjFroggyUnltd	unknown
@elleninsideyt	human
@WeAreRajasthan	org
@LisaBuckley15	human
@ChasinDreams_12	human
@Loveselfme	human
@ojyarujyaru	org
@ishtar413	human
@KatieLeeKitchen	human
@liveooapp	org
@tana_hrncirik	human
@amberdesiree_	human
@GoodwayRumCakes	org
@TheAdamSamuel	human
@_housedecoridea	human
@atticuscc04	human
@TracyStuder	human
@AMPatryn	human
@AllBlogBot	org
@orangedoorfood	unknown
@LEANONME89	human
@SandraFoster99	unknown
@Thapanee_Ice	human
@HerCupofJoy	human
@foodiestimes	org
@hapili_merid718	human
@Elkeknight15	org
@ticroixr	human
@nourishingblog	org
@AnnaArtalejo	human
@ShayCostello	org
@AYSLIN1	human
@chefrohitlobo	human
@MaudSoenen	human
@IshaNaidu38	human
@creekandcave	org
@vonnievoo	human
@Foreverjackie86	human
@GianlucaCapedri	human
@EmilieHornGrans	unknown
@StreetSeekerDJs	org
@nadinaboun	human
@LoveMarty	human
@iam_djMYTH	human
@MellSquare_UK	org
@KerryannWray	human
@TheFReporter	human
@AnnaSolenn	human
@TheCricketersBN	org
@seaofsavings	human
@franc3sca_marie	human
@kaatlady	human
@sastett	human
@perringrim	human
@ashllyd	human
@bobbiejesslim	human
@poojaraval	human
@iStyle4Life	human
@ektapratee	unknown
@bighatbadazz	org
@AwesomeForever	human
@unclassified03	human
@Papi_Cholo	human
@westendbargrill	org
@MariaAlbizu	human
@plakiassuites	human
@zippy0218	unknown
@ToastSinclair86	org
@urbanduniya	human
@DSevial	unknown
@Oddess_DaAuthor	human
@to_like4	unknown
@Paco_Belle	human
@doublestarss	human
@AntoniosRusso	human
@ewekeyyy	unknown
@acang_jayrea	human
@adrianbryceee	human
@bendedthumb	human
@NinosTuscany	human
@VoglCarina	human
@ArhErn	unknown
@lovesadores	org
@karencarla	human
@WhiteGirl_Jen	human
@Vannicelli	human
@lexerden	human
@EllisHale	human
@food_advisor	human
@KanKunSauce	human
@steve_dahlberg	human
@Fish_Brain07	human
@dione_4	human
@mzknowitallnc	human
@LambtonMall	org
@billewoodruff	human
@St_Satan_	unknown
@flourbakerycafe	human
@priyakorn1991	human
@LifestyleMommy1	org
@vazimjsm	human
@lacuccina_Hbay	org
@RhodaHamblin	unknown
@KEN_Chee_Ming	human
@WanderlustAndCo	human
@smoke_frog	human
@peterpanbistro	org
@rhibutler	human
@Mhat0823	org
@NotSoBigL	human
@sugonja	human
@GabiMoonlight	unknown
@JeffreyDBlair17	human
@AnaMatnadze	org
@YvanhaChirinos	human
@B_R_E_N_T_S_O_N	org
@AndreaBisso	human
@ASaglietti	org
@masa528	org
@BelgaSF	human
@mundolasvegas	org
@Britishette	human
@royalgardenjuhu	human
@varbiro	human
@theginghamowl	human
@CanadianPaleo	human
@niravvithalani	human
@__michika	human
@adam_drexlerLA	human
@HeatherAddley	human
@pastelhearts	human
@adriankhall	human
@jenwildcat	human
@CollegeFm	org
@ABar_Lounge	org
@jhonadts	human
@Onerena	human
@man9	human
@NaWeed666	human
@Megalicious_7	human
@dmrfinefoods	human
@perezerika_19	human
@CeciliaLealRmz	human
@DJSuperDuke	human
@Psycho_vm	human
@SomyaKhandelwa8	unknown
@seetfei	human
@StessyGava	human
@musicsoulfood	human
@EiyzZee	human
@Wine_PR_HK	org
@dthomas5467	human
@SutjiGunter	human
@prophet4lyrics	human
@ShamrockBurgers	org
@margadesme	human
@Soshi9	org
@aangelicamj	human
@Alialina_	human
@BollerWoman	unknown
@AlyssaBoo1214	unknown
@werto2013	org
@EvingelC	human
@ONEmidtown	org
@PATRICKMOLLOYS	org
@toddlonger	human
@idleavenue	human
@Gull3s	human
@thegoarocks	org
@andricsnori	human
@sliteligeeki	human
@GFBartender	org
@jenn_eugenio	unknown
@garnishandglaze	human
@AmericanVienna	human
@arlenembrowne	human
@MyBabyStuff	human
@shivashobeiry	human
@KatiCollins2012	human
@jr_chica	human
@citybug	human
@DawnCullo	human
@JoyNaba	human
@j8kubochan03	human
@Loba_Miami	org
@jessicaxo	human
@80sshoulderpads	unknown
@Tiiik_taak	human
@enencraziis	human
@DianeSophis	human
@SamanthaJ19	unknown
@marielseyer	human
@guMMy_G	unknown
@EmmaJaneKenyon	human
@recreationlunch	human
@viganunu	human
@rominapiccin	human
@BrasByMonica	human
@7DAYSUAE	org
@TuuZyA	human
@akr_27	human
@JbyMorimoto	unknown
@jajajanelli25	human
@nannannnn	human
@Hemels033	org
@EYSELATARY33	unknown
@TamaraMainardi	unknown
@paulcochrane	human
@Rahvaunia	human
@prettywandamae	unknown
@BfBrekkie	org
@Giuliarg18	human
@StephAmethyst	org
@ispyclothing	human
@Neida3love	human
@campbellandsyme	human
@LBarDoc	human
@CancunModda	human
@jewels_beyond	org
@MaxHeadblog	human
@Panda4ka	human
@HealthNutAsh	unknown
@aoMmiieZe	human
@mishiechau	human
@TheCutleryComm	org
@sajroskok	human
@jamesatienza	human
@MeInTheBalance	human
@_ShutTheChellUp	human
@saadasaeed	human
@FunkySoulDJ	org
@SurfingandBeer	human
@little1one1	human
@kitchenconsult_	human
@RealLiliWhite	human
@charmyann	org
@author_jeff	org
@Manutd_ultimate	human
@littlemsyolo	human
@narminbakarova	unknown
@rachzworld	human
@BambooNutra	human
@RajKamo	human
@OnlyCarrera	human
@nourish_nestle	org
@pinktrebleclefs	human
@A_AlBaDDaH	human
@agargmd	org
@kareenkhai	human
@Crazy_Old_Mee	human
@RoseydaDiva	human
@shivasingh	human
@FrenchChefWife	human
@duckydynamo	human
@PeacefulPaleo	human
@backroadsrebel	org
@YesseNat	human
@gemmanixon	org
@hdv_bristol	org
@UAlbertaELS	human
@Recifoto	human
@UsherAnn	human
@reiaxreia	human
@MiCasa_Home	org
@Live_Expert	human
@P1ppiLotta	unknown
@AmyTaraKoch	human
@KamrenTt	org
@4LuversOnly	unknown
@leniencymemo	human
@tryagainjess	unknown
@NICKIPILAPS	human
@anastasiamossxo	human
@whoismabel	human
@brodienero	human
@kyrieelayne	unknown
@IamAntonoir	human
@NLPaisa	human
@Jasmeanzxzx	human
@theycallmemayo	human
@Ben_Ward	human
@NaidellyneS	human
@krt_eee	human
@JemilouRazon	org
@beergkamp	human
@Merrie_NY	org
@nataliejadore	human
@L_A_Allen	unknown
@GeorgiaReeses	human
@AnnaSimpsonNYC	human
@diegozuccari	human
@IssyMunya	unknown
@AcousticsPro1	human
@Dani_Borgen	human
@meatmaiden	org
@MelBeachbody	human
@MadelineL89	unknown
@Ming_Shuo	human
@marcezpd	human
@its__mae	human
@LeannRox	unknown
@AnaFerOrtiz	human
@Mizz_sisHa	org
@MindySegal	org
@LOQUILLOPANAMA	human
@GannaDunn	human
@GetRealPresents	unknown
@BarlinFitness	human
@noemelia	human
@sakaiminami1	human
@TonyMinaj_69	human
@ClauCarolina4	unknown
@ChefMehmetGok	human
@PEAKEOFCATERING	human
@karina_moy	org
@jwell_trah	unknown
@Crazihova1	org
@BrandonBoat	human
@YunitaKwok	human
@Pazzaluna_	org
@keane_z24	unknown
@BellaLife	org
@openrice_id	org
@EdwinHendroS	human
@qdnugraha	human
@sandhmoments	org
@kimerrisme	human
@Katerina_pesch	human
@OrangeFoto	human
@cherubinisydney	org
@AvantGardeLady	unknown
@ebautista32	human
@HiltonQuito	human
@vhankhyle	human
@fadoseattle	org
@jamesbriscione	human
@HamodySamman	human
@elsa_apriliant	human
@NeighborYoga	human
@frenchyfoody	org
@Dumboy88	human
@HelloRoosters	org
@Macdonald_Watt	human
@sebasrequena	human
@man_crush	human
@diaDentista	human
@cookingbaker	human
@misslissa2	human
@MissaDisGeek	human
@IAM_ARSON	org
@StorySpirit4U	org
@jesspolizzotti	unknown
@mayu_88	human
@djdefine	human
@stylebypenelope	human
@craig_chef	human
@NourishedInc	unknown
@troberge	human
@oshin_aifitria	unknown
@EverlynONG	human
@JeronimoMaMa	human
@iqbal0612	human
@WitherspoonGril	org
@dreday83m	human
@Monbonn22	human
@Katra1507	org
@GabbinGalErin	human
@NicoleD78	unknown
@jamiearies	human
@jollydemon	human
@Sichinya	unknown
@kiekycomowt	human
@riccardo_pinna	human
@cherriecywu	unknown
@elenapelmus	human
@kimblahbie	human
@beautybymissl	human
@zalikhakamsin	human
@abelheywoodnq	org
@Zorro303	human
@PhoenyxFlower	human
@Ari02cute83	unknown
@CassOwaryE	human
@styleetcdotnet	human
@enforma_fitness	human
@abdiegojr	human
@APBTLuvrr	human
@bananawoman21	human
@HannahMarieMay	unknown
@BorsariFoods	human
@new_dwiva	org
@beckycharms	human
@PandoraBreakfst	human
@shnyvinn	human
@pmihnl	human
@Reese_global	human
@fujiway	human
@27toLifeblog	unknown
@MilenaMayorga	human
@AnuarWinchester	human
@brigstowlounge	unknown
@HeidiTown	human
@Esmasespecial	human
@Heart1049FM	human
@jameswjb	human
@DaddyFit	human
@IAmMsPrissy	human
@xLineBine	human
@LaughChat_	human
@DAPILJATIM01RI	human
@miyaarissa	human
@jediabicus	org
@ElleEnterprise	unknown
@eranatyler	human
@Beebeechichi	human
@cookiaiodifrank	human
@bishopkingston	org
@macholu	human
@WooedByTheFood	org
@MelanzLanie	human
@sharonmhfung	human
@Vaibhav_Gera	human
@The_Lauryn	human
@sashavaughan	org
@Cinders0	human
@RegineCosmo	human
@symphony_sk0707	human
@Topazrat	human
@taniasalavessa	unknown
@xxsunshine16xx	org
@REYNALondon	org
@eggwhisk	human
@ramaal83	human
@DavidCoulthard	unknown
@candyhella	human
@greenjaydeep	human
@sqfontanilla	human
@Aloraifan	org
@Jophet_R2K	org
@uhmayzinginez	human
@Beteavon2015	human
@NataliaDucati	human
@eatdrinkdress	human
@mrandmecomic	human
@pointof_care	org
@RaffyPekson	human
@YTCB72	human
@yoshikiori	human
@wirlystirly	org
@carolnidaho	human
@pidaypot	human
@sixinchstiletto	human
@gelatotips	human
@whynotcoffeenyc	human
@AmazingWorldNew	human
@iamjpmansueto	unknown
@DanielaDamico	human
@ifanyjakiz	unknown
@WinnieRottem	human
@Miamathilde	human
@greatzootweets	human
@amelie_tan	human
@CrystalgWorld	human
@BabisKarampelas	human
@readreadyes	unknown
@cpsteakny	human
@CastelbuonoOrg	human
@jesilva1222	human
@Phillipslounge	org
@Sabby_BE	human
@Shtrumpf	org
@MilanoOsteria	human
@CentralDTyeg	org
@CGarXtraWavy	human
@manylito08	human
@hammertrend	unknown
@helen_phan	human
@NeuvooMarAtl	org
@maikoo_5	unknown
@LiamNewtommen	human
@Misslootjegirl	human
@StvarUkusars	human
@Surfergirl080	human
@yluiyap	org
@shengpot28	unknown
@nickfday	human
@ashleehalifax	human
@DinoKouyialis	human
@mybeautifulcity	human
@CharliesCambs	org
@wanna_fork	human
@iamtalandz	human
@Drudge_Report_	org
@ras38	human
@704shannon	human
@Orpington1st	org
@annaclosas	human
@Jill_Cousin	human
@victorialalala	human
@gugudayooo	human
@GaynorRamsden	human
@tortoiselove	unknown
@PatrickCarter26	human
@Ora_Home	human
@WeAreMumbai	human
@hopjacks	human
@TheLifestylista	org
@CarolWhitaker23	human
@sectionofstyle	human
@realewan	human
@MrsALOMartin	human
@BiteBuff	human
@elkinia	human
@pureBCHblog	human
@BettyVBrown	human
@marcomezafansaz	human
@TheMarinaKing	unknown
@hotel1898	org
@EllasFlowerBskt	human
@213Nightlife	unknown
@sunny5666	unknown
@ChefBlairKing	human
@JBG_cpaz	human
@ntgravity	org
@ElevenNightclub	org
@ShawieMagtoto	human
@cigdemm_guvenc	unknown
@ConcordvilleInn	org
@fafa_mj	human
@amirulikhsan	human
@Jacqueline_x3_	human
@Ricardo_Edwards	human
@TheStableHouse	org
@stockbakery	org
@elennnne	human
@brianleecalledo	human
@WolfeCityHS	human
@kidsareatrip	human
@Wally_84	human
@Nick_A_Jones23	unknown
@deepagoyal	human
@hungryxpat	human
@valecatte	human
@JavierVachiano1	human
@Brenton_Gowland	human
@WhoaBella	human
@PeterAlexandrov	human
@SmoothPayApp	human
@FashionFlats	human
@PYTDaiDai	human
@relishbistro	org
@miamidolfan1	human
@naseemakhtarfb	human
@Jeannyindabotte	human
@lowfatchick	unknown
@harrietjeggy	human
@AJLagar	org
@GMFincaCortesin	org
@NeliHoward	human
@OlaPiprek	human
@ChefChitra	org
@bubble_pinkz	human
@nendol	human
@Oztog	human
@DannieHarvley	human
@kier323	human
@ElleAyEsse	human
@Chef_Jorel	human
@ALifeofSi	human
@tygabia	human
@CinnamonCulture	org
@1WithTheFlow	human
@majaorganista	human
@chasingaplate	human
@mrs_jacksparrow	human
@o___mayu	human
@ddesperado_gal	human
@asimplebag	human
@LichMyTorres	human
@16_tennis	human
@pruitt_title	human
@ryan_j23	human
@CopperSlay	human
@kurumi_nu1119	unknown
@MyWellbeingNZ	unknown
@iamcekii	human
@CorinthiaPalace	org
@actionjacquelyn	human
@MadonnaJansons	org
@AnimalOsaurous	human
@ShuqiYeoh	unknown
@hanamaru_na	human
@jmartha27	human
@VinceAvendano	org
@Ms_Sam29	human
@RE_NAVIGATE	human
@lilalindarella	human
@syedfaizalnoh	human
@bartendervin	org
@le_garage	human
@lilacpop	human
@RedLionUAB	org
@anitanj21	human
@ChorltonGB	org
@MichelleLunaB	human
@giftcardgranny	human
@boat_eggz	human
@JayneBubble	human
@eljeanko	human
@libertymadison	human
@jure_z1	human
@Tisa_dpbe	unknown
@dbeattieSCG	org
@Somerset_grille	human
@CateringRus	human
@Andichaud	human
@pure_pots	human
@NicoleSilke	unknown
@MayassaAH	human
@IndyGirl87	human
@yummyGFpamcakes	human
@sky22oct	unknown
@JamiesKGP	org
@yourchainess	unknown
@wadapho	org
@visualcindy	human
@leboutique3	org
@StreetFoodTue	org
@javaman74	human
@MyMenuPal	org
@mikkoadamos	human
@LNSalvatierra	unknown
@JenisAuthority	human
@EverydayEricaK	human
@sniff_sniff	human
@EasternRoyalHK	human
@RafaelEnrike18	human
@LaKeithaS	unknown
@echychyqueen	human
@JPWallace3	human
@joey_yzr	human
@SOdunukwe	human
@RIZKY_AHMAD	human
@AmandaBrookes30	unknown
@Dsolano78	org
@filipaabeato	human
@MsLadyA69	human
@AGeekyLink	org
@kiara_lecce	org
@alexiluu	human
@mattpenko	human
@styleAndyrios	human
@MOTHERMOUTH1	human
@MovenpickBidaa	human
@cyrillesimard	human
@lilleydreams	human
@becahart	human
@PorridgeCafe	org
@Nizc_Eizam	unknown
@NehaMihirJoshi	human
@RazorSharp2012	org
@chrisjohnsquez	human
@ExjamexjawZaria	human
@obechi_5	human
@PeachDishATL	org
@LBlytheMiller	human
@ehsandelahan	human
@slimdownsmart	human
@0324gyell	human
@Sasstainable	human
@mariondwight	human
@jaurique	org
@N_alaleeli	human
@fook_yew	org
@LexieLoz	unknown
@PhoenixBristol	human
@bodacious_b1	human
@NatalieJRomero	human
@eb4prez	human
@BBD2Tulsa	org
@Merendi	human
@ginorocks	human
@CMTavernBowl	org
@luca_15apples	org
@FindUrBalance	human
@Trumpybar	org
@1874AntBarberia	human
@claireparsley16	human
@chunghee_hee	human
@saidilulu	human
@dekoraman	human
@ashleahalpern	human
@MissBeeFoods	org
@Dot1541	human
@BaronPowderKeg	human
@CatarinaCalient	human
@LaMesaDeFreddo	human
@NasroolAnhar	human
@thisiscarmil	human
@patbalzan	org
@megg0101	human
@Slow_Roasted	org
@MCLinHK	human
@carolina_ji	human
@cameliaputriID	human
@TheatreCPT	org
@catarinavarao	human
@SW_Brereton	human
@ShadyLaneBlog	human
@Elphie_11	human
@MoraymaMSquared	human
@BrownsIslington	unknown
@KarenWeeWatch	unknown
@fashionblypetit	org
@andythom1122	unknown
@WorldTruthTV	human
@rizaliskandar	human
@JahanTheMANAGER	human
@ChateauBromont	human
@YanaBroganMoore	human
@bobosburgers	org
@MissLisaDubai	human
@MCEnglishDope	org
@BrooklynCWB	human
@Drink_Network	human
@gsaucemarijosep	human
@KahunaHawaii	human
@snapturtles	human
@Zumba_Bean	human
@goldfinchscout	org
@Misssyvivian	human
@SuzukiAyaArch	unknown
@__vivalavida___	human
@samstarfish	human
@RickyDeYcaza	human
@hrk1581	human
@HEZWAGARCIA	human
@decoraddict	org
@jmksyd	human
@Paulapora	human
@Holmesjerry598	org
@SebasSebaSeb	unknown
@penrosesquare	human
@TCLeather	org
@davidnicky07	human
@KushitesC	org
@HotDocsTV	unknown
@Currywithlove	human
@blu_skye84	human
@anieverthen	human
@tommochappers	human
@HimCzarshaw	human
@BalbierBrides	human
@edwardbaida	human
@OrganicsBahrain	org
@hyperjulia	human
@misoooora	human
@Valerotti	human
@AdrianJayH	human
@tonyscafe21	org
@Dan_Ibarcena	human
@SuperGokuBoi	human
@HablaBiendeACA	human
@taconautas	human
@OrchardTeaRoom	human
@Talitahkum	unknown
@Diana90Sh	human
@speccnazkooo	human
@icyummi	human
@migsy70	human
@junoondubai	org
@NatachaGuerra_	human
@sofiaguedes	unknown
@RioClarkKent	human
@sinembkisa	unknown
@kimsfoodblog	org
@Nomadatme	human
@theglobaltrip	org
@Lilou00	human
@luanselmo	human
@adLzXiaoFei	org
@sandraborraz	human
@ilenena	human
@Rey_D_Nova	human
@charlieizwild	human
@asuchaan27	human
@CrushMGM	org
@supersonic_stu	unknown
@mii__xxx	human
@DineChiTV	unknown
@willaymerich	human
@sagola55	human
@Burger_Code	human
@Kayie_VB	human
@3kinSaid_3777	unknown
@Olivia_kun	human
@downtowncdga	org
@DivaGlam	org
@SoniaKhiara	human
@DAT_BOI_LUCKY16	unknown
@KatharineRene	human
@iitsVee	org
@leighannaudet	human
@em_david	human
@MartinezPaulaOk	unknown
@catfoodldn	org
@Cubanito110285	human
@IContinental	org
@aR_05	org
@jahsuneroll	human
@coolmoqoo	human
@MexicaRoots	unknown
@fernand63417975	unknown
@sandraPo3three	human
@Noosiekins	human
@FaalahElla	org
@JParks90	org
@ModernCafePgh	org
@StevenYoon	human
@Sevi214	human
@LlilaVis	human
@Swifties_Cat	human
@anahutchcraft	human
@TTbyMichele	org
@almoknifradj	human
@DeltaCalgarySth	org
@itsmehabs	org
@ScarletOakDC	human
@leblogdenarcisa	human
@pricelessfanny	human
@taniasamad	human
@Dorset_vegan	org
@LoanLegalHelp	org
@GloryGugu	human
@ellenchristine	org
@computerbird	human
@followericgould	human
@hattyruff	human
@PennyBex	human
@vrtshingo	unknown
@Hanadores	human
@fgafaerie	human
@KabarEkonomi	human
@StephanieWrig11	human
@Christi40955030	org
@sara_gore	human
@pinklovermuch	human
@lizhamedina	human
@KrissysCorner	unknown
@peilanku	human
@Kat_D_Watson	human
@nelCentro	org
@PiaPiamarie009	human
@IAm_Kris10	human
@TheBigRuss77	human
@jackrossesq	human
@mack_didthat	org
@elephant1934	org
@itzlunalee	human
@blueagavebalto	org
@SeishinArT	human
@itsd0llface	unknown
@B_Alyousif	human
@Tritordeum	org
@ilseandvirginia	human
@swapnme	human
@aradhna_jill	human
@foreverinmymind	unknown
@CaityShannon	human
@sandija_ss	human
@BloggersOfCebu	unknown
@yourhappyfit	human
@DoryDeli	human
@DishGourmetCafe	org
@BrokeAssTrips	human
@GrahamesGourmet	org
@PKSInggris	org
@MiouTw	human
@UBUpurefood	human
@lustigodernicht	human
@itssGIP	human
@Docs_WC	unknown
@AnnaDanielsANut	unknown
@Msromyadamson	unknown
@ViBE_ub_berry10	human
@lianna_lim	human
@mtrabocchi	human
@Groovy_Toon	org
@HatCreekBurgers	org
@Bongeka_QB	org
@20valveKH	org
@farahjalikha	human
@H24Impact	human
@jyotishonline	human
@iM_muZik	human
@irishmktdirect	human
@hartattack386	human
@TheTofuDiaries	human
@LeviMoriarty	human
@aurorameyer	human
@androidgirl	human
@beyondur1st	org
@TBriamonte	human
@arahufanda	human
@BabaRizal	human
@BBCentersofStL	human
@zuga6603	human
@cellardoor_ed	org
@Jthomsonphoto	human
@dsrerds	unknown
@kamieshakee	human
@Fray674	human
@BeauteByHunny	human
@ntespi7m	human
@Dizzy_le	human
@rhino_ryanotto	human
@godsgiftformen	human
@mcnb1979	human
@geretkoper	org
@Tiakko	human
@stockholmdeli	human
@Stylnoxe	human
@EasyPeasyEats	org
@canityo	org
@AlixGidney	human
@gusjournalist	human
@Sukhdevuppal	unknown
@itsdebbieee	human
@princesstweety	org
@ThatsARalph	human
@03Jangles	org
@heechelle10	human
@eagleislandbc	human
@campus_tec	org
@MKMMA5	human
@TheNewsLounge	human
@NylahsCakes	human
@kbfamily6	human
@casacoccole	human
@Miles2Gether	human
@logan_prong	human
@AdamGShake	human
@p27_junchan	human
@exodus1999	human
@juanadotcom	human
@TriposoSeoul	human
@monkeywand	human
@chikitatiaraque	unknown
@Chef_Eniko	human
@amandalaurel92	human
@Andy_AVFC_Hanna	human
@livingfitly	human
@im_Me_im_Mal	human
@eefphotography	human
@ayuyu33	human
@ABlackTV	human
@SuperAlissa04	unknown
@imaginetito	human
@FaizuraZulkifli	human
@muslzroom	unknown
@katiefrobinson	human
@SpinZilla21	org
@dccell	unknown
@LuigiFrajese	human
@haziqyul	unknown
@Chef_DR	human
@_mieraaaa	unknown
@tracylr233	human
@CucinaconStile	org
@NicoliStudios	unknown
@atozfoodrecipes	org
@MagicNick13RXx	human
@kassvtr	human
@mredwardperry	human
@NazrilHakim	human
@bhoppenow	human
@_ayaNow	unknown
@SocialCapitol	org
@sylvamp	unknown
@WebMD	org
@Ainhoamm19	human
@TravelPanties	human
@ToyoGarber	human
@craig_runner	human
@iamceseh	human
@steveandandys	org
@WoodruffDeseree	human
@SurfsideRealty	org
@alfonsogalnares	human
@suksanhunsa	human
@elinh942	human
@ezelbayraktar94	unknown
@chrisrhall	human
@LilCoookie	human
@Mangia_NYC	org
@LeniseLigon	human
@umbesan	human
@georgeworst	human
@Majoahhh	human
@AWCavs	human
@POCZineProject	org
@speechdebelle	human
@KoivuDesign	human
@mobilepadawan	human
@SharondaNicole_	unknown
@monskiesolasjr	human
@challahatyagrls	unknown
@FlopoDeSanti_	org
@Gallardinis25	human
@nikhat_shahin	unknown
@mishylove	human
@MRLUSTIN	human
@CHEC_M8	org
@suzanneemery	unknown
@misscoldheartx3	human
@omnomwithrob	human
@Flawberries	org
@FlyingPanTampa	org
@Danielle_214	human
@DennisLiotta	org
@AntikaAnis	org
@Jewell411	human
@boogiedowndiva	human
@theoprince	human
@gangwella88	human
@DashaPiletskaya	human
@MSiry	human
@YleniaNea	human
@mamani_	human
@YudoSiahainenia	human
@MamuThai	org
@moeeex37	unknown
@AnaStee19484959	human
@Welikefoodblog	human
@bnodg	human
@TheWinerist	org
@DelmonicoSteak	human
@DiarySocialGal	human
@mint_on_mars	human
@jtipx2	human
@ReelCarina	human
@LegendManCool	org
@Ch0co9	unknown
@SensuousPromos	org
@NoraWahid	human
@zpizza	org
@TheLiquidChef	org
@Beautifulfunful	human
@arybarkah	human
@JoieWrites	org
@Kaliente510	org
@JuanLuckan	human
@cepii_selfi	human
@Elena_Golikova	unknown
@IgnoreUrTweets	human
@MrSteve08	human
@ProudlyMrs	human
@AchromaticBlog	human
@ShowYouFood	unknown
@CashzMemon	unknown
@SharonKinMY	human
@IamNico17	human
@domlloyd1	human
@KitcheyTweets	org
@LaViePure	human
@alexavjane	human
@Khareen0421	human
@asueba	human
@BarboraGabor	human
@SUPERNUNU	human
@RemiRamcharan	human
@missmewiththat1	human
@LaSerenataLA	human
@TheMeanFatGuy	human
@HI_Rochester	human
@design131988me	human
@4Ever_Chocolate	human
@ForzaLand_ID	human
@FoxandMint	human
@DinoDino92	human
@iineesf	unknown
@Love_LONDON_M	human
@Real_Fitrition	org
@honduras_com	org
@MusicCutie03	unknown
@JazzFigue	human
@FBCafe	org
@JuniperBramhall	human
@chesapeakestn	org
@Ahampton84	human
@ItsCheapAsh	unknown
@misskarisma	unknown
@FoodAndFam	org
@alextriesitout	human
@ashleyqdavis	org
@s_louw	human
@OhMyKneeSigh	unknown
@lhi_ngo	human
@shane_o_neill	org
@Paloma_Goleta	org
@Cooljonskie	human
@YocoEatery	org
@ThaBigHit	human
@ZeeCaffrey	unknown
@CdHendren	human
@neenu_sajin	human
@vagabonded	unknown
@NYBagel12550	org
@chefjsouza	human
@faister21	human
@camille_ruffy	human
@thewolfstl	org
@Taydolashes	human
@chiftf_wabvan	org
@alcalaCB	human
@SweetpeaPantry	org
@Brian_GoBlue	human
@HeartAddictYup	human
@KevinFlandez	human
@AshleyUK99	human
@Ehrnholm	human
@Chris_tian_to	human
@justkirkus	human
@thisismrlee	human
@itsCinziaC	human
@hottopic1	human
@MadjidBychkov	human
@no_obligations	human
@KTCHNnyc	org
@canele_la	org
@nami_namio	human
@FabFrug	org
@chefchrisoh	org
@MeehansPubHouse	org
@naaatan_620	unknown
@nikkkaye	human
@robertore62	human
@ChipELF	human
@IsabelChu520	human
@jnalewicki	human
@dinewellhere	org
@husage	human
@FizzyParty	human
@MColimodio	human
@nadegetoronto	org
@eccobella	human
@guidoflavio	human
@afiqnazar1993	org
@Bi_Grrrl_1	unknown
@Emilylosesit	unknown
@kahuyu_aki	human
@aynsavoy	human
@chuntotam	human
@DrLynneKenney	human
@femmefood	org
@TheFifthInc	org
@summaiyahhyder	human
@Kingzslayer	human
@nonaluppi	human
@lecrona	human
@clevermelody	org
@IramRasool123	org
@JOBodyRoots	org
@afjpv	unknown
@CMarieMatos	human
@beauty_and_sass	unknown
@LauraRunsVegan	unknown
@Sirjosef22	human
@GBFGUIDE	org
@mherzonzai	human
@XmasatCottrell	org
@GabryForty	human
@YoMonteolivo	org
@DIOSA_ARIANA	human
@lucyhelenamu	human
@endahadian_	unknown
@V3L	human
@Caasey_x	human
@XaviMaldo	human
@IvanTai0728	unknown
@BeadzStudio	org
@LizMancao	unknown
@mhessen6	human
@hagis32	human
@dorijeloficial	org
@ElVinoRestauran	human
@BarristersSTL	org
@annyss_houri	human
@ShannonInLodi	human
@FollowbackPearl	unknown
@EvaNiedzwiedz	human
@fenderlyn	human
@Alvii_Obrien	human
@makkyan33	unknown
@dferrazza	human
@IdeaFS	org
@iamsuperjammm	human
@heavenlybusines	human
@cavinaguilar	unknown
@bythecellardoor	human
@WisconsinMommy	human
@kokotartz	human
@AndreaBScott	human
@dogsofinsta	human
@JuliaMuseva	unknown
@elriomarket	human
@Lemonandtahini	human
@azmir_almunawer	human
@LidNath	human
@petersereno	human
@miriah84	human
@kleek	human
@anshrnabautsta	human
@LittleBuddha87	human
@sasayacafe	org
@EllisFun	human
@angelinespongy	unknown
@ChefDPort	human
@ScottsFolsom	org
@ChefGigiCalvo	human
@MizzCupcake17	human
@mscrowdedcloset	unknown
@JmeIsTheOne	human
@VanessaMcGrady	human
@UCBMedia	org
@flong1992	human
@zehrayman	human
@CaravanKabob	org
@yoga4fun	unknown
@GreenTreeGrocer	org
@ginababyXXX	human
@YoghurtLemon	human
@MadeAtRGU	org
@iamnewest	human
@cpsj	org
@fastpacedfoodie	human
@MomsLoveCars	org
@AshleyJaftha	human
@yuanitalukito	human
@elliot_girl	human
@RMNutrition	human
@StephanieLaVoz	human
@BostonFoodDiary	org
@STOCkTONBOSSESS	org
@Apathetic_Zoro	org
@BIGR3DMADSEN	human
@herbergtplein	org
@Jonesfitness34	human
@nhoii08	unknown
@staybasicblog	human
@SOHOTACO	org
@pink3_x	human
@KneadHD	org
@IamK3niTo	org
@thackshaw	human
@CandaceGalan	human
@bsfam235	human
@7MichelleLynn	human
@Hot1047Maine	org
@NancyRafek	human
@ritaguijorge	human
@MimEdwards	human
@_infiniteloop	human
@claustrawberry	unknown
@Lenkun22Lenny	human
@myhealthylittle	org
@sandwichinngnv	org
@kaalomai	org
@Taylor_Morrison	org
@LittleBird3350	human
@luisvillacres	human
@FintecGroup	human
@VeeSheneva	human
@HaydenWright	human
@HonestTea	org
@wqueens7	human
@TayXiangJun	human
@elacreativa	human
@Helofashionista	human
@flicwren	human
@drtom808	org
@milagrosFHC	org
@southstreetdine	org
@RupertPHX	human
@lilcuz912	org
@NICK8TA	unknown
@ARTRestaurant	unknown
@CoachPSays	human
@megansayce	human
@thiarini26	human
@Simpsdj	human
@AnnieNee16	human
@DorsetFoodDrink	org
@sylvia_80	unknown
@CasknFlagon	org
@AlexisMathewsHM	org
@aremlizeth	human
@STYNG_1	human
@StyleHasNOsize	human
@S_and_R	human
@KyaraIzakaya	human
@Michael_Totten	human
@MontalvansSales	org
@ENVYMETEE2	human
@BFourchette	org
@NikkiRobinson91	human
@mshabaz	human
@milNewmarket	org
@Selina_Hotwani	unknown
@bldove	human
@Smartticus	org
@JasonStokesBEK	human
@Tina_Selomitha	human
@PaulBisCELEB	human
@miraclethaa	human
@cecileremington	org
@somethingsonoma	org
@Highmark	org
@RedCoffeeShop	unknown
@KingsRowPub	human
@Circlesthai	org
@fashionotesblog	human
@Morgana_RedAxe	human
@KEdwinFritz	human
@tazrooney	human
@HoneyMonsterUK	human
@LeneRushy	human
@chloecsy	human
@fazirulsafwan	org
@khalilkhan80	human
@Cherrycola_87_x	human
@furgersen7	human
@chriswilson235	human
@FabricFrames	org
@JWMuskoka	org
@weathermanmyers	human
@_ath3na	human
@smashleychantal	human
@Daneeboni	org
@shbunny	human
@PerfectPizzaPor	org
@DillonBaba	human
@_cmontano	human
@DiabloTacoLA	human
@MohdShahrizalmn	human
@theKitchenJC	human
@sebchu	human
@ririseptiana	human
@uh_lees_nicole	human
@shmm5145	human
@TilesWineBar	org
@falconhamada_90	human
@chome007	human
@mylifetakeiteas	human
@VickieAleem	unknown
@SWBallyfermot	org
@JessicaLuce	human
@NewHorizonMS	human
@NWFollowers	org
@CoreyOnTV	human
@ChefKevWinston	human
@RandyLeeCW	human
@CrispinHaskins	human
@castleoaks	org
@corsicarchi	human
@JuliannePonan	human
@141Aisha	org
@kayokokoswim	org
@Jepp_03	human
@mielhoneydew	human
@ShaunaBickley	human
@MsTywie	unknown
@fireflygrill	org
@rjufiar	human
@kareenparker	unknown
@RacerGracie	unknown
@horsedoovers	human
@SensiblySara	human
@aiiSsaRachiida	unknown
@damlaakoroglu	human
@QuekVanessa	human
@RubyDW	human
@PizzeriaEspiri1	org
@AlwaysMusic5	human
@TiffanyGonzo1	unknown
@TasteNtheCity	human
@SASSY_Jolli	unknown
@IANAR15	human
@weitai0904	human
@PICBritt	human
@barcadestmarks	human
@0810LISA	unknown
@C_est_la_vie_84	human
@BrittGastineau	human
@trattoriainwood	org
@DONZAIOFFICIAL1	human
@TransporterTom	unknown
@TinaPaymaster	human
@leadeSign1	human
@TheBirdandBear	org
@NatureJunkieMI	org
@Hartanto_Nadya	unknown
@Smiling_Sin	human
@AbiPearn	org
@charity_ellen	human
@QT_janIce	human
@NancyvonRanzow	human
@enamelsign_etsy	human
@Nissy_1211	human
@beer8428	human
@azukolokoy	human
@Zancorr	human
@erickperez83	human
@megha_shrestha	human
@thiscrazybitchh	human
@SgCarrol	unknown
@lincolnmanutai	human
@karalydonRD	human
@iwandharmaz	unknown
@Ma_ayco	org
@pzapjot	human
@KacperSMU	org
@lim2frogil	human
@Gas_mark_seven	human
@HudsonClearwatr	human
@MatthewsYard	org
@jennytay88	human
@ABCCenterDeli	org
@jqwaldron	human
@20sumthinblog	unknown
@amkaendless111	unknown
@nwstobsession	unknown
@MadDonnas	human
@quinciple	org
@deeatmosudiro	human
@Celina_Chua	human
@imtresleches	human
@scdlifestyle	org
@CircoLounge	human
@simonmodau	human
@alex_jones_auth	org
@blooowww	human
@pasarmalamny	org
@Vetty1Ross	human
@YourrelaxSpa	org
@LotusFineFoods	org
@MSEnthusiast	human
@NatashaNadd	human
@AlandeKlein	unknown
@OoNaztyoO	human
@sugaraunts	human
@KimMease	human
@Rebecca_Homan	human
@lernersabrina	human
@thearminaxd	unknown
@welfera	human
@brookinii	human
@Foodsforfitness	org
@couponcutting	human
@Richard_Chevy	org
@LadyDearie	org
@dapuriga_kotwis	human
@ItRBeingNadine	human
@LeopardnLipStck	org
@Mlle_valerie_	human
@Kinoo	human
@proDJSONYA	human
@LynchRisa	org
@NinaKrzemiska	unknown
@ozcanbatmaz	human
@RissOnThis	human
@tephlon_don3	human
@PohsanBaoBao	human
@SuziSteffen	human
@ShadiaAhmed_	human
@mizdebab87	unknown
@sana__ahuja	human
@ukyba_ek	org
@HuguesFerriere	human
@te9ramori	unknown
@SaadMuhammed	human
@BrazenFoxNYC	org
@cxlily438	human
@parkinnmanc	org
@moe_bardi	human
@BonPlanUrbain	human
@dennissilvio	human
@rainbowcoatedme	human
@kacangmagik	human
@hannamodig	human
@GoOutHongKong	unknown
@aifeelsyukran	unknown
@NutrStripped	org
@ThePhoody	human
@ida4_	human
@LolaShaDiamond	unknown
@L0tusFl0wer	human
@fitnutuae	org
@jorgeemartell	human
@OysterHotels	org
@KnifeDallas	human
@johnbokin2	human
@SnackFixation	human
@parveensheik28	human
@LaGioB	human
@VernandoVerdi17	human
@lhenz0619	human
@thefoodiecoach	org
@DeanDumbrill	org
@teenakristina	org
@mylifeismystyll	human
@ZuceShinigami	unknown
@rye_espina04	human
@aloeforever4you	human
@UrbanBrunch	human
@herstylishways	human
@JariKultalahti	human
@inesdaconceicao	unknown
@Jshj_94	human
@HerWickedSmile	human
@inne_saiko	human
@DIGIMIXCAST	org
@Canaan_Farm	human
@LeunamDirdam	human
@LoveLunchLoveU	org
@dirtydeedsmusic	unknown
@jamesjswanson	human
@DeeDustin11	org
@Amanda_S_Flute	human
@FireMaiden15	unknown
@steph_sikorski	human
@davidliz25	human
@berniceanneona	human
@ShewithLynch	human
@SharlaEversman	human
@oliviadelfert	unknown
@naturallytescha	human
@Effisteapot	org
@LuvLyWyd	human
@Melle_Bikini	human
@azobinukunoda	human
@readyStefGo	human
@BistroLawn	human
@NoeliaSouza	human
@jinnijascinda	human
@My3girls66	human
@RobieC1	human
@vanessamcrone	human
@bcn_collection	human
@EdenFalls13	human
@Marifer2404	human
@GhitaJonesChgo	org
@emybeau	unknown
@Gary_Duff	org
@reinardalvarez	human
@McKenna_1444	org
@110Grill	human
@janicejohannes	human
@benedekcseke	human
@velynlovesyou	unknown
@im_alinz	human
@DarkroomSN1	human
@EmmaRoseHurst	human
@LGGifts	org
@Alberto_L_F	human
@paul1957burrows	human
@JEmilioPerez	human
@Thatnigga_STORM	human
@quddbsrltk	human
@fred62	org
@iamShieshi	human
@Mahmood4dtph	org
@aneliesonline	human
@IeqaHazih	human
@thefishesoxford	org
@RousseauAgnes	human
@agigil	human
@MinchiTsurugi	human
@NorFarahynn_ain	human
@Arneworldtravel	human
@PazJosephine	unknown
@SeymourFordLinc	org
@zavsfitness	org
@SombraMK	org
@Fabio_Tisti	unknown
@Jigster101	human
@ElLobo0815	human
@Erhogg	human
@MrPianomanBB	human
@anedulanto	unknown
@TrovatosDue	org
@anjagreszik	human
@thescbrooks	human
@L_RoseSmith	human
@CoolhunterDiary	human
@sunsetbagels5th	org
@leopriotti	human
@1377624485	human
@CardanBar	org
@YSS_Magazine	human
@agaldamezjr	human
@cookinbklyn	org
@ChefLWilliams	human
@DeepFriedFruit	human
@4evaLoyal_T	human
@GhyrelDR28	human
@CaleyRose	human
@Calestleong	human
@HallsOfScotland	human
@MexicaliCocina	org
@lifeOholic	human
@theformatgirl	unknown
@karl_paust	human
@chibirashika	human
@bergnbk	org
@TaurusB1970	human
@HashtagDbn	org
@NarboroughL	human
@fercorreacede	unknown
@GettiO69	org
@RRivera6	human
@velocityher	human
@foodiefetemag	human
@orangeccane	org
@UnguChentaa	unknown
@JOHNJIZZLE	human
@iamsassysammy	unknown
@Cloud_of_Heaven	unknown
@aFoodbox	org
@Morphlives	human
@BGBLindsay	human
@JendisJournal	human
@michelleshea	human
@smarttrike	unknown
@Simplythai_Thai	org
@Parodossy	unknown
@fiory_salim	human
@FinePork	human
@aungthurahtay	human
@ItsRamboRay	human
@angies0908	human
@nonchalantsxm	unknown
@BarMikla	human
@DL8788	human
@Prinsipemoko	human
@Itsmejoyeee	human
@BlackbirdEC	org
@MindlessMeaMea	human
@rossella8103	human
@veronicnegroni	org
@mermaid_noir	human
@RT_sorteos	human
@itsolivialane	human
@MistyConnelly_	human
@cansotigue	human
@My_Vintage_Look	human
@sayo1118	human
@Dutch_Yvi	human
@JuilConnect	unknown
@info_courtyard	org
@143ehraldvamp	human
@TweetUTYNITY	human
@NicoleABowden	human
@NJilling	human
@ArturPalace	human
@Fightinglupus	human
@HTMMeringue	human
@FQDadsMag	human
@theswanwetherby	org
@lilyandpeabody	human
@raulevaccaro	human
@maximegrantch	human
@CindaStathis	human
@suzumari	human
@mommyinsports	human
@Phill0285	unknown
@sagupom	human
@SweetCarolMU	human
@peninsulasion	human
@LetsStartup_MB	org
@QueenB_Tammy	human
@rika2xo	unknown
@littlebunter	org
@RonaldNg_	human
@pinklemonadeuk	human
@73angi	human
@prjewelers	human
@pawara19	human
@MechulPrens48	human
@mmagal09	human
@WYcain	human
@irunlikeagirl70	human
@KepoSBY	human
@alevefendioglu	human
@nu_tweeter	unknown
@Blasdetejas	org
@futurespace____	human
@295York	unknown
@sctvbirtday	unknown
@robingdfellow	human
@mralcomendras	human
@KOscar93	human
@eathosDublin	human
@MyTrainerGrant	human
@bugout116	human
@pignwhistle_2nd	human
@ChucksBurgerBar	org
@asnh3748	human
@harpoon_brewery	unknown
@ajohnwilk1	human
@AtlantaEatsTV	org
@milkmemoo	org
@ScribblingTaryn	human
@fidgetyfaye	human
@PinkBabesFede	org
@DaniColombara	human
@kevincible13	unknown
@robertbobochang	human
@BoxingCatering	human
@JumpOut_B	unknown
@foxxy1406	human
@si_chiau_ing	human
@KD_Nada_Mas	human
@Florals_corals	human
@jinksartfactory	human
@wbulletins	unknown
@LiaRenkes	human
@cheapskate2009	human
@SuShweYeeHtun	unknown
@susanpajaro	human
@unsdef	human
@Mrs_Ines	human
@migerbasi	human
@Jacki_Mo	human
@gingagma	org
@iloveeloiza	human
@CrookshanksArt	human
@thefoodfixer	org
@stylusdevice	human
@wkmt_2220	human
@MusicMarlonski	human
@FatiimaSoria	unknown
@KaitWinthers	human
@Yushandesign	human
@ktmtownsend	human
@VegyPower	org
@lindalkbs	unknown
@iamJimCarlos	human
@Innoroutevents	human
@BirgitAarsman	human
@Greeniebearr	human
@KingMealz	human
@tbarahona62	human
@VirginiaRetweet	human
@GregGilla	human
@BerniniOrtensia	org
@joeltang1996	human
@SherbertDip	unknown
@preethi2082015	human
@AtlBarry	human
@Sheraton_Dream	unknown
@AleksAmparo	unknown
@AquariusLife4	unknown
@jaRIPtadabug11	human
@StephanieJay_UK	human
@pack_D	human
@a18angel16	unknown
@yukol7	org
@InTheMixLA_com	human
@ArchipelagoUK	human
@LornajaneCosign	human
@rafaeldavidpt	human
@LizDaBoss617	human
@CourtTheAwesome	human
@IL_FIORENTINO	org
@walkersarms	org
@Queenthetrainer	human
@SauceCulinary	human
@SaraMGeorge	human
@heeainbritain	human
@laughingspock	unknown
@elizziebeth	human
@KeepRunningAway	human
@mohdneotech	org
@FaizArman	human
@NaemiBe	human
@GIBNC	org
@scorpionrush	human
@krishydiwz	unknown
@anahita0810	human
@SinYanLiew	human
@DinaMarie21	human
@SU_deElla	human
@SnapDragonsLair	org
@SteveB_XXX_Star	human
@MarcoBianchiOff	human
@intoruth	human
@catrinastampa	org
@FJ_Berry	human
@NadiaPortillo	human
@stephaniem555	human
@Arrowe_	human
@ContinentalWEHO	org
@ragrafael	human
@EdgarArana	human
@Nad_iaa	human
@cheftpt	human
@DrDrupad	human
@chris7wm	human
@brucar_com	unknown
@nikkiskinnywrap	org
@zuuchini	org
@WorldNaturelle	org
@imyoursuperroxy	org
@Cody_Lee23	human
@featuredeatsnyc	org
@IamMrEpps	human
@xY1nGx	human
@itsmerachels	human
@TheDapperDad	human
@tiffdann69	human
@We3Crabs	org
@JekyllnHydesWpg	org
@irvingdecordova	human
@CrushCrave	org
@KaitOlivero	human
@Miichaelangelo	human
@3_R0ck83	human
@HeavenlyDiva34	unknown
@chawrelia	human
@mgruey	human
@NielsDaniel88	human
@cheflowe	org
@CycloneAnayas	org
@yarrow89	human
@Hayley1R	human
@TheGreekPinay	human
@AJsMeltdown	org
@OldCourseHotel	org
@MikeBallantyne	human
@peperonoona	human
@InterConSaigon	org
@iamPitman	human
@lvadvocate	unknown
@nozominabeshima	human
@SnapGirl93	human
@TDSDesignsNZ	human
@JAitkenMakeup	human
@CanadianMomEh	human
@RipitupGG	human
@brooklynwraps	human
@imesareapadilla	human
@loisleeliwei	human
@BilgenTufekli	unknown
@BetaKun	human
@bmthconnect	org
@HaiHai_Official	unknown
@bb_houser	human
@iRalph09	human
@jole_katty21	org
@chynablak16	human
@alisonaussie	unknown
@WisconsinCheese	org
@belever1982	unknown
@MurtenSaerbi	org
@Facetime09	human
@eztv_online	org
@bishop_glenda	org
@vanillad22	org
@varunmenghani	unknown
@BBCBagel	org
@Phoebe_Hielo	unknown
@missa_nyg	human
@RabbiBones	human
@rachelmadethis	human
@TantaChicago	org
@DawnZambito	human
@sharonleeinc	human
@imsophiaesteva	human
@ReleaseTheEvil	unknown
@nachgestern	human
@T_Danielle92	human
@dani_spumoni	unknown
@comimie	unknown
@christiecottage	org
@LeighOX4	human
@TessieART	human
@gina_wandaa	human
@delphinhotels	human
@Salma2684	human
@Sulaymanmazhar7	human
@JulietAnnLove	unknown
@DEREK04774603	human
@GiulianaLenzen	unknown
@BirchwoodCafe	org
@m00oodi	human
@yyemiii	unknown
@CLOUDSgastro	human
@NozSung_0912	human
@semsaD	human
@roach_chris	human
@travel_gaia	human
@rags211	human
@runitbymom	human
@CherieJ_MUA	human
@wiedywe	org
@PeachtreeRoadie	org
@jadevlorayes	human
@Bistro360	org
@CafeSpiaggia	org
@lilwylie	unknown
@ManjooGaithreer	human
@CookwithaBlog	org
@JoeyDiva	human
@MOM_FAM	unknown
@NeuvooStLouis	org
@ishmael03	unknown
@cynthiasntoso	human
@Acronilogic	unknown
@france44cheese	org
@SayWellness20	org
@TimHoltParadise	human
@BeBeChuLa	human
@YolandaDeng815	human
@itsmejanicem	human
@MissFytz	human
@jacques_leboeuf	human
@superKatKat	org
@twins_mk	human
@linching2	human
@sessaspecialcak	org
@PornGIFSXXX	human
@daryllefeuvre	org
@onique	human
@Calibred76	human
@traciebee	human
@quaker_tom	human
@thechefeddie	human
@jhoysie	unknown
@fionita74	human
@nokneetoe	human
@rssarma	human
@kaizercou	human
@diResika	human
@JydPaula	unknown
@laetitiaaaaab	human
@ChefPrizes	org
@PoleJimenezE09	human
@LeaCaulfield	human
@chaaah29	unknown
@G3Three	human
@Wereldmuseum	org
@nagaianna	unknown
@jenniferabragg	human
@sulaimansr1	human
@ForbesKristin	human
@OfficiallyJabir	human
@dnapa	org
@YashleyTriv	human
@RHBubbasBistro	org
@VeroGreen23	human
@Awesome_Roberts	human
@Yogurt4YouUSA	org
@IBDwife	unknown
@redmonkeymedia	org
@elekick78	human
@Bird2231	human
@FairmontJakarta	org
@chezsabrinas	human
@Crillie7	org
@Greekwineguy	human
@alehousekc	human
@agosswift	unknown
@amandaharsono	human
@Real_JakeAaron	human
@_la_lulu	human
@azman23h	unknown
@linxiaodong1	human
@rebecca_sol	human
@kaikaew99	human
@MrSaulCastillo	human
@kerrymckibbin	human
@lizanotabbasco	human
@Arianna_Trapani	human
@Raiders562	human
@FranciPopa	human
@L1TTLESHOP	org
@EarthFareGWood	org
@QueenMaevev2	human
@FusionFitnessGa	human
@FiestaMart	human
@hamclr	human
@Krisbot19	human
@BarthSaunder	unknown
@chef_grivera	human
@wilkey_richard	human
@eatlikemira1	human
@BurnetteNguyen	unknown
@santefitnessuk	human
@hobokenshavana	org
@simplycathi	human
@yoursjassim	human
@AwareCelina	unknown
@epoba16	org
@Alemajandra	org
@Maelings	human
@nonamutiri	human
@MitchellJayden	human
@Chegworthvalley	org
@KristyAbreu	human
@jessicawalker18	human
@Nickiebutterfly	org
@unifebry	human
@amtotalcoaching	org
@NJWineandBeer	org
@zkharmaz8	human
@BaliNutra	human
@mervekumsarr	org
@JenTrento	unknown
@lenatic	human
@Luckydragon88	unknown
@wardrobestories	human
@greggates	human
@uni_retno	org
@ImprovAthlete	human
@AndreaTchu	human
@leepex	human
@iAmDre1alliance	human
@FerdinandTan	human
@BBrittBrat1398	human
@wilmslowonline	org
@yann_nbtbmiami	human
@LuchoDeLeon	unknown
@iceCreaMIKAII	unknown
@nameiiee	unknown
@cookingCatrin	human
@minkminmi	human
@naroo76_x	human
@djdancortex	human
@NinaGray_	human
@supertonnyvan	human
@TownShipSnobz	human
@FlecksCoffee	org
@hitendrazala	human
@Velez_jenni	human
@LetsEatYall	org
@pilootdotcom	human
@Dr_edwinb	unknown
@KCrow64	human
@elchamo8426	human
@KatTCartwright	unknown
@Pandachan94	human
@ELBeav	human
@Carmelyta90	human
@Dj_irv562	human
@AngelicaZrta	human
@Naima_K	human
@jaimejr1989	unknown
@Frontierfood	org
@linecookbrown	human
@japshooter	unknown
@bloggerprincess	human
@AltadenaFM	org
@NeuvooClearwat	unknown
@flashfinger	human
@FreyMaggie	human
@soowabi	human
@pierosbirthday1	human
@Pohying1202	human
@cendra94	human
@puteridyana	unknown
@inxpot	org
@Jay3Jojo	human
@julssee	human
@Diamonsitiii	human
@eileen_leenda	human
@aassshhhh19	org
@GiantBabyYoo	human
@martinlo13	human
@UrbanGriddle	org
@bruskongkabayan	human
@ChutneyCutty	human
@DrEvaSelhub	human
@emilyjane_paul	human
@TL0w	org
@Gsotoart	human
@itsluluyousee	unknown
@patrimediolimon	human
@Emmalouise_92	human
@ASOS_Dani	unknown
@brendachance6	human
@fachriasmar	unknown
@riceparamour	human
@northeastvenue	human
@StevesGulf_com	human
@wc1507	human
@Ibroaim	human
@skysoprano	human
@mzhill1987	org
@FeedingOffRails	human
@stellar_boyd	human
@Swiss_Shisha	unknown
@ChunLinChu	human
@Lu_DelGiudice	human
@JrgRj	human
@ace7287	human
@PrettyMK	human
@bishopslanding	org
@FIMELAgirl	org
@FaulknJM	human
@IQueenHeartBoxx	human
@OilCheesey	human
@gradstudiemon	human
@hotachu_m	unknown
@danielaconte1	human
@CVapDiscoveries	org
@OmniVogue	human
@yovan_phoa	human
@MargaritaRibotV	human
@Simonemercuri0	human
@thegustavomunoz	human
@janchuca	human
@sgcatering	human
@grandhyattdxb	org
@NaturallyNora40	human
@mapgoblin	human
@MichAltamirano	human
@kittykatmead	human
@FavouriteThing	human
@rocker1987	human
@Wiwin_98	human
@CristopherMnds	human
@MteresaBlasco	human
@HappyBowWow	org
@Rall3nUntamed	human
@CookRDF	human
@OlaPuppet	human
@Duttijuice	human
@lesleywright14	human
@LaurenLeeOCo	human
@PicasoSwag	human
@Madroxie	human
@Sarah_Nearis	human
@CoKEYClothing	human
@pea1994	human
@wahidawahidi	human
@avstar_das	human
@LilyLuGT	human
@TikkaTikkaTaco	org
@G21BB_YGATROLL	human
@melaniegoh	unknown
@leahdunbar	human
@LaPosadaSF	human
@OdEmelyG	human
@SurviveThe9to5	org
@ladyhaly	human
@OneLittleVice	human
@HOUKICOMET	unknown
@ReinhardReren	human
@jjaminc	human
@philipdenys	human
@megloops	human
@TrinantiD	human
@sandrayaiza249	human
@BRONZEDJ3SIKA	human
@RBarKTown	human
@OwatariS	human
@ChoklitRae	unknown
@IlCentroVan	org
@thecaseyjt	human
@DiegoMLazo	org
@SarahOlson22	human
@tamilyn_tammi	human
@hillcreststjohn	human
@MatchPubNewWest	org
@DishesandBlooms	unknown
@FMDF_App_iTunes	unknown
@Lillymacmusic	unknown
@saralatower	human
@fitfoodcanada	human
@amtarots	human
@sanpopobiyori	human
@KingPurcey	human
@ThePoshList	human
@peepeecraze	human
@EriStormborn	human
@PabloGrippo	human
@weightloss_meal	human
@HollyLiveFox5DC	human
@mchldnrch	human
@mookowarmy	human
@touristmenu	org
@TopdrawFashionx	org
@RizaFirli	org
@IamFELIXthesix	human
@tettyyuniasih	human
@Telito	human
@nadiariis85	human
@tequilahazel	human
@SharonXiaoX	human
@Pohito	human
@Senthil_KumarM	unknown
@ratihramadhanii	unknown
@pal_rudebwoy	org
@WivenhoeHouse	org
@Dressupqueen	unknown
@katyt_pt	unknown
@chen0224	human
@amy_stults	human
@ChefMeganMitch	human
@wifeman	unknown
@pencilbox	human
@SexiKryss	org
@TheTeamBG	human
@little_billie	human
@CwrtBleddyn	org
@AsmaSamsudin	human
@chayreyes14	human
@nutty_nash	unknown
@CoffeeBarker	org
@daniella_deen	human
@Mark_Lewis_NYC	human
@FamMacchione	human
@UFO_is_a_Volute	unknown
@RunWineRelax	human
@Crystalbabyy_	human
@sujiskorea	org
@thetiafox	human
@DKAsso	human
@Rinrinrin0528	human
@Lisa_Mommyof3	unknown
@sanitamima	human
@RedRockOven	human
@thequinn92	human
@Gitsfood	org
@adelinasinohui	human
@OfficialCLS	human
@AWfoodcourt	org
@Charm2713	human
@NishaP2009	human
@LisaLoveHope	unknown
@Syerie	unknown
@skand_mansson	org
@RaffCovino	human
@natreeny	human
@roxannerobes	unknown
@DaniellaVance91	unknown
@mrcharlston	human
@MrPhilGreen	org
@cheftini	human
@AnnairaOruam	human
@DesTitsAndAss	human
@thehopefulchibi	unknown
@kcirdla	human
@GrdHyattDenver	org
@Kae_rye	human
@djfreako	unknown
@LoreLeal2010	org
@Leck_Bath_Kitc	org
@erinbakers	human
@46nascargirl	human
@acubaninlondon	org
@MexicoCantina	org
@DjAmpp	unknown
@BMONEY82	human
@homechannelsa	org
@makelovenotrawr	unknown
@FrancesHui	human
@Persian_FDN	human
@YagmurAdiguzel	human
@1WfoOy	human
@Camille9387	human
@PlaneandJane	human
@SorianoJoanna	unknown
@baby_naina	human
@PERCHLosAngeles	org
@amandakwoo	human
@hadillxo	human
@ShiouWenCheng	human
@g3ndh1s	human
@AysonJesica	human
@KellyTeasdale_	human
@JrAlhajj	human
@TheMilkofLove	org
@juiceman007	org
@rossyepetrova	human
@_LisaCherry	human
@MamaQueen1980	human
@blogdemarion	human
@skinnyordie	human
@sashaDN	human
@Conveythemoment	human
@charls_yong	human
@againstallgrain	org
@Cledenin	org
@sandra_BRG	human
@MsAnela	human
@Brettstar74	human
@ShaniexxLui	org
@8tracks	human
@AnabelaLeorne	human
@sarah861421	human
@rosemfallon	human
@FerAngel_	human
@HayMuchoNivel	org
@TaminaOx	human
@AnneSai08	human
@UrbanUsher	org
@DPartyIsHere	human
@yoheipenpen1220	human
@MirandaMillang	human
@SlickVic901	human
@cheerchrischan	human
@missPeanut_88	human
@tyomart	human
@ZHotelNY	human
@AminMien	human
@iamnotkenz	human
@LupieeChick	human
@ElysiaRD	human
@esraferhatbal	human
@blAK_nAtural	unknown
@MARSHALANDAR	human
@AHObsession	org
@aioliburgers	human
@VitalityKitch	org
@emfthomas	human
@VictoriaKnight_	unknown
@eauderoseqa	org
@rwindu	human
@tatitakoa	human
@MiahToot	unknown
@d_speare	unknown
@joeykennedy210	human
@garlandandrea	human
@Aeey_moo	human
@SPUDULIKEUK	org
@eltonwhybrow	human
@kawaiiiling	human
@AlpJob	human
@izumiyhang	human
@beanandhop	org
@moniqueislove	org
@Tahlia_M	human
@KENNYANDZIGGYS	human
@bubblymaria13	human
@Paintbox_Bistro	org
@francescanon28	unknown
@vijayashankara	human
@FitLivingFoodie	org
@nonsensicalady	human
@BEAUTY_IIAO	unknown
@AfifOzawa	human
@santobartez	human
@DulceVidaCafe	human
@JoelLJavier	human
@girltartanscarf	human
@Retweet_s3ody	human
@acajunincali	org
@ladykbuzz	human
@familyspice	org
@_LaurenLovely	unknown
@Hong1D	unknown
@ChikaMae	human
@ellie_sworld	unknown
@greenish_poison	human
@PWPantry	human
@RolandOuO	human
@dafiismailsabri	human
@PasaAniMonti	human
@tartufoevino	org
@CatabolicC	human
@_XoKH	human
@VenusV	human
@elena_thompson	human
@Viona_Halim	human
@danycarrie	human
@JDsWraps	human
@marta_tg_24	human
@Style_Roche	unknown
@SavoringToday	org
@mamaguru_com	human
@IMSQUEAKYMONROE	human
@danasdining	org
@CH1CKE	human
@theAJOran	human
@petermjonesy	human
@ChefAnika	org
@james_kerby	human
@CLOUTHIERJAMIE	human
@IjatAcap	human
@ateenaneey	org
@Coco_jhonathan	unknown
@sensualfoodie	org
@MOGmuzik	org
@BestofFL	org
@MiriRod	human
@BebeHunter123	unknown
@ProvidentNJ	org
@studioblueyoga	org
@risaman_	human
@slzanmai	human
@bucanevedoria	human
@juju_boublil	unknown
@Carly1985b	human
@iamkokomaru	human
@AllTheFoodies	org
@SBBrewWerks	org
@HappyHealthyDrm	human
@jlchf1290	org
@CatFerrier	org
@katpinke	human
@MahdiRashed	human
@BrendanPCotter	human
@licey33	human
@muto_sang	human
@rodneycarrasco	human
@saori_yokota	human
@iAmChaniie	human
@olanilomi	human
@mrcmi	human
@Kingskitchen01	org
@cassandralxh	unknown
@vickyryan85	human
@ZomoYang	org
@AmritM	org
@shetallbrazil	human
@Casly_Khoo	human
@Krzi4MuZiK	human
@AugustaDPZ	org
@camillebakes	unknown
@AngelCancio00	human
@Maggietrout	human
@adelazarito	human
@FEELFREESKIP	human
@ParkGrillMP	org
@NESHRIE	human
@FilterLDN	human
@ShiraishiYuriko	human
@theterytory	human
@a_y_u_m_i_n____	unknown
@Delia_pk	human
@ChristinaLasky	unknown
@cocinasenlinea	human
@Vjnash_1	human
@ScriblicalVibez	org
@mikiish	human
@TalbotCarlow	org
@ShitWhatsMyID	human
@southernspoor	human
@roy13a	human
@andreadz76	human
@chefkwill	human
@KristofferRoed	human
@Ibti21	human
@PinkRanger62	human
@SherlyMareta	human
@anayemeny_net	human
@CassTheTrainer	human
@always_an_4evr	unknown
@AndreiaAlmeid22	human
@lilytian	human
@Monique142_	human
@nopalize	org
@danny_daw	human
@ZayJules	human
@voiceofandrea	human
@miraayuaisyah	human
@FRESHCOURTFoods	org
@teru_blue	human
@HarveyCast	human
@ivi342	human
@GamdiCal	human
@KKfeasts	human
@StyHorLikTomYne	human
@GeorgiaaBruu	human
@NANDAKERR	human
@kazuchaman108	human
@Mille_lim	human
@JAY_Gonzaga	human
@ChrissysNaples	org
@r3d_bOnEz	human
@eduardorandom	human
@Forgedinlondon	org
@legendengage	org
@JesusEsDi	org
@Benny_Dayal	human
@DelRealFoods	org
@Queen_Dangerous	human
@Active_Sussex	human
@forgiveloveYJ	human
@kpoplove_x	org
@albertmbae	human
@TopJuiceAus	org
@sofetchBona	human
@TOGAambarita	human
@alyn0728	human
@jes_vipxxx	human
@MaaruDonoso	human
@zballe	human
@Chabbiey	human
@WellAndrea	human
@Joeaf4	org
@SparrowWatch	org
@evrios	human
@zriha	human
@carinakit	human
@stefoshea	human
@Hunger4Fitness	human
@robin_sturges	human
@MiniatureImpact	human
@HatimAbassi	human
@chosumo315	human
@EZScramble	human
@NdyStruggle	human
@Joel_Victoria	human
@rusticvegan	human
@mark_Bg	human
@Angelsis82	human
@karankhosla16	human
@jromanow	human
@felleoboy	human
@vipagan	human
@pieceofcerebrum	human
@tget1_v	org
@anonymusdonah	human
@CafeVSushi	org
@aizadgreat	human
@SouthportIrving	org
@OstrovskiyPavel	human
@MSKStern	human
@matfenhall	human
@KenLee63	human
@dashingagent1	unknown
@DIYFunIdeas	org
@SicnarF_	org
@getkidseating	human
@jennyquigley	human
@tasha1807	human
@YummyFoodGirl	unknown
@FMCGrand	human
@therealpert	human
@mili_spell	human
@girlichef	org
@jlmuniz	human
@Jove_MusiQ	human
@kaliwangkamay	human
@NCreationCoffee	org
@LidiaTinelli	human
@androidsupastar	human
@masahito_ouchi	human
@MTTP_Blog	unknown
@Kid_Moxie	human
@_Sternenkind	unknown
@kuhkuhkatie	human
@HikaRuii	human
@Cheffrey954	human
@demsangeles	human
@MJMCInstitutes	human
@SkinnySoiree	unknown
@sandycosta	human
@WirTestenAlltag	human
@Ninanco	org
@Nicholezion	unknown
@EdithHeinsen	human
@Elsmere_BBQ2013	org
@Ingvarda	org
@Tharun_Chiraag	human
@964thewave	org
@amebagrafica	human
@stacibb	org
@MissAlessiaP	org
@audelacruz83	human
@mignon_marron	human
@thaifoodtruck	org
@eman_essam5	human
@anju128	human
@CarensWineBar	unknown
@MarcoDiMare	unknown
@YahyaKz	unknown
@eatdrinkbeKari	human
@AuthorBookBuzz	human
@bangahrang614	human
@thelustprinzip	human
@icevenus1990	human
@VitaFrutabar_Pa	human
@sweetjhen24	human
@urbanebloc	human
@kersteldelara	human
@BlackstoneHotel	org
@BaressoCafe	human
@LoveFreshHerbs	org
@nindyfitriyah	human
@TOHGBC	human
@EvrybdyHatesLex	org
@nayanaya89	unknown
@vonchiri	human
@LaZ_MaCo	org
@E_Y_A__D	human
@ShernaKhambatta	human
@feedinnercook	org
@quzoom	org
@devereauxgreene	human
@vidhelliasarani	human
@francyporty	human
@Taaza2u	org
@mochachocolata	org
@cmahrlig	org
@mediaAaron	human
@OrangeMooMoo	human
@Mauro_v101	human
@hanspetermeyer	human
@ShoreviewShan	human
@stiletto2snatch	org
@blackblum	unknown
@markthetweeter	human
@saeeddaniel	human
@NaStreetChic	human
@MYCKORNY	org
@DANY_C11	unknown
@whois_ReedJR	human
@stephenskitchen	org
@SimpleNaturalPC	human
@eats_by_e	human
@BulacioFb	human
@PrinceOfThe305	unknown
@AnjeloZehcnas	human
@FalconClapham	org
@unegreinette	org
@bonitakahashi	org
@_jojo2013_	unknown
@Alstradecenter	org
@LearningLiftoff	human
@Stupid_Learner	unknown
@Inadego	unknown
@yuncha1120	human
@EnderWx	human
@bachkitchen	human
@CityMarket104	human
@Rockstarr382	human
@glowkai	unknown
@GallinaDivan	human
@CindyGMakeup	human
@chearyyy	human
@marucom1215	human
@dutchesstourism	org
@NourishedFully	human
@soupbox	human
@a7mdo0h	human
@healthydayph	org
@mrsbarbelle	human
@jesslyn_jee	org
@aimeepanmusic	human
@TGSSR	human
@el_don_Raman	unknown
@MyNeonTrainers	human
@iamclair3v3nn	org
@Parivartyt	human
@NatGushi	human
@gregcitywinery	human
@NoshableAdam	human
@Hotel_Claridge	org
@ArrowVQueen	unknown
@healthyhappyhom	human
@VictoriaCRandom	org
@susierainie	human
@marisawidy	human
@BotticellisPako	org
@Carrubio_	human
@Paintrider04	human
@wldance	org
@ClaudiaSHampton	unknown
@sheryllalexande	human
@PureAndBright	human
@Cooking_Belle	human
@miyon_hirota	unknown
@velvetsilk	human
@ootragirl	human
@lgmigallen	human
@jusgrown86	org
@aniraf_1701	human
@RomiBrust	human
@baby_sansan	human
@alotta_raquel	unknown
@ChatnChewNYC	org
@by_projung	human
@manda404	human
@markchatwin	human
@MohammedTowhid	org
@emilys_kitchen1	human
@funkygal173	human
@Lopati	human
@TralalaPin	human
@LadiesDayOff	unknown
@GillyVending	org
@marcusdoucette	human
@simeetsworld	human
@lovepudge	org
@CuisinartUK	human
@MaudeHuntersPub	human
@CharleneHartPBM	unknown
@Chrisnqn_182	human
@LeCirqueNYC	org
@greyton1	human
@villagedeli1	human
@BekMcMillan	human
@ChefItUpToday	org
@DineOutBos	org
@DiTommasoITA	org
@Vivy_Ang	human
@_CocoHefner	human
@She2Strong	human
@finnster10	human
@teufelchristoph	human
@BadgerAndDodo	org
@sandra_tju	human
@EnFloresCafe	org
@tirnanog77	human
@mayumii1213	human
@iTGirlForever	human
@habitburger	org
@MattyJay58	human
@ABCGP	human
@SarahACromwell	human
@NW_Elixirs	human
@VermontCreamery	org
@inggray	human
@Stevieees	human
@Queen_Dot	human
@MarksGlobalK	human
@motive8fitness	org
@arlynelawas	human
@mestizomx	org
@108roCk	human
@antonela739	human
@Djrudebwoy23	human
@NicoleNikoru	human
@SCLoverUSA	human
@Cesarchef1	human
@palomagomezm	human
@KAHRAMANSEB	unknown
@chicken_bunny	human
@OliRamirez7	unknown
@TheMarioPrice	org
@vflamencoevents	org
@XakeryJones	human
@CassieLamonaca	human
@AuthorTinaGayle	human
@LoveFabriano	human
@CataniaSD	human
@ScoutGuideDenv	human
@Campos_colombia	human
@haemarriedme	org
@WeightwatcherLA	unknown
@MollyONeillYoga	human
@imamumontherun	org
@Misslarajayne	human
@artisticluvluv	human
@chavez66	human
@ItzTivoWhAt	human
@SamTaraTFC	human
@SandraBowers13	human
@fairymiacat	human
@enmarkdo	human
@Azupoyoo0	unknown
@FashionistaKID	human
@Krystal	org
@ClactonPavilion	org
@keimusik	org
@LAutrePied	org
@TingTongActon	org
@kajumonofficial	human
@Fighter_Diet	org
@FollowMink	human
@LoriTheRD	human
@bostonsonthebch	human
@LondonHealthMum	human
@chalkboardmag	human
@Solenakw	human
@takerukungz	human
@katehallet	human
@HDNASH	human
@CarmelaGarrido	human
@mynameisannna	human
@Shopeateasy	unknown
@dilladyshop	human
@rosalozanor	human
@vriss	human
@ladonnacarroll	unknown
@mfactory2010	human
@ChichayTampipi	unknown
@jerv_marquez	human
@supamike08	human
@RabbyRich	human
@eatSUPERFOODBAR	unknown
@Mizzombie1385	unknown
@anamursanto	org
@El_Borracho1	human
@stpn_yrk	human
@wokthiswaychef	human
@shinyylee	unknown
@Gingersalt	org
@Hilton_Carlsbad	unknown
@AkilahOnTheRise	human
@hotelbrookfield	org
@ORGiNAL_Redbone	unknown
@Nongwanka	unknown
@PONYCPUB	org
@emmab1984	human
@giselaordonez	human
@reyabisika	org
@TheInkSp0ts	org
@EnisArarat	human
@arlywijaya	human
@JasMoMo	human
@taryn_blake_	unknown
@RAWRbabyRAWWR	human
@bustamante18	unknown
@MozartsGirl	human
@EKeeneStyle	human
@KirstenInWales	human
@IAlastair	human
@Jamaicaculnary	org
@UrbanSpaceNYC	org
@ramlegs430	human
@Neebs16	human
@pamela_gracen	unknown
@famouzj	unknown
@giuliad86	human
@RingosPub	org
@GeneTLJ	human
@JWMarriottMedan	human
@haagendazo	human
@frazzledninja	human
@aislingeach_21	human
@NutriYoha	unknown
@ladyrednails	human
@HeyitzShanice	human
@TheMontroseBK	human
@Pisces0978	unknown
@littlefrog	human
@yuxiao0125	org
@CindysTable	org
@Ece44	org
@Peeptoes	human
@gboymacaspac	human
@RecipeBoyBlog	human
@arjuneeeeee	human
@Beelafea	org
@TaylorHemms97	human
@TomandEddies	org
@nasique	human
@MJOConnors	org
@JillMGass	human
@LILSUUURF	human
@CharlieMoeezy	human
@giorgioenrico	human
@gabverratti	human
@Sapples_Images	human
@kartowidjojo	human
@adibonny	org
@paigecrosswhite	human
@AlexandriaGita	unknown
@NGADABZ	human
@DH_DaHitWryter	human
@ciaobepoi	unknown
@espriweb	human
@AcrossTheBarTV	human
@ptx88888	human
@amselvinaw	human
@emmandaluz	human
@ongibongi	human
@adelineyeong	org
@Killing_Thyme	org
@kittycontagious	human
@whattoeatnext	org
@TheSpeakerX	human
@Taverna_Arna	human
@nieydalias15	human
@salunkheaashish	human
@BoondocksRest	org
@Snail13	human
@erwinparengkuan	human
@SCThrivers	human
@ABlumberga	org
@designclub_fi	human
@irwansanei	human
@avilporwal	human
@QSJRADIOLive	org
@ajayleedsleo	human
@julie_ogrady	human
@wakahagepeee	human
@Brenda_CARP	unknown
@SeacatGardens	human
@socialmediamons	unknown
@Azy98ezah	human
@newsoneplace	org
@Haalinc	org
@ShamsaAlzadjali	human
@matiasbf	human
@SarahPlain_Tall	human
@kmslbm	unknown
@longhairday	human
@JobsWithHarri	unknown
@MsFatFoodie	org
@iamkrushers	unknown
@thedictionary	org
@TheJuneGenie	human
@Mariet_Jans	human
@LexaeusWong	human
@reharhea	human
@isuh	human
@CafeIntermezzo	org
@AndyRyanArci	human
@POOKITTY215	human
@_workingmother_	human
@ManiacMagazine	org
@marinamoua	human
@snjd29	human
@Khigar_K	human
@chyboo12	human
@ANITAPAB	org
@elissawhp95	human
@theQclt	human
@Pandamonium617	human
@WithVintageanMe	unknown
@FoodBevAwards	org
@LABitesHunger	human
@podcastube	unknown
@essexgirlSE	human
@MagnusBeeler	unknown
@Event_Butler	human
@allanbourdius	org
@Spiegelkind_	human
@Ashlih23	human
@jonasliu	human
@lindiasari	human
@mbud_com	human
@forevamanda	human
@DDFulford	org
@CocomayaLondon	org
@jacksononemicha	human
@staraniseAU	unknown
@MrGyrosWPA	human
@maria518us	human
@Arsaprada	human
@HannahAgui	human
@JivSubra	org
@SylviaRector	org
@thisisdairy	human
@MBKExpo	human
@RDorable	human
@AltassanSA	human
@superchef79	human
@rajiyaaa	unknown
@ajbufete	human
@maziebrougher	human
@Enzuigiriii	human
@BeachSideJewels	org
@hrhbali	org
@BorHevia	unknown
@OfficialRobA	human
@A_MohsenMansour	unknown
@WahnyARislani	human
@londonwhispers	human
@aeliyanaisman	human
@beautifulyfe	human
@naspapa	unknown
@SaraFittie	human
@OscarW_New	org
@lynnlieu	human
@inkatyskitchen	unknown
@basakkiziltan	human
@FoodJunkieNYC	org
@B2utyStarlight	human
@wiseragain	human
@Life_Nourished	human
@hiltonbaku	org
@RussoTiesi	org
@CassieBstrong	human
@24x7ProService	org
@MiaPrimadonna	human
@favourtiethings	human
@dolo_wang	human
@Alliethompson20	org
@orangehazel	unknown
@DieselDerrick	human
@hjknowells	human
@TempleBar02138	org
@Ward426	human
@mulanishere	human
@itbykiss	unknown
@VivaLaVince	human
@DrinkDenver	org
@CrystalDMac	human
@KerryPope	org
@shunwa113	human
@DJPlayboi713	human
@PhotogChris	org
@FlyingMarioMan	human
@ayametan0603	human
@papermintkid	human
@laurentalksfood	human
@maylopez812	unknown
@BelNouvoBeauty	org
@fernandowenurDM	unknown
@cmartinizkierdo	human
@parisiancowgirl	human
@Iemyanz	human
@ReineRobot	human
@RobyMCopass	human
@DraftHouseUK	org
@IAMSessionist	human
@RazyshaS	human
@HealthySkoop	org
@PiolaBrickell	org
@KajeOrsini	human
@Steffi_campbell	human
@badabingdc	org
@pornbriefing	human
@chilerosa	human
@IK717	human
@krem016	org
@kalleatingagain	human
@CristianoBorb2	human
@JoJofurnival	org
@Mjeejee	human
@coastbeachsamui	human
@dikirka	human
@LuvMyHubz	org
@iloveorganic	human
@reillyrocket	org
@vegaficionado	org
@GYSTPlease	human
@Rakha4reel	human
@Sonjahaha	human
@SuzRiman	unknown
@jesztiii	human
@thepornlife1	unknown
@DarellDee	human
@PaytingtonandCo	unknown
@IngridBuikema	human
@cherried_dydy	human
@yumNinja_nom	human
@DNT_FXER	human
@adieucin	human
@renaranuw	org
@SatOnMeeting	human
@ElianeMahfouz	human
@tmx_kyo	unknown
@vlbg	human
@giuseppinagrec7	unknown
@goodeeeeeats	human
@UlisesRascon	human
@AntonyGillis	human
@coryuntch	org
@jeff_dizon	org
@DeVerlenging	human
@StefStrawberry	human
@charlesosmena	human
@CSPI	org
@cordell_tucker	org
@myeatclub	unknown
@TedJenkin	human
@lifesAlyric	human
@Ariels_Isle	org
@zahrapradanya	human
@TheFoodette	human
@MziiZzYxXx	human
@t1984_s	human
@rmean	human
@SoulDanceQueen	unknown
@flavorjournal	human
@SilvrbirchHotel	org
@PriBhatts	human
@BayouHotWings	org
@yascepeda	human
@fusionband_	human
@feastExpress	org
@yuki_08ay	human
@JoshMattey	human
@kyogrezero	human
@rattyraconteur	unknown
@ElTaytaPeruvian	human
@tcc168	human
@cr8dv8	human
@TardisBoyDave	human
@luckynumbrsavin	human
@nudeytea	human
@FlaminiaOsteria	human
@kemshiify	human
@dc2_96r	human
@dailycafepearl	org
@mardidupin	human
@seasonedeats	org
@NickiBledig	human
@SoulofHealth	human
@HouseRuGanxsta	unknown
@fuwa_pan	unknown
@KilikyaHotel	human
@JoshKMartin	human
@donyyudiono	human
@McDonaldsCorp	org
@food_chk	human
@RooGizz	human
@JessiJaeJoplin	human
@ElKinkitySnacky	human
@feat_uko	human
@mochonlada	human
@CastroTerri	human
@wiccanprince	human
@fenliy	human
@shahinazsuxx	human
@NetDiva	human
@anabella	human
@rosey_dagli	human
@mjisanomad	human
@boogalugroove	human
@eDeCute	unknown
@amygolowski	unknown
@HighKingCam	human
@MagzMehta	human
@rasmurda1	human
@ChicagoJoesVIW	org
@lacaritoguillen	unknown
@colisellen	human
@Yigitkrm	unknown
@Bianca_BeautyPR	human
@scgayyed	human
@Juss_ThiqNluvly	unknown
@He1960He	human
@msc2013_05azusa	human
@pancake_sisters	org
@Jor_Nald	human
@PriincessKush	unknown
@aginginthehome	org
@DBGrillhouse	org
@Clarecherry11	unknown
@EmpressJulie_	human
@killahkailah	human
@rebeccacurrence	human
@cady_lin	human
@Frontiere_Girl	human
@eatdrnkrepeat	org
@KirstenVickers	human
@KimKayaKhian	human
@leelijuan	human
@524kimi	human
@ElementzNetwork	org
@nithnitha	human
@TERAHSTONE	human
@MonsieurWAVY	human
@GetApplause	org
@Hayylie	human
@Lilypad242	org
@joebaca	human
@MKonsolos	human
@FunctioningArt	human
@LBrogialdi	human
@uncle_catherine	human
@RAYGZMN	human
@cessarcordova	human
@ms_marketmall	org
@0ymst0	human
@alachia	human
@Damianascencio	human
@MilitaryRN	human
@KssPronesti	human
@Gemma_Vendetta	org
@randyfuller1	human
@BOOMBA101	human
@daliiatorres	human
@MothersDayHome	human
@SunTimesSLC	human
@Campagnolomain	org
@JackClaudiu	human
@ibizalovewater	org
@TheHenPlanner	human
@queeniephur	human
@LDH_gazo_taizen	unknown
@fitnesslane29	human
@buttoning	human
@FoltzFlora	human
@GamzeAkpul	unknown
@ASparkleThe1	human
@Joli3	unknown
@stescala84	human
@MeimeiiChan	human
@holsumrd	human
@michelle0303	human
@AMummysLifeNZ	human
@TeenieCakes	human
@Rodaishi	human
@PrimeraTaza	human
@koreemaki	human
@Anne_Mlt	human
@Mungi_Ailyn	human
@cr8ivemom	human
@BusogSarap	human
@thedinertweets	human
@shelany_t	unknown
@epictrends	org
@JPWitkamp	human
@bonifaciodayojr	human
@annadayl	human
@nurdoludizgin	human
@nazukkoooo	human
@MO_SINGAPORE	org
@GCTRIACCA	human
@WilldeKorteGIBO	unknown
@HerenciaSport	human
@HayaAbdeen	human
@FoodyBuddy	human
@Jose_Pico	human
@kitinealvarez	human
@KenchongRafols	human
@StPetersHale	human
@nikkiwonka	human
@zeppy_birthday	human
@mzbrwneyz	human
@LukeAnthony_14	human
@the_Dirty_Dish	human
@girl_brilliance	human
@noinyan	human
@DJPaYRoLL	human
@Ainalizaredzuan	human
@RadishgirlThyme	human
@LouSonyak	org
@ChechhuGonzalez	unknown
@AllAmericanPub	human
@AngyAletheia	human
@FrancescaVsays	human
@shatjhang	org
@Hayama_Risa	unknown
@busybakerblog	human
@TomboyTarts	human
@Kentsu13	human
@mags_cooks	human
@piaCCampos	unknown
@ShinRinLee	unknown
@SlappyCakesPH	human
@JamieCaithness	human
@Beaconhillhotel	human
@padungpong	human
@omfgitsMEL	human
@DistrictPies	human
@VivaLaVickii	unknown
@YUYU_rebecca	human
@Mussel_Men	org
@sbelle71	unknown
@kaf265	human
@sandeepaegisisc	human
@sadikin	human
@AntjeMuehring	org
@DatDefnie	unknown
@fominykh_a	human
@syiqinjohor	human
@ApolloniaM99	human
@PrettyImpressd	human
@09Zouzou	human
@ukbest_essays	org
@iamheartymavis	human
@AguasdeMarco	human
@pushingyoudown	human
@vinceian	human
@artisanFT	org
@AdobeGilasCHI	org
@rittyaan23	human
@floraangie	unknown
@StephanieMicci	org
@michelevenlee	human
@BeingExample	org
@nikasnan	unknown
@rowena_suva	human
@L_kimjune	human
@JCRodriguezH94	org
@TripurariRai	human
@Ta_Gueule__	human
@elleelizabethh	human
@L_AQUARELLISTE	human
@djsexiiiflo	unknown
@Payphone_	human
@Sinyuyou	unknown
@SarahValcke	unknown
@HealthySolUK	human
@AfricaFWNigeria	org
@RoojaAzooz	human
@MilkaLoff	human
@silvykindy	human
@adobegilaseast	human
@ian_nash	human
@Daibix	human
@mollygaller	human
@GigiRae3	human
@iambencooper	unknown
@bchdev	human
@wendystar3	human
@FatgirlHedonist	org
@Gi_DUp	human
@guadalopez	org
@Mespetitesfable	human
@IreneStorminatc	human
@FieldGoods	org
@U0922K	human
@MissMacaa	human
@Swaag123	human
@amandaj323	human
@TheAnchorVenice	org
@JoeMoller	human
@do2cher	human
@FarmersRdDrThru	org
@NeuvooMilwaukee	org
@StefanieHaari	human
@peteart3	human
@ovomaltine_bdg	human
@gold_finger_69	human
@AgusLugoP	human
@JUN_Seb	human
@PlusLifeQueen	human
@fyth	unknown
@nuinaka	unknown
@NomingthruLife	org
@KvasirYYC	human
@808Plate	org
@wiedamazlan	human
@ShawnaShimko	org
@TroyTheWorld	human
@SandyWasserman	human
@PeppermillVegas	human
@Sawa_Hassan	human
@ACheeseBoard	human
@nikkicadungog	human
@RitchieCCL	human
@PorkUniversity	org
@CommonGroundsNY	human
@creolamse94	human
@marikeolesch	human
@ILVoloELVuelo1	human
@A10hydepark	org
@unstoppablevkng	unknown
@BREILGIANLUCA	human
@bromleypopulo	human
@bythanovela	human
@NestleWellness	human
@pakainin	human
@claudio_bonacci	human
@ilok4jak	human
@PassionSpirits	human
@mousemac82	human
@gradientechoes	human
@brewgoggles	human
@RockVica	human
@2ndandL	human
@ARTFKS4	human
@pinkglitter_ali	human
@Marthafied	unknown
@alv_jimenez	human
@SammyLaLa	unknown
@mustikaprada	unknown
@rev_Reverie	human
@spicemonkeybar	org
@shaun_jarrodtan	human
@eekiem	human
@erinwall_	org
@Di_Ciacca	human
@BiggyBoats	org
@usualsuspectzdc	org
@NicoleDLevine	human
@_EddieOnye	human
@Fitness_Pasion	human
@Niksterama	human
@subimpact	human
@BurgersStop	human
@rohannon	human
@andrewchristian	human
@ColeVahamonde	human
@JeffLee	human
@iamMrFernandez	human
@monyb	human
@4NTameside	org
@kathvillanueva_	human
@MZK_d_girl	human
@wickedkhriz	human
@RestaurantSu	org
@steve9091	human
@AlokVSaldanha	human
@MikeyBell1990	unknown
@frenchandgrace	human
@SatoRost	human
@Yummy_Goodness_	org
@Aleop03	unknown
@ColorMeJames	org
@prim_neo	human
@ps70ps64	human
@whiterosealina	human
@katecess101	human
@HectorMartineez	human
@raineous87	human
@NYCphotochick	human
@Tripppygypsy	unknown
@MarcellinoRisto	human
@Tamilbots	unknown
@tysmink	human
@fikkydr	human
@Roy1984tw	human
@intruehealth	org
@Westgatepub	org
@fionamonkey	human
@DoubleTreeJBR	human
@RRRRRenz	human
@jheflee	human
@jen_kirsch	human
@oh_famui	human
@coconutcontent	org
@leeandamy	unknown
@oldmilltoronto	org
@SewDIY	human
@HeartbreakStarr	human
@DoubleShottsja	org
@GoddessLife	org
@Laurenakalulu1	human
@Mimzy2short	human
@JessDetering	unknown
@MarketMiniBoss	org
@Beverley_F	human
@hoofprints	human
@Ranamavie	unknown
@athenalucina	human
@Kumar_Raju85	unknown
@LawJiaWei96	human
@a_smoises	human
@settie_21	unknown
@ammiutami06	org
@lenis_21	human
@HuaAshley	human
@thornymedia	human
@I_am_dru	human
@Hikachuuu3	human
@kma_app	human
@thanakorntao	human
@Vampirekitty77	human
@Camp_Jansson	org
@Esplanade	org
@TontoReconocido	unknown
@urprincessmae	human
@SoseTheGiant	human
@xx09m	human
@legs2013	human
@erikatodae	human
@Daiana_OperaWed	unknown
@fshnz	human
@begumfersan	human
@s_7oe	human
@YeseniaEtez	human
@elen_santi	human
@hermanhaslim	human
@YorkYates	org
@swissmom8873	human
@BritaniAlcc	unknown
@XxxJolene	human
@mahmut_45	human
@giuliaailuig94	human
@somersetgift	human
@xKimberella	unknown
@baloon_angel	org
@lovelyMARISELA	human
@WhtlyLffn	unknown
@seyo_vip	human
@inamorataaa	unknown
@ExposHer	human
@chasethesunrise	org
@Envogue_Design	human
@ClandestinaCafe	human
@daniellebrown41	human
@earlybirdsdream	human
@ChrisFarr1	human
@fen_delina	human
@Miss1z33	human
@HeatherCannady	human
@MaryanaNunes	human
@OWNCanada	human
@Diemersdaleat	org
@MikeyRomero	human
@Bgmidmn	human
@shekharsuri	human
@seldear	human
@crochetknit30	human
@masaaki_fujino	human
@Skye2612	org
@KTzevelekos	human
@chrishodkinson9	human
@BakingTourGuide	human
@Ethelskitchen	human
@NicoliShoes	org
@PerkinsCoffee	org
@unclemonty1984	human
@Juizybella	unknown
@Onion_16	human
@AndroidRadiosFM	unknown
@spiritedcooking	org
@monsterkp	human
@RubyWeddings	human
@yenifarida	human
@rosiehat	human
@MarionStMarket	human
@madalycat123	human
@lemlikesmnm	human
@ciklilywanie	unknown
@made_bymummy	org
@arirulnizah	human
@danielatrillo	human
@mayerlyfashion	human
@flashbracket	human
@TiaFarisha	human
@bagelsbeansede	human
@sasakilil	human
@WafaQureshi	org
@MeBeArdian	human
@felinfachgriff	human
@reditanovilia	human
@ynaxx	unknown
@faintinggoatdc	human
@ElineAllart	unknown
@aym_higher	human
@ProntoPizza	org
@SachaDistefano	human
@DanieleCerroni	human
@micki750	human
@Manou_Music	human
@HH_Shoreham	org
@HelenlouWest	human
@Teri0328	human
@Lori_Doris	human
@littlest_love	org
@TeamProject360	org
@NinaNoel007	org
@luxuryhotelguy	human
@aik_aok	human
@rlizares	human
@laurryramirez	human
@RerameUngu	unknown
@cherylsp_	human
@SirFilSilva	unknown
@sakuraYEM	human
@jepunnye	human
@BeatoMan	human
@IyswariyaK	human
@AdamGahlin	human
@PatienceNFaith1	human
@hoefsie	org
@rulogump	human
@eyna_nasser	human
@summersabandon	human
@tweetyganda0127	org
@PizzaBuzzUK	org
@Sonu3_91	unknown
@imPrinceCharles	human
@georgiekellyhop	human
@Grant_Russell	human
@jennyburk182	human
@ParlayDC	org
@fitgirlskitchen	org
@martinkubelka	human
@Tartakovsky_A	human
@greatdanecoffee	org
@100MontaditosUS	org
@FOURMAGAZINE	org
@taz_healthylife	unknown
@Chocolatechink	human
@DanijelaKM	human
@BabyBrainMemoir	human
@sonick0	human
@jaydonisobe	human
@PuritanBullet	human
@CatsCompilation	human
@ah_miranda	human
@Detoursnlife	human
@Rocksteady784	org
@geanallain	human
@GIRO_Cycles	human
@fabstylistika	human
@dfit1	org
@Platiborn	human
@Laura__Leon	human
@seoulsistaah	human
@sroakes	human
@NCESdietitian	org
@SekaarBDG	unknown
@Cookbooth	org
@Vlad_Vlaaad	human
@my9oh4com	human
@SpretiValente	human
@LJMCP	human
@kkkristina___	unknown
@carissamiss	human
@healthfoodpress	org
@ZestLifestyle	human
@karenlynnho	unknown
@HomeMakeoverUk	human
@ElyBahiana	org
@srini_ramprasad	human
@HoneyRibar	human
@dreameve	human
@PunjabBoston	org
@agustin_vidalr	unknown
@COCOVIEnaturals	org
@OhScarCifuentes	human
@justinjustiss	human
@stategrill	org
@millizilli	human
@Gr8BosFoodBank	org
@luisramirezjr	human
@SvetikMiss	org
@cali_kev63	human
@ArtigianoRead	org
@chelsea_yiyi	human
@k_dubrott	human
@KakiKawaii	unknown
@Vamosnyc	human
@rikkimorehouse	org
@konakafe	human
@amineknowsbest	human
@AyhemPro	org
@hgvstheworld	human
@saifbrandy	human
@blondelilli95	unknown
@toffofalltrades	human
@FairyPrincesNyx	human
@yuechii	human
@PPEDRAJASQUILES	org
@MrAleBrunello	human
@plaidandpaleo	human
@chambelf_eteuk	human
@Janoskians_FTW_	human
@MylesUrquhart	org
@MoraySecurity	human
@Val_eriacoco	human
@caralageson	human
@bdailygiraffe	org
@Uae_Salama	human
@salvetapla	org
@Gongl0h	human
@RaulCastanedaP	human
@LauraNeverminds	human
@MPioppo	org
@tittodewaa	human
@skanofficialnl	human
@StavrosPizzaOC	org
@Jasonee_17	unknown
@nenathunderlips	human
@seanfed	human
@lovetheinfo	unknown
@iamdexterDG	human
@couturegourmand	human
@Kassandra_00	human
@tommy_ooi	human
@Allychou	org
@kmelendez333	unknown
@AhXian1210	unknown
@RaspberryBlond	human
@irizhyudi	human
@_black_pug	human
@LexusCardiff	org
@kecimiao	unknown
@leregarder	human
@merck89	human
@trumpetdude02	human
@ktr1806	human
@anne_flix	human
@li_speaking	human
@calumpadmelvin	human
@juliozsar	human
@DanGlickberg	human
@Anacmommy	human
@JessiTorresM	human
@HansOlmedo	human
@PhoebePhelan	human
@dunnlove4ever	human
@mintwind	human
@frogiegirl	unknown
@_AndreaLorenzo	human
@MaceoSpice	org
@CraftbarNYC	org
@Abbyignaci0	human
@MilkShake_Bar	human
@ptg_uae	org
@chachachawree	org
@NathanielFran20	unknown
@BossClaw	org
@tsw_com	human
@ethanryouji	human
@Nani_Shah	human
@m1yamazaki	human
@OOOpenUpNow	human
@AlvinNotFly	human
@LeCreusetUK	org
@Jessica0805	human
@sheenahouston	unknown
@WalterIshizuka	org
@CurlyTazzi	org
@mansonite15	human
@decorshandmades	human
@helderasmoreira	org
@AussieFarmChick	unknown
@haraboji89	human
@ZazouRestaurant	org
@john_azomosa	unknown
@pb_shad	human
@PeteR_K_A	human
@onabbotkinney	human
@FutbolKolik16	unknown
@EvaMullerYo	human
@nana5129	human
@albysfreestyle	human
@aziziear	human
@KulkarniAnanya	human
@n1disco	human
@EmCroll	org
@msu_84	unknown
@PKatsiki	org
@F1tBombshell	unknown
@ATOism	human
@marisxaCRAZY	human
@jonesy460	human
@TheHomeEmpress	human
@Ajirawadee	human
@_grocerandgrain	org
@foxyclyde24	human
@sue_kamaruzaman	human
@amelia0458	human
@akiyoshii	human
@tweet407mike	human
@Estell61234	unknown
@adesalvo	human
@austin1989719	human
@ShelleyC100	unknown
@RiemannDwiek	human
@WiseOwlCoffee	human
@organicgirl22	org
@jayskinner850	org
@freshaexeter	org
@SunderlandLover	org
@CarolinaVGentry	human
@fabulousnikki	human
@bnt_alhumidi	human
@CharlesButlerJr	human
@limaila	human
@segalaadashop	human
@GlassScowl	human
@NatalyArdilaC	human
@EddyEzad	unknown
@sandysokete	human
@iloveJHEDHEN18	org
@Stefani_Girard	human
@englishv2	human
@ilaputi	org
@renai_s9RBQ	unknown
@GenevieBeland	human
@AxeavvheIor	human
@thebearyproject	human
@jopfoh	human
@gutimom	human
@SidClicks	human
@tracyho88	unknown
@sakurabe	human
@intheknowmom	org
@Supermommy1983	human
@Cillapuchinno	human
@istiadzah	human
@ZIN_chorin	unknown
@nanaseharu27	human
@CocoKomatsu	human
@solutionelle	org
@queensofthewild	human
@CheechForreign	human
@VelashapeLondon	org
@BoneLee	org
@valdesr	human
@shafieq_othman	human
@siem_lmc	human
@rafaela_lr	human
@FraNegri	human
@nlcorner	human
@EatDrinkAndBMe	human
@chicagoyogis	org
@iamebbyk	org
@IAMTHECHOPGOD	org
@amybzzzz	human
@NYCSunDevil	human
@boskeh	human
@AmeerulI	human
@BalloonMagicGuy	human
@ribarccelar	unknown
@robotspy	org
@dearandx	human
@RacheCirri	human
@MusicJunkkiiee	org
@silvery_cloud	unknown
@msgeeksout	human
@GrowTektonia	unknown
@MySLDesigns	human
@Ocactiuae	human
@erwin666wijaya	human
@danixskywalker	human
@muchloveche	unknown
@neenabonita	human
@MamaLuvsBooks	human
@AchieveLife	human
@Jay00789	org
@maanemazing	org
@cruzjoeval	human
@CricketsLubbock	org
@Eefz85	human
@syaharsach	human
@LlanoSeco	human
@DiahRe	human
@allcountyp	human
@dpcangel	unknown
@Fresh_Drinks	human
@jessieclairecox	human
@Firmdale_Hotels	org
@toiung	human
@athenafituk	unknown
@_natasha225xx	human
@bonicellicooks	org
@DEBOdaSIGMA	unknown
@VikkLynHolford	human
@JMayaCouture	human
@gabiszumilo	unknown
@machadooficial	human
@666MOP	org
@kimhodgkins	human
@dallascowgirl10	human
@MarketingByPK	human
@dearanger	human
@BismaMBhatti	human
@JesSoulfoodtn	human
@Jamesiixz_Biixz	human
@hboxkitchen	org
@rudyspaletas	org
@MmKazancev	human
@Foodeliciousnl	human
@Medically_Med	human
@VIBE_ub_cherry8	human
@AtomMan0	human
@Dawnshadow187	human
@bcnjiro802	human
@BrewRiverGP	human
@gorGious69	human
@RozeNieuw	unknown
@tamaki_hiroto	human
@itsanitastyle	human
@KamuiChris	human
@OrderAgentEat	human
@ValentinaRussoB	human
@RonaldjLarue	human
@luvbeibekute	human
@FedeAchilleus	unknown
@SSC_x	human
@bingsnola	org
@kizzieeex	unknown
@Phisch	human
@cilyhyfutoqy	human
@1nOnlyMONICA	human
@freeinthelines	human
@danz_lyter	human
@TUJDays	org
@dianneamaranto	human
@vvdlounge	org
@ureshiica	org
@gaellemelloul	human
@michaelbseliss	human
@HellBelowAndCo	org
@krisinthekitch	org
@Spezzie	human
@guerrillastreet	org
@chinnys_cooking	org
@DwiDjuuna	human
@KMargielewska	org
@SolciGuerra	human
@OverLook12	unknown
@TameraFairfield	human
@JEMunn	org
@shawnagomes	unknown
@theladypaige	human
@kuruma_kakkoii	unknown
@syazlinpilus	human
@TheFashionLotus	human
@Queen__Lolly	org
@mashupplus	human
@ilvoloillinois	human
@blondynesweet85	unknown
@tchelopatron	human
@pierreofficial	org
@BradFireborn	human
@7muaythaigym	org
@stanleyoktav	unknown
@SaraVoguePT	unknown
@Gourmantic	human
@St_Dollarista	human
@dailyfruitpics	org
@AmayaK9801	human
@syun1460	human
@ami1016amy	human
@christy77ann	human
@knbaughman	unknown
@Jhe_roll	human
@RDRawFoodie	org
@Bobaleboo24	unknown
@themrsqueenbee	human
@ChiaJungWang	human
@CaboBlancoRes	org
@rideo_atnatsi	human
@NorthwoodsFG	human
@peexo	human
@Victoria_Grist	human
@southofbeale	org
@sumedico	human
@Mrslady75	human
@craftkombucha	org
@redmeatmarket	human
@parkypants42	human
@CougThoughts	human
@jennyma278	human
@sarahspindola01	human
@Clayton_JS	human
@AJW_43	human
@TheTinyFoodie	org
@ScienceWatchout	human
@Neyn_Ruban	human
@semanticwill	org
@ClassyChefStef	human
@R_M_C_23	human
@Lucas_B79	human
@GreenStokey	human
@oldschoolads	human
@WesternMotorCo	human
@ivanjoachim10	human
@PD_Ren	human
@bianca_luperini	unknown
@JennieJennie17	human
@kolik_mac	unknown
@bluvaiiu	human
@stinaher	org
@BettyIn	human
@ozge_arikan	human
@meatballssmama	human
@Propersoups	org
@NadiKc	unknown
@BurtonsgrillH	human
@krystalheng	org
@KenyettaYoGirl	human
@mamacarollas	org
@C_layor	human
@laurens_latest	human
@MikeStachurski	human
@NicholasRoutzen	human
@moldy912	human
@169cm53kg	unknown
@aberikooo	unknown
@MiguelHilargiak	human
@guidecentral	org
@MakinSud	human
@devi_arti	human
@avria_xocolat	unknown
@marksummerscast	human
@FotoKurzyOnline	human
@dymarkaSL	human
@Hedvab	org
@SlainteBarNYC	org
@acemorganfit	human
@hollandemme	human
@SanFranBakery	org
@thethyglife	org
@telulabankhead	human
@LittleRoadsEuro	human
@OhMyHaj	human
@SalgiFoundation	human
@InCucinadaSari	human
@pambee_antonio	human
@VillaVager	org
@PastriesPumpsPi	human
@kramrva	unknown
@KC0168	human
@JayJayLep	human
@shioneko	human
@Th3_Dynasty	human
@rhodelsazon	org
@MissEmmaLou_	unknown
@StuHelmFoodFan	human
@JESSICAYJ_	human
@rich7985	unknown
@S_h_a_n_n_e_n	unknown
@ElMundoDeSeicka	human
@AGGTaccrew57	org
@see326	human
@Athip	human
@Luliiita	human
@AltiusDirectory	org
@Imasaii	human
@smcantisani	human
@ItsEMT	human
@aulyftryni	human
@kt_oakes	human
@ashbabb421	human
@iAnirut	unknown
@rons1212	human
@alternachic	unknown
@FredCasadei	unknown
@The_Oatmeal	org
@masanaminori	human
@Santobori	unknown
@bot17789131	unknown
@JenniferG724	human
@szhieloah	human
@xhawise	human
@DeliHoneybun	org
@STAAmsterdamNYC	human
@CloudieCo	human
@n_paloff	org
@giuliarichetta	org
@Tweeting_Mamma	human
@UnderthesunLife	human
@MONTECRISTO_Mag	human
@Friedpotatoz	human
@AmigosUWS	unknown
@singlenlovnit11	human
@AngieKnierim	human
@cndnc9	unknown
@epicbykatevon	human
@Fitnessina	human
@h3ysilly	unknown
@UniteUrbanGrill	org
@S_and_aSB	human
@YyiNGjjnGi	human
@s_tanat	human
@kutmaster1	human
@CeccoSchisano	human
@SunCafeOrganic	org
@gillespudlowski	human
@DistrictKitchen	org
@TheAmericanSF	org
@LiraOficial	unknown
@samaward	human
@etobicokehomes	org
@Clartoyol	unknown
@PassengerPicks	human
@GokhanAvcii	human
@poppinabby	unknown
@theanitajane	human
@koloinah	human
@sos_jr	human
@RoseARPowell	human
@blogdojr	unknown
@hooraymagau	org
@valeriastri	unknown
@splashofdiva	human
@jolene_carr	unknown
@BricinhuSilva	human
@CristiinaS_16	org
@bossjt70	human
@lotfiismail	org
@RosalynMarlene	unknown
@TowerDublin	org
@RosieRockets80	human
@HeartGC1	org
@alexdye1	human
@HermyMom	human
@Imraan_Aseer	unknown
@Henryreedusjr	human
@FrolleinJulia	human
@sabineweijers	unknown
@resortolivanova	human
@AbbiStokley	human
@dreituazon	human
@MichaelColignon	unknown
@kt112014	human
@jen_jy	unknown
@Meggsie62	human
@MissLynseyM	unknown
@kang_yc	human
@DiningConcepts_	org
@Focusfitt_com	org
@maxxatron	human
@finbackbrewery	org
@CollinBrooks11	human
@baysidebid	org
@SatinNSarcasm	human
@laetam	human
@sophiebarrimore	human
@apartminty	org
@MATTZAMPELLA	org
@majesticvxl	org
@kendollking	human
@TheLessSay	human
@thepoeticfoodie	unknown
@loongjasondean	human
@rino9550	unknown
@JAlfs	org
@mcanna	human
@Nurball	human
@LDsince1993	unknown
@TrulyGoodFoods	org
@XLanna	human
@EmLoveToLove1D	human
@ammdey	human
@DarkGem90	org
@Brise_MariBel	human
@CocinitaCubana	org
@mangoandsalt	human
@SupplementStop_	org
@Naaao94kaz223	unknown
@_nutritiongal	human
@theobomanu	org
@hanasoracyan	unknown
@henrydster	human
@TheRealKevin23	human
@rahmanhamid	unknown
@nicechicstyle	human
@ScaffidAnna	human
@VinnyCarr_91	human
@edXphotography	org
@REVFitnessLLC	org
@PeninsulaApts	org
@sweetbeks	human
@GmailTereypunto	human
@ATMSpeaks	unknown
@iam_oweng808	human
@claudiagene	human
@ChefSavvy	human
@FntsylndFoodies	org
@Staciianne	human
@KarisLing	human
@Mitchxoxo	org
@Ivanaiska	human
@pavielin	human
@DjCaliSlimm	human
@Play2Health	org
@Shinra_AR	unknown
@KeithBungay	human
@MoLuck1	human
@ahamAyush	human
@tropicalfoods	org
@Pedrina92	human
@MariannaAnnaa	unknown
@Makwblue	org
@ChefSueAnnAllen	human
@atpnorth	human
@NapiliFLOFarm	human
@lecafemarcel	org
@IManageStars	org
@autumnalsunrise	human
@lowsent	unknown
@now_playing___	human
@MrEdX09	org
@eaqq2	unknown
@fattypangs	human
@SpliceStudio	human
@marcusbellamy	human
@homes_tuscany	org
@CraftySpices	human
@sleepeize	human
@enolee	human
@MendezFuel	org
@amonomania	org
@chientakuestu	unknown
@BIB808Girl	human
@constancee5	human
@tget2_v	org
@zaahiradawood	org
@xapihippo	unknown
@ShephardOcc	org
@gloriettatweets	org
@ador_ee	unknown
@Moesamoeroep	human
@IanRyo	human
@yuelizabeth1	human
@cybreed	human
@thedooronline	human
@mandylovewonder	human
@AkshayaPatraUSA	org
@matugemake	human
@singerthism	human
@PornProx	org
@whimwhamlife	human
@FilipPopovski	human
@n4sif	human
@nOvaDose_Onme	unknown
@SmartyPantsMama	org
@clepong13	human
@Alex__Llana	unknown
@HotToneMusic	org
@aliahagha	human
@jptian25	human
@Alfaroj_lmashwi	human
@MsAmandaDean	human
@MinouBJLD	human
@CafeItalia2	org
@funnypani	human
@BasilZempilas	human
@PaulFarrellio	human
@krystalpua_lah	org
@Miss_MarryMac	unknown
@FiliceFan	human
@RocknRoll_Ninja	org
@SocialOffline	org
@MKLangat	human
@KaylaOldridge	human
@xclai3	unknown
@eRn_mY_dOlLaRs	human
@dieya_ahmat	human
@bitesofperf	human
@fashionford1	human
@moralmoda	human
@Gif6	human
@LindseyBickert	org
@idhananggara_	unknown
@florentdsouza	human
@1stepNorth	human
@indiaatyourhome	org
@adum93	human
@trixiemorality	unknown
@ldnfoodaholic	unknown
@PamperedSoles	org
@mikemichaelsUK	org
@bbukanova	human
@por_flavorx_xx	human
@TT1Nida	human
@cucchiaiogiada	human
@Fafossj	human
@nicomaruko	human
@_Cramer_	human
@XiaopeiZhang	human
@Lovenconfection	human
@AnnaArletti	human
@ManitobaRetweet	human
@EmpressXclusive	human
@chrislineos	human
@Eimmy34	human
@MarvzBen	human
@shellyrockstar	human
@notweetcias	org
@cantinasyracuse	org
@MireiaCarrillo	org
@boing79	human
@TGstyles_88	org
@TWellsHighSt	human
@Cuhlairre1010	human
@amirarmia	human
@patrickdjp	human
@BryceLim	org
@RealFit4	human
@CapeBrewingCo	org
@avalon1982	human
@toosweetnattale	human
@partyheidi	human
@faridbaks	unknown
@Blush_merielle	unknown
@JonnyDodge	human
@HannahLouisa_xo	human
@NursesUnlimited	human
@Cindyleen	human
@Jennitajen	human
@nezumikko_2v	unknown
@hamgyuzizi	org
@maryann0411	human
@LCHennig	human
@ThePeasKneas	human
@sacchinms	human
@StinePitney	human
@joanalcasid	human
@tuckeypanda	human
@suzidixon77	human
@HawaiianDude77	human
@themedipedia	org
@davedulany	unknown
@n1obium	human
@jeremaehotmama	org
@angeliasims	human
@tHatKinGBOi	human
@courtneymprice	human
@tonyromasgt	human
@MuZhenFelicia	human
@mitikuu	human
@chespi1984	human
@Tet83	human
@sweetgelai28	human
@discoveryparent	human
@teach023	human
@ANDYTOURS	human
@Heffman10	human
@FrontierCoop	org
@Birli_Birloke	human
@lilfashionisto	human
@aLExandriaYAP	human
@kris_baena	human
@imyoonarisa	unknown
@mo_kanaaa	unknown
@Diggiescafe	human
@Mariana__Galo	human
@DogmaCuisine	org
@MeganBrumble	human
@Kollybear	human
@YuRiNa_350	human
@buckie01	human
@prettynotinc	human
@Mr_Darchangel	human
@caramellaMARIE	unknown
@koinasubi	human
@Jessica_Persson	human
@keniarosemary	human
@alvaro_cruz_c	human
@iam_cookiemnstr	human
@L33fang0905	human
@PierrickBoyer	org
@TheSmokeHausUK	org
@tessienurul	unknown
@BlancChancery	org
@kylieryan76	human
@myvalleyvillage	human
@SophieDoros	human
@diningonmaui	human
@popsrox3	human
@SSIMRdown	human
@aflyonthawall	human
@CheckMyMelodi	human
@armessing	human
@Meg_Voss	org
@istanbulmodaco	human
@SaddlerDurham	unknown
@purityorganic	org
@foodsinheaven	org
@forgetmebot	org
@GD19880818YZ	org
@SCSUFood	human
@YN2LW	human
@KirstyTV	human
@W_Barcelona	org
@jeong3int	human
@AliceNember	human
@Tanya_Sinkevica	human
@itsjuliepulvz	human
@ch1ka	human
@mvpsclubhouse	org
@SMSeafood	org
@OhhUOne68	human
@bibasmaracaibo	human
@SimonettaDegano	human
@NisenSushi	org
@chairman_alvin	human
@na_liciouz	unknown
@laila1119	unknown
@BarnandCompany	org
@markgallardez	human
@wluDining	human
@xinyiic	org
@AllSoulsKC	human
@lifeinbromley	org
@AshleyQ94	unknown
@lauraconnick	human
@florianaserani	human
@HPMcQ	human
@Radcap_hung	human
@suzi_sulaiman	org
@Glamcookie86	human
@CrustaceanBH	org
@miii_pyon	human
@kaitleen	human
@VegGirlEatsDFW	unknown
@CraveSomeHealth	org
@arletteobeid	human
@CapHillTavern	org
@imqueeniecosca	human
@OrtegaSkye	human
@030312	human
@hamodavo	human
@lawrencekawai	human
@wandergluttony	human
@AlejandroRamos_	human
@dinoravelo	unknown
@beautifulchef	human
@Twenty20GWB	org
@WaitingonMartha	human
@FineChoiceFoods	unknown
@kuraji	human
@onevegworld	org
@ssaozyy	human
@TERASEINA	human
@simcoejamie	human
@Beknipe	human
@jerrystupid	human
@HannahPanzie	human
@audrey_harte	org
@johansenhalim	org
@azlinasunny	human
@DON_F_Lincoln	human
@Creativelena	human
@CherWangYuting	human
@Maryostler	human
@nabielabdlatiff	human
@TheBarInMind	org
@lisaho1113	human
@jessajooy	human
@NavinDhyani9	org
@hoodgourmet	human
@sinyees	human
@HeloiseSllmt	unknown
@SaraGrossiYoga	unknown
@stevengo12	human
@blackstarvalent	unknown
@3DSLove	org
@freddelacompta	org
@Nadia_Khurr7	unknown
@BirainDone	human
@Justaddedsome	unknown
@oktin_caem	human
@vascolegamma	org
@JDSheehy	human
@anarshukla	org
@baduysijuan	unknown
@ChuckVass	human
@irasusatyo	human
@LBel_Maldonado	org
@kennechu	human
@IleRomani	human
@seriouslypasta	org
@BigSheezy79	org
@T_undefined	org
@tsugululu	human
@meomii	human
@IKEAtemporary	org
@drpanga	human
@bensmart26789	human
@BaseEatAndDrink	human
@jaciyeo	org
@jettsett56	human
@angelmapp	human
@marina3850	human
@innaplesca	human
@BaconintheOven	human
@diannoona	human
@AnemosGreekNJ	human
@Staciesayzso	human
@foe23	human
@LKKelley1	human
@PlanetBakeLife	human
@chelle036	org
@mondo07gk01	org
@WhereIsKirbyAnn	human
@judethomas21	human
@Bunnifruit	human
@Tomotyahn	unknown
@ReneeGreatPeace	org
@EstefaniaCrespo	unknown
@Francesca_it	human
@JoseCaobani	human
@RebeccaKerryx	human
@TerryWhiteND	human
@Now_Cookit	org
@personalfitnes3	org
@StreetBuffNYC	human
@maraamy	human
@kajbautista	human
@mmnahamed	human
@2brichNhealthy	org
@noviichen	human
@iamchopstick	human
@WhalleySuz	human
@amila_srilanka	org
@Camilaww	org
@LizCollet	human
@NadiaEtiaw	unknown
@Jeanzpoh	human
@MorenitoOssy	unknown
@lovebunny_ninja	human
@margheperitore	human
@varelligirl	org
@shedyserem	human
@burbagecc	human
@mychaoticlife1	org
@BoltActionBike	human
@ELLEGANCE_	human
@jollandah	org
@silvercell4	human
@gaelislove	unknown
@kicyu2828	human
@NewYorkSmash	org
@ch3rry_sher3en	human
@karvusmaximus	human
@AbiBarbs	human
@risafirmansyah	org
@Erik_L1965	human
@BramalfieBeads	human
@PeapodDelivers	org
@ReemAbdelrahim	human
@JanNjniez	human
@4PointsBurdubai	org
@EatWithMo	org
@dlovelyrenee	human
@HSMAHAL87	unknown
@samfromseattle	org
@MelisaKey	human
@enchan1219	org
@TuckedInBliss	org
@LCHFLover	unknown
@fain007	human
@iamrealSoul_Mp	org
@sousvideguys	org
@sushitimesk	org
@harryorny	human
@pixiefree	human
@mmomz	human
@DIYonYouTube	org
@McDPhilly	org
@linds0120	human
@ClaryLoera	unknown
@rolalaloves	org
@AJX8141	unknown
@Urizarna	unknown
@SkinCareShare	human
@OneNatalie	unknown
@NinjaKitchen	org
@AnnaRosemann	human
@LADYCHELLEZ	human
@_saBee_	org
@ItsLouben	org
@12thSouthBeeps	human
@kesyrosianna	human
@Myhorng	human
@ty_spaace	human
@raymondsebast	human
@modiin_ru	human
@AmberandSakura	human
@HBERTistheword	human
@lechefpaul	human
@iammaklo	human
@gogo7030	unknown
@KapanduH	human
@lemabor	org
@jcphotography6	org
@ingasia	human
@MeJadeBianca	human
@LeoS2	human
@PiccoliOn6	org
@Iggy_Puff_Pop	human
@sianyyy18	human
@jo_herrera_	unknown
@Pat_NYC	human
@gleect	human
@Elbertabrooklyn	org
@Roastwoods_cafe	org
@lesfactoryfemme	human
@yAs_world	unknown
@MBray04	human
@BrachiRoll	org
@sexyzone_tubu	unknown
@vidzsulistio	human
@vztore	human
@VlknswrdTweet	human
@Fitforlifex	unknown
@longhaul78	human
@DawnBFitAfter4	human
@YoungMal_215	human
@AndreyAF	human
@TeLisaD	human
@bubblesnbikram	human
@HeidiSVisco	org
@hooknamburi	human
@Maya_lbiertS	human
@careliagispert	human
@CarnivalCourt	human
@THOMAS_FOSS_	human
@Salley220	unknown
@AngelinaHDesign	human
@TubaUlastiran	human
@CeCeDo9x	org
@BusanBBQ	human
@CLTveggie	org
@joanna_cha	human
@photojeg	human
@alwaysrennie	unknown
@aaasaaami	human
@DrouthyCobbler	org
@MaryDeOli	unknown
@downwindPDK	human
@NaturallyFitLLC	human
@SWCOWGIRL	org
@nts_g	human
@LESLIEEISENSTE	human
@CJForChange	human
@PrettiBoiiDae	human
@rahrah4evamoor	human
@VforVirns	human
@NamaSayaLoqman	human
@fitnesschicken	human
@kimbundance	human
@aggie81irl	human
@SkohnsCanteen	org
@patriceachow	human
@wilmingtondpz	org
@LeMetro_Halifax	org
@enzoladrido	human
@LintangDolor153	human
@Chii_Chiara13	unknown
@F_Duran23	human
@G_Sealy	human
@Ecomertoglu	human
@sugar_lipzz	human
@isuwi	human
@DDUBsSexXyDevil	human
@MeggABC	unknown
@angelmontero86	human
@geopree	unknown
@afridym	human
@ranchograndemb	human
@richeeleM	unknown
@ResDogFishing	human
@hapaniki	human
@alifffikry8	human
@vidamiacuisine	human
@ONLIbeverages	human
@rosemac67	human
@niajohanna	human
@EarthAngel172	unknown
@StoryTolley	human
@sam_ethan_lee	human
@megespfeffer	human
@mmdcmgr	human
@DrewP4P	human
@devijaime	org
@girlinahotcity	org
@AreoMc	human
@Meleogne	human
@RoXyLuV87	human
@fariszulkifli	human
@cibi1972	human
@Anni_M83	unknown
@angelicatweeted	human
@MicolBonacina	org
@mikichannie	human
@okusama_37	human
@AbogadoGeek	human
@cbharmon	human
@marianadineen	human
@TerenceSpeaks	human
@stephf52	human
@CzarinaGomez	human
@AndyDrought	human
@m3yLani	human
@Rizz_ndah	human
@hazeleyes767	human
@maricormacua	human
@SimplyAtHomeMom	org
@jordanabx	human
@leaAyiAndrade	human
@heagneywyoming	human
@missashnycole	org
@FloFliFlu	human
@mysmoothie_co	human
@platinumclubvan	human
@Raw_Review	human
@mixsen84	human
@mintscheng	unknown
@Mintleong	human
@llllHivellll	human
@Glorious_Foodie	org
@StPaulGrill	org
@CynthiaCatera	human
@124241C	human
@lela_winston	org
@asthegirlturns	human
@DrinkingBudSA	org
@bianclaro	human
@yuniahoy	human
@msmithphoto	human
@AngieHilsman	human
@mchefajaychopra	human
@marteenrojas	unknown
@PipoVela	org
@IslandmixUSA	org
@ikonora	human
@oceanactivists	org
@FarrahFerosh	unknown
@GFreeRadio	org
@MonicBergiyaan	org
@Sourdough_Berry	org
@jorgepilgrim	human
@JojoBrahim	human
@CWonEnt	human
@gwalli	human
@vaniimarques	human
@lesliekim76	human
@OMgrilledcheese	human
@AzizDogdu	human
@YivelyZorrilla	human
@chiftf_nbctower	org
@Rina050830	human
@Nesh111	human
@BuzzworksLife	org
@GeeTeamPrecise	org
@atheer26	human
@cjurquico	human
@Blanccoco	human
@radiantgrit3344	org
@isyangbaja	human
@1986Fairhall	human
@habanerodesigns	human
@blessed_by	unknown
@rawreligion	human
@navyaramesh	org
@this_is_me_94	human
@diancake	unknown
@vivi7604	unknown
@mikmakebonta	unknown
@LiyanaThean	human
@Anonymousities	human
@The_Salt_Box	org
@OldDog402	org
@SERsteak	org
@HealsUK5	unknown
@kayreena	human
@DaSpitFyre1	human
@AnaNiki07	human
@jaschuahl	human
@Loyalzoo	org
@hotaru_matcha	unknown
@AdamTheQuirky	human
@HorseShowHouse	org
@papi__tan	human
@TriaKartika04	human
@JohnnyBou	human
@HealthyJaz	unknown
@AnnalisaMagelli	human
@LewishamWOT	org
@withoutaniron	human
@forest_of_ice	human
@kimieybravo	human
@JustJanine8	human
@MxRTw	org
@danielooloza	human
@bekconnell	unknown
@cleanlifestyle_	org
@nickkl1983	human
@babyyqueenie	human
@woogstyle	human
@JussFrankie	human
@myfoodieaffairs	human
@lanikhong	human
@AdarhamBalfuric	human
@716_happy	human
@CorydonTimes	org
@OscarMelendez1	human
@_SMITTY88	human
@AbonPlastic	human
@kujiraus	org
@alexisamore	human
@SamanthaGraus	human
@adorkandhispork	org
@English4Use	human
@BonApetitNU	org
@nyan_su14	human
@mjrain827	human
@vivalaViv_blog	human
@ForwardUprising	human
@RaquelDCarvajal	unknown
@Ali_Za29	human
@roco_6574	unknown
@jdryerson	human
@BrittanyAri	human
@sezeneminova	human
@Ashley79227	human
@NancyMLS	human
@kealia81	human
@MsWillz	human
@LotStreet	human
@jbingoprod	org
@urrutiaos	unknown
@sugiatmika	human
@dakeyne	human
@Orlan2RT	human
@AllysonMeyler	org
@indiequeen84	human
@veggyhappy	org
@momsansmanual	human
@GLRFDsupplyco	org
@meelovech	unknown
@Dmndintheashes	human
@QUA_LI	org
@TheCaptainsTbl	unknown
@KarenMcKeon4	human
@iankhrizel	human
@arkindo	human
@TheNewOSP	human
@rachma_qq	org
@itsHelloJessy	human
@DanielDreier	human
@vardya	human
@lamaracuchisFC	human
@MarkTravRivera	human
@breen_eye	human
@OrganStopPizza	org
@Healthymisses1	unknown
@JeanneMargaret	human
@singmah616	human
@KrAzYNo1	human
@TheNani2012	human
@AlanVernon	human
@GreenLanesN16	org
@LaurenLo707	human
@raglan_hotel	human
@MaddyOsman	org
@krisztian	human
@GOCrowfunding	human
@JackeezDotCom	org
@oshirin_sqrp	org
@chicdriven	human
@IanNascar24	human
@MaisonChantalMi	org
@bjmlho	human
@GaryBurke5	human
@syndell19	human
@Naldo815	unknown
@HarryWeas2	human
@KDILOUIE	human
@itsmeSMB	unknown
@7kolorz_bento	human
@SaraDia246	human
@EatCookieChips	unknown
@jorobin2	human
@cavakc	org
@PinoyTsibogBlog	human
@andrean_rean	unknown
@WeekendCrewFL	org
@inspiritelle	human
@EarlsBellevue	human
@winsasongko	human
@nurfaiqahj	human
@VegUBC	org
@Benz_ImDaBoss	org
@axskhelifa	human
@rainy_fon	human
@OliOwen	human
@berrentini	human
@TheBensonHotel	org
@Finn_Chester	human
@JanKENZO	human
@DisneyWorldPx	human
@SaraLouieie	human
@Lindaspongbob	human
@HoTBunnyBaker	human
@dapurbalikpapan	human
@annoncookstaff	human
@maryydeth	human
@AA_Dharma	org
@AcOsziJOAN	human
@SettoreGEC	human
@ZadieCoco	human
@sherr9	human
@shelbouse	human
@Jenna3Lynn5	unknown
@BrendaBurge	unknown
@Andy_Samlall	unknown
@miamblogmtl	human
@KatlynTT1	human
@syzulaikha	human
@SireEnt	human
@NeuvooSanDiego	org
@nanikai	human
@giacomoricco	human
@Arryo_Ryo	human
@maria_s1225	human
@entwinenyc	human
@dancefitnessla	org
@inbalancelm	human
@KimAtLiah	human
@Stevanie_dw	human
@Ahmad_obaid	human
@flaviemicale	human
@RicksCafeCA	org
@almiraquest	human
@angelaeverwood	human
@UhLikeDuh	unknown
@AndrePedrosoDao	human
@lets_breakfast	human
@astrohamburg	human
@choie128	human
@iamkendii101	unknown
@SpicydealZz	org
@miss_canimo	human
@passhetonsmith	human
@BenVeraOfficial	human
@olga_korjik	human
@_Karen0730_	unknown
@belajarmasak	unknown
@Brand_NewHealth	org
@BridgeHouseCt	org
@sergioL_M	org
@hellococobean	human
@VerdeLightCA	human
@Carolina20_2009	human
@ysamonte	human
@chicagolandia	human
@SatyamBanquets	human
@DJKEP	human
@WMONEYFIRSTJ	human
@FCCCn_GORGEOUS	human
@vjimenez925	human
@Nowwa	human
@Yulichin	human
@SweetDNA	unknown
@ApKleo	unknown
@jphenomenalrec	human
@MandyBlank	human
@EricDiary	human
@sun_shine4sj	human
@KnucklesMula	human
@Uben22	unknown
@AllanPerkins	human
@icooperjorge	human
@1Dariotto	human
@RhubarbVenison	human
@laracorinne	human
@MySuperficial	human
@llhm87	human
@theyellowguide	org
@FitKeri	human
@provisiondc	org
@Toohonest225	org
@SheUntalan	human
@b_gamze	human
@shoelesstim	org
@BIGGUNT	human
@ImLynn94	unknown
@GinaKeatley	human
@Meenaltwts	unknown
@iamAnganasa	human
@PopUpEventsSF	human
@yavuzonderr	human
@wrch	org
@costa_kout	human
@CHIC_NY	human
@mikediddy	human
@farizasyafiqah	human
@BrownSugarKita	human
@GabrielVonDetta	human
@mtk_mkt	human
@KO713	human
@a8ya20ka24	org
@MamaBalance	human
@eatretrolicious	org
@dongatoconbotas	human
@cicihall	human
@TinaChargois	human
@heidi_han	org
@JosvicAimee	human
@debraruh	human
@LASTDRAGONPIZZA	org
@Rjharoon	org
@EventsinSkyUK	org
@coachGasperS	org
@CabucheOaxaca	human
@HazelBlog	human
@aaangelcabrera	human
@McFluffy	human
@theWitChicago	org
@Sophia_Leen	unknown
@MirabellWerner	org
@EMMObatman	human
@elifcetweet	unknown
@pixy_girl	human
@levitanaomi	human
@fazt_william	org
@Itsajade	human
@Cressecen	human
@lily_chong	unknown
@PCafeP	org
@ImeneMahroug	human
@C_Anton_G	human
@aznblusuazn	org
@Dreadita	unknown
@RichardNP	human
@kymsmyth5	human
@ParkHyattDC	org
@OmarV7395	human
@WinnipegWatch	human
@jsnowification	unknown
@JacquinMH	human
@Mr_Suaz	human
@VintageUAE	org
@NiyoMalaga	human
@chelseapearl	human
@AhhhhTeo	human
@estherahyong	human
@HouFong	unknown
@RamonNavarro	human
@NCicvar	human
@MacandJacsCafe	human
@shareeandrade	human
@mayssamaha	human
@CastleHotel27	org
@AnnessaRD	human
@panushwari	human
@Venomous_Ink	human
@a_lysova	human
@AvalonandKelly	human
@Natii_Mezs	human
@Chrissiesgreedy	org
@LaurieWang_	human
@Martin_Nam	human
@CommsNinja	human
@branbrics	human
@DPoloCafe	human
@FruSnax	org
@ManchesterMal	org
@evansoooon	human
@soniavdiaz	human
@PuriCalderon	human
@CyberCFOUSA	org
@RaisingSelf	human
@Jamileagrace	human
@izunie_aphi	org
@CreativeSari	human
@Johndm1999	human
@bagelottawa	org
@iNickLive	org
@SudhishKamath	human
@Lawbeatriz	org
@honeypie888	unknown
@mohdshahidal	unknown
@annatay12	unknown
@HungrySoulCafe	org
@KristysFitClub	human
@wtnbnh38	human
@carollake17	unknown
@Drive123Drive	org
@KatieCakesLife	org
@JefDrus	human
@chefmarcmarrone	human
@SmASHLey_G11	human
@osopretty1908	human
@AliciaOhCC	org
@WilliamMeara	human
@1st_arrow	unknown
@robinhosking	unknown
@CavegirlCuisine	org
@BntAlhumidi	unknown
@Larks_Owls	human
@AnnButlerDesign	human
@FamousGio	human
@fatenshahrani	human
@DovetailAgency	human
@mojowellbeing	human
@KatMonDieu	org
@ayogist	human
@ShruitRollUp	unknown
@ohoimin_	unknown
@nakamuraerica	human
@M_qualunque	human
@arcmervekalayci	org
@BarracaNYC	org
@k_3na	unknown
@skgt01	human
@MellindaLie	human
@DiMiTRi_KLiNE	human
@AliaaFouani	human
@ForkTenderEats	org
@Joesmithforreal	human
@MayahuelMuseo	org
@naokomai	human
@TheDogSquadInc	human
@Keemzus	human
@mikaylamcclean	human
@itsMechOng	org
@damarisong7	human
@LuxeandVintage	human
@visitgent	org
@NEBizPromo	org
@ry_happiness	org
@BkKoiqwertz123	human
@KateOrwell	human
@Fatomiosato	human
@SofiaKronholm	human
@REDicecream	human
@janes_allie	human
@renai_lMvTR	unknown
@TheUncannyCat	human
@faizhafizy	org
@NOTLBASS	human
@SiiraaT	human
@nat_miles	human
@Rilely	human
@MO_BOSTON	org
@KavishaNaidoo	human
@reizelannmanga	human
@Moqeet7	human
@IndraS5	human
@H_KimKai	human
@NaSziRah79	org
@TML_ME	human
@cintapuccino	org
@ModernCoasters	human
@IvanToledooo	human
@ovo_nerd	unknown
@tmtuu	human
@tintinchua	human
@TheTestyDonut	human
@DrDinaKulik	human
@danimarie_lynn	human
@camiwalk	human
@boboslaketrout	org
@NicoleGogolin22	unknown
@hamxasays	human
@frillsandhorses	human
@chuckpjones	human
@VivdeCourcy	human
@WellbeingNetwrk	org
@katherinesway	human
@Rosalinda_1990	human
@yjikurm	human
@VFlaviani	human
@PieHoleBlogger	human
@ricasoli99	org
@Rily_516	human
@CaNdYCrUsHxoxo	unknown
@ana_erre	human
@UneedaAnita	human
@Hotaru_Suzuki	human
@crabstickes	org
@notthecliche	unknown
@TFBTWEETDJ	human
@kaotic28	human
@Hybinette	human
@SeieaB	human
@kin9_t33_	human
@Treasure_E_M	human
@adamtrabold	human
@pamerodriguezv	human
@gchonox7	human
@TheSinclair	org
@NorwichLovers	human
@bteeninfo	unknown
@AngelikaRachock	human
@EverythingMom	human
@HotelAmericaTn	human
@thatlettuce	human
@shaylalamarie	human
@RiojaPlease	human
@Idol_sherbet	human
@Pho3nix_Rose	human
@deedomcharmo	human
@DylansLunchBox	org
@LaDiane_Nina	unknown
@santacruzjuice	human
@lizz0509	human
@lestie18	human
@SUIGINREN	unknown
@BravitaPeron	human
@gixxergirl21	human
@skythelimitz	unknown
@MokaBlast	human
@WhereSouthFL	org
@GallettoRisto	org
@JohnnyYbarra	human
@JosueGarciaNYC	human
@NASCHartInc	human
@UltimateHerb	unknown
@arangold2003	human
@castroecho	human
@TrystRestaurant	org
@LoseweightHL	human
@Danibar311	unknown
@alexdevera	human
@lauragibbs1000	human
@TarantaAlbino	unknown
@Instagramsoshi	human
@UTexJim	org
@TetracomAust	human
@fitnessfanclub	human
@shaunstafford	human
@josato719	human
@omarikhizura	human
@jaxonsocial	org
@alylaughlin	human
@Deyaajaafar	human
@TheByrdsBox	org
@its_me_janae	human
@bushra_yousaf	human
@uniquedesirez	human
@KosugaM	human
@bottyann2013061	human
@anitaprieto	human
@CarrotsnCarbs	human
@CatherineFeeny1	human
@CFCLeia	org
@ZolaZobo	org
@camillekaye	human
@heyalexus	org
@xav_21	human
@lara_haslam	human
@Funshinebear76	unknown
@VikLR	org
@superbcnes	org
@Mindyho78	human
@TakeaHikeFdn	org
@nikonrogi	unknown
@Louinga	human
@flordalbianco	human
@maggie_chyichyi	human
@AlegreRt_	human
@dineout_india	org
@Sasha_M_Vintage	human
@Tenderstem	org
@TasteTheEvent	org
@arsagari	org
@nxylight	human
@kogawatcr	unknown
@TrevorDavis68	org
@AvgSocialite	human
@Nata_kkkk	human
@Em_CookBakeEat	human
@Blohin	human
@luvofbeing	human
@_Cafe21	unknown
@LadyJ2181	human
@martu_alamos	human
@Gizem_Muftuoglu	human
@edwinatheRD	human
@sallycp11	human
@jessicaaharmon	human
@wansyahmie	human
@VarshaThacker	human
@princessisis06	human
@TheAwesomeRizuh	unknown
@haninzh	human
@splendsay	human
@dimitribarclais	human
@CemCitak	human
@CANEROSSOSF	human
@LMDaintyAppetit	human
@Jack_Jenkinss	human
@Pwardlow	unknown
@jamieanne	human
@docsandler	org
@Suki_Taz	human
@Secrunch	org
@i_one_kiyu99	human
@uedoahlex	human
@GoodersN	human
@ohtheaida	unknown
@EddyZahidy	human
@sheiladeca	human
@coyotebluefire	human
@ClairesNewHaven	org
@YBMisUnderstood	human
@m0shpotat0	human
@YorkLovers	human
@Lampoh	human
@fabi_prado	org
@miss_nouf009	human
@runobsession	unknown
@Tripleseat	org
@n8teWind	human
@Carlos007Joao	human
@WwwwJDivas	unknown
@diyadayu	human
@mansahi	org
@shar0nT	human
@hesstten	human
@CorettaScottKey	org
@IngtxikMarii	unknown
@Araorie	human
@homesteadhippy	human
@LGustavoCooper	human
@lu_christova	human
@gavin_almeida	human
@Yogaloveyyz	org
@yukaringOpera	human
@NatiCrmnna	org
@ElisaBosley	human
@iluvjeffy	human
@Dr_Dr3adz_Tb3ll	unknown
@besamehermosa	human
@grapefulapp	unknown
@TravelinBlack	org
@WriterFeministX	human
@Thewildjuggler	human
@Stonetherealist	org
@sadcafee	human
@tomoart	human
@farahunneyz	human
@DryoOoDi	human
@s_cyjay	unknown
@SuperNoVAwife	org
@pope1501	org
@akosiAmsh	human
@Hends_WenXing	human
@ioradiouk	org
@RhythmandBrewz	org
@shihui_tan	human
@chikage1212	org
@TaraMeach	unknown
@tofoodwithlove	human
@CandypantsSheff	human
@dputkowski	human
@Toshi_Suzy	human
@adamkuzik	human
@SouthbeautyJKT	human
@JessicaJadeVW	unknown
@CoolOnDemand	org
@ludaKrisKingdom	org
@JadoreFashions	human
@Aimmm_	human
@nt_pages	org
@BeeprB	human
@Deards123	human
@RioMayne	human
@JannelleSo	human
@dogtrap903	human
@4ever_Curvy	human
@ally_brittain	human
@lizekie5611	human
@JolieRosanne	human
@the_fussy_eater	org
@pilukiki	human
@foodarts	org
@ctully26	org
@LigaTilika	unknown
@thechew	org
@FeetandSpine	human
@lachorris	human
@madebynoush	org
@FaraHardy	human
@aidaMF19	unknown
@PEDICUREANS	unknown
@nOOm142	human
@leighchantelle	human
@BiscayneDiner	org
@rachmonkey2012	org
@Monochroma_Chic	org
@nacho11083	human
@asonofapeach	human
@ErinNissley	human
@naha5858	human
@simplykimikins	unknown
@bemamadina	human
@AvaMarcell	human
@AvalonAvallo	human
@saa_adri	human
@ethangaga12	human
@Lifetmydcam	unknown
@KikisTame	human
@kalli_gl	human
@Beds4Business	human
@VanFoodTour	org
@Sunshyne276	human
@meaganwade	human
@TheStyleTrunk	org
@rye	human
@yanders76	human
@NightingalePub	org
@alexsimmonsdj	human
@ionasalim	human
@HopesBeautyBar	unknown
@BevAlice	human
@AlanyaAltav	human
@tiffy_boo1988	human
@VanessaRicaldeC	human
@byutipulgel	human
@WeAreVoice	org
@SophieEllen22	human
@handleskitchen	org
@SKtop3z	human
@Zenita1987	human
@Rimadiputri	unknown
@yejades	org
@benji_au	human
@cakebakeshopmb	org
@taralluccinyc	org
@JPowersJ	org
@MirnaRonie	human
@mystemkits	human
@TheRubenQ	human
@sandrapixie	human
@ajittapaswi	human
@EduKoormag	human
@bestofbath	org
@makeyourself19	human
@BadrI_sama	unknown
@emilyrusty	human
@newyorkironwork	human
@yansoteco	human
@1Shahd	human
@pi_cyuu_410	human
@feliciax_	human
@NotSoAtl	human
@settiiip	human
@Vivelacrepe	org
@mantingyittk	human
@TELLitphoto	human
@dobbyssignature	human
@RandysWife	org
@Spoonandco	org
@azyabutterfly	unknown
@BintouSlm	unknown
@jenn_low	human
@ScottyLBrown	human
@MasumiKonishi	human
@DinerSoho	org
@GeoffIan88	human
@laurasisti86	human
@raymach1	human
@HotelZuidbroek	org
@rachaelsworld1	unknown
@BHenriett	human
@gipsymothpub	org
@jmapitz_new	human
@OliLeCourt	human
@WatercressBali	org
@BrunchNCupcake	human
@zuli_omar	human
@iamyayi16	human
@manangdi22	human
@Horaderecoger	human
@mariajo_jimenez	human
@IupNation	human
@DonningtonManor	org
@freddierdz	human
@TeeDubYeah	human
@Arundelspy	human
@ZoieIsHipster	unknown
@puttheovenon	human
@intocreatif	human
@thatfatguy73	human
@mizu0822	unknown
@Meydan_12	human
@watcherchicago	human
@BarcelonaFC_Pic	unknown
@CatherineNic0le	human
@GerberComms	org
@kendallcntr	human
@Yahdiel_M	org
@houseofwong	unknown
@PitaPitontheChi	human
@MaTattednPINK	human
@DaslNatalieKim	human
@EatDrinkDeals	org
@foxrocks2012	human
@ktanimara	human
@plutomutt	human
@TyAirick1	human
@KarolaRaimond	human
@justagag	org
@LaurenMarieGF	human
@yuniica	human
@sfrantzman	org
@Patiicabrera	human
@denis22rus1987	human
@o1oxrock	human
@MaltCity	human
@cleonajah	human
@ahonekochibi	unknown
@BooploveBullock	unknown
@FernandGhazali	unknown
@deisy100785	human
@westwoodkitchen	human
@USAnonProfits	org
@TroyLakePT	human
@SageStreet40	human
@LizaCosier	human
@callmedhavey	human
@harryannepotter	human
@lindsayrayray	unknown
@GastrofestJax	org
@BritAsparagus	org
@hrhgould	human
@VersaillesMiami	org
@cyndinguyen	unknown
@AcasadiCris	human
@LouisaSimmonds	human
@picturecandy	human
@Megs_x0x0	org
@AllyKatPerth	org
@Block37Shops	human
@kris_tin89	human
@flaviaflanders	human
@InspiringSaving	human
@AmbitiousGurlMO	unknown
@IreeLove	human
@SmokinCasket	human
@philipstevens	human
@LT_Looktarn	org
@mirul31	human
@meigenove	human
@LaJollaBrewing	org
@DanJBrown97	unknown
@makkon712	human
@SallyTheChique	human
@TrinaR_RD	org
@bou_lmich	human
@ArtsAndAudience	org
@ScottAaronDunn	human
@NateztheOne	human
@BFDHouston	org
@FindYourFunMaps	org
@Time_Age	unknown
@shalazyy	human
@kenzo6820	unknown
@emstweeeets	human
@iiiyosh	human
@ines_fll	human
@feyapa	human
@MOHMMADAJRAM	unknown
@DiploMix	org
@dixilarue	human
@MyLifeAsJP989	human
@DaveMayerNL	human
@luv4vzla	human
@Jossysonadora	human
@Myaugen	human
@StephBloom	human
@KorovaR	org
@NeyneBlomma	human
@massystorestt	org
@KhirtE	human
@BluL0tus	human
@princesspam	human
@Mariya__	human
@PaceyWilliams	org
@Tingout	human
@mr_grownup	human
@debby_caprice	human
@DJMoCity	human
@nickchulani94	human
@FillingNYC	org
@kamechama	human
@GregWasThere	human
@Lenesstuff	human
@DesiZuhairi	unknown
@teacaketrainers	human
@Gabrielle_fd_	human
@Claudyapooh	human
@Cassie_Jordan1	human
@renai_w7lBj	unknown
@cmbelcastro	human
@keeshameans	human
@WoodshedSmokin	org
@chscatering	org
@kevhussey	human
@charlottecrouch	human
@bappletree	human
@bared_cranii	human
@YiNgYiNg1989	human
@Tinge90	unknown
@rinapachi	human
@GeorgeLodgeInt	human
@FlorrieFloyd	human
@allialessi	human
@LTKnS	human
@IdipUdipWEdip	human
@elizabethbeier	human
@iMo7med	human
@BlueStallionBC	org
@VikBianchi	human
@MarocAlgerienne	unknown
@CaraMiaSG3	unknown
@puffleofung	human
@wellnessTV4u	org
@KNGlazeQC	org
@ije_momikayLa	unknown
@SusanVanVolkenb	human
@iamalgrehan	unknown
@gezentianne	human
@PGHHALALFOOD	org
@SimsonsFish	org
@KarmanVanoven	human
@AlisonBlaker	human
@ChapmanCollects	human
@thebongette	human
@Andy_King	org
@AfiEika	org
@glyceriaaiu	human
@Ricky_Sauce45	human
@Nitin_s1	org
@csDraughtHaus	org
@BigDawGDotCom	human
@assa_rockz	human
@AroundSS9	org
@TFnow	human
@BullfrogAndBaum	org
@POCrestaurants	human
@Beki_1	human
@PapsisBeavers	human
@REIDSbillericay	org
@yumi_gumi	human
@tomomichu	human
@cxshade	human
@SaliiPerez	human
@BrianChant	human
@OzyGalaxyEvents	unknown
@StephanieLee1_	human
@2PMio	org
@CyrilLAYROLLE	human
@halfbakedmoron	unknown
@DebEmbree	human
@iam_keitafierce	human
@TodaysEpicure	org
@AzamaraVoyages	org
@HeyyMsBartender	human
@McMoMo91	human
@jatinjuntilla	human
@USBboyz	human
@DenamineightSky	human
@mmarialaura_	unknown
@audreygoemans	human
@francescozonin	human
@BlackLegendLive	human
@JamesDellavadve	human
@Johnny_Smith100	unknown
@getfitbetrue	unknown
@PatrixPix	human
@sruthipeter	human
@NeighborhoodsC	org
@kha_kirei	human
@mii0208	human
@chaleel36	human
@EmilyJane8210	human
@BINGBINGBLOG	human
@denisaanna2	unknown
@renegadeloverrr	human
@NezzBintang	human
@AnnaGisslen	human
@TamiPeira	org
@Mitch_Torrens	org
@MigasFlorida	org
@yuki918322	unknown
@CMWineSchool	org
@ANGEL_A_ZHANG	unknown
@Dini_Nasution	human
@prnprn_jmlee	human
@felixcito	human
@ve_frede	unknown
@Radiocardiff	human
@mlsecrets	human
@erfukuda	human
@itsmesupergrace	human
@Viaa1004	human
@rhea_ivy	human
@ChullaBot	human
@adamsoliz	human
@SarahAlDabbagh	human
@TerroirCachette	unknown
@awstn_jglo	human
@Derekw_yuree	org
@kdpn_0116	unknown
@SWAGTA5T1C	human
@giramuk	unknown
@RamsayofCarluke	human
@DerekSCSwifties	human
@joesdublin	org
@kara_vank	human
@gabriela_m_12	human
@CarolPak99	human
@unparalleledcc	human
@Her_Castle	unknown
@peartsue61	human
@ChevysAleHouse	unknown
@AVJaramillo	human
@agimatcomics	human
@MySavorSA	org
@ashhleey	human
@CultureTripChi	org
@ProTonicWater	human
@cmsd613	human
@moldilen	human
@etalfinefood	org
@BiaCD	human
@WeDishNutrition	org
@PrideNiagara	org
@Taglover_	human
@yungjermy	human
@IvanKlandeztino	human
@_brendantan	unknown
@ZinurovaE	human
@Paaaln57	human
@hidynwa91	human
@sshmlcrbnl	human
@illyariffin	human
@roxine	human
@Renzers	unknown
@mstreemoore	human
@jpfox13	human
@coolhothunter	org
@pinkristiachni	human
@RebeccaEmporium	human
@YazAlexiou	human
@YuanjiaSayangU	human
@TheOmarKhan	human
@Joeymiamiidol	human
@kylemorehomes	org
@xclusivelyrei	human
@zijnnogvragen	human
@gourmode	unknown
@rebeccafloeter	human
@Lorenzoitsme	unknown
@ElMitoteNY	org
@shanewo4806	human
@WinOneMil	human
@FunnySeesters	human
@IkaSetyo_hk	human
@bahama21	human
@r0n44	unknown
@PastaRemoli	org
@glshalev	human
@cf_wagoner	human
@nowheresharon	human
@JuliaGruening	unknown
@AliciaCarbajal	human
@satoko_es	org
@FishballWeng	human
@chefmomrosebud	human
@CountryGrocer	org
@TropicalKitchen	unknown
@dmunsieee	unknown
@DASHISUSHI	human
@House_of_S	human
@RezRezart	human
@dcebik	human
@MiaCyrene	unknown
@KumamuVG	human
@sofrabakery	org
@TantalizersPlc	org
@adzinaias	human
@nyn_02	human
@Taraballs	human
@AgusKhooPranolo	human
@AndreasZuriel	human
@BTAK49	human
@Ic206Bones	org
@AMPMIEss	human
@IDoItFa_REENAH	unknown
@DonnatellaHowe	human
@catarinam2013	human
@Miaaababes	human
@RT3KSA	org
@rmelicious	human
@Sarah_hewett	human
@ruiantunes74	human
@lifetishdaily	human
@katbox4	human
@hidakasuhardja	human
@annelacy94	human
@Diego47564549	human
@tynesidebarcafe	org
@tathei	human
@Knits_Knacks	human
@CallaLilRapture	human
@alissaangelo	human
@annedejong91	human
@ashami1962	unknown
@lindseyfalloon	human
@marigogharbawy	org
@nishinoke	human
@Dapurpenyet	org
@beiling95	human
@_Ellinia	human
@batsinarow	human
@Ave_ry_J	human
@Lauren__LA	human
@J8Solutions	human
@bambi_fantasia	human
@TheFonduePot	org
@misszoweemoore	human
@omnamaste	human
@evankirstel	human
@Chearol_Elol	human
@patra0311	human
@calista_caprice	human
@BCMNY	human
@HolyCityHappyHr	org
@keys_emi	unknown
@custardorcream	org
@SandwichHams	human
@ChezHx	human
@marylishhh	human
@Rachelex3	human
@xTheLastBaronx	human
@Alita1978	human
@VicQ_77	human
@CafeRichiesto	human
@RamiKadi	org
@IntrovertBaker	org
@viljatilliv	human
@JasmineAuthor	unknown
@mjnobio	human
@justcallmenathy	human
@azie_amier	human
@DJDELANOJA	human
@k3anl33	unknown
@kaM_Artwork	human
@GladisJurz	human
@hi_ro_mi_nn777	unknown
@sammymangopants	human
@carriemae_h	human
@DavidCalhounIII	human
@SkyNorwood	org
@edencraigx	human
@tangQverymuch	unknown
@jimmizacch	human
@bakewithmelissa	org
@connieayala09	unknown
@Air_Lariosa	human
@DowntownWPB	human
@AimeeRaupp	org
@pallavizza	human
@SusanSternini	unknown
@NorsehaSani	human
@WhiteleyDawn	human
@GlensGardenMkt	org
@kameo445	human
@KacheXy	human
@CHARNELLE2	human
@YokuMokuGulf	human
@TGBIndia	human
@munibaram	human
@twist_nyc	human
@Totstraks_nl	human
@LoveFish_Chips	org
@BonnieMarder	unknown
@NormansTavern	org
@Dave_Byrdman	org
@ave52520	human
@ZSGhost	human
@TippinsPies	human
@OnCelebrityNews	human
@DecorAdvisor	unknown
@desseriemanuel1	human
@YardFaversham	org
@McNeng	human
@winyeemeebo	human
@frostydg	human
@hiya_im_edgar	unknown
@lmgold21	human
@LineAtallah	human
@geekindad	human
@JuzoYoshida	human
@APPLESTONEPIX	human
@Philosoph_Stove	org
@alyshabian	human
@terasu73	human
@queenvhyna	human
@bonitamuliawan	org
@EmmaPRCo	unknown
@sangeethaveg	org
@SJKillaB	human
@soepmeteenvork	human
@AshleighPatel	human
@Tomomi	org
@MadeHealth	org
@WorldFamousATH	org
@AVWB_ESTB1995	unknown
@Twilightseven	human
@asaladlover	human
@RozannaPurcell	human
@TopgolfUK	org
@privatedxb	org
@ysk1020	human
@Julianna_MF	unknown
@Lucy_Boo_Mays	human
@TurtleWisperer	human
@StanleyParkBrew	org
@WordOfMouthLDN_	org
@TriLestariatun	human
@MTDot9	human
@meannski	human
@xxxmystik	human
@AbuDujanah9	human
@MeliAravey	unknown
@Brownannie775	human
@hahahafizal	human
@SkiDiDiTMuTTa	human
@WF_Deals	org
@TheMcAteers	org
@iRunFitDC	human
@TC_CERKESLERI	human
@colacole	unknown
@ecem_erdem	human
@miamifoodpug	org
@xxTanzerinxx	human
@chindalove	human
@AcousticJournal	human
@daniel_vais	human
@Bloocheeze	human
@inFineJakarta	org
@DATssocute	human
@RobbyWL	human
@townshipbg	org
@Anil_oo7	org
@ViennaBeef	human
@BottomLab	human
@JoyJolise	human
@kofidagaf	human
@Jay_NeVe	human
@hirohiro1218	human
@bklynmuseum	org
@JustInThymeLLC	org
@iOsQiitar	unknown
@CMAASC	org
@ahpyng	human
@carolinebuchan1	human
@mrspepperpot2	human
@vivianlstyle313	human
@Pipaarodriguez	human
@zorandra	org
@LymoTweetUp	org
@amaramirulyusri	unknown
@chocolatehana	human
@atenithaz_p	human
@re_na_DPC	unknown
@jcartwright912	human
@AtlantaAtNight	unknown
@billycoy	org
@applenamos	org
@willlai84	human
@masupunoyama359	human
@jasmineVesque	human
@MarcusTurbo	human
@Chrisswaldo	unknown
@RomeroGroup	org
@InesMzr	unknown
@DinerDimitris	org
@CRonari	human
@christylecko	human
@tizucelorole	human
@aljeffbasilio	human
@LeSpotNoir	human
@Neenz87	human
@Sho_I_Be	human
@IMJPRO	human
@Skiptonyoga	org
@NETICK_GROUP	org
@VikingRange	human
@HarpersLanding	org
@Amz_Tea_BKS	org
@GRAL_K_ANAYA	human
@JenatMOLM	human
@OldPuebloGrille	human
@Eternity9	human
@RedbankCo	org
@happishopr	human
@RiaTumimomor	human
@ikkookook73	human
@SJOPR	human
@thejuanfruitful	human
@IngryTorres	human
@MyBookJacket	human
@GarnityaWinda	human
@adrianaruggiero	human
@sofiebringas	human
@cocinademuerte	human
@WeRRestaurants	org
@Soophsschoice	human
@SNC_Flowers	org
@PanamaRTweet	human
@PureEssenceLabs	org
@ok_Sophie	org
@RefineYourWorld	org
@amandacroberts	human
@AdrianoCisani	human
@Clubpartyflyer	org
@kosherlikeme	org
@BilbaoCarmelo	human
@peterelvidge	human
@simplynabiki	human
@Victoria_llove	unknown
@kdsw1300	unknown
@rabiahumayun	human
@maeet_maeet	unknown
@fourpointsdt	human
@Cat_ASTB_Trade	unknown
@stefannylukita	human
@pedpsychdoc	human
@annasevial	human
@iamadorkable	human
@hippiehealer	human
@TufnellParkLive	human
@NatasjjaAemn	human
@scarletfever24	human
@k_eesh_a	unknown
@DelorasWetzler	org
@truebeautyblog1	human
@angel31tacbad	human
@AnggieKhu	human
@AnikoAudebrand	human
@mjanerobles	human
@TyHanner	human
@iAmLolaBrown	unknown
@realalinalabour	human
@xinxinshenghuo	unknown
@LuuuuChavez	human
@parent_tech	human
@junchanteur	human
@Shaheener88	org
@J_andresparra	human
@joshujusman	human
@jason_3212	org
@Sumiyo_k	unknown
@edocerruti	human
@michelletos	human
@andreasalazar1_	human
@reyamaf	human
@ERICSEATS	human
@i626leo	unknown
@DixonTam	human
@dimplesAJ22	org
@TatjanaTweet	human
@ConorJames21	human
@MyKitchenDiary	human
@Volim_meso	human
@EATER30A	org
@minisport12	human
@AzziLynn	unknown
@RUMImama0616	org
@HazelCrapon	human
@russo_turk	human
@elryrina	human
@ClaytonKitchn	human
@chaa_ch	human
@a_cha02	human
@funny_liu	human
@masvanputten	human
@LaMaraquita	human
@gienaee	human
@ToriaRogerio	human
@hoanggry	human
@HR_Mommy	human
@ChefKunal_FC	org
@robbo86otm	human
@Rtiss29	human
@TalkToKarishma	human
@Fazile	unknown
@Crystal4712	human
@John_Barati	human
@PinkyFLizares	human
@BDunoon	human
@fdhov	human
@yourpalborno	human
@ichigoyora	org
@Square_Donuts	org
@HealthyGurlz	org
@vindonk	human
@HolleyNholley99	human
@AndrewHeslop	human
@esstartup	human
@marucancio	human
@Raulinc2012	org
@CrisMPascoal	human
@autocat0601	human
@ellieKWONsshi	unknown
@TJs_tweets	human
@Jelena_Kukic	unknown
@AttilaVillam	human
@endisyah	human
@jame_jone	human
@RnDHipsterEmp	human
@sketch678	human
@ashurireiko	human
@RICO_MIDO	human
@Shandy_Blue	human
@kiksthasupastar	human
@maemperez	human
@esterterhoeve	unknown
@AlliPaloo	human
@10photo	human
@GetCraftedNOW	human
@kvb565	human
@hadeemtaufiq	human
@Ema_Breeze	human
@tabbyw28	human
@CrossFitMASS	human
@mariabacodimou	human
@EmoryFaye	human
@yleniamiller	human
@comolomio	human
@jrcpriego	human
@melfann	human
@AandGmerch	human
@AlexKeenan1	human
@nursemeg1978	human
@anfIzzat	human
@joody_Guzle1	human
@flaviaborges	org
@Marco887	human
@PinupBrooches	human
@djalmoney	human
@beautifulsoul40	human
@Venustasblog	unknown
@Jam_0122	human
@niiwwen	human
@Misscady	human
@VillaBlancaBH	human
@Hey_ItsChloe	human
@TWCNewsHV	org
@Jarq212	human
@King_David	human
@haze_b_blue	org
@BeyondKale	org
@SpringsBusiness	human
@CitaCUEvas	unknown
@hellokinnie	human
@iammle_g	human
@VelvetGlovewpg	org
@tintonardhie	human
@SlurpRestaurant	org
@Belfast_Klout	unknown
@JemBaines	org
@WilliamOlivers	human
@StoyFitness	human
@SUBCONSK33Z	human
@HuddleHouse	org
@ChatNoirPoirot	human
@RolonCamila	human
@ApriaNia23	human
@ice_htz	human
@Rebby_Ross	unknown
@Carlos_Pulido11	human
@Balanced_Brooke	human
@TitiCrafty	human
@FrocieReyes07	human
@_the_obvious_	human
@Jaydontwhistler	unknown
@meaganshawww	human
@EarthHeir	human
@susanwong347	human
