@eatravelivemag	org
@miumiu_misono	human
@PRPerception	org
@LauraPrat	human
@sarkajonae	human
@KKAllen_Author	human
@lou6e	human
@HeatherMarianna	human
@iamsheabutta	human
@KiwianaNYC	org
@JonnyD310	human
@deanhoteldublin	unknown
@karl_laird	human
@LuisPiedra76	human
@GonPeloAzul	human
@dbodyalchemist	org
@PaulineWing	human
@FTEnemyNYC	unknown
@nonglexxx	human
@detoxcoaching	human
@Bows_Ribbons	unknown
@somedaypicks	human
@NoddleShuddha	human
@nongtong_55	human
@shisa919	human
@WineGuru2	human
@zeldawasawriter	human
@WalterMira	human
@LaFolliaOsteria	org
@MWrestaurants	org
@KaidCruz	human
@lassecarlbom	human
@chloephoon94	human
@Kirtashalina	human
@SoCalRestaurant	org
@Wang_Food	unknown
@thewittfamily21	human
@iamkhameel	human
@RismaDwiMW	human
@LawsShop	org
@TigerwonNYC	org
@WelshCountry	org
@Ginny9334	human
@JillzyPopz	unknown
@RandyWalker	human
@c_donzelly	human
@DjSose	org
@PlaCazr	human
@paengmie	human
@CityTavernDTLA	org
@MsMeasurement	unknown
@bibitabibi	org
@JennaLongoria	org
@AnitaBuffem	human
@kimbridges1987	human
@DutchAJ	human
@thecharleslloyd	human
@XclusivelyErica	unknown
@Manu_erree	unknown
@PinkyGuerrero	human
@newscam68	human
@FamilyRadioBeck	unknown
@Blue_Grill	org
@walnutpesto	human
@winniekepala	human
@LanceScurv	human
@bricktracy	human
@TalalThabet	human
@yazcanli	human
@JosephLou	human
@adriszamora	human
@khriztianleon	human
@MoreAlondr	human
@LesleyM1126	human
@WhatGloriaLoves	human
@JoanrbrooksR	unknown
@AleenMathews	human
@rurikasugarplus	human
@kram_wid	human
@anisuffee	human
@foodmadebytom	human
@WeymouthClock	human
@RubyRed617	human
@paagalkhana	org
@The_Real_Nez	human
@wandywoo1	human
@RichardJusup	human
@cookaholicwife	human
@BlueMartiniFTL	human
@GraffBayCity	org
@Memnon_	unknown
@TeamProApps	human
@WorldFamousPB	org
@Jimmieschocolat	human
@s_fudge_ken_ism	human
@perfectlydishev	org
@onlineberniaga	unknown
@JWHEATSR	human
@yoyochenghua	human
@elenamhernandez	human
@FRGSummerhouse	org
@HashOffFood	human
@Moha_Celvan	human
@intuwatford	org
@monzaskd	human
@SignaturesResto	org
@CaramelizedT	human
@ysy448	human
@white___orchid	org
@drouin_erica	unknown
@fhineleecious	unknown
@jessicaordelia	human
@sylkelopez	org
@BtWeightloss	org
@flourarrange	org
@AineCarlin	human
@MsMathi	human
@FlavorfulExcurs	org
@VivaBrazilL1	org
@edgardmariano	human
@HalekulaniHotel	human
@haalcala	human
@modelnyesha	human
@michelleposadam	human
@ThaliaWiggins	human
@angelonfire23	human
@Cafe_Grounded	org
@AlberMndz	unknown
@Love4rmJudeGirl	human
@MrsMmeCharlotte	human
@SteffieLaw	unknown
@AkoSiJown	human
@CampeonNYC	org
@David_Ishmael	human
@CogginsPollock	unknown
@nolapartyof2	human
@EdgarIbrr	unknown
@CrickChris	org
@RiIseAboveAll	human
@ktaperez	human
@FaithsWayFit	human
@takaaki373	human
@SakayaKitchen	human
@SusannLind	human
@BatmansBride	human
@lydiafhall	human
@renbabyvip	unknown
@fitupofficial	human
@nonahanaedina	human
@iusedtodothat	unknown
@RedDoorLeawood	org
@linvanilla	human
@paleo_margo	human
@Tirage_London	unknown
@ruminasato	human
@sarahwilkon	unknown
@PhillyNightOut	org
@jejeeha	human
@CrystalEsser	human
@klriv6981	human
@MercatChicago	org
@rifkyvettel7	human
@MahirBLUES	human
@MokshaDining	org
@cicizuzu	human
@mshatila32	human
@iamangeladianne	human
@indianapolis420	human
@evelynliem	human
@zoivision	human
@thecleanmenu	org
@dgirl48_ang	unknown
@msmeimeiz	human
@CristaLee	human
@homcharleston	org
@BROTHALOU	human
@Irapirsun	human
@TheHandbagNews	org
@PolidoriSausage	human
@mstashaizlovely	human
@iTunes_Codes_	human
@MarkOglesby	human
@Malolilinda	human
@virginiebalijon	human
@GoodfellowsLtd	org
@Tweet_Ireland	org
@Hilda_Mariana	human
@illegalmouth	human
@88G_DRAGON	org
@rjrogo	human
@fashionenvogue	human
@rogerrabbitss	human
@stefan_nteph	human
@khai269	human
@nontan___	human
@YasminaCazacu	human
@healthydubgal	human
@Donny4623	human
@DonnaBARGA1638	human
@jasonetperez	org
@DeenaPinto	unknown
@qatareating	org
@edgalbani	human
@ThitipalO9	human
@hsuancp	human
@jacy3110	unknown
@bloodybestchi	org
@LYFEKitchen	org
@foodcology101	human
@pablozarg	human
@maudejrobbins	unknown
@slines	human
@BellamysDining	org
@stephzuniga	human
@LeaVelours	human
@RenWaverly	org
@elisadalbosco	human
@BeSmart_kz	human
@rherreraIE	org
@tae_chick4	human
@winendine_Ww	human
@DoxisBekris	human
@MbaliBAM	human
@Nic0Lin0	unknown
@ciprianogjr	human
@SandrarbowerR	unknown
@momfiles	human
@JC_Mason	human
@ZAIDAHMED_97	human
@genpalabay	unknown
@MontLalin	human
@Sheer_Delight	human
@Ronnie_Mex	human
@JvilleKitchens	org
@Classymom6581	human
@GinaMurrell1	human
@adidooms	org
@D_KING_OF_KINGZ	human
@foodie_ling	human
@CuscatlecaBakry	org
@Cured_Bridgford	human
@RustyDogLee	human
@lesterlee55	unknown
@ADAMCUMMINGSS	human
@parekoys25	unknown
@MamiSongaMorena	human
@isanticorchiano	human
@PertwoodFarm	org
@Tahinirest	org
@ghianpullan	human
@MsTramayne	org
@OutpostCoop	org
@theazcenter	org
@LinenHallNYC	human
@whatsupgudali	human
@NiSiDP	human
@ponyo1929	unknown
@VividhFineDine	org
@xxx_yumika	unknown
@TheChilliPickle	org
@Hg2	org
@goodnightlovely	unknown
@jiyuu1102	human
@MrCroqueMX	human
@fawnheartcronin	human
@jeje_tol	human
@gotomycompass	org
@susanmdavid	human
@NIshakCTV	human
@fioyendilotto	human
@KaraGould85	human
@SweetandSocial	unknown
@1406produccions	human
@lovesgallery	human
@scottkRVA	human
@stanardfoodpix	human
@EDI2822	human
@hallschophouse	human
@KlareensAffana	human
@ICAL_MIRROR	human
@SRochelleB	human
@jorgeadriandm	human
@CampariAmerica	org
@Marcell7893	human
@RmrzDul	human
@JairoLara65	human
@ky_shiorin1209	unknown
@TavistockTT	org
@FinnMcCools_VA	human
@Lara__hassan	human
@TalkRadioPower	org
@tsaraka	human
@danicaxoxo27	human
@BeingEileenC	human
@Tishap89	org
@kureinai_011	human
@jenz_kwok	human
@KingofKitchenTR	unknown
@Lukes79thSt	human
@apyo_pyo	human
@newshaven	human
@lizlasarca	unknown
@jocydyfapyhu	human
@RealAllen23	org
@RetweetATL	unknown
@GianzRossi	unknown
@PennyLaneWB	human
@jgriffith615	org
@MADTravelDiarie	org
@IRONEMOTION	human
@paulregabooks	human
@IniQual	org
@angskk	unknown
@luludeshop	human
@CertifiedSteak	human
@moriliche	human
@zehmatilda	human
@TheBootyGeek	org
@Square1682	org
@JerryHousel	org
@lendakosowski	human
@michelelove67	human
@ruruu516	unknown
@mamashighstrung	org
@1SweetAppetite	org
@chemistdikauna	human
@NotlawFilms	unknown
@date_night1	human
@DeanneBlom	human
@AVKP	human
@ForeverLovelyC	human
@Ina_Angel	human
@PatzKaegi	human
@busymamareviews	unknown
@Power_PilatesUK	org
@dittie	human
@creativeddam	human
@AmandaImani	human
@viviancsm	human
@Oftravelsntales	human
@shuns1109	human
@stith215	human
@heatskitchen	human
@AdriaVlds	unknown
@Games_Box	org
@KarenkyeeK	unknown
@Allthingspitts1	human
@KINKI_LOUNGE	org
@J_Kwest	org
@LAC4Commish	unknown
@JimJamGin	human
@KcalWorld	org
@blossomcherry_c	human
@KatrinaElleP	human
@Bongphyn	human
@fashion_marias2	human
@DubDrinksCoffee	org
@izkradeep	human
@PhoenixFlamez07	human
@dailyherald	human
@Novemberhunkkk	unknown
@TheParisNYC	org
@MamaRougeDC	org
@BoldskyMa	human
@MCM_Deli	org
@NSsnacks	org
@trip4real	org
@valarmos	org
@Trevor_Bouchard	org
@clovieee	human
@ProCheer_Cara	unknown
@IrvinsBrasserie	org
@stylekaew	human
@PrinceThony06	human
@aplomin	human
@naturalvitality	org
@EmporiumPluit	org
@saliredo	human
@r_burdine	unknown
@kinsaiyamiraku	human
@pooh_1960	human
@MariamMarts	human
@rutycorral	org
@fadzlinarahman	human
@VVVLeusden	human
@HiRolla1	human
@RubenMorales62	human
@MrcoVla	human
@ThanakornNY	human
@peachytweety	human
@LAKES70	human
@smarlaang	org
@sandeep9sarma	human
@AngieCMercedes	human
@cornishl1	human
@Niceguyitachi	human
@dietitianuk	org
@MissParkAve	human
@AuraCrb	org
@adenorah	human
@HarvestBarnNOTL	org
@tysonklloyd	human
@thegomamas	org
@Dliteproductos	org
@YN0402	human
@engelineong	unknown
@journeyitself	human
@TeddysCoffeeBar	org
@elraqs	human
@KarolineLys	human
@novemberl	human
@TimHortonsGCC	org
@GusGusFunBus	org
@mumsthe_world	human
@razonater	human
@LadyMRod	human
@TheCounterEd	org
@pickles_pears	org
@AlessandroNove	human
@markfx411	human
@speakingofstyle	human
@micaelabbb	human
@memevelasqez	human
@waimearoyal	human
@ateh0704	human
@Fap3000	human
@majumariejune21	human
@ILuvMyLips	org
@sierra_csc	human
@IrmaCorales76	human
@mont_conti	human
@ItsKinzaaa	human
@jali_chef	human
@jennerrxo	human
@JockYogaGuy	unknown
@tijan50	unknown
@NormaAgrr	unknown
@AceNasir	human
@IndraAizen	human
@crazy_head08	human
@GreenHenDublin	org
@mamakebed	human
@Fabrytam1969	human
@bymiyu	human
@dgsinwny	human
@taylorddante	human
@l_mikhutina	unknown
@eetsu0121	human
@m_benedicto	human
@SummerGrayStyle	org
@drocktrot	org
@thesarahsummers	human
@ClaudiaShanta	human
@SYorkshireHour	human
@MaxPayne316	human
@meals_chiswick	org
@DaraInHawaii	human
@TheCaskRepublic	org
@julesolandesca	human
@LulusNoodleShop	org
@maunderingmuser	unknown
@fashionwebby	human
@ruhrestaurant	org
@kokalazar	human
@Kurtflurt	human
@SmokehousePDX	human
@juuuleee_bln	human
@NancieTT	human
@nadiah_luescher	human
@alexepriska	org
@Jewell5022	human
@_madaaa	human
@innaaacavalli	human
@_chefjc	human
@Carry15456	human
@SugarLeafTreats	org
@Giftbak	human
@FortKnoxFox	unknown
@Huev0D	human
@brianhasfun	human
@bernaozkan35	human
@DaHomieChris23	human
@ddestaa	unknown
@scizzics	org
@PuertoSanLucas	org
@solarestaurant	org
@Glowbal_Group	org
@805Foods	org
@zero829	human
@SweetiesFree	human
@DjElSid99	human
@Giaaaan7	unknown
@dLifeofStuff	human
@pmehrlich	human
@NikiVincelli	human
@Changing_News30	human
@sakura19xx0111	unknown
@cucharaoriginal	org
@ItsOnWithA	human
@Sicilian_Food	org
@PPSEACL	human
@Fitho	org
@HealthyBalance8	human
@starbasset	human
@FashionandCream	human
@vanessalmorris1	unknown
@yavis1991	human
@paulapack	human
@m_mastropietr	unknown
@120Diner	org
@HealthClique	org
@creativeplate14	org
@OneSnobbyFox	human
@cliffpavlovic	human
@VandHcafe	org
@hmr_tete	human
@ALMOSTANEER505	human
@SvHeredia	human
@GuhChicken	human
@glezcadiz	human
@BornRisky96	human
@nastyshot88	human
@jerrysoon	human
@_Enchantress	human
@HannahPa1	human
@_petzy_	human
@rgs1000	org
@gardeniaph	human
@NoraGuzman654	human
@VittonesPizza	org
@KillaPandaBear	org
@TinaLobondi	human
@TheMatthwsHouse	org
@GourmetTableMia	org
@Diego86092	org
@tintoys05	human
@rahulbijlani	human
@lilhope2003	human
@mommy2fiveboys	human
@AlfredoFierro75	human
@diggums317	human
@phthalogwen	human
@LrnzoBtz	human
@washingto_t	unknown
@TarekGeyer	human
@elha0224	unknown
@MonicCrvjl	human
@SamanthaSpice	human
@lilzlilz	human
@MaxxPerformance	org
@markstrausman	human
@MayaBurritoCo	org
@hoxtonradio	org
@trcicb	org
@AimeeMeng	unknown
@Living_Lou	human
@quecomemoscoach	human
@RadioUnplugged	unknown
@larasalud27	unknown
@michelarom	unknown
@Woodworth4	unknown
@SammyJacq926	human
@khrissieloves	human
@pipeyanguas	human
@rubbyroo1	org
@koukou_dennsetu	unknown
@McmorriB	unknown
@Ligniet	human
@changemichael	org
@Shawnna643	human
@morewirralcusts	human
@LoyalLeoPride86	human
@cheryljespinoza	unknown
@YirouYen	human
@MrsHx3	human
@SimonPellegrino	human
@learn2fly	human
@ViolaTozzi	unknown
@ShirleySjr	human
@ray1307	human
@lula_deli	human
@00046426535	unknown
@LowndesDining	org
@WASABITEPPAN	org
@JenWilson2602	unknown
@AudhamEnTha	human
@PrlaVrez	human
@Robbie_Gallegos	human
@DanielleMariaxo	human
@TheFoodClub_TR	human
@FrostySpell	human
@nelkson	org
@ariannegozon	human
@piquecooking	org
@CosyManchester	org
@WellandGoodNYC	human
@JingMaghibon	unknown
@chrispang89	unknown
@elogerolin	human
@FoodieStrid	human
@kerihansen	human
@BarToma	unknown
@flyingkettle	org
@Bell_Horus	human
@eatdrinkoc	org
@AndSheCodes2	human
@Verdis_food	org
@FettyLMAP	human
@bettyafoust	unknown
@KangIpin	human
@tjiayuan	human
@FANOFGIADATODDM	human
@andreyodessit	human
@Buckeyefanohio7	org
@tacosandtequila	org
@slowdownsavor	human
@globalbeauteh	human
@WhippoorwillTO	org
@0hlahlah	human
@periosan	unknown
@RDrils	human
@MariaProvenzano	human
@tya_priyandito	human
@pie_rivera	human
@jasminemendiola	human
@BeyondBarbi	human
@MindOvrBatterNY	human
@Cremaschina	human
@jakobimiiking	human
@KP_Utami	human
@marieLtaylor86	human
@BeerAcademyHome	unknown
@ichitarok	human
@escapehubris	unknown
@IDalexandregoh	human
@Khreyane	org
@YssaBella0430	human
@Oon_Yi_Xun	human
@dindaurora	human
@Lela_Rahman	human
@akitirz	human
@TiltMumbai	human
@walteretbell	org
@negrodamus91	human
@JennJukebox	unknown
@mamalucilove	human
@ayaselethe	human
@forkfellow	human
@LaPalapapgh	org
@nick_botham	human
@HaTomTai	human
@PicnicSitges	human
@BristolEating	human
@juicybeige	org
@aerowellness	human
@amccollums	human
@BitewiseApp	org
@JadeyChow	human
@Sigina	human
@OldeHearthBread	org
@jody4presidente	human
@blackscallop	human
@GiusKent	human
@FatimahBura	org
@TheHuntsmanTO	human
@MrElliotTorres	human
@HavanaCentral	org
@KargiGogoPDX	org
@KikiPedroza	human
@some_cities_wm	unknown
@Thippadey	human
@QuarrySpoonBlog	unknown
@___a0y2k01	unknown
@jessmccallum81	human
@JulizaAdzlizan	human
@PhoebeJean7	unknown
@ashlfox	human
@blackjeweltc	human
@9zY6fX	human
@fabfoodieblog	human
@DanielleS_Dec	human
@JayHeey	human
@Sarshyeats	human
@WFM_Nashua	unknown
@HeavenlyPasta	org
@DesertPalmDubai	unknown
@hijabistamag	human
@JagieSelayro	human
@nudfud	human
@giodantonio	human
@hanginwidow	human
@Charoenchai_Ch	human
@ChefRichSweeney	human
@Habtoor_Grand	human
@shindelsea	human
@chelseasiegel1	human
@Kazto_100720	human
@cheerykitchen	org
@CafeMarie	org
@paigekjohnson_k	unknown
@Theladygilbert	org
@soufi_mazlan86	unknown
@SunandSipCups	human
@kwaichi	human
@peaches07	human
@Innisbrook	human
@emeline756	human
@Gay_4_U	human
@snadymujic	unknown
@veeno_uk	human
@ChefMacT	human
@RashaInTheCity	human
@BrodyYoung1	unknown
@Gardrigo	unknown
@eaprile	human
@THotelCagliari	org
@AllanManangan	human
@SultanaOf	human
@ElikaLaylaEka	human
@OpenTable_BOS	org
@_CastrO_	human
@lagoblu	human
@BoundaryLDN	human
@iAmRasta_Rebel	human
@IYBM_TakinOva	org
@RogelMns	unknown
@MissRemus	unknown
@RohailShow	unknown
@BellaDonnaAU	human
@ruralrooted	org
@salsanch	human
@2UrbanLicks	org
@MartyMartin28	human
@gregorymiller00	human
@fera_felicia	human
@kennardt	human
@natsnextadv	human
@mho2405	human
@NL_Princess	human
@Memo_MKS	human
@Chocolate_Vent	human
@nikkleszsz	human
@Kepo_Bandung	human
@misscocopuff	org
@JunaeBenne	human
@LolaGanzarolli	human
@phoenixcaterin1	unknown
@NicolasIc_	human
@ChicBeauty_	human
@Frydelig	human
@ShariGiordano	human
@Tropisueno	org
@paulorendain	human
@BTKris89	unknown
@NanaMontufar725	org
@DavidAbes	human
@DoktorHeinrich	human
@PeterRabanus	human
@Oceane_Rodrigue	human
@sugapie30	human
@JosiahBenton3	unknown
@MIOX0I	human
@Donniemay0810	human
@enomooshiki	human
@KimFoodTalk	human
@tinytgilbert	human
@EllenaholmgrenA	unknown
@W39thKC	org
@vaninabuda	unknown
@AdrianaLiquori	human
@sugengpurnomo75	unknown
@Brynwchef	org
@christiegstein1	unknown
@AsahiBeerClub	org
@Uaeiyah	human
@CassanSwiatek	human
@SoFLiTay	human
@amanda_paa	org
@msttake	human
@JOANNALETIZIA	human
@aliceb0balice	human
@nicholaschong23	human
@brightonchamber	human
@HighlandParkMkt	org
@QX179R	unknown
@Amberlinella	human
@Suzy468	human
@fantasticharris	human
@KimAnhLePham	human
@BackCafeDuMonde	org
@reenaflores	org
@lolyta_hikaru	human
@SnackItToMe	human
@debtfreeguy	human
@tictactoc2015	unknown
@Ahlamaltaamare	unknown
@adventmonk	human
@DraSusanaKury	org
@urbery	org
@PPGWinterPark	org
@healthyhen	human
@eastcoastdiner	human
@eleneivelin	human
@clubbrasserie	org
@Watchfit	human
@Sleek023	human
@Cheranlly	org
@aryllamien	org
@nuts72	org
@KaseyBateup	human
@iNeymarrjr	unknown
@ShrylMgwd	org
@IzeSnowy	human
@ThiBangHoang	human
@homedecoraguru	org
@AnnoDomaini	human
@TheCrwys	human
@michellebjohns4	unknown
@kyoko_tojo	human
@ValpakWorksSJ	unknown
@durellarthur	human
@oliviasutantoo	human
@BlackHustle876	org
@mom23blog	human
@IsmaelSanchez83	human
@wanderbloom	human
@Wendellrodricks	org
@DuLa_ND	human
@glenamiu20	unknown
@DelmonicoGrill	human
@mammajossan77	human
@joetoastino	human
@chantlewhite	unknown
@Fanychachi	human
@SexyCASportsFan	human
@QararaRasha	human
@liguoripartyof4	human
@EWindshield	org
@TheDallasDiva	human
@Child_PR	human
@aafiya235	human
@afbnyc	human
@ktacbangoon	human
@cindyzax24	human
@anthrofearE	unknown
@Marco23Ermini	unknown
@AlveesAndree	unknown
@moonstrik	human
@emasherbone	human
@Will_Cortez	human
@BreastCancerH	org
@AoiHirayama	org
@tedz_lee88	human
@borakaradana	human
@StillHangry	human
@ChefBanksWhite	human
@azure_amalfi	human
@Sagi21Aeb	human
@AvailRhey	human
@diazschloss	org
@BrainBalanceSF	org
@pandora904	human
@AtlasTelevision	human
@hi_aibiby	human
@zylva	human
@EdwardJinKim	unknown
@genisosall	human
@DesayunaGalicia	human
@Nutritionforeve	human
@MrReply	human
@MissLx150	unknown
@tai_emery	human
@tengkukery	human
@GCSouthampton	org
@bossbill1	human
@007mortgage	unknown
@snrkdnfj	human
@elisastile	human
@BestRecipesFind	org
@emalocks	human
@WholeBodyReboot	org
@Sarahtoland18	human
@paocafetampa	org
@Zora_by_L	human
@ServicenEventos	human
@rawfoodbaren	org
@mikogat	org
@I_amGob	human
@Quibellp	human
@CodenameSoda	human
@vincentlai	human
@laurentwalker_t	unknown
@FairburnsEggs	org
@MirBon	org
@localharveststl	human
@orkt1977	human
@lemonfilmblog	human
@Alzarubn	human
@MrBuchanan58	human
@alechecasino	human
@AgencyAddicts	org
@ayacompose	human
@BeeHouzz	org
@swannewbybridge	org
@GlassOfBubbly	org
@xwraymusic	org
@Knotis	org
@LariosOTB	org
@CinemaBar1950	org
@ashleieio	human
@skyradio101fm	human
@netutcc	human
@Tafaribuzzin	org
@Kale_Mustang	human
@hellobobbahouse	human
@MBGlamourville	human
@houseandecor	human
@riana_ifacs	human
@tunnetila	human
@rudylopez86	human
@CaitlynvwarrenV	unknown
@GAIA_LifeForce	org
@summerplum	human
@SimayTurkoglu	unknown
@tusharthorat	human
@SuperStarJayvee	human
@juancelistino	human
@LauraHartshorne	human
@bebejosephinedy	human
@rejjisheart	human
@undergroundchi	org
@SydneysGourmet	org
@YemSmoothies	org
@BrotherAmos	human
@BIGTYME221	human
@heatherdcRD	human
@dublin_dining	org
@robedibimbi	human
@ThePrimeHG	human
@AgentBertram	human
@FabiolaGmz_	human
@03Antoine	human
@suhossiii	org
@PopplewellC	human
@grogreek	org
@FokkoWolthuis	human
@AZheartsong	human
@KeishaKroeker	unknown
@ShangTing_Hsieh	human
@okinawaadairsvl	org
@capricorn3577	human
@lovemonello	org
@HotelStudios	org
@OrganicFood_dxb	human
@M6Martinez	human
@susaneyoung	human
@TeddiUrsaring	unknown
@OxygenCafe	human
@kaylaRawrss	human
@therockmylife	org
@CloeRigaud	human
@francismagsajo	human
@xSaffie_starx	human
@DRPlife	human
@ZikizWraps	org
@PamelaVazquez98	human
@PriyankaBhadran	unknown
@LVBss	human
@LeParcObernai	human
@KilljoyKidPL	human
@partymenuplan	org
@devonvalley	org
@aziey_zaini	unknown
@GoodfellowPaul	human
@Anj1LL	unknown
@brunchdukest	org
@MyPlate	org
@oxafina	human
@OliveNektar	org
@ShadowofOrchid	unknown
@matteblackorg	unknown
@ChrisMcZero	human
@miss_aly	human
@thecheesecourse	org
@eMazingEvanston	human
@mrs_k_rock	org
@iamlin_DUH	unknown
@missfrugal	human
@ThelmadwestD	unknown
@EtralaLondon	org
@enelrahs12	human
@MaxChina3	human
@nyonyacyber	human
@ProduceJenn	org
@robindmann_d	unknown
@Cody6860	human
@King118	human
@diddy_di50	org
@Benjamin_C_Dean	human
@FirstCanadianPl	human
@CAOutdoorPlay	human
@DeraMason	human
@MultiMediaBeck	unknown
@NeilaK20	org
@eleqt	human
@DinePhila	human
@Webkinny	human
@VictorsCafe	org
@tercise	human
@LaManchaW4	org
@zicomarr	human
@revitamt_ELF	human
@HenryJooneur	human
@BeachCityDee	human
@DarlingHomesInc	unknown
@Gladvillain	human
@lapsed_angel	human
@cjbarna	human
@MyMisa31	human
@ThomasScriven	human
@Bettykatexox	human
@HakimBe	human
@RobynAdams86	human
@naonanohome	org
@Changing_News28	human
@FreedomFoodsAU	org
@starstylecom	human
@proteinbites1	org
@_mariisms	human
@dOKEdOLLAZ	unknown
@kaycammack	human
@gianluca_san	human
@lauraetflores	org
@bangersandbacon	org
@cceesworld	human
@indlest	human
@TowandaJAZZYB	human
@Syltbar	org
@JasonBoojs	human
@rajean	human
@DelfinaRoloff15	human
@OhioCatfish	human
@magzy7	human
@elle_florence	human
@_PettyCrocker	human
@tylerg_casper	org
@unitedramen	human
@silvanefranco	human
@racingit1	unknown
@Himchanoona	human
@dtlaartdistrict	human
@smiling_ly	human
@LindenIsSocial	human
@WhoLovesYou_UK	org
@My_Recipes	human
@AngelicaIbrr	unknown
@MimiPerez17	human
@WallyStacksUm	human
@thecorktown	org
@TowerOfVape	human
@verygoodcook	org
@shobhan03	human
@TheChefsPlate	org
@guerrera579	human
@RolandoC_	human
@Table24haarlem	human
@NayaMacuha	org
@chipsaHOYT	human
@vickymrt	org
@EatsInTheBed	unknown
@Beyonciara	org
@pinterventures	human
@yuuchan4649	unknown
@thatsTamil	human
@UlisesTorres87	human
@HamptonManor	org
@iRapReaL	human
@HumbertoCastr65	human
@HungryNiallerr	human
@GonzoLecture	org
@guyscorp	human
@nic_moniQ	human
@mandkbutchers	org
@LaParrilla	org
@HalfPint_19	unknown
@RegionWellness	org
@AHNutritionist	human
@silviatug	human
@londonbriki	human
@ronanr	human
@heenalmistry	human
@burgersaloha	human
@sojufied	human
@Sahakiel	human
@HoustonAffairs	org
@mrquacy	human
@bcookingrecipes	org
@Food_Eco	unknown
@ChicosLeamSpa	org
@Itsgayu	unknown
@vonnechunjuan	human
@CUZZIECUZZ	org
@healthatworkUK	org
@StephaneMouttet	human
@meglaurensia	human
@WarfordRebecca	unknown
@Ai________Lee	human
@OElenaNavas	human
@CoyaDubai	human
@ceritamucom	human
@kernelita	human
@BowdenGroup	org
@DrNirvana	human
@adsballesteros	human
@MyLifesJourneys	human
@SkyloMarQ	unknown
@LetsGetLunchin	org
@tecco975	human
@leiannoffduty	human
@bewellbuzz	human
@BirrieriaRosa	human
@jMacklinsGrill	org
@_STUFT	human
@CoiTajoDesigns	org
@FarmToPeople	org
@heypau2	human
@emdad07	human
@bigcitylifemag	org
@TattooNewsUK	human
@MBonabudget	unknown
@woodsidegc	human
@jraeanna	human
@JenFerruggia	org
@smguarneri	human
@SexyRasMusic	org
@BryceAsher1	unknown
@OneCanadaSquare	org
@MzDerria	human
@master_blizz	human
@paolahernandezj	human
@JoannWinborn	human
@noelconan	human
@biggs9172	unknown
@panda_desu	human
@Melt_Shop	org
@NaggiarVineyard	human
@doggismore	org
@CAOLANO	unknown
@jade_walker1	unknown
@kage5	human
@trinadolly	human
@BeautyPepy	human
@eellaa04	human
@fly2themars	human
@iamfrodin	human
@photogirlbtf	human
@Izzo202	human
@wildburgrr	human
@Pharaohsis	human
@IndasAdventures	human
@EmmaPigsRoses	human
@gwenbeau	human
@springtomorrow	human
@VersesCuisine	org
@anahirobs	human
@WellB_Leb	org
@imjacobfuller	human
@missaoki	human
@RaqulVg	unknown
@dreamshomedeco	org
@ciarale01	org
@Bevsmartly	human
@NYStatesofMind	human
@MillyBag	org
@ChocolateBarUAE	org
@RachelsRiches	unknown
@RahulP86	org
@madzandosay	human
@BtzMedina	human
@ImKylee	human
@styleandbeat	human
@BaywoodClubRest	org
@Airenme1112	human
@Classified1A	human
@ShantezPR	unknown
@drnitesht	human
@ANTO_DMV_PRINCE	unknown
@imjenchen	human
@focusgroupvzla	human
@javoletas	human
@jaimotto_1	human
@bar145kentOH	human
@UlisesVzqz	unknown
@CaptainBaxterSK	human
@AngelosPreston	org
@shta_bel	human
@EATatFigandYork	org
@MigulAglr	unknown
@Commeorstyle	unknown
@AshMarinaccio	human
@satoru2181	human
@mr_independent5	human
@AllDesertGarden	org
@buchihinata	unknown
@overunderdown	org
@TheOlivePants	human
@GreatFoodPlease	org
@Big_Herbster	human
@BillieO2	org
@loswochoos	human
@coachnutrispt	human
@Ianandbeverly	human
@Siharath1	human
@caf_leo	human
@JL_TheProfessor	org
@Binge_Daily	org
@susyrico	human
@officialroyston	human
@poiseinparma	unknown
@oballajohn	human
@skiingischilly	human
@NitaSellya	human
@DeeNailArtist	human
@pingngray	human
@Websterku	human
@Kaleigh881	human
@ecctay	human
@NPurplemore	human
@foodytown_vegas	org
@jbrox08	human
@maikazaldivar	unknown
@vheney	human
@FloHolmes921	human
@ErinLoves2Run	human
@Karla__Castillo	human
@KJacksonCumbria	human
@Cafe1500	org
@Epochehns	human
@WakinyanMaza1	human
@FishWorks	org
@KHConductor	human
@DelishNutrishRD	human
@KarmaGT	human
@AlinaCampbell	human
@BingePod	unknown
@vanyacuy	human
@nasi_pelita	human
@BarronHufkie	org
@ThisMomWinesLV	human
@ILuVDr_Seuss	human
@TINEtenenen	human
@MarseilleDeals	org
@SopieSchifer261	human
@InnsBTS	org
@VABeachJess	human
@jusjus7	human
@gelixr	human
@DiscHealthyFood	org
@SugarPeppers	human
@TheFanGal	human
@cl_hostel	human
@xeniamd	org
@BF4FROSTING	unknown
@graspkun	human
@iheartyoyo	human
@apelemon	human
@DitaDamaii	human
@AngelMichelan	unknown
@Ronald_De_Loner	human
@MarianaShark	human
@thet25	human
@ashishgakrey	human
@oliviaarezzolo	human
@3ll3nlauw	human
@Ruby_Gallery	human
@arilyairfan	human
@idropo	org
@skemer	human
@BluffViewCHA	org
@FunkyWhiteGuy	human
@eleny_eli	human
@EatDrinkCoconut	org
@TELDOLAP	human
@Servilarcas	org
@rocKEITHeer	unknown
@ZoeyZhang1	human
@GabyBosker	org
@itsdaniellaa	human
@AmoFranklin	human
@IONutritionco	org
@alia_ainuddin	human
@RitatsolanoT	unknown
@Will_Sparkle	human
@Mavidearmas	human
@CoachHannah_BTC	human
@rocketsflyaway	human
@nopillcaddy	org
@Jennachengg	human
@DurhamLover	human
@Just_Jaco	org
@sunnysidegrill	human
@TheTeaDetox	org
@Oneindia	human
@MarriedJen	human
@thinforwin	human
@eatneatfoods	human
@LauraBijoux	human
@siewlee1810	human
@a7x121985	human
@HealthFitnesscz	org
@Princess_Sian_x	unknown
@glimmertwintx	human
@fojuhufymywug	unknown
@SandraRobbins32	human
@AlamandaCP	human
@aktetreault	human
@laura_mndzlpz	human
@angie_hikaru	human
@Abbiew14	human
@christine_THA	unknown
@LeynasKitchen	org
@Nielsen3hop1673	human
@sillissandwich	human
@reek6	human
@XANtthe	human
@C_Stanbury	org
@GraysChorlton	org
@earlsTK	org
@TheEpicuresDish	human
@LaurieEspino	human
@gfgotoguide	human
@Insta_VWT	human
@nelly2212	human
@IsaElAton	human
@de88888888	human
@elenadimarco	human
@GetMomFit	unknown
@jayleen_	human
@LoutrePoilue	human
@LottieLoveFood	org
@DianaManciaa	human
@ValentinaHortus	human
@KidsRFoodies2	human
@food_lunatic	human
@rtcompetition	org
@meigen_eiga	unknown
@mpitsheva	unknown
@zigiprimo	human
@LZenoR	unknown
@Joelho_de_Porco	human
@CATHERINE_PEATR	human
@MissRubyLips	human
@B_skillz18	unknown
@CleverHenFoods	human
@LifeAficionada	human
@jesuisdianaaa	human
@socialmoms	org
@kaixinwong	human
@JudithLuscalzo	unknown
@Jabbers19	human
@lindsaytaub	human
@Manoel_A_	human
@Dshizknit	human
@BrianLindamood	human
@pickuphill	human
@BLONDIECANTUC	human
@AndreaPagan	human
@Angelkitten39	human
@LianaLove86	human
@hibabyblog	human
@choco728	org
@vancityreddevil	human
@littlegath	unknown
@giulia958	human
@sdik0051	unknown
@poiofloda	human
@grinnerlynn	human
@mynameisbrew	human
@shinsingkit	human
@TeresaGilSC	human
@apurvrdx	human
@VicDalyce	human
@WWSoupDragon	human
@Fulgencio510	unknown
@NakedPigVernon	org
@wordupincpatty	human
@Serendipity3LV	org
@CityTavernCC	human
@knowledgelaw	human
@aregli	org
@Divegirl808	unknown
@willardschoff	human
@MlleEnIrlande	human
@corinnetrang	org
@YukieBabii	human
@misstiarej	human
@UPSManLIVE	human
@jdrade2377	unknown
@LisaComento	human
@iamchrisjohn	human
@LoveJerseyFresh	human
@JpHubbard	org
@robertvasicek	human
@irrrawrrr	unknown
@kumi02kikilala	human
@double_radish	org
@ModeDevoted	human
@eddy2090	human
@N3V3RNick	human
@BestFoodGroup	human
@TuttOSuLinuX	human
@gustavoalcocer	human
@daviddepalma	human
@NadiaAzahari001	human
@Tasha23Sexy	org
@DenHartama	human
@RafiDean	human
@JoySanley	human
@thesamuelbaek	human
@LowaBeebe	human
@jeanschris	org
@europabridge1	human
@LindaPortman	human
@yuka0109	human
@OsakaBestLunch	human
@VVSDS	unknown
@CrepeCoCafe	human
@FelCeeCee	human
@GirlsBoysandMe	org
@HomeLifeAbroad	human
@SuperRary	human
@beardnose	org
@LeStUrbain	human
@PaulRutters	human
@AshiqinHaris	human
@leahh_95	human
@MarieElleDee	human
@mccjr02	org
@FletcherFoley	human
@AncaSurdu	human
@Heathers_eats	human
@lafedesonoio	human
@claner	human
@Franky_KNugroho	human
@LibritasDeMas	human
@Italyrometour	human
@RaquelSoraya	human
@AnchetaCelest	human
@fashion_istany	human
@BrocksWkoutVids	human
@EmerilsFish	org
@JaimeGonzalez24	human
@SofiaHanden1	human
@LemondNutrition	org
@_Dannyr04	human
@CrosstownDiner	org
@RickyRandum	unknown
@ajoyadvani	human
@caseyfordalexan	human
@Jones_HerneHill	org
@5683_968	unknown
@wearebangradio	org
@GalleyandGarden	org
@DretodiWurl	human
@Joesbrighton	org
@Mila_Furman	org
@krismanoelle	human
@maymae_luv	human
@HugosRestaurant	org
@justincsm	human
@batubarkut	unknown
@AlFeezy205	human
@precisina	human
@CAGrownFruit	org
@zaidijai	human
@LLRfitness	human
@WatersWife	human
@MrOrlandoDavid	human
@Damn_Genie	human
@rowygajoqojy	human
@sarah_mestarihi	human
@ToKenBBQ	unknown
@Itechecom	org
@HausOfDAY	human
@Ruh_Roh_Rachel	human
@katiericard	human
@purplediego	human
@EhonStudioD	human
@byBeeta	unknown
@thirddinner	human
@zurbaines	org
@titisariatthar	human
@minnybrioche	unknown
@edbot5000	human
@NsaAdnan	human
@jasonetmoore	human
@drezzie_sc03	human
@MMondemon	human
@MoshaiGiz	human
@Palmniti_NTV	org
@JamesAbel1990	human
@FelicitaOtake	org
@jectorelsueno	human
@linelalia	org
@sasscafedubai	org
@eireenejairee	org
@MyLenStyle	human
@jenny_ghraichy	human
@yoecint	human
@dougperalta29	human
@iza_xoxo	human
@steak_umm	org
@LannaWaldron	human
@12210514	human
@CatalinaKris	org
@mariafangshan	human
@SquareCircleNYC	human
@withloveamor	human
@livedclife	human
@BlascoGram	human
@shadyrockstweet	human
@masyumarori	human
@Kim_Yoonaaa	human
@roxyaedoo	human
@GnarlyGal	human
@Olio_Lebanon	org
@MusclesBeauty	human
@ChawkePubGroup1	human
@Thankilates	human
@shollysholly	unknown
@joelopann	human
@skuiija	human
@MaximilianoHP	human
@FreshFarin	human
@300sandwiches	org
@DaisyRadio2	unknown
@iiturralde	org
@jsuperstar1	org
@neat_simply	human
@GaleMerced	human
@linachandra	human
@theGazettE_Red	org
@lc_fancy	org
@DCBarrel	unknown
@Nic1004	human
@lelechan	human
@AlbRecipes	unknown
@rpwilli23	human
@Orderup34	org
@DR_AlexChen	human
@JacksDanaPoint	org
@opatron	human
@MBApageant	org
@TeresaFritschi	human
@aswildchild	human
@SAEatOut	org
@henny_tawas	org
@TheZach	human
@Ton_Tottenham	human
@KillHershey	org
@TimeOutBari	org
@BarryFenner	human
@YvonneSam	unknown
@Drinkmakergo	human
@M_s_Lloyd	org
@IndianFoodZone	human
@msbrwnbombshell	human
@BrettCohrs	human
@iamaldwinsantos	human
@_TheHighField	human
@MVPCreations	human
@naditAnathema	org
@YliaLittr	org
@blake_sunny	human
@SarenaShasteen	human
@dzaf_ry	org
@lucygbuck	unknown
@macabaccang	human
@LATravelMag	human
@d_rocks01	human
@JadeSarkhel	human
@LeMeridienKochi	human
@RomiFerraretto	org
@todaysweddings	human
@DaretArc	human
@DomesticDivaMD	human
@heartloveshome	human
@Pennethornes	org
@tinamistad	human
@mamaknowsbest12	human
@eliaaelena	unknown
@cyndiburgess	human
@sharpsitter	human
@Jeica3	human
@BlueJayHJB	human
@NCCoop_AB	org
@Rubee100	unknown
@JoechefBartlett	unknown
@Lizeroni	human
@TriTipTrolley	org
@HIPHOTELIER	human
@Garrys_Grill_MD	org
@rodneydcarrasco	human
@nizamofficial	unknown
@rogsch	org
@1104_usa	human
@justchang	human
@janetetdavis	human
@ChristenaAmes	unknown
@ForeverADreamer	human
@MAMITHEGENIUS	human
@rendyzxz	human
@IMAYUKI_R	org
@SaraLNoad	human
@Kainesway	human
@GiveawayBandit	human
@SihleMamutse	org
@iammrAR	human
@cutie_mammie	unknown
@sambakall	human
@Kamsgirl	human
@JGadFly	human
@Food_Ticker	human
@RedSaltCuisine	human
@LetsAmaral	human
@pambasasiao	unknown
@JosefsBkry_Cafe	org
@Samy_978	human
@passwordrandom	org
@BabyMisty00026	human
@InvisibleSignz	org
@ERIC__AVILA	human
@PaniniDurini	org
@slump7	human
@nickushor14	human
@Marthoms20	human
@BestJra1	org
@lonnekenoot	human
@SandoviciME	human
@_yuma0923	human
@fusioncafelive	unknown
@dennisthefoodie	human
@meaaaanne	human
@RicettePaoletta	org
@lanasolyluna	human
@WendyJSmith57	human
@sarahcoldheart	human
@RockStarMommy	human
@bqTim	human
@pbear6150	human
@Revolutionarrie	human
@oniells	org
@Swagdude321	human
@lefteyedgirl	org
@chi_na_tsu_121	human
@NeuvooAnaheim	unknown
@MaadiHotti	human
@Twopbt	org
@JESSisDWW	human
@PR_Twilight	unknown
@HowardRBSmith	human
@lei_d_norris	human
@CerilCampbell	human
@1_New_Life	human
@twindrag	human
@jacobnix	human
@MadHatterGSO	org
@iHeartMBlog	unknown
@ISellTack	human
@FocusonFoodies	human
@naineomas	human
@tungbeer	org
@SilkysXXX	human
@rober_thompson	human
@yelleybelly	human
@iamyourBABYGURL	human
@VeganFreezer	human
@AldayaaUAE	human
@cindsl	human
@ShellyShellKo	org
@amadordubai	human
@CheltsGirl	human
@tedyokcey	human
@Scott3P	human
@EiEsworthy	human
@BeezieBabie	human
@SAShenk	human
@Greedycow	org
@AdunaWorld	human
@pumehana_hauoli	unknown
@PA_THICKNESS	human
@FaqihahDzakiah	human
@TaraMCTable	org
@louislombardi	org
@UnacceptableAbe	human
@josephinee9	human
@BrittaniCrook	human
@ikuya	human
@greenxfairy	human
@lip_mana	human
@elizabethadao	human
@BoBIsleofwight	org
@bot_innovation	human
@Listbrary	human
@RBBeachBum	human
@veelulu	human
@windyLye	human
@Cheremere	human
@samuelhall	human
@Zaibaaaa	unknown
@tabbaz123	human
@EatWriteRetreat	org
@timmy_uk	human
@therandomnoise	human
@kinji52	human
@futurestefan	human
@thegramsreviews	human
@WhyTokyo	human
@Miami_Eats	human
@Food_Related	human
@BingeVideo	human
@courtneyhill05	human
@Donalt_Castro	org
@asli_tolu	human
@MiCk3y_2003	human
@jankyshit	unknown
@MilesForStyle	human
@ljubi_menja	human
@whiskey_bacon	human
@yamajishouten	human
@sillydrunkfish	human
@Huiskamerwormer	human
@TeamMadvibes	human
@AmarnaMiller	human
@czechjanulkah	human
@Julesmond	human
@tgreen93	unknown
@sofian_dm	unknown
@TalkMilitary	human
@PrPugLove	human
@nishimotton	human
@MamaBuzz	unknown
@eRico_klimt	human
@_melmico	org
@rowancollis	human
@Rina_Ann	human
@GustoWFG	unknown
@cjgeonzon	human
@tglenspencer	human
@babycakesmel3	human
@elza_lauzne	human
@aemanzach	human
@rapjoeybatts	human
@sassykinah	unknown
@TheMoodleDoodle	unknown
@sandrajija	human
@HajerGodefroot	unknown
@margeri	human
@divacowgirl	human
@hamsiniravi	unknown
@SUBWAYCanada	org
@LizQuen_	unknown
@KinKhao	org
@BaileyNox	human
@SpartansRequiem	human
@reesymac	human
@Typhoon_UK	org
@Add_FlavourZA	human
@NisaLuvsFashion	unknown
@miz_mama	human
@MrRands	human
@beesis26	human
@novicambridge	org
@limpces	human
@HaneCook	human
@JENNSLOVINSKI	human
@buzzinbaltimore	org
@skepticalCAL	unknown
@BOSSCHICK_007	unknown
@AreaChamberi	human
@Banditto1967	unknown
@viadellarocca21	human
@italfood91	human
@FunnyBOUCH	human
@gabylutz	human
@JskJen	human
@emy_summerbell	human
@timbo_SF	human
@ENashEatBeeps	unknown
@MRS_THICKUMS	human
@Oneandonlyss67	human
@tedd_doubled	human
@PDXCheesePlate	org
@nandini_066	human
@kunhan13	human
@vanessavy	human
@RadissonRoyal	unknown
@1216Ballet	org
@CouponWand	org
@TimeaTorok3	org
@WehttamYssub	human
@BLOCK62breda	human
@socmedwhore	human
@ShellBeans_MDV	human
@BeppeViso	human
@bellion3	human
@DBAbarbecue	org
@jeanmkinney	human
@AppLesQQQ	org
@multiallergy	unknown
@foodtravel_pl	human
@riverpantry	org
@jmroubinek	human
@shakirzakaria	human
@JCEcho13	human
@ImHUNGRYofOK	human
@bekivallance	human
@LittleMsEms	human
@falconenamel	human
@meroDRG	human
@_belovelive_	human
@BlindSchoolL1	org
@DoubleYolked	org
@China580	human
@FoodPosse	human
@quipjestpun	human
@kpopsnaps	human
@CapeTouring	human
@Yosein	human
@mori_haruna	human
@artescamila	unknown
@FSSingapore	org
@SunflameIndia	org
@SantiagoRiver86	human
@msradenovii	unknown
@EatOutSuffolk	human
@simplywenz	human
@jeraldine44	human
@matthewwlj	human
@BistrotModerne	human
@Shantell1030	human
@womynydecent	unknown
@ConteVision	human
@geekyqiwei	human
@sultanakebap	human
@benjamintsu	human
@budonglaoshi	human
@JoanneLai	human
@rianash_maxx	human
@AlienNeighbor	human
@MelissaCrouch1	human
@unbuenbocado	org
@Shelly16Gossip	human
@dithhhhh	human
@sgtjbourne	human
@HStGreatSt	human
@xKarlyLouisex	human
@flocafeny	org
@chaddymardini	human
@TasteCookSip	org
@adverlicious	human
@3mindspromo	unknown
@NutriFitMama	human
@108Marylebone	org
@LisaMRomano	human
@MassimoMMaersk	human
@nikkiwestley	human
@eisenstaedt	human
@Alberta_Foodie	human
@DessertMaker	human
@AnnaMW91	human
@owain_christian	human
@bay_food	org
@Jika_Jika	org
@samosastreet	org
@lennerswest	human
@TamTamiTamara	human
@Tiffsburger	org
@gunshock	human
@min_mandy	org
@ezudean	human
@KitsuneWLoss	human
@joey87062	unknown
@_Winter_wind	org
@Jude4367	human
@WaelBouyahya	human
@oceania_nevaeh	human
@ilaLestary	human
@BoricuaArroyo	human
@DomAdvMrsV	human
@Fra4Food	org
@jet_settera	human
@dave_pena	human
@irawantri	human
@lyssy40	unknown
@DJohnWatson	human
@KidMurdock	unknown
@FarmersWifeRam	human
@totemsunrise	human
@StephenvanEeden	human
@OlioePiu	human
@ClarkLincolnPk	org
@ryanywong	human
@healthy_new	human
@Rachel_Hendrson	human
@Mark_Kreazy	human
@MadridCoolBlog	human
@NataliaPiche	human
@ChefTroy223	human
@rehina_p	human
@erica_soto11	human
@welldonerecipes	org
@YurikoYorke943	human
@KatrinaWatts2	human
@LiveLeighMusic	org
@ehellah	human
@1educatedpalate	unknown
@ManducaBibere	human
@WingfieldOctavi	unknown
@BerylCruise	human
@Andreeabicho	unknown
@hotandefficient	human
@MarielGuzman	human
@dothedaniel	human
@meOllyGuseva	human
@DutchPrimetime	human
@PanchoVillasRes	org
@SusanneCk_	human
@FSGeneva	org
@HotelColumbusRo	human
@iamjeckjeck	human
@surfyogarunlive	human
@shivam_gulati	human
@hklovesloths	human
@chertseyshepper	org
@josh_ea	human
@kitty_hedley	human
@minervalp86	human
@AteemFateema	unknown
@RLamuth	human
@CelebrityChefTv	org
@Chloooooex	human
@SteevieM	human
@MissHdez	org
@TheAndreiReyes	human
@zeppy_church	human
@GeorgeSbrugge	human
@QhingMei	human
@RealHungryInLA	org
@melzmanna	human
@SuraYakut	human
@Irwan_Faiz	human
@Yohda_Laleh	human
@maijinsting	human
@_OScience	org
@tippytoes	org
@quantumjourno	org
@Alan713ch	human
@m_svendse	human
@_mariamK13	unknown
@Kerr1ck	human
@querellesblog	org
@OveliaPsistaria	org
@alicesaga	human
@RYAN_INCY	human
@silviahart_hart	human
@momosukezakuro	human
@maruja1022	human
@Melissa_JoyB	human
@WeiTing_Chang	human
@MzDeeVa4you	human
@PepeluArteSacro	human
@shupo23	human
@madeulook	human
@ricklauder	human
@ecopizzaLDN	org
@lunchwithdavid	human
@KingfisherLancs	org
@kitten_728	human
@forageVancouver	org
@Goodeats22	org
@AMCConsolidated	org
@iAPPLE_LOVER	unknown
@VentesFlash	org
@NewquayCLIC	org
@Cyberpaul001	unknown
@enggayvicente	human
@chicocowater	human
@mattmansen	human
@LSCHANGES	human
@mark_duong3	human
@Cribeiro_CAV	human
@Shmorgan85	human
@albertetthomas	human
@mamaizon	human
@melis__ekin	human
@Majed_Elmalke	human
@annuusingh	human
@essexbodyguard	human
@YingYingYingTan	human
@_Gonzi	human
@Simple_Seasonal	org
@mameitachou	human
@Gushima_SA	org
@cafepierrot	org
@chroniclesofaRD	human
@Gaslamp_Popcorn	unknown
@totomoyo	org
@RevaDuenez	human
@chiaerhn	human
@fashionableview	human
@Mnorsaif	org
@NatsChronicles	unknown
@NewsFunStyle	human
@risengrindla	org
@irenegianos	human
@rtay	human
@FRIEDIA	human
@Naa04200825	unknown
@odongisme	human
@trumatter	human
@cuqiezee	human
@PorkerToCorker	org
@Pratya_JO	human
@Trucosdecorar	human
@hoxz	human
@HotelWellington	human
@iamyogeshmathur	org
@eggandspoon1	org
@_bonen_	human
@dvshopca	org
@bluebebopgirl	human
@Barbados_Island	org
@awesome_pyxi	human
@JoaoMiguelCipri	human
@LeGrandDenver	org
@SineZZZZ	human
@Chulitaxosexy	human
@LavenhamPink	org
@hope_slimzees	human
@RuthNieman	human
@mRiannev1811_vp	human
@wanderwwonder	human
@vCampOz	human
@MikeCucurullo	org
@WillowLaneBlog	human
@LOABusiness1	org
@jayro684	human
@chacorinachan	human
@SEVENCLOVERS	human
@ashleyunfilter	human
@LasCasuelasOrig	org
@therealduprai	unknown
@ZoeyPMA	unknown
@cfimages	human
@YuraTrotskiy	human
@CandiWare	human
@vapemerch	human
@fabguide	human
@laspinall13	human
@wanhamdi	human
@EddieYahya	human
@bloodrose0108	human
@PGKateG	human
@VivienneEllazar	human
@ke820531	human
@Abariciajustine	human
@irene_raina	human
@DigitalKingpins	human
@RikaP16	human
@LadyMoney74	human
@BenSCanning	human
@feliceconteamor	unknown
@Wongahlin	org
@RidaBatt	human
@AsparaBuddies	org
@crazyinterluvit	human
@Steps_stilettos	human
@jackquibaby	unknown
@ElaineBarlow	human
@lemueljopio	human
@PJBreakfast	org
@Iree94	org
@Happy_In_MySkin	unknown
@EchoGoodner	human
@megumi_tomihari	human
@FoodTravelME	org
@JesusChrist2004	unknown
@bezcoupons	org
@DaleWhitney7	unknown
@elmrestaurant	org
@TinaDiG	unknown
@Lovinglyyour	human
@haruna_0717	human
@FMealtime	human
@iMaxymilian	human
@debclembuckert	human
@lucky_bambou	org
@EashSobadd	human
@ojskitchen	human
@notconsumed88	human
@HungryHamOnt	org
@lacocoelle	human
@CyrineAbdlNour	human
@highhappyi	human
@iamdarkelfin	human
@susankmann	human
@EunderscoreZ	human
@GotDragonUSA	human
@Timothy_Boyle	human
@MariaMartin46	human
@slicingit	human
@oyvegan	human
@galablog	human
@laineyx	human
@MuzeyafBhatti	human
@dorothydee	human
@RwdHbib	org
@Chaotic_Zero	human
@thatgirlcartier	human
@BigAlsDeli	org
@skythaisushi	human
@YumblesHQ	org
@DJJLava	human
@FairpineLane	human
@Ze_Geek	unknown
@LilNinjaTaiger	human
@yukiliang98	human
@jessemcray	human
@thatjessagirl	unknown
@MylenaNatanni	org
@Anamaria1117	human
@tzdelar	human
@Maachan_r	human
@jinhee330	org
@Ohhitskelly	human
@Nazie	human
@FCCM1856	org
@LIVINDREAM10	human
@tommyjoyce5	human
@toughasnut	org
@jaroooood	human
@STIFFYBOTHWINGS	human
@underthatwing	human
@wychwoodbarns	org
@Lilypinpin	org
@pintoothai	human
@Kemmyandreotti	human
@AspiringAntonio	org
@vinsidh	human
@ABJColeman	org
@JunneNicola	human
@guanabanalondon	human
@amengciu	human
@1djcutty	human
@saraamaral91	human
@CFAVictory	org
@dela_beautyblog	human
@WeLoveCooking2	org
@EatPictures	org
@Em_Dash512	unknown
@greenbriarpub	org
@ederenzo	human
@CeFlan	org
@ssmith556	human
@organicwraps	human
@junmykau	human
@DLeeBrown	human
@ArtBySandra	human
@KitchentableLV	org
@LaRiberaBilbao	human
@Beetroot_Beluga	human
@MLHauken	human
@Danny_thill	human
@VoulaHalliday	human
@FranciscoJGR	human
@January489	human
@HRC_Hyatt	unknown
@wawfrodsham	org
@Chele_Mike	unknown
@EricaFrymire	human
@Sirilchanett	human
@FrancescoJulia	human
@MarioPresi	human
@DnDDomain	human
@Ramona_van_Dijk	human
@Jokensnack	org
@gigarc	human
@ANCHEristorante	human
@GrandHotelSavoi	human
@circa75sydney	org
@KCBranaghans	org
@IamLizkie	human
@Anetelka	human
@gtholly_holly	human
@Tertulia_NYC	org
@hankscafe	org
@nikkowijaya29	human
@shinta_1512	human
@gnmmh	unknown
@ashmita_m	human
@jedykurnia	human
@ariesinflight	human
@Anna_Pernice	human
@RecipeTinApp	unknown
@ItzjakWiki25	human
@xocanadianangel	human
@SartorialChic	human
@reeddavis	human
@huntertraffic	human
@Dona21123	org
@black_marketLA	human
@MahirsExp	org
@SabineJofficial	human
@nobodybutgrace	human
@Perfect_Nazo	human
@Irishfeisty	unknown
@hello_wii	org
@northscammeray	org
@RELHOLLA	human
@HermioneWood	org
@RinaHamid	unknown
@theaternerd7	human
@KazafDoutzen	human
@AmandaFaymous	human
@marron110	human
@thequeenkm	human
@hanayan0309	human
@rodd1972	human
@a10_aju	unknown
@TehNewYorkTimez	human
@katemalay	human
@Grip324	human
@annfa163	human
@Sayaka_cheer_D	human
@niea999	human
@RitualWellness	org
@nellytjoeng	human
@chriscarreras	human
@chocandcarrots	org
@Arianna13051980	human
@AvinasJewelry	org
@bloodandwater	human
@farrielle2	human
@san_sun	human
@MonikFlores07	org
@HelloKittyEve91	human
@iftaul	human
@YeahDatsHer_	unknown
@QWJames	human
@julessiu	org
@iamAdrianGale	human
@stardalila	human
@cjcperlas	human
@UncleLouie	human
@AnthonyMcAllen	human
@LiveAFullerLife	unknown
@NavinKundra	human
@SalsaPosada	org
@JackCreasy	human
@Baoaseresort	org
@Dorothydancing	human
@Cinders54	human
@tschweizer	org
@pizzajoes55	human
@pirateNo1	human
@HanoyLoveTina	human
@rossopolis1	human
@AthleticAvocado	human
@OffTheHookOKC	org
@ABBA6IDDONERKEB	unknown
@j3nnb3rry	human
@RealMomKitchen	org
@GreenieBear	unknown
@ESquareHotel	org
@gabsbee	human
@dominic357	human
@SarahJames456	human
@jasoniboy	human
@VinnieRicasio	human
@sfsoulradio	human
@cookingclaudine	org
@mimai1122	human
@KebapSuda	human
@aly1897	human
@natalie_chan16	human
@SnacksASundown	unknown
@chrisbooch	human
@food_for_health	human
@handiscakes	human
@SharamKasouma	human
@TOTigerLilly	human
@Fash365	human
@TheCheckoMtz	human
@OrganicMelinda	human
@Mz_BK_Phoenix	org
@greenerideal	org
@flexmussels	human
@FoodieFC	human
@tam8225	human
@Sheldrakes1	org
@Imphrank	human
@r_redz	human
@xGoingIncognito	human
@PBRistheshit	human
@thelunchspotirv	org
@thetaleofthefox	human
@fitz1503	human
@RavenTierra	human
@sophiemichell	org
@maNouanGel22	human
@trackerorgan	human
@bbmpinstumblr	org
@_pip_pop_	human
@manmarubuu	unknown
@CafeCaribbean	org
@besteducationn	human
@tsai1031	human
@ventanasoficial	human
@xoMYSTiCxo	human
@SimplyDevine_NY	human
@GALLAGHER0KATHY	human
@mrsdanaalbasha	human
@MusicIsMySeoul	human
@RacheL_MyLif3	human
@manu10fcb	human
@farrakay	org
@Zaxbys2080LRR	org
@evilmo6329	human
@AlvinTWK	org
@justwrite15	org
@NathynMasters	org
@joshebrown2575	human
@OrlandoMeatball	org
@BenvenutiPR	org
@CaposRestaurant	org
@iLorenzo	org
@_douglasalexa	human
@GastroDiner	org
@BruinsBabe311	human
@Antico_Jesmond	org
@ShikinAzmi	human
@DrPostALot	human
@subhash0766	unknown
@instagramkitten	human
@GradeAFoodie	human
@navaho4	unknown
@HodgesCleveland	org
@RayleeHatch	human
@GerryQuinto	human
@kincommunity	human
@LawKoonHong	human
@toast_mistress	org
@L20HOTELSCHOOL	org
@JamieBds	human
@6002kei	human
@billgatesdubai	unknown
@OriginalKazila	human
@jaegersports	human
@IranaPayne1DTW	org
@koichiro007	org
@LoisHoleHosp	human
@PaddyBarrysPub	human
@Ingrid_Clarissa	human
@SandpipersCove	org
@bungsandbears	org
@BNjiokt	human
@CozyManhattanB	human
@karenod11	unknown
@JRocketsQTR	org
@PaneBistecca	human
@alvinsrambles	human
@marufoo	org
@ELISAMONTAGNER	unknown
@ciao_from_italy	human
@akichon1212	human
@giuseppeFM	human
@MonicaGronchi	human
@KEDDToronto	org
@alfonso_m92	human
@_homedesigner	human
@meanfitfoxes	human
@MorenaEscardo	org
@Gauribee	human
@laserboxgirl	human
@joe_amhed	human
@DominikaTomasi1	human
@nadasto	human
@KrystenSark	org
@smoshjessica	human
@rirairishpub	human
@briii_XOXO	human
@NancitaKapi	org
@Chan_Stillovh	human
@DietaAzona	org
@busy_dan	unknown
@milmielmil	human
@Tee_Boogs	unknown
@platinumbd	human
@SwanWhittington	org
@EYE_DEAS	human
@EddyFrance	human
@ryancadie	unknown
@kantolynn	human
@angelinaelander	human
@mnystedt	human
@MatrixWatcher	human
@pault_13	unknown
@crazedcook	org
@365sonrisas	human
@glenngenius	human
@jameskyut	human
@jabbathebutt	human
@AcehimNoprst	human
@aGirlObsessed	human
@brianagregorius	human
@UAlbertaELP	unknown
@b_hez	human
@Aagan86	org
@IOWinfo	human
@MamaBrightSide	org
@MrBrowns_BBQ	org
@mamigorota	human
@FabOCGirl	human
@SellyXia	human
@blknwhitekeys	human
@ilovephillippas	org
@_brendancarroll	human
@wtingz	human
@annalisacimagli	human
@tastelegacy	org
@HavanaTropGrill	org
@SoFabFood	org
@rachwhitt13	human
@javaman47	org
@NikosBarTaylor	org
@tonyliau	org
@maavargas	human
@OpalDDavenport	org
@RonKingAlien	human
@halfyourplate	org
@zeppy_rabbit	human
@JUMBARS	human
@Toddynho1982	human
@sarahsauryou	human
@lattestilettos	human
@itsmeAddieT	human
@pupulandia	human
@CountryWaffles	org
@JerseyWhippet	human
@xionasy	unknown
@Dom__Dominique	human
@Alsacien_a_NY	human
@theajamila	human
@Celestialvegan	human
@chocosammie	human
@EBSullivan1	human
@murifitness	unknown
@Miss_vava_voom	human
@_alicefang	unknown
@FiloteaPasta	org
@Jefro5	human
@WillyB1980	org
@MalayKita	human
@eatwellforlife1	org
@CCastleView	human
@PhillTurnerDIY	human
@FerielleMinaj	unknown
@dguzmanadame	unknown
@FromJapan4You	org
@yeahitsmemariel	human
@winc1970	human
@HaoChii_London	org
@Rotolos	org
@RotiBunzCafe	unknown
@BobbisKozyKtchn	human
@georgehirsch	human
@ThinkingSlimmer	human
@choccss	human
@EstherYann	human
@luanakarner	unknown
@stuartmoss	human
@keepontoasting	org
@Marlene1602	human
@gwen2a01	human
@syeh3	human
@theamandalee	human
@hatasir	human
@olchik_olechka	unknown
@shenyang06109	human
@Annock	human
@angelametodo22	human
@CharleneC90	human
@chocoholicRD	human
@renai_j8wBx	unknown
@AdieSalihuddin	human
@delvickios	org
@PurpleGrapeTeam	org
@WaldorfHilton1	org
@ProntoDenver	org
@lopp85wu	human
@CostaVitagliano	human
@HotrsShrewsbury	org
@brendabuendia1	unknown
@DashofSavory	human
@romi00v	human
@labels_lacquer	human
@alyssa_poma19	unknown
@CrazyNLuvGuy	unknown
@CouponingINtheD	org
@girlbouttown_	human
@ChefAaronBrooks	human
@K3VINENVOY	human
@affa_f2s	human
@pvCci	human
@rainydaybites	org
@RoyceCalac	human
@littleteochew	unknown
@yurikonagano	human
@cerulli	unknown
@kanahina	human
@inPEKANBARUcity	org
@neurotickitchen	human
@DaniqueKorf16	human
@dalilamian	human
@shierkurnia	human
@QuellaLunatica	human
@SabaDublin	org
@JD_Walker	human
@OhCholet	org
@nantacy	org
@fabricatedlie	human
@lifeofsameim	human
@BTsBaltimore	org
@VeslianaVM	human
@Flames817	human
@AdventurousBlur	human
@LISA_JENNINGS_	human
@5NapkinBoston	unknown
@foodonclick	org
@AdrienneADiaz	human
@bellestar66	human
@TeamGetOff	human
@iceleon94	human
@lovelainetan	human
@hi_its_emmy	human
@PabloJohny	human
@Madrilicioso	unknown
@MasonRose	human
@FSLisbon	org
@TalkMilitaryFam	human
@CafeMagazzino	human
@liephe_chuu	human
@TheDishOut	org
@FiligreeHome	org
@_Table21	human
@TrainerAlison	human
@cstan79	human
@LittleMarketChi	unknown
@_KDSecret_	human
@princesscdr	human
@SialaFitness	human
@GothamEthicsDoc	human
@AlinaIsaev	human
@lexa82	human
@egiseptiadi	human
@leunglowing	human
@Bakkenem	human
@Alessiuccia72	human
@JADGM1245578	human
@headturnerdj	human
@fit_soon	human
@annabettinam	human
@sammy_tim84	human
@alas3lads	human
@markcoysimon	human
@casshada	human
@DailyTarDeals	org
@MaraVz775	human
@OldMajorDenver	org
@TheBonfireGrill	org
@Uliana_Olson	human
@ayusalwaazura	human
@maichi256	human
@boemagazine	human
@ElizaMsjo	human
@awayfaringchef	org
@HaasHolistic	human
@Slurrppy	unknown
@BellandWhete	human
@eMazingGlenview	human
@nwfoodette	human
@SeelanVandA	org
@BakerBearded	org
@hucklegoose	org
@RBlu_DMC_UAE	unknown
@OTOMEKEI_HAMMEE	unknown
@yeyeosunyemi	human
@meals_faringdon	org
@BarBounya	org
@OxfordExchange	human
@Yalin7977	human
@pmahardhiko	human
@keeka1976	human
@juschatagain	human
@tiffanyturchyn	unknown
@brymorganna	human
@KthDl	org
@manae_miyakoshi	human
@Rnhell03	human
@Alexandra24Tf	human
@FSMiami	org
@queen_sands	human
@ImBrandonBoyd	human
@Zinccafe	human
@prix_discount	org
@jollybrickspub	org
@PaninoBar	org
@BarneyButter	org
@natashavh84	human
@East9thStreet	human
@PopUpRepublic	org
@diananguyen_au	human
@leehaena_21	human
@AudreyDior	human
@Walkinvegas	human
@MandaTan	human
@burnie16	human
@JoseArnaut	org
@thetruespoon	org
@aarios7	human
@ChipCompany_	org
@janinesmnt	unknown
@JamesDalyCoach	human
@ajstenaka	human
@liltonebrigante	human
@76cheeky	org
@Silence_sings	human
@so_syed	org
@tusabesfredom	human
@Filterchai	human
@Chanman83	human
@Prof_WEB	human
@Masseuse124	org
@Get_Jus	human
@40fiedStrength	human
@angielkay	human
@KadyOC	unknown
@VeganFoodQuest	org
@bargarten	human
@JaneConstantine	unknown
@FreshProductTV	human
@jonnybowden	human
@MeghanYuriYoung	human
@britnymelinda22	human
@OsteriaMattone	org
@Silas7456	human
@ConsueloNanetti	human
@arunsilva	org
@vito4224	human
@PalmarosaSW	human
@DimEmekaObasi	org
@tinswoosh	human
@ItsMeMoonRay	unknown
@paleopro6	human
@KirschBlog	human
@PETER_WENDEL_	human
@serewygotafu	unknown
@agubagu7	human
@BonitaJamaica	org
@damn_lifecrazy	unknown
@Vane_Curiel	human
@GenkiCornwall	org
@Geri_Henderson	org
@Irayaa	human
@yuyu7moon	human
@Patriprodu	human
@LoblawsON	org
@MelanieMui	human
@HauteDining	org
@mbjoligard	human
@INDYSCRiBe	human
@thatniggakaren	unknown
@Milaaa_01	human
@RaysCopperBell	human
@faizalhasnan	human
@AmiciMarketPB	org
@LaFos90	human
@CarrieFehr	human
@MontageBH	org
@katetti	unknown
@OakLawnPapaJoes	human
@TheAnnexWynwood	human
@germaine_liling	human
@AndreaKcc	unknown
@StringsRamen	org
@LazyDepression	org
@yucarinxxx	human
@simonthnutter	human
@danaguro	human
@IbahnOfficial	human
@FoodMarketLove	unknown
@imshakataak	human
@VagaNutrition	human
@mountainthirst1	human
@festradaNYC	human
@jeffteves	human
@Dawn_Johnson16	human
@lexusofportland	org
@Lutha313	human
@maakirasoi	org
@randtree	org
@meals_clapham	org
@thebelmontLA	org
@Its_WOP	human
@pigsbum53	unknown
@miyabinoteiri	human
@Soo_ELF_na	human
@Alexandra_R90	org
@LoveShoreham	org
@GrandCentralPDX	org
@JENGOBA	human
@SofiyaVerloren	human
@smellysuzie	human
@JoyVanichkul	human
@Karin_Hosenfeld	human
@Brian_ThaLion	human
@JACK_fm	unknown
@MommyUnwired	human
@rminamin	human
@jmediaHFX	org
@HJPBSc	human
@DirkLB1	unknown
@sophisticated09	human
@miejout86	human
@gurmecibaba	unknown
@cmdetroit	org
@IZ0IAM2	human
@sasamotomasaki	org
@Total_Food_Serv	org
@jasswink	human
@ErinLi_P	human
@FlipJuicyChic	org
@CraigCamp	human
@Pearlsade	human
@bernardovera	human
@TheListerArms	org
@cuevabar	org
@m88ta	human
@retweet_lebanon	unknown
@mondolulu	human
@iBristolPeople	org
@soulaperture20	human
@frankkruz	human
@galaxysports14	org
@ajadayne	human
@rossoneradoc	human
@jill_peusca	human
@komodofood	org
@winewankers	org
@HollieWysada	human
@AvalonInsider	org
@hankshackelford	human
@DePazibear	human
@paulistanice	human
@UneSaladeVerte	human
@WokExpressIndia	org
@hwangela	human
@rickrick888	human
@quirino254	org
@VitVitVegan	unknown
@videoamusing	human
@SeoulTaco	org
@jewellery_bank	human
@ckitchenette	human
@gearpatrol	org
@BansteadAapep	human
@Lienceyuliana	human
@lover_sandwich	human
@CompassGrille	org
@touristinparis	org
@maeda_c	human
@KaizenKon	human
@PaperChaseCase	human
@stevenamcqueen	org
@Ramses_Madrid	org
@19860521jun	human
@kyllemariedazon	human
@romi_sonobe	human
@obsessionphras	unknown
@Xquisite_llc	human
@StrongBabes_	human
@YoshiTodo	human
@EventsDLC	unknown
@lorenzodecaro	org
@Coqbull_Cork	org
@vintagetraffic	human
@charleszaw	human
@cafetwenty20	human
@LoveJadeSky	unknown
@ClaphamFood	org
@KathEats	human
@wordontheblog	human
@JessMc861	org
@denisemallabo	human
@mya_restaurant	human
@newsuperantonio	human
@PaulaStei	human
@lisacat_1	human
@Geskes_Grill	org
@lilprettiesnyc	human
@Pitou_38	human
@FANCYJAMESS	human
@mabelogoshi	human
@bunnielove6	unknown
@foreverin_shape	human
@thelittledoorLA	org
@turanobaking	org
@PatronPancakes	human
@gulayvatansever	unknown
@ronon44	human
@StewJoh	human
@Dwayne_M_Blair	human
@RebercaJya	human
@ImYourTicketGuy	human
@EGREEN504	human
@yujiokada3	human
@JoeFishChicago	org
@MattAlmodiel	human
@Loveproto	org
@ginoduds	human
@GrilleYVR	org
@JaxMakesMovies	human
@madriddiferente	org
@Oriole9NY	org
@Nasoya	human
@CoffeyTalk	org
@camerinobakery	org
@healthyndelish	human
@jjcjejmami	human
@z_sirirut	unknown
@iamCarloPascual	human
@jlo619	human
@METALUNUN	org
@privatereason	human
@malcoJOJO	human
@SocialSharerUK	human
@priyadotcom	human
@SabrinaDume	human
@JBePhotography	human
@DJAyseA	unknown
@purplemuggle	human
@samansarii	human
@SoBouNola	human
@YolieSilae	human
@Anitasi99	human
@amittenfull	unknown
@bobsboy30	human
@Fit_not_Skinny	human
@jEnNaLyNwAsSoN	human
@LocalEateryPub	org
@madame_siti	human
@roberguernica	human
@AninhaVarjao	human
@MarcelaZvl	unknown
@pakoholic	human
@dailYoga	human
@nadiak8	human
@Nummiies	org
@karinaldrich	human
@pitfieldpopup	org
@DeebaDee	human
@chatora_nyanko	human
@44Farms	org
@Naijha	org
@Kellye_Toon	org
@gonulunce	human
@ZeynepBenhisavi	human
@ChefEsther	human
@relishments	human
@Island_Bistro	org
@GunillaOdin	human
@RamyChahine	human
@skrobism	human
@dolce_de_nicole	human
@7starptc	unknown
@xgymchick	unknown
@stillawake	unknown
@DrinkYour_Juice	org
@BrownsNham	org
@EnduranceZone	org
@CherylannPasha	human
@shakshishetty	unknown
@blue_foodie	org
@JDBIllustrator	human
@phillipbloch	human
@mantry	org
@_Mary_Kathryn	human
@ThisMamas	human
@IAmSKULI	human
@alexnikolovn	human
@Jennell216	human
@RedRocksARL	unknown
@KelseySunstrum	human
@GladzDada	human
@sunshinediseno	human
@mamuileanne	human
@JoannaSable	human
@nallamarie	human
@PR2Fly	human
@Lifestyle_Oasis	org
@EVIL_DESIGN	org
@missanneperry	human
@JuveGram	human
@Jerrica641	human
@TheCaptainTable	org
@ElephantWalkBos	human
@Ab14Basharat	unknown
@pghconcierge1	human
@Balicravings	human
@JackieOhYeah	human
@shuyantallyyy	human
@j_ra86	unknown
@TerzulliMarco	human
@tanni888	human
@dear_carrie	unknown
@gii_90	org
@ATL_Events	org
@sandy_gilson	unknown
@SoNiUzZ	human
@FreshPicksPDX	org
@CrocusPaella	org
@kakugen_Glq0Z	unknown
@thecupboardchef	human
@starchefmummy	human
@kltubosan	unknown
@FuuriZero	human
@mahalolano	human
@WannaESF	org
@empress_agnes	human
@ViriiDiiana_	org
@Diiz_Sweety	human
@gas_elo	human
@empirelaundry	org
@CRANE1011	human
@tcbystvincents	unknown
@MaravillaLMP_	unknown
@williamemaxey	human
@shelleywade	org
@LinaLianjiAngie	human
@FFredFredBerger	human
@deisydiana	human
@miltonnas	human
@meld193	org
@chrissyina	human
@TheSistahChick	human
@KSFLUK	human
@KhairyAlHafyz	unknown
@WhiteCityBoy	human
@TrattoriaBianca	org
@mizzyluv	human
@TomHirschfeld	org
@halaparis75	human
@einteilvonmir	human
@TheFederalBarLB	org
@poelek	org
@soul_lee_8ball	human
@VivianAshworth_	human
@LaCascinaTO	org
@patronusr79	human
@FoodInstitute	org
@iamHoneyAngel15	human
@john1966olsen	human
@QiYoYoga	org
@naxny	human
@carawline	human
@julyenzovik	human
@b_ry16	human
@Mikele_mu	human
@SevenoaksTalk	human
@miggitymel	org
@jazzerdonna	human
@SaluNOLA	org
@LoveBattersea1	org
@CesarAlejandroG	human
@Kaitsmiles	human
@Araujo1Ramon	human
@KelHarrisxmwahx	human
@FranTodaro	unknown
@MeetSia	org
@ZeldaHarkinian	human
@roninme	human
@Sugarbear14us	human
@AngrySummit	human
@MarinaD23	human
@err30	human
@DansReview	human
@lauraa_ak	unknown
@Nightdublin	org
@halimmohd	human
@elifcetinn	human
@fashion_fitfood	human
@FainGD	unknown
@jenny2babe	human
@Liz_Ce	human
@senshudanyu	human
@Sevinfiniteen	org
@Hybartec	human
@momandthree	human
@Nakkers20	human
@CCGrillAmerica	org
@PizelsWorld	human
@fitncookies	human
@Kristine6823	human
@walkiMR	human
@leoken	human
@erinkatiesneeze	human
@yowar03	human
@tonnie1116	human
@chefrockyt	human
@jayhayes007	human
@wowpopcorn	org
@bunster10	human
@mesmerizegarden	human
@DamianoAvanzini	human
@milestonesABBY	org
@krisgimena	org
@silvia_z91	human
@albieespinola	human
@EMSquared6	org
@GirlNextDoor992	unknown
@Road13Vineyards	org
@JLepianda	human
@TheRealAdrian06	human
@kentdeofficiel	unknown
@GreggsUSA	org
@DocMagrogansWC	unknown
@pizzavillagio	unknown
@BookendsBinEnds	human
@KiraElste	human
@masarusan529	human
@thisisevan	unknown
@dibakkaram	human
@kiiksCQ	human
@dinnereverynite	human
@ondemandRD	unknown
@thewinereserve	org
@jjflizanes	human
@TheLOTDallas	org
@Mass_Musings	org
@tonyandwine	human
@TheFlemingHK	human
@TheBroadmoor	org
@samkj27	human
@claudiaK1209	human
@StaniJovana	human
@iamsookirst	org
@TheDubaiMall	org
@LogiQPryce	human
@CrazyCoolCL	human
@qistinakamal	human
@arvivares	human
@CafeCharlot	org
@dynasty509	human
@Musicxtu921	human
@matoreyes	human
@chiarapinto	org
@GnsfO9	human
@Mahantesh_MolMD	unknown
@liesjuhh19	human
@Reenrei	human
@toshisyung	human
@miokosaran	org
@AmyMcPhailClark	org
@JMR_BHR	human
@guinness_2009	human
@Cookismo_fr	human
@thesecreteats	human
@mizutamat	human
@ad454	human
@hottdawg805	human
@TheGranarySC	org
@PyanCGT	human
@OtherLifeInTheW	unknown
@PrintworksK	org
@weedporndaily	org
@DottyHayward	human
@papilles_uk	org
@RickandAnns	org
@getempoweredtoo	human
@clumsybaby	human
@OldParsonageOx	org
@otlob	org
@ellarysgreens	org
@TWL5098	human
@PecintaMovie	unknown
@labodegamy	org
@PullmanDCCDubai	org
@Slendertone	org
@dneburgers	org
@mfwbeautyblog	human
@GangstaRealz	human
@ReturnoftheCurl	org
@Suzy_W10	human
@TallTreasure	human
@LydiaKayE15	human
@Elinka_potins	human
@BayouBakery	org
@TwitTuiER	human
@VeggiePowers	org
@Suite36nyc	human
@gloungesf	org
@ldnbestbrunch	org
@xxnaaxx	org
@TerrenzVM	human
@SodexoUMMS	unknown
@clwbcoch	human
@sarahriadi	human
@pyerr72	human
@marais_marion	human
@FoodFolksandFun	org
@OurLadyof2nds	unknown
@mertail2003	human
@shearersFF	org
@ameliaprimarini	human
@erichollenbeck	human
@HGIDelMar	org
@IgnaCer34	org
@GosakiSakicchi	human
@cjbruce	human
@AllonszoVera	unknown
@adrianpgibson	human
@ngs4ngs3	human
@MELISASource	human
@ViaBrasilVegas	org
@CHEF_FIT	org
@MissSammiSun	human
@chefPriyanka	human
@KRISBONE	human
@BeanEnCounter	org
@momcanihavethat	unknown
@IngeniousTravel	org
@MyFamilyTable	org
@satomi08311	human
@emigd88	human
@HeiDiva11	human
@VickySingh_91	human
@CarlavdP	human
@comomanger	human
@plainchicken	human
@AquaByElGaucho	org
@Maarahlicous	org
@MyWheatGerm	human
@Hoteldesers	human
@MadlenSatz	human
@roger_chen	human
@FitnessIbiza	org
@WhatWeAteCo	org
@aliciacorbett	org
@MommyTrackFit	human
@HackneyBureau	org
@everydayfabfood	human
@heaatherwighton	human
@cookinesi	human
@teruteru_3456	human
@kjpigao	human
@TAnthonyAuld	human
@BonnWong	human
@PornoBrazil	unknown
@ufuckingwantit	human
@Popupcorner	org
@Wanatipk	org
@mattallison	org
@treysikel	human
@MinettaDeli	org
@altaj_4	human
@RecoStackz	unknown
@Glow88_	human
@Letty931	human
@TheRegentSE24	org
@gloriouslawn	human
@MutisMutfak	human
@pediRD	human
@FoodPinup	org
@rolypolypunk	human
@prannanyc	human
@kenji197503	human
@yume_harun0	human
@charlottefreyam	human
@WhitePearlDiana	human
@thistlemistfarm	human
@sue_sopian	human
@LoganSausageCo	human
@MeglindaKusnadi	human
@flinderslanenyc	human
@Sexayelies	human
@CDoorduijn	human
@Bestamvsofallt	human
@gospright	human
@ElinorGM	human
@ahmad6353	org
@NutsGirlsUK	org
@DinnerDetATL	human
@bristolbarMAD	human
@dcpndsgn	unknown
@LoveAddictNYC	human
@_flourwatersalt	human
@AnitaPezzotta	human
@fytbarney	human
@JunctionSouthie	org
@giuliana84	human
@kakiyiu	human
@SA_FoodHosp	org
@Amoore312	human
@dee_sophiee	unknown
@WonderfulWakey	org
@kyreAlcris18	human
@itsmaribelisaac	human
@Biancalegrange	human
@EchelonSyndrome	unknown
@Yai_ChangPor_TH	unknown
@Germanesba	org
@kalpeshshah28	org
@DeAnzaAppliance	human
@pintsizegourmet	org
@marta_doll	human
@MizMelle	human
@BMINOR9	unknown
@TantanneDS	human
@DriftwoodRDU	human
@ChoupieAndCo	org
@skrillex_coco	human
@TheCurryDude	unknown
@de_arez	human
@tampabites	org
@brokensmile44	human
@BLVD_Hotel	human
@mulberryaustin	unknown
@stefaniecrisafi	human
@anicaramel	org
@SheRuClaud	human
@LuciaLeaf	human
@leili77	human
@CavalloNeroAnc	org
@Jessicalucyxxx	human
@lisacm404	human
@HelenMoss18	human
@NVoncken	human
@savvymomdotca	org
@lindcamilla	human
@Borrego_Dulce	unknown
@kristenking	human
@tennisgirl83	human
@VegGalaxy	human
@Hala7sq	unknown
@FoodNFitDiaries	human
@schroederssalem	org
@franciscusresta	human
@aryia1	human
@TBBedin	org
@Official_JCope	human
@tastyeverafter	human
@MargotCeleste2	human
@joeygiorgianni	human
@cristabby	human
@stivesliz	unknown
@JaasmineJenie	unknown
@WallseNYC	org
@DadaistaGastro	human
@AmandaHuus	human
@msyumtum	human
@VWri	human
@LibraryTasha	human
@mongetapalau	org
@reutsh	human
@AptsForRent	org
@londonmums	human
@Dinda_Meitasari	human
@RoseCityKitchen	human
@angelflyz	unknown
@VilmasWellness	human
@focacciagb	unknown
@GORGEOUSGRETTA	human
@las930	human
@LaVieEnRose31	human
@reelRosendo	human
@Frank_Fellows	human
@Mozelle728	human
@TheChelseaRamSW	org
@twydalldee	org
@KaizenLiving	human
@Mirandi_Nel	human
@ChouxChouxCharc	org
@freshonbloor	org
@adrianeats	human
@HHHealth_H3	org
@KshHlly	human
@YNotBreakfast1	org
@kohos_tokyo	human
@suiteshotel	human
@XianSays	unknown
@Jeffries_Cath	human
@TheLegalWifeFP	human
@F515CA_P	human
@WayBetterSnacks	org
@ThinkZoeBoost	org
@CupcakeBonnet	human
@SophiesDxb	human
@BowersYvette	human
@Familycakecomp	org
@laurenvdp	human
@AndreaDeChene	unknown
@marlymagma	human
@patrickhere	human
@DolphTweet	human
@RICOstudios	human
@RookeryMacon	org
@genefejs	human
@vegasluvs	unknown
@coverpay	human
@keep	org
@justonwinrow	human
@JeanneStephanie	human
@Conquistadortas	human
@burningdanmuji	org
@ardy22	human
@NOMIANSARI	human
@FourSeasons	org
@sebastienne	human
@laughwm3	org
@LaCalleJordan	human
@vivienchan	org
@HangriKapkejk	human
@hadassamalia	human
@gyabes	human
@raulsmith22	human
@JuxeboxRdbs	human
@Zh3nBang	org
@FXGazella	human
@townelake667	unknown
@K_la_tee_da	human
@TheHurricaneInc	org
@WonderlustCris	human
@harukaoshima11	unknown
@eatingaround	org
@Mr_Houndztooth	human
@BorghettoVillas	org
@CadenCollins791	unknown
@ChefNoahSKYBOKX	human
@celtic_crossing	org
@TerezaMacha	human
@DebbieCowell1	human
@mellamoonz	human
@CarolineLazo92	human
@jubelbwi	human
@siKRITako	human
@vonezyo	unknown
@Kovaleva_Irinaa	human
@DJSTY_	human
@MissTeeLoveFood	human
@Eggs4FoodServ	org
@NafirinEtapa87	org
@lancechia	org
@Leroylime	human
@davidc3p0	human
@OttawaLAFF	org
@ValerieCampbell	unknown
@AFLVideos	human
@EROTICAPORNSTAR	unknown
@Cecesm	human
@yahairsantiago	human
@chrisAKAfrankie	unknown
@elymary84	human
@xdubhe	human
@AswaniJaishree	human
@babychrispi	human
@TavernRF	human
@Carolnanana	human
@NeWNetwork	human
@TKDinBrighton	org
@BrunoCarvalhoJJ	human
@N2theLightPara	human
@TwoDartMom	human
@FridgeWhisperer	human
@PetiteCook	human
@bodybyburks	human
@pchickpea	human
@ChanLihHoe	human
@TPutraZilIkram	human
@imKen96	human
@ttomacs	org
@MartyQuad	human
@Harlem1920	org
@MPchoco	human
@itsautumntweets	human
@BLOGHoneyImHome	human
@AjlinaMatluma	human
@takacomomonoi	human
@best0keptsecret	human
@sageman1957	human
@mk_giz	org
@aderomli	org
@101Concepts	org
@chambador	human
@JustaBlondeMama	human
@ForLoveOfGrub	org
@beautydiarynl	human
@CookWithManuela	org
@alexslowhand	org
@nanrae	human
@juliarinaldii_	unknown
@BertoldoGiulia	human
@zeppy_bags	human
@khiewjija	human
@shikapouts	human
@dppruittjustbe	human
@nickseashepherd	human
@poochieLVGG	unknown
@JBuggica	unknown
@expresion56	human
@LaMonarcaBakery	org
@swisscatering	human
@Tdod_V3	human
@Think_Rice	org
@RockandBrewsPCH	org
@Cik_Orchid	unknown
@AlysiaStern	human
@BTFlyt	org
@sweetsxsougou	unknown
@Twiggy2cook	human
@HotHouseTO	org
@ywong17	human
@495DM	human
@chocolatemoosey	org
@HouseofTarg	org
@JamesFeeley	human
@RenataGortan	human
@WillGorgeousy	human
@parkaerin	human
@andrea_gore15	human
@ChefColonna	org
@iKnowTheChef	org
@adibahazlin	human
@OTAVIORCAMPOS	human
@lorismithlove	unknown
@FulGeo79	org
@JonSinger22	human
@hotelmajestic	org
@Aquintuple	unknown
@BarterMarketbg	human
@Yvonne_Lennon	human
@17m1a7n17	human
@LisaReinbach	human
@BLMonster	human
@MissAfandi	human
@TaySTsvety	unknown
@wooyooicecream	human
@JbyrdMuddyWater	human
@ZahraVickyJulia	human
@devans00	human
@Kikay0428	human
@CambsCityHotel	unknown
@AysimW	human
@UncleCharleysCo	org
@jessnha	human
@garethdrake33	human
@dumplingiow	human
@CrazyCatGrrl	org
@CulinaryCouncil	org
@tomyu23	org
@DjNotNice876	human
@kukki_pochi	human
@Hiupz_Hpydielha	human
@fitnesswithkat	human
@KOMEKOME518	human
@streetbirdNYC	org
@jossimarlopez	human
@solidlifefitnes	org
@TheRealHen1	human
@billyforce	human
@UAeroFly	human
@gforgelato	org
@jeffreytowen	human
@Rosdefrances	human
@PikiAndrea	human
@GeecheeGirlCafe	org
@ForeverAlphanso	human
@The_Menjangan	org
@BIGCHIPmamasboy	unknown
@InvigoratedLivi	human
@CoalVinesKC	org
@fuckdarren	org
@DSpencerFearNot	org
@Giulietta2228	unknown
@Thirty2North	human
@louk_pad	human
@MikhailSujan	human
@EtsyLovely	org
@kariupo	human
@bbecca94	human
@aksuperdance	human
@DaylenReza	human
@FitnessINFOsi	human
@kathrynann1	human
@anguilla_	human
@BaileyDiamond1	unknown
@peepcat	unknown
@EmKyleNutrition	human
@salafbot	human
@xxFemmiex	human
@Lauras95	org
@dori_akmar	org
@SawtelleJT	org
@FallenAngel2106	human
@susan195120000	human
@Birtha_Babyyy	human
@starlettstella	human
@Esko23q	human
@LadyDeSchorr	human
@quentinrousseau	human
@sandravivi87	human
@ChefMolon	human
@bromelain34	human
@turkishdancer	human
@DinkTravelers	human
@Cftmegaro	human
@Anelp	org
@ViralFollowing	unknown
@Trini_Rishi	human
@BarTakito	org
@mydeliverychef	org
@LambruscoDay	human
@DianaBostanova	human
@Commanders_NOLA	org
@macmanicad	human
@thefoodremedy	human
@Nr75	org
@creationwines	org
@StayYoungMedia	human
@MSweetvalentine	human
@Big_beefys	human
@micagirl24	human
@PaulaBeneyto1	unknown
@nerdymoofo	human
@ala_michelle	human
@desviapyon	human
@Kelphinfishie	human
@CarynBl	human
@rosslynnvalle	unknown
@Qiing_girl	human
@F_dicct	org
@TastingWings	human
@Crisoleydi	human
@Sunderland_hour	org
@2525_ui	human
@SocialicityUK	org
@LittleAblazed	human
@AleValente91	human
@vanessitamala	unknown
@knitstamatic	human
@kim_membry	human
@StaceyMacS	human
@SabrinaSyahanaz	human
@lazy_meghna	human
@Malu_Lund	unknown
@franzzon30s	human
@nite_stars	human
@kikisare	human
@jordanalbertus	human
@Knitwhats	org
@Serenina89	human
@PercyandGrace	human
@tramatics	human
@girlgonebad13	human
@HalifaxDeli	human
@AurelieBourgois	human
@rawcanejuice	org
@Upaya_Naturals	org
@anime_sew0p	unknown
@bredanielle0602	human
@srcntrgt	unknown
@irishman71	human
@JennyFaltus	human
@lissetteporta	human
@SportsRcollege	human
@Lamont182	org
@Healthyvega	human
@SeuJuon	human
@StEvEnZaI89	human
@ghassan_ayyash	human
@Ngotunhi	human
@SeanReichs	human
@vitaminDfitbody	human
@Ma_Mon	human
@why_in_the_heck	human
@TheYouCode	human
@CheshireBuzz	org
@RTSmithsDeli	org
@sandisosibisi	human
@NikokoB	human
@MsLaLaNetta	human
@js_toronto	human
@Talk2gokul	human
@sam_am_cafe	org
@emanueliuhas	human
@FitriaSapri	org
@nienkejisca	org
@gburgercafe	org
@Fortuna_Regina	human
@pjaycastillo	human
@mycrohnsfood	org
@mishaandreasen	human
@AlexRusso1988	human
@RawFitnessLife	human
@amolmohanty	human
@type1jamielee	human
@Hyunmi_SuJu	unknown
@rochelleamy	human
@drugfree31	human
@Ciscoswestlake	human
@gymjunkieuk	human
@masimaro1990	human
@ArunBakery	org
@Clownfyre	human
@fumiyabom	org
@TatinessEnt	unknown
@All_The_Rage17	human
@shutterbunny09	human
@DeeQ8	human
@annpkuy	human
@alexanderkoko	human
@LaCarretaCuban	human
@AHPetrova	human
@drinkdc	org
@whiskchicago	human
@cariboooo	human
@ElenaAlMansoori	human
@typemystyle	org
@itsHARVEYJAMES	human
@TheAbdallahPost	human
@Yuriphil24	human
@FlyingIguanaJax	org
@tripchowcf	human
@shninc	org
@kevinGEEdavis	human
@SimplyCheerful	unknown
@_ursasays	human
@dshen02	human
@NerikoDesu	unknown
@TheFoodEffectDR	org
@poshinpink	human
@Keighley_Bryant	human
@aboody69	human
@brisnaturopath	unknown
@DaintyRibbons	human
@GFJenna	human
@Twin_Birds	human
@JennaRitchie2	human
@DeanStTownhouse	org
@queenmakenasty	human
@rizkymuhdakbar	human
@gourmandeinthek	human
@vgenove	human
@DorianDossRDN	human
@chocolat_J	human
@rookiesnack	org
@ma1205ma	human
@implausibleblog	human
@alexparon	human
@byJennyS	human
@Coopi23	human
@SuziEats	org
@aseacombe	human
@KINKYJOEL	human
@FezzyMcFezFez	human
@memyselfaki	human
@Lumiinousstar	human
@TableforONE_PV	human
@ajusto	human
@ChicConfessions	human
@Westat2quarts	human
@DebsgCafe	org
@karinas142	human
@graceviva6	human
@alexmottern	human
@Lilac_45_k	human
@higashikanaicho	human
@Foodidude	human
@FrostieMoss	human
@kimshih1203	human
@hotlead	human
@misterjap	org
@ameliaharris1	human
@CarolynRWest	human
@Tink_Dsi	human
@iyervinita	human
@knottypinebrew	human
@MichaelVBMO	human
@MooiMaDeLiefste	human
@MonaBitmore	human
@JoamirTerrero	human
@CourtneyKHansen	human
@sayna33	human
@LaurenTaylor913	human
@iMel_86	human
@DaneLifeFitness	human
@CentralParkCA	org
@DorkingBBG	human
@TheDaveWalters	human
@Melle_Mela	org
@BelgradeMap	human
@vevlynspen	org
@mysaucykitchen	unknown
@stm3ib	human
@Day_sy	human
@AGirlsKitchen	human
@foodslimited	human
@ABCCanteen	org
@BombayEmerald	org
@LFACountryStore	org
@CakescookiesM	human
@fixxraven	org
@corpsuitesnyc	org
@negr55	human
@insta_Slavyansk	human
@dancingvalentin	human
@thegildedsprout	human
@mexiricanjd69	human
@chiho0611	human
@Chonilladotcom	human
@PentagonRow	org
@jennbare	human
@pemudafm	org
@FoodgasmIndia	org
@JosephineClerki	human
@LucasRoasting	org
@InstaBryansk	human
@Maxitaria	org
@mangoandwheat	human
@JensBakeBlog	unknown
@juliekim727	human
@baroqueprincesa	human
@NuengOhno	human
@pizzapazzamiami	human
@jaiden_red	human
@ribbon_net_hon	human
@nwworkshop	org
@robin1z	human
@SalindaFrancis	human
@accord29	human
@ajaykhasnabis	human
@royciepoisie	human
@eliafarhana	human
@zoulmuslim	org
@NeuvooMyrtleBe	org
@vfsCafe	human
@ThatAliceCooks	org
@PhoDlite	human
@DARLINGTON316	human
@CafeBustelo711	human
@brigittezarie	org
@BeastRestaurant	org
@TivoliandLee	org
@nekogesaku	human
@rashadahamed21	human
@IUPFans	unknown
@ThePaisleyBarn	unknown
@joelbuhia	human
@UpperDeckNSB	org
@KallpaCrossFit	org
@emejotabc	human
@JennySinaon	human
@CuriousMinds69	human
@manoopy	org
@jienzzeric	human
@DebCurtisBigBnd	human
@MailleUS	org
@BACScratchBar	org
@TiffRECords	human
@camposleo	human
@futaarin	unknown
@fhmweb	human
@matteovinci	human
@fantasy_kitchen	human
@EnjoytheCourse	human
@building_upbabe	human
@FerNBeeZy	human
@Keat1009	human
@msmanila99	human
@ComingHomeCafe	org
@Michelle_M_74	human
@KenMHC	human
@sarazspecial	human
@kyotaro_dayo	human
@johnnyrocketsco	human
@eatcraft	unknown
@hyshamhyszham	human
@zaydalopez7	human
@NONEITALIANO	human
@genzelkisses	unknown
@Health_Tips	org
@fancyachuck	unknown
@riojikun	org
@literallyanika	org
@kaciwdm29	human
@NoLeftovers_	org
@ViktoryaLc	human
@eastendcounty	human
@beautifulbooze	human
@lovelondonlook	human
@indianfoodrocks	org
@centiawan_sw	unknown
@amberlissshh	unknown
@Momo1Official	human
@schzzimydeanie	human
@silverspoonus	org
@chibiloulou	human
@RiverfrontTimes	org
@fix_credit_now	unknown
@BloggerMumma	human
@joeypinkk	human
@KENS5Roxxs	unknown
@Badabingsta	unknown
@ChryslerDealsON	org
@loft38lounge	org
@oneofmyregulars	human
@NewToPalmBeach	human
@FollowSocialUK	org
@top3racing	human
@QasimBzCricket	human
@jbeckhamlat	human
@nency210	human
@arm_yukio	human
@LeanMuscleProj	human
@FoodFoozle	human
@kamercier	human
@kristin3ram0s	human
@Julie_Park	human
@MissAlexV	human
@clannad0514	human
@Tazcastle27	human
@Yoginijoe	unknown
@difrancosdenver	org
@JeromeKG	human
@VolarGmail	human
@spermselz	human
@zamb4284	human
@solucionsocial	org
@fafaabdul	human
@jorenerene	human
@wooden_memory	org
@WmffreCaddawyc	human
@duriangorengkry	human
@_rizkyfarah	human
@MelnaBite	org
@EloisaIannitto	human
@VeronicaVismar2	human
@delishment	human
@HedFurst	human
@JoBrain	human
@aaronora	human
@cakebirthdaypic	org
@Lorentix	human
@fatumohd	human
@GoSocialSA	human
@The_Grosvenor	org
@MaisonCupcake	human
@Werner1240	human
@oscarricher	human
@BellaBiachi	human
@Nancy_Deol	human
@HailKingDre	unknown
@heArtsonnet	unknown
@ranirasoi	unknown
@spiritedtable	org
@andres_tequila	org
@the_sandwichco	org
@DaveLenoTV	org
@KariAnnR2	human
@MeGs_N_KeGs	human
@MsIrinasMusings	unknown
@SavoryPrinceton	org
@colemanjweeks	human
@althani5566	human
@WorldRadioNet	human
@LisaRogers_inSC	human
@RGilfert	human
@MissPowerness	human
@ClaireF14313	human
@QieqieHarris	human
@whatisonmyshelf	org
@movie_time247	human
@ShireHotelsUK	org
@OMGSDFWFOOD	org
@rockandglitter_	human
@momeur	org
@nmk816	human
@Swabbies	human
@JezabelCarey	org
@JuChingWang	human
@LadyWarizar	human
@CarloPeaxe	human
@lifeastwo	human
@Molevelius	human
@g__urena	human
@Jeannieriv64	human
@EdinTuzlak	human
@DaisyZa4	human
@ThePrettyFork	org
@LyndMaldita	unknown
@izahjohan	human
@NewcastleGusto	org
@mikecordeiro	human
@rhona_o	org
@TheStinkyTofu	human
@HealthyNews_WR	unknown
@DeAndreWright	human
@maxinelow11	unknown
@d821yip	human
@iambazooka	unknown
@DORALCITYMAP	human
@vickiecouturier	human
@SexLoveNWar	human
@ManueauDyllan	human
@SMKimura	unknown
@nuckyzuu	human
@bunsong_anak	org
@BoatCook	org
@Cubanwithatwist	human
@SandyChew	human
@Groundworkcoffe	org
@instaRybinsk	human
@LeinadDOP80	human
@BonganiKubheka	human
@abe_erb	org
@JodisWholefoodK	org
@OldeBlindDog	human
@willy_photo	org
@Ktens	org
@toeylovely	human
@uda445gogo	human
@puim5	human
@MayersCassie	org
@SKCwitter	human
@MsJen678	human
@gaijinmades	human
@gogo_london	unknown
@RowvilleCK	org
@ThePurplePage1	human
@LeslieRossiALWC	human
@Jerzup	human
@EladKeith	human
@Cara960111	human
@obiwandar	human
@DragonCon_ATL	unknown
@SmartyHealth	human
@CantineBio	org
@EzzadEdzral	human
@KateSwannYWLE	unknown
@norma_EEEEE	unknown
@jiggleepufff	human
@colorlightsfood	human
@Avin_Edza	human
@Shutterramma	human
@GENETICBOI	human
@DistritoPHL	human
@okayburger	human
@ninanocas	human
@TiffanyZeyer	human
@cardiffcityuk	human
@merrifrances	human
@swclf74	human
@DinedelAlma	org
@mira_kuang	human
@_mememenu	org
@SheilaAlissja	human
@NightHawkFoods	human
@rudykins	org
@donnas92	human
@ChinnyHyunSeung	human
@MrsMoten	human
@wawalts7	human
@EstefiYogini	human
@BRYAN_E_BLAKEL_	human
@nickswestend	org
@clairesgoodfood	org
@AmbitiousKitch	org
@Chizzy_FG	human
@gatehouseSC	org
@paularocio8	human
@ksmothers_	org
@carpediem_VA	human
@UnprocessPantry	org
@Bakeaholic	human
@MLacyStudios	org
@raphapampam	org
@CiaoCristina	org
@JasonShepherd_	human
@Vics_P	human
@LEZNSTILETTOS	org
@RealFoodforFuel	org
@TFrugalistaMOM	human
@Ab62Alan	human
@martiescookies	human
@michaelgomez	human
@pratociclabili	human
@St_Nika	human
@wantatasteblog	human
@Pragmatic_Girl_	human
@sims_canvas	human
@lesfoodeuses	human
@itsmeJOEL_V	org
@JoJoSpeaks	human
@tavern_village	org
@charisRistyle	human
@FrancescaV89	human
@HaoHao2986	human
@TheGoodnessMag	unknown
@dreampicnic	human
@GinnisUK	human
@PHurtProd	org
@MyFoskaOats	human
@saradelu	human
@huangingout	human
@JahyLaBelle	unknown
@Veginburgh	human
@presscatering	human
@whirleytimes	human
@daratman7	human
@mindfulJoy	human
@maemari05	human
@Positiveevegan	human
@punkgotfat	unknown
@poyosann	human
@SirataStPete	org
@lcs1122	human
@SavannahChase	org
@LeBistrobyLiz	human
@madelman1970	human
@kkawin45	human
@FEDbywater	org
@ayvazakbacak	org
@houseofcamgirls	org
@joey1059	human
@Enterprise_ITS	org
@MissSWong	human
@Nemabuay	org
@PartiPants27	human
@nooyuizz	human
@BKwasnicke	human
@ChefIvanFlowers	org
@TwoBucks_Cory	org
@tripkizi	human
@KMEAS	human
@mochikun0416	human
@MrTomK359	human
@PeJantans	human
@flo_motion	org
@bhgrestaurants	org
@craigmawhinney	human
@TheIDMapCompany	unknown
@Barnackchef	human
@calikarab	human
@EatinistBitch	human
@emireerose	unknown
@Nevaaha	human
@imom	human
@jepprih	human
@LilyLani	human
@aredhot1	human
@nifarro_park	human
@LocalitaLA	human
@SynClaiRWest	human
@SokuMassimo	human
@kundrii	human
@netdog713	human
@kaleandavocado	human
@ChokyMervine	human
@AvynaCos	human
@ATGLeaside	human
@Black_Seeds	unknown
@RexChern	human
@rhusseinali	unknown
@MLMAvengers	human
@cezanneab	human
@GraffitiJ1	unknown
@afoodfairy	unknown
@DanielaFini	human
@Setsuko136	human
@Ricomincio_da_4	human
@SuadRamirez	org
@onimii	human
@RudeRobotTones	human
@Rachelnutrition	human
@HappiHeifer	org
@eckah01	human
@SuperglueGrace	human
@haikumad	human
@Terra840	human
@noa_hamada	human
@OliveRetreat	human
@aSEATaxiCab	human
@BeckaFaulkner	human
@scrappinlois	human
@handmadeblighty	org
@ShazasScrapbook	org
@Tuddenham_Mill	org
@SMBAntonio	unknown
@biteboxSA	org
@fatrabbitdallas	human
@carlosgonzalesj	human
@Joashdrmmr	unknown
@jackib11	human
@Faris_Manap	human
@Eve__Lopez	human
@TheMarket_IV	human
@jessinfectious	human
@TwoManyCooksLtd	org
@sillychurro2	human
@safwanshokri	org
@stevemorales27	human
@mikehardcastle	org
@PB_Signature	human
@GlutenAway	org
@dasha_leschenko	human
@MikeManicka	human
@StrongBurger	unknown
@Yusof_Arsad	human
@mmtrevisani	human
@Olaaudreyhere	unknown
@hoshikoi_may	unknown
@WerkenFM	human
@LifstyleProBlog	human
@sarahehill85	human
@matcho_suba	human
@VillageWhiskPHL	org
@thepatmendoza	human
@Lipstickvoice	human
@cookiesofoakham	human
@TheFitFork	human
@mislolas	human
@Azhreicb	org
@AquaFizzy	org
@julienbayle	human
@LongLiveThePlug	unknown
@AmalFashanu	human
@twiggytu	org
@Lizgsmith81	human
@GCMarketplace	org
@Crystal_Hotels	org
@BiancoMartinis	human
@JolandaLD	human
@cfoodchicago	human
@meizofarhana	human
@1PamelaHiggins	human
@Uschi808	human
@aquuarium69	human
@standinghere	human
@Adallynn_albee	human
@t_mo101	human
@CandyNamwan	human
@EdmundCruz	human
@mtparson	human
@claudia_etc	human
@ItsMito	human
@TiffanieFaith1	human
@5napkinburger	org
@fer_zamora7	human
@MacailahMaxwell	unknown
@SaidGarciaSolis	org
@Sur3No13	human
@ThePloughInn_	org
@FramesSanchez	human
@RinzLix	human
@doughmesstic	org
@UMS_Arts	human
@Mj5886	human
@gustotv	org
@ShawnMurphy1	human
@clairecly	human
@gormeimarket	human
@raul_sanjur	human
@mhandeelicious	human
@mcel_0325	unknown
@socialbrewery	org
@parkminei	human
@PopUpHamilton	human
@icebitchsins	human
@Toretto_D0m	unknown
@horiko	human
@JustamereCafe	org
@frostyblood	human
@VeronikkaVenus	human
@funfun_yukako	human
@KenChooCK	human
@adymorun	org
@snsd_children	unknown
@cl_baldwin	human
@FoodlandHI	org
@BeautyWithPlus	human
@BrickWorksMkt	human
@michelle0007	human
@housefpaparazzi	human
@Emitaw	human
@CeRusso	human
@980Sauce	org
@coconutcollab	org
@CuisineMouton	unknown
@RockabyeParents	human
@dulcelilliana1	human
@bradpierson	human
@may2ee	human
@simplypotatoes	org
@TheIronChuck	human
@robbiehowarth	human
@PaulFolger	human
@fzeix28	human
@LIVINitaly_LS1	org
@yourownfitgoal	org
@__monday_	human
@HogsBreath	org
@yottsu_yt	human
@ZestyBrunette	org
@pixelparable	human
@iziz02	human
@GFTPhat	org
@SawmillPrimeRib	org
@TrinityLondon	org
@RescueDurham	human
@Happyguru777	human
@MORELeighRTs	org
@AngelaVIVO	human
@tkr01	human
@Rob_B1988	human
@randomgrrl	human
@Daviontan	human
@Baileystkitchen	human
@Spangaloo	org
@RunSteph3	unknown
@GRUPOHABITA	org
@koocino	org
@WeAreVeganuary	human
@LindaCarmical	human
@hennabuns	human
@floatingBOHEME	human
@Stash_Deal	org
@NevadaRetweet	human
@cheflovely	human
@antonellamerli	human
@thetexanpantry	unknown
@halierenee88	human
@verdelicias	human
@CataloniaValenc	unknown
@DEBERSABE	org
@Bezega2	org
@NusaPavlic	unknown
@WilsonsKitchen	org
@tnkrbell152	human
@DanielleDaoust	human
@laubhoarst	human
@pLongLao	unknown
@qunitatyler	human
@lynkeechow	human
@coffeesojourner	unknown
@HavvaGecir	human
@NicolaAngileri1	human
@HudsonMKE	org
@BodyByBecky	human
@DNM_Phi_Bars	org
@Rachh0614	human
@jeaninaaure	human
@Dcology	human
@mikeblu1	human
@edieangelo	human
@_KimzyJFirefly_	unknown
@manoelite	human
@divebot	human
@EmilyRowbotham	human
@IAMKINGPUMA	human
@misssatinyheart	human
@elene_rush	human
@FourPointsCUN	human
@frostybutcher	human
@IaraOk	human
@IlSantaMilano	org
@AtlanticStation	org
@leileiana	human
@SweatyBetties	human
@ElleChanel	org
@BeautifulVonni	human
@HaleInuSC	human
@mommyskitchen	human
@mllemodeuse	org
@CLNH_Lunchbox	org
@Mhollstein	org
@kheenshin	org
@Evitons	unknown
@active_cooking	org
@houdatlisa	human
@Kopapacafe	org
@KatiuskaAnzola	human
@Ryvita	human
@_Maggie_123_	human
@johnnycakes8	human
@CagenNYC	human
@Kira_on_ebay	human
@MistyMorganNet	human
@Coffeeyouneed	org
@frenchoven	org
@OLearyPartners	unknown
@WestBeachBmouth	org
@11chiqa11	human
@Tai888	human
@kaffe1870	org
@Feltersnatch22	human
@Rhonda14Jones	human
@LexCNaturalmix	human
@_FlorHernandez	human
@TrapsChopHouse	org
@YA_DA	human
@melloves2smile	unknown
@greta_anderson	human
@CetyT	human
@WordSatSpangalo	org
@ChopstixOrAFork	human
@iAmChino69	human
@creativeideastv	human
@brkerdn	human
@perfoxtion	unknown
@LigaGram	unknown
@ruthyb1986	org
@INTHAKOOL	unknown
@BotiguetaM	human
@satokoloveyou	human
@jameseatontyler	human
@FlamingoMantra	human
@TweetTeste2	human
@rxxxm621	unknown
@916pinzon	human
@Pupun_Dudiyawan	org
@AkelaCooper	human
@Charlotte_Vidal	human
@Elimarie6	human
@Promote_Thanet	human
@KwesiRobertson	human
@Bowsessed	human
@zuvi2	human
@YASMIENatics	unknown
@yelyahgina	human
@VivantabyTaj	org
@romeattractions	human
@defunct1	human
@RehabKitchen	human
@chrissy__	human
@Wendela81	human
@CLTPieAuthority	org
@nachann125	human
@SimplyTwiggy	human
@TommyGShow	human
@AILAlalovesyou	human
@pitapituk	human
@droidy	human
@ivan8497	unknown
@ArchKarenina	unknown
@Joaquina588	human
@LuvWashingtonDC	org
@greatdaywithsm1	human
@TracyNRD	human
@MrsAurelie	human
@missdar429	human
@arrie0	human
@dindafab	human
@VibeShifting	org
@StephanieEpps2	human
@kushanmitra	human
@DaniloEV	unknown
@PMCButcher	human
@Suo_Sdey	unknown
@sandwich_yum	human
@bluemoonmexcafe	org
@Clementtang	human
@sonjiw	human
@dv3	human
@SheeshChigwell	org
@dannclan	human
@itsuzitime	unknown
@AbbeyRoadR	org
@nerotunes	org
@Lunchquest	org
@mikerantonio	unknown
@steveplunkett	human
@PutuAyuPratiwi	human
@KateNewman_1	unknown
@jordanblake0	human
@DCHamer44	org
@reesesums	org
@fatfoodiesworld	org
@paulethughes	org
@hazman_1995	human
@barbikiu	human
@msborggreen	human
@Moms_Magazine	human
@StrandSmoke	org
@Jemmillion	human
@deka91	human
@chrissybrigden	unknown
@StJosephHyVee	human
@Lene_uncorked	org
@BornToWorkout	human
@JFWooten	unknown
@94Ngela	human
@stevemaxis	human
@joycedigest	human
@Jollibeats	human
@Siew93	unknown
@Lelibels	human
@blonderunner	human
@PLA_burphrom	human
@FiennaLittleBee	human
@zipidydodaday	human
@DreamDaysBlog	human
@mrsheatherlyxo	human
@Atty_Byuti	unknown
@chefkevinwarren	human
@Walnut_Health	human
@XXFashionDiva	human
@MainSqueezeLA	org
@Overcoming_Ace	human
@IrishWhiskeyDC	human
@wildangelinaa	unknown
@Blessme1	human
@amazingrolly	human
@yahhtigidig	org
@realkuzzofly	human
@hannahhhdaviess	human
@EstaDeModaMx	human
@noteofafoodie	human
@rikkipoynter	human
@tankipink	human
@davisdailydose	human
@ZombeeKittyMeow	human
@BowArts	org
@BatwomanKCH	human
@HuntsEatBeeps	org
@Brooklyngrizzly	org
@paanhahapaan	unknown
@missmelbies	human
@kcwineguy	human
@SuperSoulSis1	human
@VynxVyxen	unknown
@florica63	human
@theresadungo	human
@CartoniGiappone	unknown
@FitzBowden	human
@WellFloured	human
@mklopez	human
@donjaa_x	human
@knockboxcoffee_	human
@ZeinaKhawam	human
@JamOnHawthorne	human
@yikesks	human
@menschohneplan	human
@Foodexsaudi	org
@MrsVNovac	human
@RonSonatine	human
@GreekOnTheGo	org
@wasmitb	human
@DanielCampbellp	human
@rachma_rachma	human
@sillyjessicat	unknown
@DaylePereira	human
@CherryzGirl	human
@MrsFolarin215	unknown
@BtsRadford	human
@distresslife	human
@hadassale	human
@TalkRadioMoney	human
@joiexxx	human
@eblankenship3	human
@CultusLakeGolf	org
@healthycheflady	human
@LukeGolds	human
@NCbackyarder	human
@RockitBurgerBar	human
@DayaPelaez	human
@HappyHealthMama	org
@RoryJL2014	unknown
@dafi1611	human
@AmuraoVonn	human
@oneworldplate	org
@julesserkin	human
@jenna0999	unknown
@icutnurhafni	human
@MissYarmosh	human
@littlmissandrea	human
@Kpup59	human
@kiipfit	human
@petalumapie	org
@PureCountryJa	org
@GrindWestchase	human
@xo_kaylafrances	human
@dallas9561	human
@chori112	human
@butsrslylol	human
@cheapsimonly	human
@OmnomnomHealthy	unknown
@gyakutenmuzai	human
@InnatDosBrisas	org
@Yaniboy18	org
@yukie174	human
@LebStream	human
@LaTraGuerra	human
@LizaManangan	human
@JOSEGOVIA23	org
@SGFTJNATIONWIDE	human
@MarialeRamosR	human
@Sabirah_Asma	org
@Italydeluxe	human
@WSL_Cambridge	org
@MyPaleoPlan	human
@MauMaster	unknown
@sebzsebastian	human
@NewquayCarnival	human
@leiza	human
@SalSeduce	org
@chillacupcafe	org
@SugeidyLorenna	org
@WhistlersTO	org
@Trilliumgyal	unknown
@DJ_Bagel	human
@topherlykins	human
@KittyMcCaffery	human
@NicoRadioDj	human
@mookieakakitty	human
@johnny_willy_	human
@Kelloli	human
@jamaica007	human
@DJDAMIANJR	human
@jessicaaa12xoxo	human
@recordmanmike	org
@galonjoey	human
@GoldenApron	org
@geordanjoel	human
@matepl	human
@yoursmagazine	org
@greengraciously	human
@abbycontrery	human
@nurl_shar	human
@Magic_Cauldron	human
@tonkinbell	human
@Reem95N	human
@jaebelleny	human
@billysorocks	human
@HIFareham	org
@hardwaresociete	org
@mariameijeiras	human
@twigletsmummy	unknown
@ceyrekmuhendis	unknown
@zoechristodulu	human
@MarieFostino	human
@kathyzucker	human
@JKuntz10	human
@eatinginthehub	human
@sofiboettner	human
@CatherinneD	human
@papaePePe_	unknown
@BocadoFoodnWine	org
@JMike_the_Joker	human
@QuodBrasserie	org
@BarcelonitBlog	human
@hisbabyPRINCESS	human
@piyalisekhar	unknown
@WBokyll	unknown
@nier_venn	org
@HetRoekenbosch	human
@MyfoodparkHTX	human
@dancoxart	org
@TheChurchKeyLA	human
@TischlerScott	human
@healthlioness	human
@MissKrisAngel	human
@RofaMW	human
@magdalena_DrB	unknown
@p_minimarket	human
@yllemsmith	human
@nao_pure_nao	human
@LaurieBea1	human
@nirvanalagoon	human
@Fayrouz_BA	human
@BurgerGabohPKU	human
@stevesnedlands	org
@qudabest	human
@nicoleliloia	human
@Ffer_nandez	human
@withloveyvaine	org
@AngelDanceMusic	human
@CoffeeMilano	org
@leighangeles	org
@AmmanLeRoyal	human
@TaurusSoulWorld	human
@BingePlayer	org
@alejandrochaban	human
@ValenttinaHH	human
@NDSUExtFood	org
@itsMAPF	human
@Boban_Stijovic	human
@_MAlEmadi	unknown
@FoodGlasgow	human
@Aggies04	org
@momsconfession	human
@LeroyLander965	human
@princessyv3	human
@julesfuelyum	human
@EloiseArt	human
@localxheroes	org
@wikihostel	org
@watdidthefoxsay	human
@slemmerss	human
@igotleverage	human
@RuggieroSal	human
@twright55	human
@MonroviaKat	org
@AnnoDomeini	human
@saracharbonneau	human
@missjenny917	human
@Esterelle_	org
@BRoooooCCoLi	human
@guywithatie	org
@choicesuk	human
@encorebookclub	org
@GonnaCookThat	human
@Lo_Ny_UES	human
@saruneko	org
@Bellenoux	human
@_beckyboop	human
@Rorosy	human
@mummsyamanda	human
@love2xbomber76	human
@FollowYourHeart	human
@ChitaCollazo	org
@thecanvass_	unknown
@ytyger	human
@chavahkinloch	human
@TommyBorglin	human
@KellyCNU	human
@at_field0925	human
@sofiaberen	human
@JeannetteC9	human
@carlito_mtg	unknown
@ezrylpark	human
@HuatulcoJulie	human
@SandosCaracol	human
@nakaoji	human
@HaLockey	human
@SanJuanMarriott	org
@xiaoying_kpop	human
@HunWFD	human
@valeriemanzano	human
@welcome2woodys	org
@italianfromlove	human
@mfcooking	human
@mynnisme	human
@scmame	human
@AshlieRiley	human
@WFMFAIRLAKES	unknown
@JADiasporaNY	org
@takashialaaf	org
@mrsasaki	human
@Gourmet_Gents	human
@DrizzyDre876	org
@BRKFSTRepublic	org
@leomavinong	human
@BrittBogues	human
@Cricketers_Orl	human
@ChastityBelt33	human
@sanukorah	human
@healthyeatsgirl	human
@NatuurlijkDD	human
@michiinaba	human
@TerranceOmar	human
@laulea_XOXO	human
@Cecelia6278	org
@Ma2004777	human
@mongastronomy	org
@OMonesit	unknown
@LindyGrundy	org
@koi_zyosi	unknown
@fizzandnonsense	human
@matriarchmiza	org
@Positivi_T	human
@beaglelondon	org
@Ajgul0	human
@Edan_Samuel	human
@SammiDollz	human
@henbot	human
@YouHad2BeThere	human
@Missy_Spud	unknown
@c0nf31t0	human
@robertbarry13	human
@VIANNEYsessed	human
@hindrysek	human
@EnquiriesB	org
@RosaMulya	human
@missioncaterco	org
@DoraliceBnds	human
@plantsandpages	human
@Reza_Hoveyzavi	human
@marissapetkou	human
@CJunecooking	human
@talentZz1	human
@LeDeliCorner	org
@Model_Denise	human
@Turchax	human
@oliviermela	human
@GymTrainerJOEY	human
@TribestUK	org
@VerdenE5	org
@cathrinlove	human
@lyzadime	unknown
@KingsCourtSteak	org
@nene753	human
@labebe_angara	human
@Anksolutely	human
@VsaJean20	human
@MassachusettsL1	human
@BadNewsEric	unknown
@BigCityDiner	org
@TheRealBigPappa	human
@ayatcharis	human
@MarkyMarc23	unknown
@marieblancaver	human
@rushabh11	human
@gasworksplaza	org
@manu_fra	human
@cathyeverywhere	human
@cleaneatuae	human
@My_Delight	human
@luiyotinta	org
@daphnesimsp	human
@gwenstyles	human
@AmericanTables	org
@HeritageHtls	human
@TheHillEatery	org
@RinLevi15	human
@PoetryUniverse	human
@oOSummerOo	human
@healingtomato	org
@Tokyonome85	human
@gwendys	human
@spanglishwriter	human
@emipenalozaexx3	unknown
@miyuchinpo	human
@Rcosun	human
@llorente_fran	human
@MaismamnoS	human
@Cee_Riv	unknown
@lourdesballve	human
@gina_sh	human
@ballu82	human
@BellPaola	human
@OsceolaBistro	org
@facescafenoho	org
@alvinquah_	org
@goblinbox	human
@DetroitGeeQ	human
@PassionFishBeth	human
@PauLynn_W	human
@ModaTerasModa	human
@emawari	org
@TheSqueezeCafe	human
@ChicagoDan75	human
@FourSeasonsES	human
@jun_hing	human
@monicasya	human
@katiemoffx	unknown
@shuquin	human
@shey0326	human
@Islambott	human
@stationhousesp	org
@AquaBallDrink	org
@Yoanamerilla	human
@LUNCHottawa	org
@frankgcaruso	human
@ar7uri7o	human
@HaruDW95	human
@TerresaHelm	human
@didangpulido	human
@gourmetpigs	org
@Vickalmaro	human
@twittwitniMatt	human
@TengalBoy	human
@cindyho0108	human
@G_DAVO63	human
@ruralmoms	human
@AlexDavis223	human
@Jai5477	human
@followthevan	org
@CrossfitRDC	human
@aoryuto_chanz	org
@BVongkhamsay	human
@Real_JMax	human
@HashreenBhullar	human
@KoilsByNature	org
@aizabebeh	human
@Primetime822	human
@JeffTjin	human
@L7Shawn	human
@missvivianwc	human
@RealHumanMedia	human
@TeamCalandra	org
@jahova33604	human
@dorkix1	human
@itGirl_Nirvana_	human
@husain_hawt	org
@DavidGTMcMahon	human
@Giuliasiegel	human
@LeTrucCafe	unknown
@thebullandswan	human
@gizem_dmk	human
@EmmiLaineHKI	human
@from_table	unknown
@DrSumayAldoseri	human
@bethylou10	human
@addienava	human
@COREYANDREW	human
@PhenSilvia	human
@Adriana61149806	human
@aramburo	unknown
@BeaAzcarate	human
@pattypattita	human
@FedUpFoods	human
@Sarrysfree	org
@MariaColastre	human
@Perviz401	human
@iiiyqhel	org
@OHayTheresMe	human
@dancartner	human
@wiwowowusli	human
@AndreaMazzi	human
@MunchySeeds	org
@1motivatingmom	human
@lowrimgr	unknown
@AdrianGood1	human
@ManuelCuevas	human
@practicalcook	org
@WhiteLionBar	human
@MyHealthyGlow	org
@WildlyAware	human
@chilolunseon	human
@NuttSaravoot	org
@StayAtHomeMum	human
@meg_yakamashi	human
@mealsandheelshq	org
@Jwchong1224	human
@OdellsGF	org
@veniaAT	human
@tabelabot	unknown
@diego19mania	human
@spooncvc	human
@RachelBegunRD	org
@LizEssex_	human
@stawbery_elsha	unknown
@YanBasa	human
@SmartGirlsBlog	org
@AmBahari	human
@PHAnews	org
@danubiuslondon	org
@therebelkitchen	org
@stpauligram	human
@nimal90	human
@annaademai	human
@georgeousfever	human
@reggieruelo29	human
@TheWreaker	human
@TrazeeTravel	human
@Greenwood_BBQ	org
@victor1062y	human
@aychulus	human
@BettysOnKing	org
@Disneyjenlee	unknown
@LYUCIFERdb	human
@Shalala_I	human
@LuccaManga	human
@oh_fitness	human
@StephanieKaz	human
@JaydaCabbell	unknown
@GramercyGrill	org
@_ElisabethMorin	human
@CosmoGlove	org
@ReaderGalore	human
@Rupika_V	org
@Raamzis	human
@Alyssa1396	human
@FashionLadiesES	human
@soniajuradops	human
@ini_rhea	human
@PCB_Cricket	human
@ReconBlackbird	human
@BedfordLover	org
@WantiMauricio	human
@SimonaGabree2	human
@lightbourne	human
@SammyNichStyle	unknown
@avosfromperu	org
@casskiley	human
@courtneygibb	human
@GRAlexHotel	human
@AnnaKarlsson75	human
@crzyluvbeauty	human
@Bo4Go	human
@techmantweeting	human
@TridentMumbai	org
@LeinieBaltimore	org
@delhifoodiesDFZ	human
@dmo305	human
@CentralSaloonWA	org
@Gwen__Marie	human
@joeyhariko	human
@ashainks	human
@MrTommyCampbell	human
@NordstromBvue	org
@Dangelo_Luu	human
@paolosavi	human
@ai0714	human
@xyiry	human
@UnaThamrin	unknown
@LindseyMorales0	human
@Matu_Skinny	human
@claudzbyotch	human
@tstheen	human
@Za_ART_MASTER	human
@incelikli_haita	human
@AngelicAlysha	human
@ShaylaRacquel	human
@babyfacedez	human
@vVeNeSS	human
@PastaZalla	human
@a_buso	org
@Shaun_Balliah	human
@ToxicOrb	org
@Indigomind999	unknown
@LarryPimentel	human
@PieraToniolo	human
@BVlcek99	human
@La_Favorite	org
@jetaimerenehair	human
@RoseDupouy	human
@Underground_edm	org
@Ris_Pep	human
@LoveLouisSmile	human
@InfusedGeek	human
@ShunColeTweets	human
@0105mizuki	unknown
@MarketRegina	human
@auctionitonebay	org
@StartupTweetSF	human
@RTorrance4	human
@PizzeriaTesta	org
@DesertRose_SK	unknown
@Ilaria_Illiano	human
@glencct	human
@AyreHoteles	human
@DhIaNu	human
@danamo	human
@a_new_sprout	human
@AlesitaPerez	human
@parsimoniousp	human
@youmustgoblog	human
@eatmypies	human
@yesiconfess	human
@lovewalkcafe	org
@FoodProdDesign	org
@0giani0	human
@robsabb	human
@fukui0226	human
@se_bdg	human
@ProstBot	org
@ARIELESTANGA	human
@MeimaeWu	human
@DINE50_	org
@The_Ad_Bureau	org
@rgowshik	unknown
@ButtahBrown	human
@amrisistian	human
@Radisson_Belize	human
@skinny_mins	human
@ABallaminut	unknown
@Masako815	human
@JeremyPalmer7	human
@YemiThe1	human
@LinelJoseph	human
@Irene_tiantian	human
@Andre_fmonteiro	human
@IndigoLasOlas	org
@GAPeachOnMyMind	human
@RamsdensCafe	org
@TravelersBrunch	org
@hanny_w	human
@drmaxl	human
@fatinfauzi92	human
@CiaranDunne86	human
@21cLouisville	org
@RonPaulTeam	org
@ViewLondon	unknown
@WAC_Midwest	org
@meli8am	human
@PATERNOSTER1	org
@gustiamo	human
@canuhandlme	unknown
@WinesByRaz	human
@mollygranza	human
@kitchen1331	org
@nathanhayward	human
@SharonHalim	human
@DJJakov	human
@mami_sue	human
@AbrarParwan	unknown
@HarHarmLess	human
@elfajry	human
@DIETER98093955	human
@iivychaang	human
@HillcrestFarm	org
@hafiz_hod	human
@faytraveller	org
@ChristieSilva	org
@ThickCABarbie	human
@The_MarketMogul	org
@SNewellOpitz	human
@JacksonArthurUS	human
@luckypennysb	org
@edrinfurtados	org
@56italian	org
@NourishedAvenue	human
@mystdancer50	org
@yowitsmeeapril	unknown
@gmarkolivares	human
@albertorinaudo	human
@VirtualBondGirl	human
@Daim_craZy	human
@janinay07	human
@selinasatrijo	human
@Dutchez209	human
@NicholasDenmon	human
@AiniSho	human
@livsoban	human
@nauli	org
@your_salfie	human
@DarrenGuzmen	human
@girlsonfoodblog	org
@way2gomom	human
@David81782585	human
@workttech	org
@HWMHomeopathic	org
@Matingas	human
@1peebrain	unknown
@FemmeNerd	human
@artbreaker_kael	human
@secret_streets	org
@ShangriLaJKT	human
@iAmAlexander408	human
@EvelynJ6978	human
@TheSurfinCowboy	human
@Nblackthorne	org
@dishnitoutblog	human
@joefoodie	human
@safa_sefo	human
@Bistrot_b55	org
@MizzWhite23	human
@2bate	human
@BurbageTime	org
@marissarkhan	human
@JuliaLiebtAnja	human
@ayushayuyu	human
@soccertennisdad	human
@Paride_Taurino	human
@rachLmansfield	org
@juliemarkoska	unknown
@morphx99mq	human
@vroomservicenow	org
@Hmagboul	human
@SuzanneShoker1	human
@EQPpics	org
@LaTropiqua	org
@_joaosouza	human
@AnnaGnatenko1	human
@UrbanLifeSA	org
@woodbarhouston	org
@sjanee11	human
@purestjoy	human
@CabotRD	org
@LeosDeli	human
@Taproom307	org
@bluekardel	unknown
@Hamiewch	human
@ia_taka	human
@PurplePills24	human
@parissecret	org
@stefaniegrace	human
@pips88	human
@AllMediaLinked	org
@Wellstkitchen	org
@DarylAnn21	human
@Chef_JOJO	human
@Breadonbutter	human
@VCCDublin	org
@Brownstownmusic	human
@Susan_Vienna	human
@ChiaraeAntonio	unknown
@QeeLanna	human
@OverTimeGrind	human
@bakingbites	human
@BeckettBull	org
@TravelAnnex	org
@enjoythetunes	unknown
@pila_ocha	human
@allisonskwirz	unknown
@cravemelttap	org
@Hyeoxik	unknown
@123simulation	human
@hannekeharkema	human
@croquemr	human
@thasyasusanto	human
@pranzichicago	org
@andresgtweets	human
@emach09	human
@The5andDiamond	org
@ShyneInspire	human
@adeltaferreira	human
@VonMiddleton	human
@brumjq	org
@krmt04	human
@BostonBabe74	human
@BrandonBCoates	human
@VenisePang	human
@freshlygroundpr	org
@shumaine	human
@1hub2kids	org
@HyattRValencia	org
@Jeff88Ho	human
@SteveWellens	human
@NewsFeedNewYork	human
@yukina_hirai	org
@laraslifestyle	human
@shijuvenate	human
@luv2bfree	human
@SofiaEfree	human
@rainonika	human
@RTowner20	unknown
@Briankhor95	unknown
@DJAC82	human
@aremafood	org
@Valerie_ky	human
@bauer_nick	human
@BromleyWOT	org
@Colonia927	human
@spruilly14	human
@Pinkitchen	org
@JAZZYBWHOOP	org
@SandyToesMom	org
@winendinedc	human
@jamesross1997	human
@Otis2030222	human
@sugarcozy	human
@steff1026	human
@kuddliekat	org
@der_Greiff	human
@Nazpoleon	human
@panpanamy	org
@goakonnect	human
@me_owth	org
@JosephGEditor	unknown
@lyd63117	human
@marooshindia	org
@yudeebi	human
@AzharAndiTahir	human
@CultureWhisper	human
@aki_navy	unknown
@ImChelseyNicole	human
@WheelsDropDone	org
@SilavadeeSamui	org
@RoccosSausages	org
@chicasdelaxampi	unknown
@miserylovescovt	org
@Deezy_fabolous	human
@msstacey22	human
@watertablehb	org
@FarrugiaJose	human
@Imakash_	human
@Rachel_Tsang_	human
@louiseconnected	human
@lexniko	human
@RNJohnston	human
@synergy20	org
@MahoneysOshkosh	org
@RogerRangel11	human
@ggallagher71	org
@NashOriginals	org
@TrishaTrixie	human
@OsteriaMazz	unknown
@sewabs	human
@AminuRAZIF	unknown
@letdown	org
@xilefnhoj	unknown
@patricehuggins	human
@alexisstclement	human
@ikachan	human
@Alice_lxw	human
@justmahogany	human
@NJVAthensPlaza	org
@laricirp	unknown
@mainelycoles	human
@Empire_Ott	org
@MichaelsCafeNY	human
@MFSAleigha	unknown
@xerruelvilla	human
@wanderingmason	human
@faustabole	org
@TRACKOstil	human
@littlefoodblog	org
@Marcus_MB1	human
@LauSinatra	org
@OasisCafeSLC	org
@DCHobans	org
@tieuheoheo	human
@mh_harrison	human
@Chris_Madsen	human
@King_Of_Beauty	unknown
@Sapphire_Maknae	human
@andri4n4	human
@garcoseph	human
@sukh3gs	human
@kuro2maker	human
@beetingtheodds	org
@Lozabella_B83	human
@WokingShopping	org
@uknowxx_	org
@PurpleValleyDes	human
@EverydayRD	org
@lost_iam_noone	human
@rick_rasheed	human
@Lecanardivre	human
@whuzmyname	human
@BryanTheCEO	human
@Wriggle_London	org
@DealsnGossip	unknown
@creyonjp	human
@emilianomei	human
@VagaBundoBunda	org
@woupidy	human
@TheBrassAngel	human
@NamaSaya_nisa	human
@schlimes	human
@TheHornSaloon	org
@azreen18	human
@ChessKimo	human
@Lola_pancakez	human
@FancyLuvyaaux	unknown
@SoniaChll	human
@RadissonBlu	human
@ChefPascal	org
@jamescookson6	unknown
@nabila_rasidi	human
@TheRealGroundUp	human
@ElisahJacobs	human
@thomaswanhoff	org
@gandhiriverside	human
@JasmineMaeRayos	human
@ChayanneJoel	human
@meiku_ura	unknown
@ValparaisoHotel	human
@Winter_Geisha	human
@circlitedpixie	human
@YansingOng	human
@infini_t_cafe	org
@Eysac	unknown
@Robertwood100	human
@perrachicamad	human
@naa_vl	human
@Laurina5012	human
@Arumenelia	human
@connorowens5	human
@MeiilisaT	human
@falcaoCa	human
@meganmhigbee	human
@BlkChyna	human
@Fendalene	org
@LaRoseBlancSJ	human
@Silla_Amaral	human
@Tweet604dotcom	org
@Yajaira_Vanessa	human
@LoversMelbourne	human
@haseebkazmi95	human
@kuma_hidamari	human
@endoedibles	org
@mqr_105	human
@sOuLWiNnErSeven	human
@ParishFoSho	human
@DGStorytellers	unknown
@__RagDoll__	human
@stylesocoy	human
@Janicekbaby	human
@tatehemlock	human
@callmebene	human
@mattFNblake	human
@JoleneVossen	human
@lindsaydawnful	human
@Sheeluvs_Muzik	human
@s_quan518	human
@RayInformatics	human
@sunflowerr5	org
@ExeterBizClub	org
@trvlwrtr	human
@TheDesertEagle_	human
@CommonwealthChi	org
@contentedcalf	org
@iam_missviolet	unknown
@Ladygoat	human
@phyrhed	org
@IhuntILLINOIS	human
@homespunitems	human
@bethaknowlton	human
@akinaoto	human
@poshmichael	human
@kidkerrigan	human
@jaded_amar	unknown
@DealerBeauty	human
@eddieross	human
@aluceron	human
@speed_racer420	human
@chuckwheat78212	org
@mandimayhemm	human
@Haifa1	human
@merkelope	human
@Treesazeits	human
@kwekukweku00	org
@RezRezaei	human
@panpansanghk	human
@DScagliozzo	unknown
@SAIKO_makeup	human
@AchaAsharmine95	human
@otsumami34	human
@AbbeyGLA	human
@jessicalaii	human
@katyhagelin_dp	human
@HAttwa	human
@NewsMissLunch	unknown
@ThoroldTourism	human
@food24	org
@PriLoVee	human
@DesiElizJ	human
@surayahunn	human
@Azraz	human
@tanisjustice	human
@Glutton4Dublin	org
@marumachap	human
@jooleroo	org
@rouxandme	human
@StudioCosentino	org
@giulia_arche	human
@ChrisLopez1993	human
@haoliangsu	human
@KeysightDE	unknown
@foodvolution	human
@9kido69	unknown
@JBLEWIS1983	org
@SparkoftheParty	human
@cindybernadette	human
@plant2plateLC	org
@KRenteria79	human
@giorgio06z	human
@MzM40	human
@FitnessTamara	human
@cannon_lucille	human
@XiiaoSharon	unknown
@jasonpinto100	human
@Blogtechweeks	human
@RNsongwriter	org
@Stereo_92	human
@loveballetmuch	human
@coreharlem	human
@Morrighani	org
@Vany3012	human
@PrinceJameson09	human
@jazperjay	human
@WinnerMelinda	human
@RedFrontPlaza	org
@caizer	human
@dimaswibowoarif	unknown
@BlokHeadPerfect	org
@moveeatteach	human
@zigfridhoxton	org
@sillyfeaster	org
@KEVINo83	human
@shinyhealthy	human
@westvillagefood	org
@avancampen	human
@bodytargetltd	org
@jajaBOOOOOM	org
@JamminJeff	human
@gastrotourDF	org
@KeeLou2015	unknown
@AshleyEBlom	org
@CavvieC	human
@themillermenu	human
@arg_on	human
@gmdu	human
@ahealthyagenda	human
@thesimpleparent	human
@candidabbrava	unknown
@KCLeomo	human
@diningdish	org
@UnheardChef	org
@bunnybutcher	human
@SkypiratePK	human
@LeonorasKitchen	org
@Sonia_Kumari01	unknown
@BenedettoTozzi	human
@ChefDaddySteve	human
@jasminedejon	human
@JohnWF5	human
@Apostrophe_UK	org
@Desirai	human
@TeaMiBlends	human
@bizzylizzycooks	org
@ThornHaven	human
@IvorRomeo	human
@flodeau	human
@Bakedwithstyle	human
@gqlee04	human
@krystinaf	org
@The_UnbrokenOne	unknown
@ErdaHanee	human
@rachaelnice	org
@deannepanday	human
@mrupert84	human
@madhusdutta	human
@SuperMoms360	org
@koixx	unknown
@DocsUnivCity	unknown
@itsmeErick	human
@00Reject	human
@ohmyaby	human
@adridiaz06	human
@ClritterlbC	unknown
@row_nel	unknown
@aric7463	unknown
@TheVicBattersea	org
@thehandbooknews	org
@ianbeckett	human
@WellKneadedFood	human
@thegrovecafe	org
@misskaylaaa	human
@DatingDance	org
@IAMtheGoodLife	org
@WineCafe_Nerima	org
@thehousewife	human
@AttiehDist	human
@chokitto25	human
@FrancescoJ1	org
@albert_ice	human
@littlegloster	org
@ItalyFoodDrink	org
@TeresaYea	human
@tongyunliu	human
@carmen1z	human
@ThisJenTweets	human
@catrocket21	human
@magscheung	human
@jdreee	human
@trabalba	human
@itsuyen	human
@MommyofB	human
@shandyfarliaagi	unknown
@EasySliderTruck	org
@MyNorthTickets	org
@GYMFRESH_JIM	human
@IMRYANPONZ	human
@DarenFlitcroft	human
@kwlim1820	human
@9grandstudent	human
@JeninniKWB	human
@bgbuquid	human
@RachelsFL	human
@hikky1119	human
@NongisNaphat	human
@GARYMARTINGREEN	human
@Day2DayAdv	org
@HyattChurchill	org
@TastefulSpace	human
@amun1966	human
@laprepcom	org
@Suzanne_Tham	unknown
@TheCooksCook	org
@leovillasmil	human
@CorriganMayfair	org
@laurahofer5111	human
@AnaRRocha	human
@OORerbot	human
@Sil_ig	human
@XioMadera	human
@onatchabo	human
@lmhagland	human
@emlaforge	human
@PPapineau	human
@sundaysiblings	human
@mehrnaz2244	human
@NorthWestNosh	human
@msolalcala	human
@AndrewE_Dongalo	human
@nancy6685	human
@Zed93zeddy	human
@StephKall	human
@kirstinmckillen	org
@SerahAlabi	human
@NauticalResort	human
@DaunteManning	human
@MusselBarArl	org
@Cheyday514	human
@JungleJamboree	human
@finnalestaryt	org
@OPSO_london	org
@SarahSambuca	human
@hannahleadykast	human
@RajBaddhan	human
@riceflower	human
@ghieerni5	org
@steviu	org
@EmmanCiriaco	human
@just_belz	org
@HRHPanamaMega	org
@pinphafan	human
@MadHatter_Wey	org
@Nibaldop	org
@JANUAI2Y	human
@theflipsidenash	org
@alimathis	human
@xCharlieBumx	human
@SAWhatsHot	human
@TheNikkiDuBose	org
@freeyen	human
@John_____Brown	human
@AR3Albert	human
@hopesky	human
@peaceofclay890	human
@KAlexShaw	human
@RISEL_ASANO	human
@LolaandFinnsMum	org
@DemonFM	org
@JofelerGimena	human
@myrnasilvap	human
@Cirquedufromage	human
@SavCityEnt	human
@Donahoo_CTC	human
@johnykoh5	human
@Yildiz_M36	unknown
@CafeCranberries	org
@DevnaDave	human
@MarsyaArista	unknown
@AskHarrogate	human
@cindyrina	human
@astrasuites	org
@Amandalien2008	human
@ephong	human
@ZekeQuera	human
@JamesChong	human
@bouidifouad	human
@NewSmashWords	org
@shoes_jp	human
@OscarFCastroIV	human
@heyimbrendo	human
@pgcsent	human
@mayangkelapa	human
@becs_taylor	human
@y_a_w_e_h	human
@TheKingandCo	org
@cevicheplaya	org
@vegold_food	org
@AlliG77	human
@meow_roy	human
@Fit_Wonderland	unknown
@BertReymen	org
@mlherrero	human
@rowenapavlou	human
@Estoy_SH	human
@SultansDelights	org
@PonyBee	human
@agenciangelazul	human
@TastefulPantry	org
@GeneRodri	human
@marcospina07	human
@MilfordTwitTalk	org
@WestEndBIA	human
@ClutchChicken	human
@stevezak	human
@elo_renaud	human
@DafneDeL	human
@CottoncandyKa	org
@MooshuJenne	human
@Adie_107	org
@OkiShell	human
@ErinAnne46	human
@CityDining	human
@TheLordClifden	org
@angPLASTIKmo	human
@kousei59882073	human
@kewkew34	human
@Sibyl951	human
@mintstones	human
@luminouswellnss	human
@CompanyofCooks	org
@OrganWiseGuys	org
@RetweetedEnergy	unknown
@reizalmursal	human
@RevCambridge	org
@TeeJayToday	human
@judelanne	human
@guineveretab	human
@apexgomez91	org
@AugustaSupple	org
@BethanyErin1	human
@Diiini	org
@androlone	human
@Raunileena	human
@diyfitnessclub	org
@anger_food	human
@WeinsteinNights	human
@ModeRosa	human
@ayumeylie	unknown
@kwanie_bo	human
@RiverCottageBri	org
@tugceecelikk	unknown
@KOGCorp	human
@slwdwn3g	human
@blueoiseau88	org
@CocinaCasera1	human
@Huz_zai	human
@QueenBeeZoe	human
@RaeRayRay	human
@kimneville2	human
@yzampitella	human
@fuggsandfoach	human
@claireessexgirl	org
@mikenseer	human
@Fuckin_Famous	unknown
@FoodDrifter	human
@TheCarlMyers	human
@iRefuseToCare	human
@bestofcyfair	org
@BrownsVCT	org
@yukiikuy	org
@EllermanHotel	unknown
@jayceepablo	org
@LatifahAbdur	human
@Jennyfermarcano	human
@MirjamDI	unknown
@OreganoBasilico	human
@therealarifjina	human
@foodietude_blog	human
@AndreaDelPesce	human
@foofiiie	human
@Downtown_Ttown	org
@TheForresta	org
@kraylfunch	org
@OvejitasDeDios	human
@FourShopping	org
@highlandgrillmn	org
@MartiPhen	human
@CoryEstes	human
@eva_faus	unknown
@DARTHKUSHNER	unknown
@StuartWatts1lon	human
@Old2NewGaming	human
@EldoradoHotel	human
@MissLadyLeX	human
@CpnFantastico	human
@aruocco1	human
@MissoulaWales	human
@CafeMonetNJ	org
@jurylady5	org
@YouveGotMELL22	human
@Adhiyasatriya	human
@dindandiniga	human
@fatboyfoodie	human
@rick_varguson	human
@afrivenues	org
@RetweetBOS	org
@We_Heart_Vets	org
@fang_chris_6	human
@sumokeng	unknown
@vansfoods	org
@NikkiNurtures	org
@Ilfalconiere	org
@marytheluckyone	human
@Healthyfoodbyme	org
@MENU_Portugal	org
@woofeous	human
@cmanzano_Gel	human
@nikkywang1991	human
@Bistro_Campagne	org
@heels7408	unknown
@montecarlobcad	unknown
@JakzonKane	human
@azrinizzati	org
@commonobjects	human
@elaine_dupaul	human
@SaucisseDeli	org
@RosieFoodie	human
@KoloKennethK	human
@AnnaAnnabell245	human
@AilenOldano	unknown
@matthewvicenza	org
@JessicaBitme	unknown
@c0Sabrina	human
@aru_sakka	unknown
@BeazellsCajun	org
@AndyDeJesus305	human
@PrincessPassion	unknown
@BarnsleysHour	human
@nicoledobluis	unknown
@WFMlosangeles	unknown
@linzedens	org
@theregos	human
@LetsPOPCORN	human
@TheRedDoorSD	org
@cook_byyourself	human
@JayMistry88	human
@TribalSoul_	unknown
@EliRobainaTV	human
@lifentco	org
@veravic1228	human
@chrisahbie	human
@SymsPantry	org
@isinorestaurant	unknown
@1stSimona	human
@JerenyPorlas	human
@Gods_ButterflyR	human
@xtinababiie	human
@TBirdGourmet	org
@uuldhanz	human
@MarketHouseBrix	org
@marinamaric8	unknown
@YoTryDis	human
@1star808	human
@AmyBowie	human
@BrainBalanceWMA	human
@twerk_beezy	org
@ar_aui	human
@Joey_Corr	human
@Ksetpal	human
@azheem2000	human
@shellilouwho	human
@lindsayzv	human
@greek_on	org
@LUCHIMILLIANI	human
@Elenacruz	human
@SanDiegoNewsNow	org
@KojaxSouflaki	org
@CuliKiewiet	human
@sueann_ng	human
@JG98580	human
@lyssaheyyy	human
@EatRightOntario	org
@pambukkk	human
@downtownmomnyc	human
@GALIcioso	org
@ewansulin	human
@wuthecleaner	human
@OsvaldoMun09	unknown
@lovemii1206	org
@LAStarCosmetics	human
@ammarkz	human
@annyde9	human
@RaqelinhaaN	human
@HumanistPundit	human
@cindykimhk	human
@Clemencia5267	human
@milkteaxx	human
@SageAndRelish	org
@RedJezebell	human
@Toom_supachai	human
@caseytdumont	human
@CarmaPR	human
@Jaidjen	human
@HuiShannnie	human
@ThePeachBellini	unknown
@EatGoodTimes	org
@LeanneABevan	human
@AlejandraTrinit	human
@MagnumSolace	org
@p21cey	human
@locstitches	human
@mishamaze	human
@gaciru	human
@Custom_Burger	org
@LeanneSlimWorld	human
@Beca_Perez23	unknown
@justenjoybis	unknown
@CUTvision	human
@mokclubroma	human
@phixoul	human
@DJ_KevinMove	human
@BeBodyfabulous	human
@Jemwell	human
@Libs_22	human
@ravpig	org
@Meanchef	human
@Itsiyaaan	human
@vulry	human
@GreysonKentxxx	human
@Simply_CharMie	human
@TheDomesticGirl	human
@dawn_trudeau	unknown
@IvanaAgnesT	unknown
@weelissa	human
@thisrunrecipes	human
@Contour_Affair	human
@noGuruDiet	human
@Zilfstar	org
@OKC_Foodie	human
@HealsukHeals	unknown
@Jpy27	human
@LeiGumanit	human
@danielduquec	human
@Denovo777	human
@BTWNRY	org
@austin_heckman	unknown
@VibeRevStudios	org
@cabbie702	human
@802gohan	human
@mylittletestkit	org
@yourpotofgold	human
@VoxPopple	human
@Yuri_is_Ito	org
@janipooja	human
@blusherbrownies	human
@vintagefuchsia	org
@KarlaonQuinpool	org
@youreworthfit	human
@ShayeDRGaray	human
@Lennae87	unknown
@IPT_GeloMorelos	human
@Masa14DC	org
@kmb_krista	unknown
@Two_Hooligan	human
@geekgeekmac	unknown
@Iammrpizza	human
@alicetwain	human
@xnicknj	org
@KenCeder	human
@donnell_anne	human
@GUILLOTINE89	human
@farasaila	human
@theheatherfawn	human
@emljhow	org
@DanniDeville	human
@RobinSpringer1	human
@aldoadela	human
@corsophoto	human
@ohmyteashop	human
@FeliceAdeline	human
@EdnaMonroy	human
@olfaktoriapl	human
@CHEFJUSLA	org
@TaleeHeat	human
@Faxionese	human
@you_doughnut	org
@BecciBrisland	org
@ChrisJonaWong	human
@aidiharon	human
@i_charm14	org
@body88age	org
@JunSebastian	human
@Raicya226	human
@iTearful	human
@SuccessCoaching	org
@wizardemman	human
@juriloves1d	human
@SINNOTTRAGEDY	human
@MrsPalazzolo	human
@COCOhernandez	human
@Pumi_PG	human
@PHenri51	org
@charlesabinader	human
@ivyseowwei	human
@t00nch1	human
@ArianeResnick	org
@Dwieetarrii	human
@cambsuk1	human
@ChiaraLTurunen	human
@kewlot	human
@yoyosounds	human
@RawExplosions	human
@brianroslund	human
@crazymoana	human
@kurupted85	human
@DaniRaeBae24	unknown
@ishouldbemoppin	human
@MeKatelers07017	human
@doncambronero12	unknown
@MaikeSoen	human
@CriticsGuide	org
@Majonline	org
@SarahSinging10	human
@Bond_Lee_Back	unknown
@WineCoveZA	org
@eatwritego	org
@yvannesteva	human
@c1282	human
@CalzadosHB	human
@IssyandSofia	human
@SpeakYogyakarta	human
@Fusengn	unknown
@KahtieCooks	org
@WildtreeNatural	org
@Fitnessmania_BG	human
@Warlord1p	human
@OliviaRose1994	human
@aliyajaderosa	human
@Omni_Hug	human
@dennisduncanson	human
@LifeCleanse_	org
@profiler_mar	human
@cc06778e126b46b	human
@Lindy_	human
@The_Style_Swag	human
@ikkifujiwara	human
@fussyhunk	human
@StellaKarunia	human
@beemer00o0	human
@MarianTHickey	human
@Rafe_Rosal	org
@mainusan	human
@amarshallewis	human
@howarddelirium	human
@FlyingFeliz	human
@Shieru_sp	human
@cathkatz	human
@Esther_Noa	org
@DivAmber	human
@elputniuqA	unknown
@TCDTC	human
@SassafrasCafe	org
@HZ68607445	human
@dennisscoop	human
@plustwo_xD	human
@VeronicaMScRD	human
@McCallsOrganics	org
@bluelovinmei	unknown
@Tanakawee	unknown
@AleyArif	human
@BCDlane	human
@_rosieglow	human
@FaithBowmanSays	unknown
@Liz_Cerezo	human
@LandisMarket	human
@MassiltSTR	human
@teafortwo_c	human
@lsrfr	unknown
@AshwinQ	org
@Kurdishrecipes	org
@WidyaIsnin	human
@personalitini	human
@VidWall4k	human
@RadBluSandton	org
@ZaraAliKhan	org
@lovatic_echelon	human
@tiancostelo13	human
@alexespayje	human
@ByourBself	unknown
@Shrieder	unknown
@BetterCater	org
@Himeka19870315	unknown
@BeccaStories	human
@Bernice1219	human
@blkskvrk	human
@TravelerFoodie	human
@Rita_Erlich	human
@PritchardandUre	org
@reluxu05	human
@MiCasaCM	org
@puffpass86	human
@eomirou2012	org
@BlueIce6102	human
@GayGuideMexico	human
@nonporkperry	org
@TheOneUp	org
@janiie_93	human
@michelleremkus	human
@nettifesus	human
@herbstreet	human
@ariaadjani	human
@carouselworld	org
@ms_sara_renee	human
@marcomeza	human
@cathyleetong	human
@Joker8x1225	human
@Yuto_Chisvert	human
@preciouslittle1	human
@DeryaKakciGoksu	unknown
@undercurrentgso	org
@SaltiD1G	org
@KKLOTHING	unknown
@Fa_bass	human
@baminluv	human
@BeBre247	human
@KililiBaharini	human
@nicholasspap	human
@TeamMartinez610	human
@MSistersAkmar	human
@LOL_BlogIreland	human
@carolmerza	human
@WanderlustKitch	human
@specialksl69	human
@dewirossilia	human
@madtyper	human
@gg_rainey	org
@miyo_340	unknown
@DawnLlanera	human
@fa146352	human
@SantiRestaurant	org
@YazzyNas	human
@Trevoz	org
@vickki1000	human
@digunsigar	human
@simbiosisgroup	human
@aliceangelineg	human
@payanotopten	human
@TweetV_Free	human
@staraccessnow	human
@TheaGlindorf	human
@LittleArabia	org
@kaishocaphill	human
@pREciOusTOni19	human
@kenjiro16_bot	human
@LucianoSchipano	human
@wvanillasugar	human
@Faichilleach	human
@divafabulosa	human
@Chula1718	human
@emitsaa	human
@PigandKhao	human
@vladgarza	org
@Annarza	unknown
@DanielaSilva233	human
@LLeyav	human
@NYCGirlinPearls	human
@heatherdeBruin	human
@vriliakiki	human
@chuchuchu62	human
@Wnicholasgomes	human
@smllStps	unknown
@ChevreDiaries	human
@Charolette291	human
@sapphireskyeM	human
@ThereKrisGoes	org
@golf_mint_07	human
@fong_anita	human
@househealthy	org
@ha_chu	org
@OTPromotions	org
@HealingCooking	org
@BrockEatHealthy	org
@Chevar	human
@Treyvon1018	human
@AxMortiz	org
@yuri_kombu	unknown
@ScarlettBice	human
@going_dad	human
@JasperSong	human
@margueriterwal2	human
@Sornsamdaeng	org
@CarloVischi	human
@WCWECEO	human
@SoleHealth	org
@OGalache	human
@lanaberrie	org
@_InYourDreamz_	unknown
@DelectableDET	human
@Foodwanderer1	org
@edvinr818	human
@NPVitkus	human
@DeannaCarmen	human
@JosiesBW	org
@JohnHarris9929	human
@BALLANDCO	human
@shortcakesdiary	unknown
@THEJUGERNAUTS	org
@bornchozen	org
@Yoga_Soedarma	human
@Christie_Lazo	human
@EthanKrane	human
@TheBiminiPub	org
@akosiredfirefly	human
@crazedmom	human
@ocvilla9810	human
@verrillfarm	org
@JavierCeriani	human
@IndiMate	human
@eva_novarita	human
@joannaonthelake	human
@akkinShiba	human
@ShaneBowley	org
@Juliette96club	human
@roseloyola	human
@PeteWadenz	human
@iamhanishamdan	human
@Ms_MartinaR	human
@Liew_Chunhong	human
@HRHPrinceKK	human
@KingsHeadWorcs	org
@rrspink	org
@reinaldoaduran	human
@kerryberryluv	human
@ShakinaYoung2	human
@AlFath_Asli	human
@lisavcurley	human
@CorsatoEmanuele	org
@chouNancychou	human
@alexrunsforfood	unknown
@BlissSquared	org
@WaangHeidi	human
@Nestle_CRUNCHes	human
@FtLauderdaleMag	human
@ninamagal	human
@WeightWatchers	human
@CaptSteve	human
@ClaetynShayne	human
@DTBxDraculina	human
@Berry6189	human
@pinkypinkyshow	human
@JanelGr	org
@ansiansela	unknown
@TriSportWorld	org
@Nonpavit	human
@BaySportsMom	human
@walaafaqeeh	human
@Luv2beme85	human
@sofaspudnik	unknown
@CafeDeliNairobi	org
@obuk	org
@PatriciaWee	human
@hale_alt_review	org
@BookPuertoRico	org
@ggoneglobal	org
@majafluri	human
@VintageELLE09	human
@goldenroadpub	human
@BIOEWORLD	human
@JeromeChan	human
@memomiew	human
@GustitosBakery	org
@b4lb0	human
@NiaRestaurant	human
@ayanofukuoji	human
@ahmedrabea	org
@CoutureBeans	org
@captnjakesjerky	org
@sardisjaque	human
@CristinabCristy	human
@tinhaz92	human
@Keyla_melanie	human
@YouDreamOf_Gigi	human
@StuffMySonsSay	org
@ShilohTT	human
@sarahgrant62	human
@3ndys	human
@MaliaZheng	org
@bOOterfly_rhian	human
@hometasting	org
@KellyWelly86	human
@FunnyAuthor	org
@GoDairyFree	org
@samantha_05	human
@BigEasyNC	org
@SirWinstonBrs	human
@Mattyy__	human
@javito991	org
@prettinish_nish	human
@khemboontharig	human
@95210org	unknown
@saoriUrb	unknown
@rivera22mark	human
@funeisono	human
@KritikaandCo	human
@TheMarkOfficial	human
@RANDluxury1	unknown
@tovarito85	human
@OngDoreen	human
@sankziel	human
@heidi_robb	human
@BernieRitchey	human
@napalmlabs	human
@HighHeelEsquire	human
@PenaGlasgow	org
@sponkster	org
@Gina_skittles	human
@LazySheepy	human
@aureliesauthier	human
@Amberlash	human
@syber_silly	human
@tthiri	human
@AzusaMoriya	org
@kabeljauInferno	human
@RonaldRHarmon	human
@felice_woon	human
@Pizzatown_Sackv	org
@NinjaMinato	human
@Kraftmatiks	human
@mikabaton	human
@Koallaz	human
@DJHizkia	unknown
@ms_b0oklover	human
@JamaicaMixedIn	org
@SLXcud	human
@KELLENCACHE	unknown
@yellow_yachts	human
@LandLLosAngeles	human
@AweseeGardens	unknown
@PaneraKansas	unknown
@zenybebey	human
@AlaskaBerlin	human
@MzJenn2U	human
@CandiceRose13	human
@sissysexton92	org
@FoodGamut	human
@PurpleJazzflowr	human
@aurelievanhoute	human
@Pitbul_inaskirt	human
@woitekj	human
@titashi	human
@SarahLin1	human
@nami221	human
@beckspress	human
@heomberreehee	human
@GiantFoodStores	human
@ScarletHollands	human
@SuryaRestaurant	org
@trent_nig	org
@Salmontini_Uk	org
@MaryMarytkraus	human
@nizam_ii	human
@baby_kane	human
@lisadaniels3	human
@eatatblueroom	org
@nowhy2brand	org
@shawty1902	human
@jenko79	human
@sherrellrgc53	unknown
@tebibyoussef	human
@jenejel	human
@anabelMT	human
@JYV_03	human
@Carochi	human
@ImJoeyHon	human
@djdguan	human
@Epicrealist	human
@garethmarcuk	human
@modelovers	human
@LifestyleMkts	org
@CarsonNugget	human
@Violet__Lin	human
@Latteuser	human
@AllDeMiracle	human
@soulcup9	human
@nelsontraynor	human
@jackiejoneslive	human
@MrRonSays	human
@thehealthhutuk	org
@EdibleBrooklyn	human
@VillaMamas	human
@Colacolchik	human
@bloodyladyrinoa	human
@coilynansi	org
@alWaleedSS30	human
@EyeDonghae	human
@Jamea	human
@MCISMYIDOL	human
@swiftmediagroup	org
@KoreanWasted	human
@HotTopicKarma	unknown
@learn2serve	org
@lauren_015	human
@venus723	human
@misssixfeet	human
@Auntie_Cathie	org
@Mr_maquiavelo	human
@nicolesavilla	unknown
@nachingon	human
@mayyamapee	human
@withstilettos	unknown
@NeuvooCharlest	unknown
@StyleOnTheSide	human
@HeatherGrayce	human
@Misfitkim	human
@BLMark	human
@the_clean_me	human
@DesiGayLife	human
@Hendry_86	human
@GaboArismendi	human
@CorinthiaSG	human
@AlamoHotDogCo	org
@ChinnyChanChans	unknown
@liiinzi85	human
@cocomamafoods	org
@notsojorge	human
@monkeyzmommy	human
@daliiinee	unknown
@sacnicthecruz	human
@bhamiltonmusic	org
@just_reptilia	human
@ChrisHawat	human
@maidsinblack	org
@sayhaytomeg	human
@ClaudiaT91	human
@Anton_Gwapo	human
@keatingpa	human
@vezzalius	human
@DVSDelightz	human
@capunkalexpiero	human
@shunafish	human
@yyysjkkchd	human
@ringovino	org
@HungerJamesBlog	org
@ceciliabell	human
@firztborn	human
@ElaiaCafe	org
@thewaiterrule	human
@123mhmhmh	unknown
@PAelaD	human
@AbsurdInfinity	human
@uwai0001	human
@luxuryscotland	org
@thatsdurentis	human
@GrnMangosCater	org
@cheeze_mag	org
@foodie_eces	human
@mrgq181	human
@kana_chaan	unknown
@Blessed_Loretta	human
@ediblerichmond	org
@mangotreedc	org
@jtiltonflood	human
@JYparadoxchild	human
@joey_augustyn	human
@TammyPageOx	human
@ryno_72	human
@ShawnaBeauty	human
@SkyKongKongCafe	org
@kathyuy93	human
@NatenAl	org
@khushisakhrani	human
@joycee_poh	human
@mldMcdvid66	human
@Michigan_Rt	human
@no1gingerpickle	org
@GrandCentralMkt	org
@GRFatRooster	org
@KayKay__1	human
@chike8mhn	human
@FitryOmar	human
@EEKckyldz	unknown
@Paopy2IIAM	human
@NourishKelowna	org
@wilkravitz	org
@AmiraAlyarubi	human
@teenagelife983	human
@millenislove	human
@Cherie_Amour05	human
@Fiocchis_Pizza	org
@Health_Well_Up	unknown
@natashajwarren	human
@jennanorth	human
@heyitzsunyaa	unknown
@DontPanicMom	human
@_Amaral___	org
@AdelesNashville	human
@ArleDillien	human
@Lynsey549	human
@LoDoEatBeeps	org
@HijaFruta	human
@thelauly	human
@Everlasting_4U	human
@RaulCorreapr	org
@kim_manning	human
@hashtagcakeme	human
@PorSingsSong	human
@nyaaaaa____s	human
@cadguycad	human
@BookMunchDxb	org
@wolfsoul	human
@p_staatz	human
@elonnabettini	human
@JuaniBuda	human
@WestcountryEggs	org
@KingsDreamer	human
@SuJinTenorio	human
@MapleAve147	org
@sotrendyblog	human
@aphiodite	org
@Myx_tet	human
@CRPCCC	human
@fred_torres21	human
@paf_arh	human
@BADRMF3	unknown
@MyZafferano	org
@slakingfool	human
@helenaawad	human
@FaithnhuffN	human
@FondaLola	human
@alessia_camera	human
@HerrNicholas	human
@maryfher_	human
@jlobusta	human
@JeasterPhoto	human
@ColourfulPalate	human
@MyLittleRascal1	org
@brntlyjnny	org
@ideasinfood	org
@frankdavies713	human
@babamotip	human
@IvanaCRD	human
@abrilazg	human
@ming29	human
@elbuendiente	unknown
@annapetisidoro	human
@FriedEggLove	org
@zeeblikesit	human
@Kasia_Tunnell	human
@SaraONeill13	human
@HyunJoongie	human
@dgtex_ru	human
@duermeveland	human
@Imc_coffee	org
@mchennychenchen	unknown
@Kyle_Chu	human
@honixon97	human
@jchen3605	org
@charmaine_ro	human
@khesney	human
@JessChangStrong	human
@richardmergler	human
@ko0ty	human
@theElvictorious	unknown
@kanakanasakana	unknown
@SweetGillianism	human
@adayjchen	human
@EmilyWillsonx	human
@vaNzDifferent	unknown
@unplantedco	human
@RevoShark	human
@biepronouncebee	human
@deelo70	human
@MikeleCerioni	org
@iamintomusic	human
@CarnellUNYC	human
@TheZenParent	human
@teddy_Z	human
@kuethesun	human
@TheBoulevard703	org
@4L13Nboy	human
@Restoin_UK	org
@Paleo_Chef	org
@Ataichan10y	unknown
@taherlunch	human
@MommyFactor	human
@jenitZz	human
@DaniquedeWinter	human
@MichelleWPark	org
@jasonbill08	human
@karlSev	human
@pepsijamaica	org
@ModelChef100	org
@CaptainRish	org
@BOC_Music	human
@EgleGraziani	human
@foodiewinoSF	human
@BRIB3AR	human
@SuzetteRollin	org
@BWillN	human
@AlmondBreezeAUS	human
@MakeupbyDamee	human
@heartyoufromme	org
@ED00793	org
@cronicasgourmet	human
@TJoyce1971	human
@LathaViknesh	human
@StuartTang	human
@StevenChandra	human
@GingerRoots1	human
@FirstWeEatNL	unknown
@3gwebs	unknown
@AS_FineFoodsNJ	org
@ceVoke	org
@CostOfSale	org
@DoloChosen1ss	human
@HappybooNisbet	human
@HOT877Zambia	org
@kingyinb	human
@megaton56	org
@Nimhungry	org
@jeriaoates	human
@teapartyatthree	human
@GundaReire	human
@aleOrelllana	human
@ChefIanArthur	human
@hlzazzle	human
@pailinlyn	unknown
@iTzDEViOUSBitch	human
@lilyajie	human
@BakingAMoment	org
@HotelinPisa	human
@GrandmaDowntown	org
@sam_setiawan	human
@gggilliannn	human
@meetashy	human
@Fleta889	human
@the_sycamores	org
@Janizz24	human
@MartinRouleau1	human
@corynaliza	unknown
@claudineoalfaro	unknown
@Mcaelatias68	human
@PHLOysterHouse	human
@shadeoffashion	human
@xiaolincheese	human
@ShadyAlnamli	human
@KwokMichael	human
@JimLim111	org
@AmyCragnuliniJB	human
@haqnificent	human
@TanJiaHong	human
@icecoolsnow	human
@milly8512	human
@ReinaaRoyale	human
@renitalcollins	human
@melkettle	org
@Lalal2ak	human
@dnelsonsambo	org
@ara_and_spirit	human
@NatashaBaig	human
@AAbramshe	org
@TrapBoyy	org
@yukakty0308	human
@FarmersBottega	org
@Reika0701	org
@Natiortiizz	human
@ally_evans	human
@yasuko_MM	human
@sankofa1982	human
@_ThtSt0nerLook	human
@junyijude	human
@Ms_Cooksalot	human
@kumaneko_8	human
@PhoeniciaDiner	org
@simonseaforts	org
@Metchalyn	human
@cute_chuck	unknown
@bysarahrae	human
@ZacharyReed	human
@whatscookingbb	org
@SeemaJindal5	human
@srijanz	human
@HealthLush	human
@simms_amanda	human
@caffebeneusa	human
@AyizDAce	human
@staysocialhouse	org
@One_RWY	org
@IITonNamII	human
@BrumHour	org
@itsbeben11	org
@foodindubai	org
@tecknotot	human
@bartendersgirl	human
@tortelliniandc	human
@xmagic_dustx	human
@nuts	org
@FoodIsMyPorn	human
@ckhealthworks	human
@shahadali	human
@TyTwinny	human
@runridekupo	human
@Silhanvi	human
@EraVSorosoro	unknown
@dj_mac_nificent	human
@amomsimpression	human
@neil_cuaresma	human
@lehlickromero	unknown
@choithramsuae	org
@SugarsNSpice	human
@bellegL	unknown
@JoyceyKa	human
@CandiceKumai	org
@ThePAMom	human
@scott_cover	human
@winemanboy	human
@Princemojo77	unknown
@MyTravelingJoys	human
@modelxfactor	human
@SuperBusyMum	human
@mohd_yusman	human
@KATOkski	human
@uytopher	human
@ashspinelli87	human
@FoieGras4Ever	human
@FridaCoco	human
@luckycat215	org
@shrimoyeec	org
@MMontagueLiving	human
@elsapoveda	human
@thetransporter0	human
@roejapaneseja	human
@cynthiajdurbin	human
@frida_sophie	human
@guyfawkesyork	human
@Welcometoharlem	human
@Shrewd_Foods	human
@IpanemaSeattle	org
@Cspr4lf	unknown
@drinkmemag	org
@meals_earlscrt	org
@BeelmansDTLA	org
@igalarr	human
@SingleMomPlanet	org
@moderndayGF	human
@eat_news	human
@HouseFundsUK	org
@MiRecetarioblog	human
@BilaG729	human
@kathyDJkat	human
@Ingliston	org
@VenusLMY	human
@Lazyfish73	human
@amandasername	human
@EatOutLDN	org
@khattleeya	human
@BEHGenY	org
@JoshRelova	unknown
@iCarlyFan2009	human
@svengunnar	org
@fancygirltable	org
@Go_Chisou	org
@R3KZ	org
@amandamhayes	unknown
@VIParis22	org
@FoodieToursRD	human
@rosalio87RSA	human
@wagstaffchicago	human
@appleintravel	human
@ts_tidbits	human
@Janbagnall	unknown
@BanonokeBGriff	human
@SoMoH	org
@DennysCanada	org
@rejdechavez	human
@quietbuhcrazyee	human
@LilouHome177	unknown
@sweetoscar79	human
@WellcomeTourist	org
@SianGunney	human
@aj_alzuhari	human
@irmghard	org
@HollaMan69	human
@WVfrugalCHICK	human
@TheATLAssistant	human
@remonmoerman	human
@dewinner	human
@DoctorChili	human
@MCParkgate	org
@Bakeshopoakland	org
@DesiChumbak	human
@Fashion_Workrm	human
@milVaughan	org
@mrsdimemmo	human
@mychildworldcom	human
@dewaluva	human
@jeffdavidson_au	human
@DrRobinson2014	unknown
@MartiNAok5	human
@B2L_Consumers	org
@MariannaDeLuca_	human
@mokarim93	human
@jessxrenae	human
@jjeremiaa	human
@ElBrunchBlog	org
@Bigrockgrill	org
@onionisa	human
@IoSonoPanz	human
@FJuncky	human
@Chijuvenation	org
@bphotoart	human
@MartinsGFree	org
@vachelon	human
@jirakong	unknown
@gregalprin	human
@Myhaverphoto	org
@im_bobbycarlos	human
@jesz_tjiong	org
@doreen_89	human
@thubaki7200	human
@zedinizneto	human
@achawkphoto	human
@rameshRTIC	human
@NemMorte	org
@sexylexi05	unknown
@FaezahEzzah97	unknown
@TrevorBoller	org
@SFPConcierge	org
@DantonioLaurent	human
@BeingAlison	human
@FeedingMyKid	org
@zianrv	human
@CaseyGuitarsHH	human
@imagesbykristia	human
@Rated_J3	human
@maria_haske	human
@Wolverming	org
@kaneryanthomas	human
@NomNomYVR	human
@pcpalmares	human
@CheapChomp	org
@Nooga4Lunch	org
@muncherapp	org
@KayleighP89xx	human
@thadz_love	human
@Grainful	org
@SheenaPradhan	human
@SpankysKitchen	org
@belsiak	human
@Babypop	human
@rudyrosciglione	human
@GoIzakaya	human
@mikekitter	human
@AngelosPizzaNYC	human
@Baileymariereid	human
@ArabNewsRt14	human
@QueerVeganFood	human
@ChefJoshRueda	org
@BocaChicaMN	org
@Bangbangboookii	human
@DeanW1979	human
@BlueCrabMartini	human
@bonjourOiseaux	human
@GoldenKrustBkry	org
@LO_SIGUIENTE	human
@Nakednut35	human
@thebabyvegan	human
@LavenderBistro	org
@CrowsDairy	org
@Holliem003	human
@greenami1	org
@DaShak	human
@ohciknaalaa	human
@putuekarista	human
@PetersSelect	org
@Sarahcroft	human
@rachel_quenzer	human
@kelvinhong87	unknown
@FabioGesualdo	human
@ChubbyNoodleSF	org
@BogotaBistro	human
@Paceina	org
@biscuiterie	human
@SlimsPorkChopEx	human
@TheClaphamNorth	org
@100milesfoodie	org
@icy5cabrera	human
@KydooTheEmcee	human
@man14_14	human
@hapmichigan	human
@gotovimschastye	human
@WieLampard	unknown
@BrettGarrot	human
@HarietteL	org
@TheRefectory_	org
@steadierzebra3	human
@natussshka	human
@yendasr	human
@BowmanDAllen	human
@BodyBest_	unknown
@Bistro31Dallas	org
@WatatsumiUAE	human
@TinneCooks	human
@Fabio_Merche	human
@arisa_maeda	human
@matthewmoments	human
@Roselynn2152	human
@BorriMajlufOK	human
@ybarselah	human
@RadenMan	org
@TheVictoryGrill	org
@cloyd_044	unknown
@wildaliem	unknown
@AsadoGrill	unknown
@DaintyBride1	human
@Lolann	human
@DafamHotels	org
@born_the_brave_	unknown
@foodgoblin	org
@Machine1986	human
@ChatherineHuang	human
@kaorifuruya	human
@phoenixnewtimes	org
@goldyfish79	human
@Chiara_Scuro	human
@gakilar_sho	human
@AMoraitis	human
@Chief_Broham	human
@RebeccaBitzerRD	org
@AvenueHove	org
@GracewturnerW	human
@danneuro87	human
@bellekitchen	human
@SpassoNYC	unknown
@kokoshamell	human
@ggooray	human
@JanetBalsbaugh	human
@VirginTracy	human
@CasaLunaIbiza	human
@FairozKareem	human
@IAmChillWill	human
@cooharvey80	human
@edenwoknyc	org
@giovanna_acha	human
@OutToLunchC	human
@alladz45	human
@PritiMenon85	human
@jccolgate	human
@VapianoKSA	org
@TheTasteHitchin	org
@TheBeansBlog	human
@lilblackkitchen	org
@Avid_Traveler	human
@usedyorkcity	human
@Jill_Eats	human
@irvine10via	human
@thelittlegay	unknown
@rjsamson07	human
@myayaya_c5	unknown
@pipinpa	human
@PamelaLoveridge	human
@april_golightly	human
@todaymedianews	human
@2chowchow	human
@Jamiepage1000	human
@LushGrub	human
@odysseypizza	human
@Sybil872	human
@emilykwan13	human
@AbayaAndHeels	human
@hushdinnerclub	org
@AlBadiaGolfClub	org
@zhaotq77	human
@WhiskyWall	org
@MlleLauuu	org
@darshan_ganesh	human
@DonnaandTora	unknown
@HeirloomRestNC	human
@GGreenier	org
@BabyMichelleV	human
@mandyismandy	human
@honestburgers	org
@_IndulgeUrself	unknown
@Jess1caRenee	human
@LaineyNoel	human
@MightyGenie	human
@ChefBird	human
@swttmorena	human
@kayechad23	human
@jemsterrr	human
@martinadaziano	human
@albertabrego	human
@healthyfoodspro	org
@TescoHealth	org
@scenesofegypt	unknown
@StephyLumZ	human
@papergirlPR	human
@qthemua	human
@Luchaesque	unknown
@nikkinewchapter	unknown
@dontcallmestepm	unknown
@Gary_Voyles	human
@SilveryBluey	human
@RawYogaUK	unknown
@VVLicious88	org
@reginabeth	human
@Amanda58123	human
@sandyphalom	unknown
@Timothy_Hughes	human
@DrSherriWorth1	unknown
@theoriginaltops	org
@lusciouslara69	unknown
@noonunoon	human
@yumskim22	human
@alven327	human
@LallaOfficial	human
@iamskyscraper30	human
@emmaculantNIK	human
@siamkittie	human
@BacudJake	human
@aaqib_akhtar	org
@HerRoyalSweet	human
@AbujaChef	human
@XiioTong	human
@liledefrancecr	human
@MszH0n3ydutCh	human
@robinsenne	human
@TakeOutTech	org
@altodoseculo	human
@CarlitaHidalgo	human
@tasteamsterdam	unknown
@Immfashionblog	human
@canametller	human
@jomyut711	human
@Veggie_Inspired	human
@mkjmc	human
@CarolRasche	human
@w_1221	org
@foodsheduk	org
@Cover3Dining	org
@GlenysClarice	human
@tascasansofe	org
@Citystyle_guide	human
@TheBaronFredman	org
@marinusbothof	human
@nekonomario	human
@dylonix29	human
@angieti	org
@GauchoBBQ	org
@MakuMonkey	human
@hanemyohan	unknown
@EatMachoNacho	org
@smeeeff	human
@radiankusuma	org
@daniellalode	human
@Golfkocken	human
@MidfieldsGranol	org
@anhelo_koichi	human
@SwamiBaracus	human
@PudgysHuman	human
@Nextlevel16	org
@HeartSongTarts	human
@Agpenamx	human
@ichijiku_rye	human
@joshie1206	human
@SyC_conbeth	human
@WidianOthman	human
@Chantal_A_	human
@noelletansingco	unknown
@shelovespie	human
@JamieDeBree	human
@kristinecrook	human
@aikacnswagg	human
@xperienceharlem	org
@MMEkenny	human
@ThriceMedia	org
@dulceochoa25	human
@nate479	human
@kookkikkie	human
@guestlistblog	human
@Foood_Poorn	human
@MatiiiiiBurgos	human
@StripATL	org
@oldchurchworks	human
@shazamuhammys	human
@warrenwwwong	human
@nattylara	human
@Dinangela	human
@LStevensonPR	human
@FabulousFoodFan	human
@GlamazonDiaries	human
@bnblovers	org
@WindaSholehudin	human
@HakeemAbRahman	human
@lady_e13	human
@karalizabeth	human
@eviln478	human
@BistroPJ	org
@HollyDalton17	human
@stefyorlando	human
@hirockma	human
@IS_magazine	human
@Amethyst_blog	human
@SweetestLiitta	human
@martinceviche	human
@MoreMoneyBuk	human
@PrincesTT1	human
@ayana0811m	human
@chelle_lly	human
@collinemae	human
@ale140	org
@superkawaiidang	human
@NapaRiverGrill	human
@the_cocktailguy	human
@Kerence07	unknown
@AzwanBamadhaj	unknown
@Kezbia	human
@ishecamangian	human
@louistrent	human
@astallison	unknown
@FransiskaTirta	org
@TonyRomasAruba	human
@pateyeball	human
@NOZOMI_LONDON	org
@LieutenantsPump	human
@StayfitJILL	human
@meals_holloway	org
@AnoukVergison	unknown
@Elyse_Setlife	human
@JoliePapillonUk	human
@ChaMikz2	human
@Leonpthepoet	human
@Ely_gypset	human
@Annas_Porn	human
@for_ryanM	human
@Surbhi_1902	unknown
@ThomasJonesJr81	human
@tamaokung	human
@BigReviewTV	org
@JarlsbergUSA	org
@leesah05	human
@alextudorborghi	human
@Alicemegan93	human
@heart_and_belly	human
@DanielBoulud	human
@mirinia	human
@zonefitness_SA	org
@IstiFoodIsland	org
@helenarwester	human
@Criistal_A	human
@moore312	unknown
@lifedisneystyle	org
@SoberMindHeart	human
@ATimeToKale	org
@Lils_Hui	human
@LiviRynn	human
@yarnsalad	human
@Megan_Salpietro	human
@Radisson_Noida	unknown
@mrsamezaing	human
@yacco_333	org
@TheFitnessU	unknown
@TorreLuca	human
@SandSLiving	human
@PinkCabbageCo	org
@Sill1990	human
@Guiillee27	human
@p1nkroots	org
@SimonDanczuk	org
@dlayphoto	human
@MariFer_Cruz	human
@paolobeezy	org
@alittlegourmet	human
@MDub70Deuce	human
@mettajay44	human
@TautlihC	human
@yuliainneke	human
@viemerjhosnil	human
@poopersita	human
@itsgoldierox	org
@NisoOnthebeat	human
@HCWHotFlash	org
@TheMarkCross	org
@WrongDayToQuit	human
@JennlovePhanToM	org
@BYP_Fitness	unknown
@nucleartomatoe	human
@shionobe	human
@ShawnieMikes	human
@Chef_Samson	org
@michalismarinis	human
@FeltPIZZAZZers	human
@TukTa_Intakard	human
@xalwin	org
@jarfed	human
@SteveC85	human
@JCoxaj	org
@missapple__	org
@elfsternberg	human
@CityKitchenNY	org
@dyepipoizzzzz	unknown
@stephaniecks	human
@Herzahafeez	unknown
@martabgs	human
@Lana574	human
@AcaiBenefit4You	org
@simang1979	human
@erica_cirino	org
@Leland670	human
@MaaruGm	human
@CharmsCatVLC	unknown
@mallstar	human
@StrengthAddicts	human
@UrbanVineswc	human
@luquechef	human
@foodiepalooza	org
@TankaBar_Eric	human
@micamontoro	human
@barsinsydney	org
@arijojo	human
@Harlownyc	org
@AlishaDong	unknown
@furby2009	human
@PirateDuke	org
@Ludovico_Techno	human
@YongHueiSia	human
@spotosny	org
@seinrahman	human
@Premium_Closet	human
@petsounds99	human
@patweecks	human
@mysidekickandme	human
@niehwen2012	human
@yumin1985	human
@Real_Life_Doll	human
@ErnasGourmet	org
@versencechy	human
@beady_stace	human
@VLOGSTUBEcom	human
@hitchedmedia	org
@EAVintage	human
@Alisha_Knyte	human
@MIACulinaryTour	org
@Debzkissy	human
@cafemerlotsd	org
@Naim_Nini	human
@xiaowing00	human
@FitMonkey5	human
@yalie82	human
@Hello_Jaylyn	unknown
@aQ45715	human
@IqramDinzlyHM	org
@Dandeliondirtrd	human
@chrispilton	unknown
@amandarbryant	human
@Working_Bees	org
@xthexsunx	human
@ESPN_SCORE	human
@itsronniemarie	human
@JurieeSalvatore	human
@Keith_JYangz	org
@UltimoPigeon	human
@santipuerto	human
@BarrioBoliche	human
@FSCairoFR	org
@otematt	human
@iamRhovieG	human
@liamchad	human
@Brodaska	human
@Catsmoreira06	unknown
@scott_vanessa	org
@rehanak55	human
@WatsonBrosInc	human
@darrylzuk	human
@GiveItSomeOomf	org
@GRANDFINERY	org
@trinitalks	org
@PinkCheetahPR	unknown
@754025	human
@haswendy	human
@francescamacci	human
@adamandevee9	human
@kaylakruze	unknown
@bianca_hadden	human
@OCandiq	unknown
@AngieWorldOrder	org
@Traveltawk	human
@VeganMyWay	human
@eatlocalpgh	org
@pimzo	human
@lebistrotchar	human
@TheGreenClovers	human
@dESPERATEfORmIC	org
@chinatsu74piyo	human
@whatlottieloves	human
@harrehprinces	unknown
@HeartLisaPeace	human
@Savour_TheTaste	org
@pooja_rao0330	human
@rox_aria	human
@miss604_RN	human
@nutritiousfig	human
@jeppantes	human
@TheAdCod	org
@Chalmers519	human
@MickelsonMarcus	human
@Orchid54Bistro	org
@TranthamAnne	human
@Cafeat407	human
@sdtest01	human
@tiaardita	org
@SolomonYork	human
@GreenPasturesTX	human
@coffeejavaman	org
@CLWithers1	org
@Theprimaldesire	org
@CocoSanRoc	human
@WFMsandiego	org
@elrangga_sngr	human
@CRdecoration	human
@YumikoChin_94	unknown
@voguerss	org
@hommpion	human
@BunBunBea	human
@susanacoerver	org
@Bubble370	org
@Basilorbiscuits	human
@Aeylasadu	unknown
@lynnestreasures	human
@tanayumi	human
@ReciIrida	human
@btsenre	unknown
@mammapavift	unknown
@SeRenethengkhim	human
@moeydean	human
@ecookingonline	org
@CharinyaR	human
@skatercooper2	human
@RidwaLz	human
@bonalovey	unknown
@too_feisty	unknown
@DBBloomingdales	org
@bbop1664	human
@SanDiegoEvents_	human
@Kazi24	unknown
@Trend_Actually	human
@OneAldwych	human
@ingFedericoMena	human
@ginamc04	human
@CouponAwayDebt	unknown
@RRBNY	human
@LeMiseraple	human
@ScarpettaLA	org
@PietroRicci8	unknown
@FoodShow_ltd	org
@chennaivision	human
@DonnaFayeOng	human
@mrktcafeteria	human
@fede_sapienza	org
@gdmFitness	org
@magic_meiku	unknown
@gcheung28	org
@PromoteMusicFR	org
@Vanessa_Jim	human
@SohnJee	org
@antttmg	unknown
@CambCommon	org
@Lusianaswjy	human
@SORestaurantBar	human
@VolareBrenham	org
@MarthaMelder810	human
@allamateurblog	org
@AlexBuhagiar	human
@filipinokitchen	human
@MyDPhuket	org
@tubukoDX	org
@architectBENJIE	unknown
@0303maco	human
@greenbeenfood	org
@Rose_Kenne	human
@mobe_0622	human
@GyexRt	human
@divasolympia	unknown
@FannyBlogger	human
@princessviolago	human
@Juliamj_angel	human
@IlaryIannaccone	unknown
@LyndaDaboh	human
@CulinaFamily	org
@KoalaMomBlog	human
@ijat_CracKing	human
@calodin	human
@DawnBarca	human
@zhater	human
@100dagenGV	human
@Myojojung	human
@ChefDehghan	org
@stazzyhubbs	human
@Lee_Elvin	human
@MidnightCouture	human
@KNMagicTemple	org
@Restoran_Aprel	human
@JuliaCostello1	human
@mariellabella	human
@sisbyirene	human
@WrittenByJazz	human
@duncan38d	human
@YelpLouisville	org
@bingnalex	org
@NextMeApp	org
@DianaMieczan	human
@Rosemarysnyc	human
@chakleila	unknown
@malteserus	human
@MO_JPN	human
@KammCafe	org
@fasefoodie	human
@DNAbuDhabi	org
@Richan0405	human
@HotelBandung_	human
@maxdooh	org
@ZosiaSwiatek	human
@theREVELERnyc	human
@Jaime_McGrath	human
@K1NGP1NCUMM1NGS	human
@pelixxa	human
@papi1173	human
@LaynesEspresso	org
@maplesyrupbacon	unknown
@rakochan_kj8_	human
@NicoleRenea87	human
@tataroo	unknown
@sangspatel	human
@GeekandChicGirl	human
@choseinvisible2	human
@langostalounge	org
@PatriciaArata	org
@CharlotteHbg	human
@oneupedyoustill	org
@finditinfondren	org
@hh_coop	org
@LuKKov	human
@gersonwd	human
@gmigmig2	human
@scoopkmk	human
@marianaigarza_i	human
@JustinIrwin4	human
@FaceULove	org
@windswin	org
@HolaSoyReyVS	human
@nicbran74	human
@RajKotecha	human
@Deal_Town	org
@PinkGirlNotes	human
@TuscanAuteur	org
@murphyali	human
@JoeyJoeyreid	human
@CotiVivanco	human
@stephaniebola	human
@PYRO83	human
@YukisBabies	human
@tweiting	human
@ChrisCatchyCake	human
@cinnaminhbun	unknown
@djUnchain	org
@DesignerDaddy	human
@gengmarkdhen19	org
@UoWcatering	human
@syedz88	human
@The__Estella	unknown
@aang_pallen	human
@SisAndBrosBlog	human
@DominikWaitzer	human
@erickasallador	human
@CarinaGonzales_	human
@DEARLAIO	org
@FHS_FoodHygiene	org
@SmarkApps	human
@ShintaBenilda	human
@ahcmartin	human
@EmergencyTiara	human
@RafaLoucel	human
@TheBishopVesey	org
@RestaurantsOvil	human
@KnoxTrioCafe	org
@OrkedSha	unknown
@ninz_reyes	human
@whatsupgurgaon	org
@SmartBalance	org
@yellowwarbler1	human
@Frl_Moonstruck	unknown
@nofrillsCA	org
@Daniel_os19	human
@Zaibyx	human
@LitleKittyKatty	human
@VillaLidkpingBK	human
@Garry728	unknown
@newspornworld	org
@faithandflower	human
@Royssh	human
@ch_winchester	org
@marlow_helen	human
@AllensGrill	org
@evy_go	org
@TheMuckyDuckBar	org
@ErraticMechanic	human
@Vashionistas	org
@WesternAvenue	org
@D_nish	human
@brookecandi1	human
@B_Yond_Beauty09	org
@missomgies	org
@SergePichii	human
@5SOS_shiori	unknown
@emilyvvhite	org
@_Haineko	unknown
@josordoni	human
@shereentan	human
@Danna_af76	human
@threisyenajoan2	human
@_920728	unknown
@philinvancouver	human
@meccistimecca	human
@Bonbonsdevie	human
@imaaronccyRM	org
@phillicoco30	human
@ekabuyco	unknown
@angela_eng89	human
@SirivanhB	human
@_Siwonest	unknown
@WhilmaL	org
@bajubbq	unknown
@SmartLunchrooms	human
@tinpacpaco	human
@SweetyJo8	human
@ESGfitness	org
@joycekiehl	human
@alexvachamber	human
@hudsonmeats	org
@throughmycloset	human
@wrappedupnu	human
@hanaegao1	human
@VelvetVictoriaM	human
@Food_Clinic	org
@junkfoodjourney	unknown
@sexyLEYdyyy	human
@startups_rt	human
@Romond_B	human
@mymws	org
@Chopstixfix	human
@ryanracine	human
@NuthinToSa	org
@LCDietitian	unknown
@Vancitygirl03	human
@X_Tila	human
@leximonz	org
@rapture1973	human
@tomohirotajiri	human
@UnicoiPreserves	org
@mourneseafood	org
@SEOtherapy	org
@anthony54250262	human
@pizzaworkshop	org
@ARombaut	human
@RobMantovani	human
@iPukeHelloKitty	human
@firstlettergp	human
@hit0my62	human
@ivetteespinozab	human
@kwanning0606	unknown
@MsMac_FamStuds	human
@NikkiPaul1	human
@ShaneDS27	human
@Janetfaye	human
@cephemer	unknown
@neenapatel23	human
@IMXproductions	human
@atomo1980	human
@ABTW_Patrick	human
@taka405	human
@bilabambam	human
@julia_yeung	human
@SonyStanis	unknown
@onlinegewicht	human
@Matt_Briggs	human
@rachlmari	org
@PAUL_USA	human
@CRoberson0810	human
@ruteritamaia	human
@PeterGriffithss	unknown
@LaurenMcgowan	org
@kate21488	human
@fatimaalfabu	human
@selena_desu	human
@donstugots	human
@imbevda	human
@DaveHagerman	human
@FazzIerra	human
@bucsrays1	unknown
@sparkyblue	human
@RapHallo24	human
@AleckzRosas	human
@onlyima	human
@Baldovi08	unknown
@PPT_Search	human
@FOESAD5150	human
@shermie40	human
@theveggiebuzz	org
@RockStarRemedy	human
@em_102	human
@AndreaLeipert	human
@AgnesHanashiro	org
@China_Doll28	human
@EatingVeggies	org
@_IAMZACK_	human
@BLENDA0305	human
@shanemcandrew	human
@LeaClark	human
@WheelersDubai	org
@ALLAHIN_SONSUZ	human
@Fez2424	unknown
@jetcitypizzanc	org
@pressroomcoffee	unknown
@davidcao11	human
@Truxtons	org
@805BarandGrill	org
@RemkoFuchs	human
@HStreetDC_	human
@DrNoppolKaikany	human
@snaccards	org
@AltissimoCeto	human
@Phaithilicious	human
@sums1121	human
@michashi	human
@juniesunshine	human
@PodcastingGroup	human
@foodbeast	human
@anupxaxa	human
@mrnishanth	human
@BrendaErens	human
@ivanSe_OK	human
@BitesTapas	org
@conroy02	human
@Ben5386	human
@FoodComaPlease	unknown
@leeanneofficial	human
@joti67	human
@LouisianaLovers	human
@htgdublin	human
@andrey_glukhov	human
@jackNjill247	human
@TjoenTjoen	org
@cindysimo	human
@Ouisies	org
@luvluvu___	unknown
@SunnyGirl_PR	human
@ritavania	human
@IvyHouse_	org
@MariaSGoncalves	human
@gloriouscash	org
@chefryansmith	human
@easypeasyfoodie	human
@NVanderVere	human
@pongming	human
@therealindawang	unknown
@jenisequa	human
@BrigidSATX	org
@realtonefazoolz	human
@LeanderReis	human
@RajVilasIndore	org
@WhatsTheFoto	human
@cucumbertown	org
@Lowesy	human
@NikkiHeyder	human
@EdgarTheisen	human
@laudesmousseaux	org
@ICECREAM87	human
@joey_arm_strong	org
@Almondcherry1	human
@GooddayPhoto	human
@BierhausNYC	org
@AphyriALuVSuGar	human
@Tobyhilftcom	unknown
@Cinziaccia	unknown
@mochi_kan	human
@GardenCafeSLC	org
@Natariys666	human
@Jeng_puspita	human
@ArlenaHolak	human
@sharonannettee	human
@VickiEssex	human
@aquadog29501	human
@S_R_Fernando	unknown
@joetea48	human
@Cragswfc	human
@hilcohilco	human
@HolyApostlesNYC	org
@sofitel_arroyo	human
@rajiohead	human
@y2eggs	org
@TuttiFruttiDej	human
@CubaLibreOrl	org
@TarmiziMahmud91	org
@HelenSmithzy	human
@SammyTwee	human
@AandO_Realtors	human
@themixtapemastr	human
@SUBWAY_UAE	unknown
@imfamousbeats	human
@kittyguia616	human
@lorynnvan	human
@EDKInnovations	unknown
@PieterLoridon	human
@thegiveawaybot1	human
@LaCreParis	org
@ZueryChumel	unknown
@403337	human
@K8_Savage	human
@iLaguiole	human
@Numreen	human
@Xuelie	unknown
@phil73vn	unknown
@CoolFromTheAve	human
@BubbleTeaCafe	unknown
@abmthembu	org
@zeppy_artdeco	human
@eltarasco559	human
@harnessdhashtag	human
@JUS1K	human
@MaNiicole	unknown
@NailTravels	human
@caribburton	human
@BOX8_in	org
@Arepaki	org
@TraciHockeson	human
@VENOM_BIH	org
@carose85uk	human
@bakeribrooklyn	org
@xosweetheart3	unknown
@LindsayHammond1	human
@Pricelesslifeof	human
@IKEA_CostaMesa	org
@AnthonysCake	org
@CrazyWrapMomma	human
@Bordinos	org
@andika_jeng2	human
@Kat_2301	human
@weedsglass	unknown
@awinBah	human
@CabotCoop	unknown
@L4URENCHOO	human
@FemiSyahbani	human
@stefie8888	org
@StickyBakeShop	org
@twyu86	human
@PretToGoUAE	org
@lelanieblogs	human
@hannahbupshaw	human
@86swimmer	human
@SZoppelletto	human
@demotivacija	human
@mignonjuwelier	human
@SelwynsSeaweed	org
@myonlyonedream	human
@yumi__0401	human
@fairy_cakes	human
@jack_o_felice	human
@jessefof33	human
@La_Una_La_Vega	unknown
@natashamusic_	human
@daniadaniel	human
@takemegu427	human
@Georgina_Jamjam	org
@theartistbaker	human
@lingandlouies	human
@RoadChow	org
@HausofG	org
@eden_21	human
@Nutsuya	human
@Dyanaleelop	human
@HornyDutchy	human
@Anothercentsave	human
@Alexitasierra	human
@milkymarines	human
@TansyBelVintage	org
@FairwaysChicago	org
@Style_Lovely	human
@OneOriginalMAC	human
@AnnyBurdis	human
@Dasabuvir	human
@HDLI	org
@KingBest410	human
@mini_lexiii	human
@LoveLindaWang	human
@StLouisWashAVE	human
@coffeeculturein	org
@kalinaross	human
@carissagan	human
@nieuwsdiscussie	org
@travelnavywife	unknown
@ElektraAbraham	unknown
@ChurchStTav	human
@aimanafro	human
@AllyBFraz	human
@pigandpearlATL	org
@DeanyEatsWorld	human
@elsanjuanresort	unknown
@RunJumpScrap	human
@GrandAquila	org
@Mapraw_MP	human
@NormansNewWorld	unknown
@92_pisano	human
@HARVEYEMPOLIO	human
@gorop_	human
@168mania	human
@izzysalsa76	human
@Couponing101	human
@OnaPonaKookt	unknown
@wilsabin	org
@1lovedanel	org
@kleppiberlin	human
@Preetha1809	human
@missTissa19	human
@JoseandSons	org
@HalfmoonPutney	human
@lenna	human
@TaraQuigley1	human
@CarriageHouseNY	org
@actoraldo	human
@2ch_gazo_omoshi	unknown
@juicy_justy18	human
@2wo2wentyfo4r	unknown
@MarzieMNor	human
@Anne_Thornton	human
@ZynpZeze	human
@MonAmiGabiOB	human
@youngik79	human
@cookingbonapp	org
@soapkitchenstyl	human
@Changing_News	human
@TheZetter	org
@DeliciousCafeMY	org
@FoodFans	org
@TimoUusi	org
@natyrose86	human
@gatnomboih	human
@egobeverleyarms	org
@Anrym11	human
@manumeller	human
@badwolfdc	org
@iam24cha	human
@Marzamemibb	human
@Qurapfruits	human
@GrandHyattJKT	human
@pattie_poniente	human
@CharmeMax	human
@howtodigit	human
@SweetandSazz	human
@Exclusive773	human
@ShineAnnabelle	unknown
@JennJ20	human
@shanekurup	human
@Achan04Acm	human
@ZezoAbd1	org
@MrECarlin	human
@TheThreeBrits	org
@alexiamav	org
@HomerStCafeBar	org
@nonhomogenized	org
@iambenzb	human
@EricaaaLim	org
@BistroBisDC	human
@natebasuil	human
@AldoGnocchi	human
@PopUpNBO	org
@ShoeFash	unknown
@WillSarsgard	unknown
@ArrowheadLake	org
@ReneeANDSharon	human
@capdiaz	org
@Malisa5812	human
@vanedeny44	human
@MJakielRusin	human
@yelena_	human
@Nativo_08	org
@teylapearson	human
@hilisting	human
@MomsMagBlogger	human
@FSStLouis	org
@chasingnora	human
@liv_carbonari	human
@yeewittlethings	human
@HBHarvest	human
@sebdo24	human
@BAutunno	human
@melpig	human
@YelpReno	human
@brady_heather	human
@Leaderjp	org
@FunkyyyElephant	org
@KelsieYohe	human
@SteensHoney	org
@JulianLark	human
@207foodie	human
@ivrashton	human
@cookingalamel	human
@Nagoya__Yom	unknown
@Brian_Tha_07	human
@Noheolivo29	human
@charmainia	human
@cacaobakery	unknown
@LoveLaughPeacee	human
@ourminifamily	human
@Nutri_secrets	org
@bhed635	human
@NeuvooPartTTO	org
@sydneyroofpros	unknown
@_LEON55	human
@kenfong88	human
@RaniaYounes	human
@capitolcider	human
@MrsSpalding24	human
@forkfuloflove	org
@AntiMomBlog	human
@RedVelvetBaking	human
@JoshuaMarilyn	human
@AvosMexicoCA	org
@24650619	human
@itsAmeeezy	org
@RickyBuller	human
@LouiseConstant	unknown
@aendrabusri	human
@lovelyladycakes	human
@ZsquadSexy	human
@Kaleena_Slenker	human
@ljnutrition	human
@BillCosbyiSpy	human
@just_krizz	human
@poohbearhln	human
@callalaelphoto	human
@KarinochkaP	unknown
@Nomating	human
@CamieB	human
@thehungrydudes	org
@3PPrettyBlog	human
@natestump	human
@top650	human
@alisonkwf	human
@SuPastel	human
@GomerDeli	human
@JulianRoseGibbs	human
@ValerieBowman	human
@ClintTip	human
@AwesomeNiki08	human
@alyssajaen	human
@HealthfirstNY	org
@LovelyDubley	human
@25LibertyTO	human
@Lunch_box_mom	human
@CakesandMore	org
@Rojchanawit	org
@Bruns_L	human
@coconut_fit	human
@akissofcolour	human
@clive_Mr_O	human
@KhanOli	org
@TeeToTable	human
@mywherehaus	human
@xxmon_22	human
@OPeksev	unknown
@tangiebabybear	human
@toffeenutslatte	org
@ThePointBistro	human
@feastfashionfav	human
@Nikita57	human
@monster__DX	human
@felicity_young	human
@angelika_91	human
@CampbelltownMal	org
@iloveseble	human
@RelaxInPR	org
@Pchefy	human
@LarryScottJr	human
@iamMZENVY	human
@Anukram_Human	human
@fabienlaine	org
@mdgillespie	human
@ThatKevinScarfe	human
@joelfeder	human
@bunstone	human
@derrickruthless	human
@foodiarieslon	human
@ilovememphis	human
@That1blakkkid	human
@Emilly_Allen1	human
@chewclue	human
@kristi22s	human
@lapillow	human
@lalaluvtech	unknown
@Robb_Gentile	unknown
@JONGisJONG	org
@zedezign	unknown
@MartinWalker666	human
@RandumXtv	unknown
@PrinceGeorgeHfx	human
@AuCointreau	human
@Ashleya0012425	human
@ManilaSpoon	human
@eddyzainal	human
@LilMizV	org
@SallySalitCohen	human
@MardakooshJo	human
@CoachYanelba	unknown
@FieldFarmEggs	org
@RossMarkFood	human
@DeoWatti	human
@FOODmagUAE	org
@TopSARestaurant	org
@thefoxismine	human
@inilinaloooo	human
@Win_President	human
@HRCCopenhagen	org
@a_sa1227	human
@Felicia_han22	human
@strongrtogethr	org
@kristle22	unknown
@yonglok1802	human
@DrinkBmore	org
@tim_mckee	org
@Frannyonthego	human
@ozlemaydogdu1	human
@OnlyHypercar	human
@BroadwayBrewPub	org
@MayaTodayNews	human
@wishpi	unknown
@Madein1961	human
@blerinadaneja	human
@AmyLouu_ox	human
@xChelleLouiseXx	human
@Isofrutusa	human
@DJ_OscarColina	unknown
@FoodUk	human
@vidiprima	human
@JelenaJessica	human
@octavianisusan	unknown
@iwantumila	human
@Chefjasonhoward	human
@AmberPodratz	human
@TurnTheFUp	org
@gyrowolfenz	human
@alfredrocks	human
@JustCallMe_KAT	human
@michaeldinn	human
@tiliahdesign	org
@D_Chidin	human
@charlshubert	human
@thecinemafan	human
@KansasRetweet	human
@Stylistsmuse	human
@kimifan	human
@MrsKrystie	human
@dm_aisen	human
@TOXICwildBARBIE	human
@MheeCosmic	org
@_davidrw	human
@solua08	org
@Davenew80	human
@RiversideBIA	human
@cookinstilettos	org
@goladleDallas	human
@Komatwuu_373	human
@HastyWords	human
@MonsieurGourmet	human
@nufaatmoam	human
@MiamiSmokers	org
@societygroupau	org
@alanlee888	human
@Ironclad_knives	org
@AdrianMegusta	human
@bffoodie	human
@izanndanny	unknown
@33Acres	human
@Patsachonn	human
@bigdogbrekky	org
@annadestiii	human
@coconuthead227	human
@JennaMackenzie_	human
@foodinphotos	org
@YoniPronk	human
@LeCafeCrepe	org
@TheFaagio	human
@BarsSociety	human
@ThirdWaveCafe	org
@CangruuvAtl	human
@rubyenvy	human
@StrawberrySiSi	human
@cafebarzini	org
@BanfieldClaire	human
@lovegabryelle	org
@_Kangaroofie	unknown
@FabMaryNTheCity	human
@famameer	org
@LGWhiteAuthor	human
@FoodCurmudgeon	org
@GreaterByGrace	human
@AdystanStan	human
@AnggieJuniarty	human
@shanakristine	human
@nohbodium	org
@TheEagleLG	org
@SalamanderHotel	org
@MonteCarloStars	org
@2_Real4U_	unknown
@PerrySt_NYC	human
@infusedreviews	human
@Maica_Records	human
@ELLEmusicpage	unknown
@sweet_corn	human
@CMLobsterRAL	org
@eringi0404	human
@dreamzld	human
@traceys22637898	unknown
@WISER1st	human
@obckansas	human
@lgh1990	human
@udybakpau	human
@lunaluna0520	human
@kym1400	human
@MeridaNatural	human
@NiceSpanishFood	human
@Shelly_Allen	human
@Sarah_Nicho	human
@kcajor	human
@EandGLaSalle	org
@sgudlaug	human
@conniefranco	human
@ZaetaZae	human
@CiaraBallintyne	human
@MizzHazeliciouz	human
@LeighSuznovich	human
@moon_tatsu	human
@CupcakeBeauty22	human
@sarah__monaco	human
@NorthfleetTalk	unknown
@acoupleofmoms	org
@rienapaundra	human
@duls_duls	unknown
@bushnookgilslan	org
@nacoxo	human
@ortegasg	human
@Fooditka	human
@GaleaJamie	human
@entourage_dubai	org
@7aremas7be	unknown
@fortich723lip	org
@HMBeauty	human
@AiphingSho	human
@chestercaras	human
@Vrouw_Netwerk	human
@jackiekoh	human
@3HerefordRoad	org
@itilafenep16	unknown
@jesshagadorn	human
@OhMyFuckingAdam	human
@mspampchef	human
@DrewKid_	human
@daniel_c888	human
@kymsharlene	unknown
@_YukiSNow_	unknown
@AustyMahoneLove	unknown
@smallysbiltong	org
@m_malinee	human
@pafellarry9	human
@RetweetYork	human
@onebigsteak	org
@rafapradoIII	org
@glinarg	human
@mantha_luhan	human
@KeallyH	human
@TheMercury_Dal	org
@MoiSarahJane	human
@AdventistReport	org
@MinakoTYO	human
@sunnyhill11	human
@JessElaineHill	human
@MaurizioConti15	org
@CityofLondonEC1	unknown
@Gayot_NYC	org
@HaremJets	human
@Slappaho82	human
@RioMointi	human
@Bayron_ramirez	human
@sucolnot	human
@AndienMayaSari	human
@indraagusrahman	org
@DianeMichiko	human
@blujayrain	org
@Falafill	org
@Precious_20y	unknown
@joycylin407	human
@okimama01	unknown
@gallopsintel	unknown
@ManosVip	human
@AdsmarcosSmith	human
@HUNGERPANGNYC	human
@halloboot	human
@SantiArbide	human
@coffeencravings	org
@KobetSteakhouse	unknown
@ResaleGTA	org
@n_defan	human
@deliverydotcom	org
@StandByChef	org
@kami_purei	unknown
@energyblast4you	unknown
@FirstandLastPR	org
@marcomcdonough	human
@MinxyTrixie	human
@sevodnya	human
@JenMcGahan	org
@Naina	human
@Heather_v	human
@mendozasteff	human
@CattComb	human
@_maria_pinto_	human
@Gayot_San_Fran	org
@si3w_hui	unknown
@thecliftondeli	org
@kkadodia	human
@danita_carr	human
@Z_nStorm	org
@BrittBratBliss	unknown
@FireKingLife	human
@stefanyvillalba	org
@Abeezy7	human
@TravelandLust	org
@thesoupdragon44	org
@Sobrinos_Roma	human
@CameronBarGrill	org
@Jennyhero0126	human
@BonesWorld78	human
@marioapalmer	unknown
@endless_sorrows	human
@ivythaide	human
@mistytewest	human
@Alexandrarcori	human
@CitySpoonful	org
@chefdianedimeo	human
@BeerthenFood	human
@KGuti31	human
@LaraPulumbarit	human
@FayeLewis85	human
@PaulJhingChua	human
@MarysPlaces	unknown
@SpaceExeter	org
@hbusick	human
@RadioNetHawaii	org
@j0m4R7	unknown
@kikay10000	human
@fightAIDZ	human
@FlorBarrera4	org
@Leoutha	human
@birdyqu	human
@SNRTG	human
@dwaejiyan	human
@ChiSignature	org
@myblocktyler	human
@chilivae	human
@PrinceJoonsa	human
@BgoCrnStoreCafe	org
@Corduroylounge	human
@VespaPizzeria	org
@DamePetite	org
@BornToEatBacon	human
@TheSlicePizza	org
@MissAshikaBaan	unknown
@myanma87	human
@aaronhasspoken	human
@HenyOkaSheila	org
@JonteBovang	human
@Earline395	human
@jack030479	human
@TheRealLilyox	human
@ChipsFamilyRest	org
@lotusthaisd	org
@thepregameny	org
@NevilleNuckles1	human
@onceamonthmeals	human
@jamarseay	human
@AzizaNouri	human
@lilabelle23	human
@Spooncereals	org
@Barcailkley	human
@akzentuiert_	human
@pnychik	org
@goranimperator	human
@anconitana	human
@Leigheff	human
@TheSnitchSeeker	human
@Kim_JooWoon	unknown
@TexMexFood	org
@Inspirehamilton	human
@StephySaSa	org
@HSRetoucher	org
@neac2014	unknown
@BiRiteSF	org
@jenn_jenn_w	human
@Sant_Ambroeus	human
@RadioHumberside	org
@JtowneTavern1	org
@cafebonappetit	human
@DeniDenDen	human
@alijohnson88	human
@signyournamenet	human
@relevansokmo	human
@olisticapilates	human
@MiyakeLisa	human
@YennyAng	human
@JoanneTognarel1	human
@FreshFlyers	human
@riri_chuck	human
@MsReneeLove	human
@smxmagazin	human
@Isle_of_Olive	org
@Alamgirahmed	human
@SenhouseDesigns	human
@pinkepanki	human
@joycemfb	human
@LaMadridMorena	human
@pereko	org
@kaisama	human
@whitebrownsugar	human
@GrassfedMeatCo	org
@EatBroccoliRabe	human
@robiannrocks	human
@_02_24	unknown
@FrankVerrilli	human
@ShawnMShapiro	org
@rina819n	human
@brasserieSTL	human
@SportsBet_Daily	unknown
@ISLYHandbags	human
@dineprestons	human
@ChicagoRilke23	human
@deshommesr	unknown
@bradallan68	human
@aletheaanh	human
@HaliHannigans	org
@ParkLaneJkt	org
@slycepizzabar	org
@nasiruddin92	human
@mjandhungryman	human
@RumSoakedChap	human
@terrysiddall	org
@SmhyeL	human
@LinsCuisine	org
@CompareDisHols	org
@CDCChronic	org
@RScottReedy	human
@LORENZOREYESMA1	human
@VegOut4Life	human
@PatronskyBA	human
@sierraf31	human
@shilakreuzer	human
@smileyeats	human
@MARYBSTV	human
@ahmadkama	human
@westfacehyuk	unknown
@Jagaira	human
@PattyAparicio88	human
@GreenGreen67	human
@thewrightdoctor	human
@G2Whisky	human
@patrikdiazsima	human
@zerky13	human
@luckycathigh	human
@1985LUKE	org
@rasheedlight	human
@RozyRos	unknown
@NovariaOpa	human
@brenvale404	human
@GoMoji	org
@TopgolfColony	org
@NocheVH_ATL	org
@nekopiano_PR	org
@fumik1036	human
@MrDeliciousBar	org
@yoko_march	human
@87Campanella	human
@Debz73	human
@RiseBar	org
@misswrightdaily	human
@Yucavalcante	unknown
@iMarkusAnthony	unknown
@FrothyMonkey	org
@Aspi_Shy	unknown
@CBusConnect	org
@bespecy	human
@jatjat1213	org
@waticala	human
@CafePeppercorn	org
@augustmoonpa	org
@SirTerryScott	human
@JanBTweets	unknown
@dos40lb	human
@ColoniasCondesa	human
@chunaru	human
@billybaggins	human
@djkbrar	org
@eldiaz03	human
@AustralianEggs	org
@Soy_Wendell	human
@JayRockRealty	human
@YolandaGrant	human
@La_Sofiaaa	org
@ilovebirdthings	human
@CoolbreezeNick	human
@kappyrevolution	human
@marvindegracia	human
@forever_Strange	human
@mytumtumblog	human
@eddiechinsan	human
@jdmchef	human
@bejby1982	human
@Matdile	human
@omnivorcookbook	org
@Fromshorttolong	unknown
@mamakinwa	org
@RogerWeasley	human
@vincentAlaw	unknown
@SpotGourmetLA	org
@Melidays	human
@IAMlildrummaboy	human
@gustajanie	human
@PotLiquorCAS	org
@GoGoMine	human
@RasuCosu	human
@jessiehessie1	human
@kitchengoddess8	human
@_HeatherRiley	unknown
@marcop85	human
@CamiloTello	human
@DrSickpickle	human
@TorinoMagazine	org
@WErratt	org
@Beanybopp	human
@natsuo78	human
@3mosk8er	unknown
@Man_Fuel	org
@AgatheAlexandr_	human
@kaobay	human
@jerome_bermido	human
@KarlaHarmer	human
@sandysbaking	unknown
@NexusGirls	unknown
@framul	human
@bmnasimreza1	org
@WFMColfax	org
@sl_lounge	org
@3chefsmiami	org
@idnaf_rizal	human
@marie_383	human
@wgrssousa	human
@Sheena_DAFAM	human
@LisaFiorenza	human
@mafaldatwl15	human
@hillreeves	human
@kallardnyc	human
@mzblook	human
@NoemiCilenti	human
@Vida3212	unknown
@Ingoofy	human
@annisaazmiii	human
@kunterbuntweiss	org
@Lady_Sahy	unknown
@minifridgeblog	org
@TrolleyCarDiner	org
@AINAWORLD007	org
@TomsUrbanLA	org
@PTI_Thompson	human
@OliversAstoria	org
@consensioluxury	org
@TheKissters	human
@Gisminguito	human
@_mamadeb	org
@YESGosso	org
@Meikaiqbal	org
@Danpasquali17	human
@SurfBarbie_	human
@Xia0L0ng	human
@asl4nrawkz	human
@GratefulTables	unknown
@TheLambTavern	org
@jerrysavarez	human
@EarlsYaletown	human
@lucychangbvba	human
@LaDY_KinT_Ga2	unknown
@MarmaladeOne	org
@WinkworthSJW	org
@JoaquinLugren	human
@DOMINEON	human
@tamissamadeira	human
@ratuvictoria	human
@DJ_CYBERPUNK	human
@blue_myst	human
@wrecklords	org
@GITNB_EATS	human
@freerides22	human
@Txell_Arribas	org
@PalomaBlanco	org
@GeeksUnited1	org
@Paulina7190	org
@AmberZanders	human
@mcdoel1401	human
@ellwoodz	human
@takkmcr	org
@PepperidgeFarm	org
@crazygirl24	human
@_no_fucks_given	human
@CourtneyACurtis	human
@ghirottipain	human
@LaurenAtKiehls	human
@PC_IOP	human
@arnebya	human
@helloskinnyme	human
@cherrylynacueza	human
@NickyHutabarat	human
@Avril_Fleur_	unknown
@Tuty_Alawiyah	human
@badge_88	human
@zumbanationbya	human
@SimplySnackin	org
@Hot6LocaleArea	unknown
@nigeltechfreak	human
@loulabelle46	unknown
@_jetsetera	human
@UKBeautyTips	human
@divinegraceeee	human
@lau_ra	human
@TonyKoukos	human
@manyonerise	org
@RealindianFood	org
@BarBeQuick	org
@tsu_jy	human
@Kiku_Love1	human
@mercyPD	human
@AlliParker726	human
@ShipleysGrant	human
@astroboysoup	org
@omoshiro_Kun68	unknown
@ButoolH	org
@olanyrbeah	human
@TattooedFoodGal	unknown
@vaca8advice	org
@Diagogo	org
@kamolato	human
@hwang_li_wei	human
@allmanneroflife	human
@royaljaydee	human
@trahner	org
@Monroes3001	org
@elespejo84	human
@boomboomswag	org
@Germangirl0152	human
@sassme	human
@citichefny	human
@DiningOutVegas	org
@TwinDeborah	human
@Theidenthal	human
@ippolitoseafood	org
@raleys	org
@sakinananahh	org
@OffersChester	human
@ttinycourageous	human
@Tasterie	human
@Victoria_Qatar	human
@yuuuuuiiiii	human
@BabaganoshBlog	org
@donacain	human
@PiccoloBTN	org
@WFMorangecounty	org
@Sijiascarlethao	unknown
@D0NUTEASOM	human
@lisareneenicol	human
@KitchenetteJO	org
@flashmobamerica	human
@statzharlem122	human
@FoodStrategy	human
@RunnerGirlEats	human
@jamcircus	human
@Mewsbrook_Cafe	org
@QponLessonPlans	human
@discobar1	org
@cucinahobbyital	unknown
@CityBiz_SL	org
@ParisienneNord	human
@dbsoo	human
@belkytab	human
@Sophii_Jacob	human
@mawazo_mengi	human
@arbysworld	human
@rustichellafood	org
@Harem_Emperor	human
@Ilaria_Baiocco	human
@Seju_Mishil20	human
@Chitown_Tom	human
@pipandnut	org
@carlyveronesi	human
@ARATA1012	org
@rurina	human
@LaurenGruel	human
@Laveta344	unknown
@hikkyusan	human
@WFMlasvegas	org
@boi_2Reckless	human
@CosyClubBrum	org
@MssionHillsLive	unknown
@AnakinsAk	org
@shanghairose_	org
@CanberraLover	human
@cana12h_	human
@Cillywine	human
@rhonieljedh	human
@BubblesPolkaDot	unknown
@AngGalluppi	human
@poiployllks	org
@allanjamesRN	human
@WFMtucson	unknown
@Babyface_ssc	human
@tamtu	human
@astrogirlrocks	human
@TUDawood	human
@LovelyAppetite	human
@MandySua	human
@canaryfuture	human
@K_tes	human
@jackienewgent	org
@ChewOnThat	org
@HiltonAviemore	org
@moks2204	human
@tyrafendy	human
@dedlb	human
@MoMoReese	org
@lonecrescent	unknown
@LaVidaOrganica	human
@marcopodeschi	human
@Radio25Live	org
@blogpossivel	unknown
@NomadsAnswers	human
@Ale_AdR	human
@kdiskdsdfs	human
@narizara	human
@GoodHospMktg	human
@theredhot	human
@solsticekitchen	org
@vrremtulla	human
@scratch_eats	human
@MY_Airports	org
@mnobita	human
@erictantanto	human
@JeffreyClukey	human
@myswapsee	human
@s0cialnerd	human
@EvonTmy	unknown
@Miss_BeeJackson	unknown
@SarahDundarawy	unknown
@catchtamtams	human
@TigerTigerCroy	unknown
@Slumpgirl	human
@psyanides	human
@Manda41	human
@xFiola	human
@tkessler07	human
@Pure_foodie	org
@TheGrey_Lady	org
@reybotax	human
@Vyne_PH	org
@MmeJetSetter	org
@Waitingdocu	human
@ricardom76	human
@Nerdy_McFly_Guy	unknown
@demi_souzaa	org
@Shizuporn	human
@LiveLifeEvents	human
@FitNFun4Kids	org
@verylittlealien	human
@BGGrillWhistler	org
@davidjbell	human
@officialBabaero	human
@arrbel	human
@DoppioZeroSA	human
@shosho_snsd	human
@Krissy_r	human
@toshigupta	human
@AyuDcs	org
@piropro0913	human
@luckytommylee	unknown
@gelGELOgeller	unknown
@saika0518	human
@Maren7a	human
@todaysnest	human
@djELITE	human
@ForkMedicine	org
@AnanNantajurapo	human
@nicki_my_idol_	org
@shamrayonok	human
@GsPrinzessin	human
@TAPconvention	org
@MarycroftHomes	human
@xx3mogxx	unknown
@BENTELEVISIONS	human
@snazlan	human
@Boondockfinds	human
@ADMaddox	human
@BuenProvechoHN	human
@OxO_m249	unknown
@Vina833	human
@ButtermilkKitch	org
@Uptownbk	org
@aadxb	human
@_sellyseptiani	human
@Jackson1009	human
@TheEagleHouse	org
@red_head__	human
@Howie_everland	human
@atasteofdevon	org
@RichesfromRag	human
@davidechoi	human
@Sirikwan_G	human
@IAmPengChin	human
@jameane	org
@FitFoodieFinds	human
@kasidejken	human
@lebron_jovon	human
@BreadTalkQatar	human
@JoFreemanMakeup	human
@HappyMommyProj	unknown
@Fedakanynka	human
@Iippu	human
@CittaToronto	org
@BalansUSA	org
@anto_dls	human
@delishHB	org
@himeSIAO	human
@DubaiFoodClub	org
@JessicaSylvina	unknown
@KallMePrincess	unknown
@JustMyDelicious	human
@Lyzasunshine	org
@MariolaML	human
@Amanda_DeMar	human
@GolfingBinge	unknown
@almostlanding	human
@bitchbrunchden	human
@faithalfahad	human
@took_hnla	human
@Omegasun	human
@Theformerfatgrl	human
@DavidPerlmutter	human
@SimplyD_xo	human
@RestaurantHopLA	human
@superjeir	org
@anime_xI8Of	unknown
@ManNattawut	unknown
@niisanda	human
@bottlesoup	human
@SugarBeatEH	org
@getagrip1	human
@Mario8863	human
@sakurasaku_0309	human
@lexlawrencedj	human
@MartinsFoodMkts	human
@SSKID1012	human
@WonderfulExpoEn	human
@AntiquingOnLine	org
@kevbeau68	human
@SignalIntrusion	human
@DanaLabels	human
@JessieChan	unknown
@tennisit1	human
@RebelSweetHrt	human
@zcatz	org
@JustinFuentes	human
@ajafuang111	human
@BreathlessLV	org
@clivedatblckguy	human
@Eduardo_KatyCat	org
@audreyworldnews	human
@Ed1988	human
@JenniCzech	human
@Stella_Korosec	human
@gyalahgwanbadd	human
@fitrahzain	human
@sebrusk	human
@la_stanza_rosa	human
@OrohKoloay	human
@masalcafe	human
@1soccer_love1	human
@MoveableFeastin	org
@BlackPearlDen	org
@tilli_tillina	human
@LeRoyalMonceau	org
@KALTBLUTMAG	org
@caspu007	human
@amodeo51	human
@dtachaniago	human
@TheNextFood	unknown
@LiveRunLoveYoga	human
@wbites	org
@monsura	human
@MIXHAELO	human
@ChefStellino	org
@HimalayanPeak	org
@GrupoLaMusa	human
@TanyaCagehin	human
@StaceySamsingh	human
@herbapusher	org
@sagaciouslyme	human
@TessaLovesSushi	human
@diahris	human
@IamBThompson	org
@NashBanana	unknown
@prixfixesoho	org
@kkslnr	unknown
@patchworkbanana	human
@sungrazer	human
@Foodshala	human
@mauchterlonie	human
@clemcookiefairy	human
@noraisnotaninja	human
@AutumnKym	org
@PriscaHawaii	human
@BonChon_ZSquare	org
@1stChanceEvents	human
@nativesunjax	org
@Fotbollskarro	human
@hoteliconhk	org
@josephhoayek	human
@kauaifoodtruck	human
@ZaapThai	org
@LneNou	human
@CMCafeLA	org
@NeOTonYLEE	human
@LAMONGERIE_USA	human
@fadomiami	org
@TorontoBruce	human
@jay_yong	human
@ashleyllee	org
@plume4444	human
@iamohds	human
@EscapeWithJilli	org
@Ashlee1906	human
@AskPbm	human
@AlbaaaReyes	human
@stlouisatrium	human
@LAbite	org
@yutazu	unknown
@AdjiJati8316	human
@ChanelMargot	human
@VIPRoomDesigns	human
@lilipadi_bdg	org
@Pappagallos	human
@FashionFoodFun1	unknown
@historicbuildco	human
@WFMphoenix	org
@pnoiknight	human
@elmorotavern	org
@lazysuzanblog	org
@mcjsoriano	unknown
@kiri_soleil	human
@thekingmedia	human
@ScritchfieldRD	human
@AnnaLee89	human
@MomAboveAllElse	org
@FabrizzioGQ7	org
@sophie_berman	org
@cliosfoodcraft	human
@IUP_LOVELY	org
@Eat4EnergyRonna	org
@purbblelouise	human
@Hugos_Houston	org
@2justByou	human
@prettisnow	org
@Falafels_India	human
@otrevino_author	human
@Charmaleena	org
@Maxtapper	human
@fannyslater	human
@DownshiftingPRO	human
@deniseetbaker	human
@dgiacobello	human
@goteamgreengo	human
@Osiades	human
@sroosterhof	human
@oblogdatitaa	human
@JustinCBK	human
@easyguycooking	org
@Ines_Cruz	human
@EmmaWhitei	human
@gabigabin	human
@KDollery	human
@RoFilipo	human
@udg1	human
@drevargas	human
@Ina_bananana	org
@BadillakBliff	human
@priaw	org
@Craig_Fellows	org
@BiggC43	human
@awangesti	human
@trinketbox24	org
@yoyoyowin	human
@runawayapricot	human
@nagi1202	human
@HelenaLeFur	human
@Layanmka	unknown
@ReynBasuel	human
@PieceACakeNYC	org
@Jen4Ever4Always	human
@Rekar1999	org
@AbrilLovesMusic	unknown
@reginagrace38	human
@nolabucket	human
@dullbluelight	human
@HarbCafePerth	org
@pumdiets	human
@Akira_Deadly	human
@Jacky856_488	human
@KaranbolPopTart	unknown
@LawrenceHinesNY	unknown
@CBKatonah	human
@emzjeff	human
@CaliComfort	org
@tokiessewunique	human
@bogalousa	human
@MAJoyeel	human
@lalenalive	unknown
@Food_i_Like	org
@Zee_Zipora	human
@Sosa_Amber	human
@bubisanchez	human
@DJsheKNOWS	human
@pandamidz	org
@ihsankhairir	human
@victoriacuesta	unknown
@hotboxcafe	human
@vjcolemanjr	human
@keke_everyday	human
@LilianaJones	human
@Kenzi_Lilith_Bo	human
@Gian_Blogger	human
@NanniesWhoCare	org
@BeccaBesser	human
@JerseyGirlRulz	org
@ericabsamonte	human
@pamelaquinzi	human
@sailu	org
@davideimparato	human
@burrito_red	org
@MunchistLA	org
@libralxxiv	human
@exilekaoru0111	human
@silomlaser	org
@dawnchubai	human
@Capitol_Cardiff	human
@MB_Chamber	human
@rietsa	human
@LatinaLifestyle	human
@boom973	org
@BassHitter	human
@KOLITA_PROD	org
@shiroiyume2606	org
@dimamanko	human
@isaacabk	unknown
@PersephonArcher	human
@SocmedBeauty	org
@LauraKSosa	unknown
@BerkshireBowls	human
@kodabrooklyn	org
@adamjazmy	human
@DonRamons	org
@wghutton	human
@heartofmary	human
@Tidsbestemt	org
@WellEat	org
@mu6instinct	human
@eventsjamapp	human
@MVlckova	human
@SuzlinSulong	unknown
@ErwinTjong	human
@whokilledlola	human
@Tatyana_Utkina	unknown
@SzeneTanz	human
@TrineJensen08	human
@makeupNdesign	human
@crackberrycream	human
@MatthewBouch	human
@JaeWang	human
@salutfranceave	org
@Bystandersunion	human
@fishisthedish	org
@rinopi55	human
@Attea2d	human
@CookieDude_2332	human
@iamikhael	human
@EmpressMCF	human
@chocolab_AU	org
@DiscoverDenton	human
@Donegal_yyc	org
@theshed_resto	org
@PixieKristy	human
@TriaRestaurant	org
@1966_ALEJANDRO	human
@darienne_louise	human
@arliniwibowo	human
@IronBred	human
@megganrayy	human
@fair_claire	human
@FeastBistro	org
@emasworld	human
@dragonfly1304	human
@pipnlittleblue	human
@FidanASLAN8	unknown
@chefcecygarza	human
@msicefan8	human
@GiaMedia3	human
@sweet_kabocha	human
@Anna_Sydney	unknown
@miyabizon	org
@EatLearnRachel	human
@amratty	human
@macevedon	human
@cellouis_	human
@TanikaTan	human
@sussexgpoultry	human
@FirmySK	human
@AyeBee_me	human
@dapperhouse	org
@AnaPettus	human
@TheWinewood	org
@DealsPlus	org
@BF_Giant	unknown
@giliWoodhams	human
@MuriyantoCarl	human
@vaniaphanphan	human
@abouthungryeyes	human
@_felipeveiga	human
@carolJhedges	human
@LBspins	human
@francesco59000	human
@barriobites	org
@henrickrw	org
@KyrzStyle	human
@nutnellaspread	human
@MrAllanOkello	human
@spoonfulofsugr	human
@_markethill	human
@princejericho	human
@sahbireen	org
@IAMJESSICAHAN	human
@preppygirlNYC	human
@IdeaWorldwideCA	org
@mbstylz	human
@coffeewithlala	org
@DHighlands	org
@tsubuco	human
@ambernmccain	human
@AendzeliSiPi	human
@OGGSVenue	org
@sugarrhigh	human
@leroux_danielle	human
@ChefsTableYYC	org
@mslunavictoria	human
@AshleyLAR	human
@L_FOR_LIFE	human
@sakkychan	human
@therovingstove	org
@EHolywell	human
@LoveEnabled	org
@slr8	human
@GerLeeenleen	unknown
@MonasCafeandRe1	human
@locsuperstar	human
@BerkityBerk	human
@Boomqueesha	human
@Natira_NRW	human
@AmicosPizzaTO	human
@slhannold	human
@diveronastick	human
@small_maria	unknown
@MaggieBluffs	org
@ivanng65	human
@TheAlchemistTL	org
@eric_tcc	human
@JuliaAkar	org
@johnnywhygull	human
@reklaw422	human
@JackiMartinez	human
@kimeste	human
@Lemeridienmex	org
@NicoMariam	human
@iamjeremylara	human
@jezdee	human
@Nazimah_Aziz	human
@anastasya_LV	human
@butydiaz	human
@lardolondon	org
@FairmontDubai	human
@5secondidiash	org
@OfficialRauldT	human
@soom_e	human
@cesardanielhg	human
@debogriff	human
@Jools1986	human
@janetta888	unknown
@NightOwlMarketi	human
@peterpkk	human
@ItsMe_Julito	human
@TrainsGoWooWoo	human
@su_urya	human
@tumtumfufu	org
@dj_patter	human
@Shweta_MT	human
@ClassGuitarist	human
@bombiereloj	org
@vdomicilio	unknown
@brunostevez	human
@GrandMAN1126	human
@breezybr45	human
@ReMicroGardens	org
@jewelrymandave	human
@nicola681	human
@SkySdt	human
@WhatupBrian	human
@hhtcheung	human
@LadyOfGraves	human
@calligkatrina	human
@Linz_Alegria	human
@sonnia	human
@dreaming_4_food	human
@larra_surri	human
@themezzaninepr	org
@traveltheend	org
@ismilefirst	human
@jennifer_browne	human
@brookgreen_mk	org
@RustleandRoux	org
@C_Squire	unknown
@foodiecrush	org
@AlecKrayzel	human
@Rea324	human
@lesdoitmagazine	org
@jolie311	human
@Dicksons1953	org
@FMRSanchez	unknown
@PoppyPuff	human
@GFCFyouandme	unknown
@MareIndacoBB	human
@frogcooke	human
@cicitrapratiwi	human
@vellourie	human
@MiSsPrIsSyViRgO	human
@Karnabash	org
@meowminx	human
@HazyLou	human
@SparrowCoffee	org
@VillaRomanaCNS	org
@uplift81	org
@Graduate2892	unknown
@_JayTuazon_	unknown
@jc_sanchez23	human
@JoePL7757	human
@fXSudirman	org
@MeghanPatke	org
@TheOldMillInn	org
@RickWesley80	human
@465TheAvenue	human
@HiltonGardenATL	org
@presarino	human
@SolmarResorts	org
@mattsthe1	human
@V1CK84	human
@jonnathance	human
@jayelovespurple	human
@Lelia_Vera	human
@MichaelSDee	human
@IzadinWolf7957	unknown
@nicy_mouse	human
@tenielle29	human
@Angelina_oct	human
@MrDewdney	human
@ZiggysTulum	org
@smg1970	org
@A_LA_TURKA	org
@hamajo_tv	human
@coy_malone	human
@POL1987	human
@miketuangkitkun	human
@Mayangsters	human
@alobarnyc	human
@Kat_JSA	human
@krissylovesfood	human
@CNhel	org
@Daniel_Adie	human
@LenoreCaine	human
@johnthore	human
@BonjourClem	human
@Sydney4Lunch	org
@GabeJohansson	human
@MsChelseaSmiles	human
@YesMrMike	human
@bcprmiami	org
@Rygod3	human
@2g_Yellow	human
@Busy_Skinny	human
@jnewin10	human
@suite_travels	human
@MaddieKarwecka	human
@mrshellz	human
@Moonkaiser	human
@Ciaraod_Nutr	human
@StareCityKW	org
@Cosmopolitan_LV	org
@CecilieDR	human
@famishedbanker	human
@SmuggsInn	org
@knowles_krystal	unknown
@ChristabelBeeso	unknown
@ChildcareNetwk	org
@NewkirkTrudy	human
@katsixron6	unknown
@zacharymgray	human
@TristanTV20	human
@xxxRadushPxxx	human
@brandyval	human
@echpan0625	human
@CostanzaM2	human
@irachingaling	unknown
@kbalman	human
@deerajmandarapu	human
@Junsoo_Bae	human
@AskNaoma	human
@oui_plan	human
@GallowayChilli	org
@a_bopes	human
@simotopona	human
@SteBacon	human
@RewindRoe	unknown
@WestParkHotel	org
@littleroseca	human
@WendyNealy	human
@NuGoNutrition	org
@Viktoryas_dead	unknown
@pink4jen	human
@uchan_emilia	human
@QuartinoChicago	human
@AlyMashrah	human
@BlaiseOrange	human
@HousePorn1	org
@LouiseJosephina	human
@TrangHamm	human
@DhilaB	human
@LisaOHaraLoomis	human
@realnutritious	org
@getYoDizon	human
@thedishstance	org
@loafonline	org
@MorningDailies	org
@debbiegirl	human
@baublesnbraids	org
@cdropcafe	human
@_AlexaPage	human
@mistate19	human
@Sassy_Caitlin	unknown
@BobbyChinn	human
@Arteest1	human
@adrianchandraf	human
@flo_herrera	human
@AutobotSax	human
@OrangeandLime_	unknown
@EmmaVSlade	human
@josevargas_94	human
@ArdvinKester	human
@_INDOLADY	unknown
@NYPamperedChef	human
@TheQuinceTreeUK	org
@visska_	human
@OOTDsharer	org
@naynaywilliams	org
@naomifebby17	human
@OroMahjoob	human
@bobbiekingsbury	human
@RealBethelple	human
@NidoDC	human
@HMGourmet	org
@fogielairra	unknown
@Yajaira673	human
@huilaushanmy	human
@Glassman1550	org
@silefer30	human
@CubicKitchenBar	org
@makeupbydevine	human
@Nickzonline	human
@Grendler	human
@JunitaZhang	human
@Saracst	human
@kostaszoo	human
@BeccaSpraggs	unknown
@evilqueenallana	unknown
@TourdaBeleza	human
@onehunned	human
@laws_ken	human
@mai_ling	human
@workbyricky	human
@loribaz	human
@AprilMae808	unknown
@rie069jpn	unknown
@Jen_MommyofMany	human
@prettynameless	human
@paredesjon	human
@theupgrade78	human
@AKABANE_Kei	human
@Kingg__D	org
@twitertink	human
@Nenitriwahyuni	unknown
@MaylakePtyLtd	human
@gonutrisha	human
@chowienl	human
@MikieSquared	org
@metsky_horison	org
@yangssi_oppa	human
@EversRandom	human
@JorjD8	human
@OliveOils_es_UK	unknown
@wa_kao	human
@evanafter	human
@Rated_KG	human
@kiatravelbali	human
@burnhambakery	unknown
@NommyShot	human
@njsun	human
@Laauliiii	human
@Lunazul81	human
@bookmylot	org
@PCM_Expo2015	human
@alison_grooves	human
@al_Moro	human
@TheVampDeVille	human
@CoonMelissa1	human
@Blak_n_Blu_Mavy	human
@TsardChua	human
@Poppadom84	human
@TheSetai	org
@Zella_Chicago	org
@koteffa	org
@baangbaba	human
@CNTravelerSpain	human
@lapirogue	org
@My_Armenia	unknown
@AmericanBinge	human
@Space_Anchor18	unknown
@iChrisC	human
@stiletto_sequin	human
@TayAurelia	human
@Lady_Cupcakez	human
@barsinmelbourne	org
@teeamjay	unknown
@CivitelHotels	org
@hubbubcafebar	org
@NNYYEELL	unknown
@GourmandizeUS	org
@GnaTalamantes	unknown
@Ms_Scandal	human
@CanadianBudgetB	human
@nipa0711	human
@Awd0813	human
@HusbandInTow	org
@creperiecoquett	human
@AndrewGigante	human
@savourwines	human
@BecciPrather	human
@marinda_drake	human
@itaharjopawiro	human
@doncorpus	unknown
@zudars	org
@2012MUJAKT	unknown
@IAMMADVIBES	human
@norwich999	human
@yeeyroro	human
@kennyhowkl	human
@IlColazionista	human
@CSopraffina	org
@seshen	human
@hamptonssalt	org
@evogem81	human
@LLMExclusive	human
@LaCuisineHelene	human
@transcenequeen	human
@iamAleFerrara	human
@djselect	human
@DeliAnytime	unknown
@ZeusIsMe	unknown
@TwistedTailPhl	org
@CafeZojo	unknown
@libertadgreen	human
@labranchebrandy	human
@krupagrocery	human
@snow_lurve	human
@sunnyherring1	org
@pakorn360	human
@aCatCalledSalem	human
@maja_amalija	human
@AtlantaTM_Homes	org
@ManilaPlaces	human
@zeppy_tea	org
@1017Thugger	unknown
@megelizdry	unknown
@JAXFirstCoast	human
@sheisreyar	human
@Mvpkoi	human
@NuOhn	human
@tigercorpusa	org
@Bakingqueen74	human
@fraqslobster	org
@FamishedFish	human
@BreakingFast_	org
@meninadosoculos	human
@LinzyAnna	human
@rejramirez	human
@MaisyMeowBlog	human
@PixieDust027	human
@wooddyworld	human
@kimber1256	human
@ChuShuwei	human
@AntonWirjono	human
@PLANET_Me_Rant	human
@ylee_r	human
@wararengou	unknown
@Kyllllieeee	human
@redsunbuffet	org
@paibikery	org
@RamonReyesJr	org
@indosweetsports	org
@Patolovich	org
@Eventastic	human
@FitnessForHim	human
@burcu7kardaslar	human
@RedRoostTavern	org
@PhoenixTM_Homes	org
@WFMventura	org
@Surgery4Free	unknown
@thechewclub	org
@mimibradz	org
@SmokeDallas	human
@VeggieBeastBlog	human
@fsrinaga	human
@_mstorm	org
@Alexsurfing	human
@Eggsolicious	org
@Keng_RangSit	human
@destinationlux	human
@Start_UK	human
@redlipsblondie	human
@sahrakatoglu	human
@India_Bistro	org
@Jvillesfinest	human
@NYRecessionista	human
@This_is_MIKI	human
@MidtownlunchPhi	org
@NOLAsSalsa	human
@KarinnaGv	human
@CLEvival	human
@ScottFooMusic	org
@benyrz	human
@SkPeco	human
@StyleSlicker	human
@GregA1313	human
@riannotti	human
@FrankieGDaMex	human
@sdca2hnlhi	human
@fregole_tw	org
@BloomKitchen	human
@top5jamaica	human
@3_Shaudd	unknown
@fitnesssucess11	unknown
@CameronPark	human
@SaintThomas92	human
@kim_0_1	unknown
@SourDieselShaq	human
@Stobiespizza	org
@ElenaMcglennon	human
@ZoomOnMarseille	org
@yuit0422	human
@LMPNY	human
@sjsjsj1985	unknown
@ELWELLGRILL	org
@Mariachiara14	human
@buttersweetbake	human
@eatinc_au	org
@loteriagrill	org
@BlondeMode	human
@TownNay	human
@BlueWhorexxx	human
@ichasitihodijah	unknown
@AnasheLux	org
@Breakfastetc	org
@PRJ84	human
@LynnLivia	human
@theamandajean	org
@jorgeeuran	human
@RichNHolmes	human
@MsCarolineKarma	human
@imchad9	human
@thefirstbiteis	human
@OhitsJon	human
@theroxxbox	human
@TheNamesHeidy	human
@flutokol	human
@Ch1e2	human
@bluelight48	human
@joonie26	org
@SMarieGuido	org
@YsaSanabria	human
@greengoodiesokc	org
@LordSaraswathy	unknown
@Vintage_Spikes	human
@objetlee	unknown
@foggy030	unknown
@ameliaalock	unknown
@philipguillen	human
@AaliahDud	human
@UpperSide81st	human
@FelissaViviendo	unknown
@meals_kingscros	org
@ikke_lett	human
@rucsIncharge	human
@miyumiyu0708	human
@SlimLovers	human
@DefarhanoVII	human
@wani_here	org
@CouriHojo	human
@lewebbordelais	human
@Caprigourmet	human
@CornerCourtyard	org
@horn_ly	human
@zappafaye	human
@tabletonic	human
@KennyLagrosse	human
@chabiichscake	human
@exarmydadof4	human
@needaphone	human
@dimisharodgers	human
@MLunaGt	human
@WrgKemangi	org
@LulubelleND	human
@OneKensington	human
@DoubleTreeABZ	org
@kmagbitang	org
@KeilaJVG	unknown
@jjcobwebb	human
@JOSEV15	human
@EnderhanG	human
@AsianEatables	human
@AlSaudLV	human
@domingoyo	org
@PhilMedObserver	human
@TankaBar_Junior	org
@PDGarcons	org
@mssfran14	human
@ImJustRayne	human
@gordon0283	human
@pika_chin1451	human
@FarmToFace1	org
@TeasAndMore	org
@roo787	human
@TBeth_Photog	human
@TankaBar_Shawn	human
@jsfood_bargains	human
@samarthsikotara	human
@siddysays	human
@MahaloMunchies	org
@nelraM_Marlen	human
@M3delrosario	human
@Bellasr1	human
@VnAWaterfront	human
@InnomaNews	org
@smithsloughton	org
@GoncaloGLima	human
@sugardaddysnyc	human
@mellekimberley	human
@MsPurplePumpkin	human
@yogaretweets	human
@khansohaibuddin	human
@LunchingAZ	human
@JagroopDawn	human
@Zincmoon	human
@NOoGhRe	human
@FollowKennyCage	human
@Jager92	human
@tw_AVOCADOshimo	human
@AdelineCuisine	human
@BauhausRest	org
@pianogura	unknown
@DINEONIN	human
@KirstyRalph11	human
@docshut	human
@yu_yamada__	human
@twins_chon	human
@Tasia253	human
@ng2_online	org
@katemarshallart	human
@keesy_8	human
@TrainingM	human
@BL3SS3D2B3	human
@LenaRudy	human
@ozamaru2011	unknown
@grace_cheng	human
@ohvaa	human
@GirlieJackstone	unknown
@tenofworld	human
@francherechan	human
@Pavitecnik	human
@wtfpaulie	human
@SLPDenise	human
@Mel_McBoutin	human
@Mrpit0	org
@galangbagus	human
@SachiMonster_	human
@JB4eva_xxx	human
@LALPUSHP	org
@pankito09	human
@churrosroyale	human
@gustoglasgow	org
@sandramurphy999	human
@DevinMCH79	human
@TYPHENIWRITER	human
@justimbaste	human
@puthology	human
@NarNar90	unknown
@yeocancook	org
@AusarTehuti	human
@function360	human
@LacedIvory	human
@InNYCsite	org
@RoncesVillage	org
@VintagePinch	human
@CuffieCooks	org
@Danielab199518	human
@closbeautyspot	human
@ilovegurus	org
@heidilnd	human
@HarleyGrayKnB	human
@frbv21	human
@LiveLikeYouCan	human
@Tashkentsky	unknown
@3MTLegacy	human
@_akira99	human
@bigp_69	org
@tcharmill	human
@jomiroeming	human
@famreviewguide	human
@awesomeangel93	human
@ceomgmt	human
@eRneL215	human
@amouly_	human
@s4mariel	human
@BradfordEats	human
@eaststavern	org
@felipemorca	human
@Souperchefanna	human
@nitty1k	human
@jackalnofx	human
@zm_kne87	human
@fadzlijaafar	human
@NickTheStick88	human
@truemcqueen	unknown
@MsTji	human
@retweetyson	unknown
@KasthyPark	human
@rbtaskiran	unknown
@kina29	human
@tridlovesU	human
@RPascouau	human
@_under13	unknown
@GiorgioZamboni1	human
@RintaroNikkuni	human
@Mr_K_Lunden	unknown
@WatSon914	human
@smarthealthtalk	org
@VaKABurger	org
@siongchinchan	human
@GuerinKatie	human
@wenDcal	human
@iamnardongputik	human
@christinarardin	human
@AtourFoodsInc	org
@DennisVollmer	org
@UBTandR	org
@bfeedme	org
@LaTasca	org
@Fasn8nUrMind	human
@aleksUgarow	org
@sweetiemma	human
@MaaayMarinho	human
@Forthrightspirt	human
@kilmesyes	human
@lembonganisland	human
@SophieSheep_101	human
@QuesoMuffin	org
@PhanXiaoDan	unknown
@art_artlee	human
@TantiSukowati	human
@henditjia	org
@nuonrg	human
@heavensent2272	human
@gzmkmrc	human
@NYsSQUARE_YOU	human
@mworks0	human
@itstiff	human
@SaraletitiaP	human
@DunbarMiles	human
@blackswanchesh	org
@Rashimashi	human
@salverelifestyl	human
@aaron_aqip	human
@lisa25Mulryan	human
@sixtimemommy	human
@thethomasrose	org
@Lovingbargains	unknown
@katcadwallader	org
@Pricilliatan94	human
@Maenamjai	human
@SEHAHealth	org
@AnthemEvents	org
@MalanisCuisine	human
@JusttheBottle	human
@VapePorn	org
@sarabapa	org
@magpie1920	human
@TebogoRamokgadi	human
@fitnessfor8life	org
@polancojc	human
@WeirdTendencies	org
@TinatinMusic	human
@SweetTshow	org
@Mommyshangout	human
@jessshamus	human
@mytweetmark	human
@Chasity7070	org
@XConstantino	human
@CristionaAston	human
@laboaquesetrago	unknown
@krafthouse5	human
@losangeles_eats	org
@morernie	human
@Lilo_Abernathy	org
@tupelohoneycafe	human
@iLoveLaurynHill	human
@pukkatoronto	human
@misselaynie	human
@PickUpStix	org
@Checkcinco	human
@KibbleK	human
@El_Rob3rt	human
@gundam_aruaru	unknown
@naoTOayaKO	unknown
@GastropostVAN	org
@Rootology	org
@Carlitosguey86	human
@RichardsMeats	org
@MizzCrecia	org
@kidhaider	human
@redheaded_XD	human
@kiss_k2	unknown
@sandytoe	human
@thewestinhyd	human
@vynne_ean	org
@SerenaMarieRD	human
@Hausoftopper	human
@citrinebeaute	org
@cats_at_work	human
@sweetpeareen	human
@manais83	human
@HoustonPeach	human
@NonnasChesfield	org
@SkylaS	human
@JOSEDUMAR	human
@LeDiplomateDC	org
@Dainasmith7	human
@PiliGrill	org
@corina_718	human
@jeremyg0	human
@sroddfellows	human
@anisadays	unknown
@MarkSweeden	human
@MalbecPasadena	unknown
@withazed	human
@Secret2Sexy	human
@cathy_c19	human
@iangalliguez	human
@CoiasGlasgow	org
@dott_lurgo	human
@DTContainerPark	org
@PARKROYALprmta	org
@mariapiirsalu	human
@JADRCHEF	human
@vodka_and_relax	org
@lexmm1211	human
@BrownBagCafe1	org
@SancocheTV	org
@SERIOUSLYSEXXI	human
@s_nummelin	human
@FinlandStyle	org
@crazyboyiiii	human
@jenstyle	human
@ThePepperGuy_	org
@DuseksChicago	org
@cheryna27	human
@Cafealacart	org
@SadiyaAzhar	org
@AzraiSidratul	org
@CoachRitaB	human
@anthonykouta	human
@GenusBononiae	human
@orient_espresso	org
@SXEBETTY	human
@MoxieMingle	org
@StephieFrance	human
@bonesj0nes	human
@Mizz_Briggs	unknown
@djcjdiaz	human
@Nenny1202	human
@Ayee_Gibbs	human
@JojoeAli	human
@shikky1213	human
@J_Kovesh	org
@retrodinnerdiva	org
@StoryHillBKC	org
@eatPerformance	org
@radias2002	human
@FrosoLuca	human
@shopeing	human
@SnancyB	human
@cardiff_rev	unknown
@oopstoots	human
@CaseyLeeorTwist	human
@Annetworth	human
@jeandohnson	human
@ManRabbitHouse	unknown
@BobbisBistro	unknown
@colombianaenCA	human
@BusyMomofTwins1	human
@MKH_Wifey	human
@TonieBoaman	human
@maonity	human
@DraftHouseNC	org
@jeandsanders	human
@EcoCarWashRhys	human
@sol_zagato	human
@gourmetchefen	human
@byrawlins	org
@umersfitness	human
@JamaicanImages	human
@5hukriHamid	human
@AshburnPub	human
@CafeBouludTO	org
@oliviavachon	human
@Frenchy_Foodie	org
@NikyTheSweetie	human
@FaucetInn	org
@jfarrelldesigns	human
@ChezWu	human
@winda_c	human
@ChelleySpeakNow	human
@AbbyChuu	human
@LaFemmeFoodie	org
@davenewsham	human
@ChangingNature	unknown
@JustConcierge	human
@Nanteshype	human
@Aspaww	unknown
@gracefulpalate	org
@asakoapa	human
@Severnshed	org
@GCourtney83	human
@cd_kantine	org
@cupsnack_ID	human
@ardhene	unknown
@lebeautemps	human
@kprsRT	org
@EriPyon36	unknown
@Punk_Wok_Food	unknown
@ChezWhat	org
@thatsui	human
@BeautiesBrunch	org
@papaoro	human
@tebajjwa	human
@caffedemokambo	human
@OpticNerveAsia	human
@aelisala	human
@patrushkaz	org
@kevinpineda_712	human
@ShantyTownR	org
@schrubba4	human
@CarlosAContento	human
@VeggieBottoms	org
@chelseaoliviaxo	human
@MissWorldMegan	human
@Bangonstyle	human
@tgttx	org
@mizanmahidin	unknown
@iamyeL19	org
@TheQueenBlogger	org
@cdenhamdesign	unknown
@koi_hard	org
@mym0mmybrain	human
@Shimienicola	human
@gotmyways	human
@reeeeeow	human
@massa1121	human
@L3DK	org
@_Sian_Thomas	unknown
@goldenroadbrew	human
@LLLtravel	org
@nondaku_ray	unknown
@begumtaskiran	human
@ImperialMerchnt	human
@ItaConsulateHK	human
@MallingNetwork	human
@Iphiink	human
@COOPER_MARCUS1	human
@Sabryllina	human
@CoralieMichard	human
@ChefGruel	human
@Mii_s418	unknown
@KimJ950	human
@rkweblog	human
@majani1796	org
@mazikku_6	unknown
@FloraFineFoods	human
@TylerVillageCle	org
@crofty7437	human
@PloughShadforth	org
@curvy87	human
@ivanamp1	human
@imilo06	unknown
@leeyoboy	human
@MsDrea420	org
@afriadihikmal	human
@StarNationVi	org
@LoveWildLiveFre	human
@MHaffiezMNazri	human
@weedpraylove	org
@Patrckk	human
@cjade20	human
@musehappy	human
@BayAreaMommyCom	human
@scrapcollectr	human
@camille_blonde_	human
@bYunTaec	unknown
@BSFScreenWriter	unknown
@mayo_Oliew	human
@foosye_cfto	org
@fundapastanesi	human
@borongo78	human
@Yuiyaaan123	human
@Laurentiius	human
@FrederickDamore	unknown
@shahtommy	human
@Sexy_e_Linda	human
@MikeSaintcross	human
@TabithaPhilen	human
@gabermahmoud1	human
@preventionispos	org
@CtWsf_jktandy	org
@stephaniebnyc	human
@Dominic_Rea	org
@will_orchin	human
@ken_makewithus	human
@glitchgee	human
@marissaivana	human
@antyandrekusuma	org
@CHCPedu	org
@1viejo_	human
@AyakoNottBower	unknown
@ExperienceLife	human
@AuthorJesiLee	human
@QueenEindhoven	human
@EnjerinLank	human
@Jess_Right1	org
@Cuisinivity	org
@WhatsCookingUSA	org
@NBeloved	human
@e005063	unknown
@sumthink	unknown
@_BrittanyMorgan	unknown
@leonamanutd	human
@Yahiness11	human
@iketurner83	human
@ElynorDoreen	unknown
@ozgestyle	human
@BoneyardGrillTM	org
@pimpyourmat	unknown
@Wen__Chie	human
@iTravelandDine	human
@LisaBiondo1	human
@ubsttctdsed	human
@Katie_Ruocco	human
@hadaverde13	human
@Bloomsbp	org
@PangeranRafies	human
@vfm0617	human
@DominiqueRebel	human
@VividAudacity	human
@FairGameGFT	org
@PinkBunnySuit	human
@tantan27	human
@GOLDiiLOCS	human
@lamakanj	human
@8568_	human
@Bukita	unknown
@miamivice_22	human
@Skylarklondon	org
@societysouth	org
@stoneloveem	unknown
@EnjoyAmericaNow	unknown
@malekbenhlima	unknown
@uwwilo	human
@blackzenmama	human
@lazarandadallas	org
@mellsplace1	org
@OldSchoolYYZ	org
@OMARSANCHEZOMI	org
@cynetvin	org
@LandOLakesKtchn	org
@HollowManSeries	org
@oreillyskitchen	org
@AIshopgirl	unknown
@WFM_Swampscott	human
@NoneEvo	human
@bamabennel	human
@menahen1	human
@Upthestreetblog	org
@TankaBar_JasonD	human
@jillangel1382	human
@fabianpfe	org
@Yananymouss	human
@findmartinhere	unknown
@ClaudyTheArtist	human
@mrrodillas	unknown
@mrssouw	human
@wanie211	org
@furby1976	human
@FLKeysfishguide	human
@EleonoreLafleur	human
@SensimarSide	org
@pedrortiza	unknown
@ailsabm	human
@gymskitchen	org
@guerramarkitos	human
@elistiana_	human
@BuddhaBarHotelP	human
@Chowinthe559	human
@Winniehitto	human
@Gayot_OC_CA	org
@Love_Food_UK	org
@adthenshesmiled	unknown
@95Forty	human
@niatravelwriter	org
@amylovelubin	human
@YuTTyu1	human
@EbonyBlur	human
@Shondavette	human
@amiller1119	human
@ritabook11	unknown
@BorntoJetSet	org
@RoZelleLee	unknown
@PatNasty24	human
@zahyong87	human
@joshmannfitness	human
@Ludigouvea	human
@AhJie1222	human
@MadameGitta	human
@Soraya8945	human
@xoxojacquelynb	human
@katholigores	unknown
@table26palmbch	org
@frvanilla	human
@elliotts_tweet	org
@RedLivingTeam	org
@yocchiwa	human
@isseiko193	org
@ScottyHatlevig	human
@AshleePi	human
@AvenuesBistro	org
@LWChamber1	human
@O_So_Omar	human
@Michaela_J_	human
@ghamlouch_m	org
@farmdrop	org
@TrySpaceCo	org
@i_am_jazmin	human
@allyskitchen	org
@AZuptar	human
@MCLampaSays	human
@Nikki_Takes_NY	human
@pinkiebag	human
@I_M_Telling	org
@jabv02	human
@PromocityRD	human
@ParrotClubOof	org
@JKapetanovic	human
@HattiW	human
@goditttt	human
@daxryder	unknown
@LudsMac	org
@R_Jovanka_M	unknown
@peter77710	human
@achictale	org
@wellfedfamily	org
@lhinglhing_ll	human
@barkingbaking	human
@jamieharrington	human
@LadyCamden	human
@seriesx522	human
@tdadlookbook	human
@riodejaneiroD	human
@Tudderettes	human
@heatfanatic	human
@AKCuisine	org
@Cynicus_G	human
@RulyabiiMargana	human
@GetYuve	human
@OxygenMagazine	org
@ssbogan	unknown
@lisybutterfly	org
@PVTVFITNESS	human
@onlydewen	unknown
@CeliaChalice	human
@KeeperHome	human
@romeoyjulietcab	human
@Novotel_Tng	org
@drurybuildings	org
@norikouyou	human
@hiphopmom_skye	human
@LesFenetresRest	org
@JONIBOODiVA	human
@Bu_sut	human
@bratzjzel	unknown
@lamsaty77	human
@HolidayInnDC	org
@boozychef	human
@Camelia_Styles	org
@JosephineHby	unknown
@AXceleratept	org
@Julz_83	human
@AmyKristin824	human
@shallamae16	human
@Matthew_J_Moser	human
@PrimeTimeTally	human
@elliott_inamasu	human
@BuddhaHosea	human
@renegadelovers	human
@advocatehealth	org
@YourSpiritSpeak	human
@marcelina_mace	human
@3akeifak	org
@ApexContestPrep	unknown
@Xandra_Mae	human
@agustascon	human
@sharapooh22	human
@HealthyHalifax	human
@kristenarinlove	human
@pat3rak	human
@ChiroCards	human
@cakemaniaitalia	human
@susannefraser	human
@zeppy_spiderman	human
@missflora	human
@eatdrinkbekerry	human
@NoelReneNieva	human
@KEAHImage	human
@emdarlington	human
@WhiteOakNyc	org
@AnnaRBL	human
@BOSSFISH99	unknown
@SMiLE_Ne	human
@CateT253	human
@KeriEjustice	human
@STLJimmy1	unknown
@MayaAllbones	human
@tatumancheta	human
@LupiandLeos	human
@eLiiZZYv	unknown
@deeCHOY	human
@SchaMrsHisham	human
@MuLovesGDOnly	human
@PaisleyProduce	human
@Rou_Ting	human
@ArtCharlie	human
@Dj_vegeta	unknown
@Jazziepickles	human
@GuidebookBeats	human
@TeRahTeranmuzic	human
@fud4urmood	human
@_Veeg_	human
@mealspirations	org
@ecOnuizer	org
@TheRainbowLodge	org
@iqiyyiqi	human
@FerCasiraghi	human
@NadineTarabay	human
@spaMandyNYC	human
@CharsWebRants	human
@cupid8184	human
@angelfire287	unknown
@LinaShehadeh	human
@medicalsherry	human
@WrapwithAllyssa	human
@davidbiedert	human
@RobbinZirk	human
@MyDuvets	org
