@TonyVS12385	human
@tonberry33	human
@naomiquinnell	human
@ShaquentaLakay	human
@MisterQtastic	org
@bloominghealthy	human
@localcityshops	org
@kymmiisha	human
@LittleIndiaBLMR	human
@LaRosaRest	org
@efatrie	human
@kaysnaturals	org
@uknowyukinko_	human
@dnyandeo11	human
@MariaCampoyPS	human
@aylin24fit	org
@smoldher__	human
@Siren_Eats	human
@belmondoformen	human
@cyrus_08	human
@Shoeburytweets	human
@kana_am	human
@NaneeLv_Guava	human
@wslcantina	org
@MommaBeFit	unknown
@AdamBlake11	human
@BBQDryRubs	human
@valvalval_fame	human
@EmilyMiller1515	human
@iamDDdazzling	human
@NewArdwickBodyC	human
@kodomo_hokkori	unknown
@RUBIcocktailbar	org
@gl4znAm	human
@ArchieCorpin	human
@PCUSAPastorAdam	human
@rellbabyy	org
@Crapsterz	human
@awesome9866	human
@dhikadhiko	human
@RattiAnni	human
@Da_Moley	human
@LipLopp	human
@Smits2015	human
@food_junkies	human
@kidsnutrition	org
@BenzaBurgh	unknown
@SaraDiPie	human
@INDEX_Holding	org
@Ksvivekanand	human
@bbarling	human
@yapsherlyn	org
@SwAg_MoLLiExxx	unknown
@pigdealdawson	human
@TaittingerVEN	org
@gnaMaRi3	human
@mulysa32	human
@causwells	org
@karenaffe	unknown
@krizme	human
@DhaxG	human
@lovecitykitchen	org
@TownsmanBoston	org
@nina_nein	human
@mes_mots_doux	human
@VEGASPLUSME	unknown
@GlMME5	org
@chichaemp	human
@KPkiddoc	human
@Michelleluvh	human
@lespotizarbel	human
@JeanieHaddox	human
@ferdyskywalker	human
@nightdrivemiami	org
@j0mi75	human
@PIApromo	org
@OutofWater_Blog	human
@MrTVrC	human
@BokenBoardwalk	human
@gowenmedia	human
@mbrgr	org
@roomeezon	human
@JennyPearcePR	human
@huddy_	human
@adlesmana	human
@NYFreshDelivery	unknown
@juanmanuell24	human
@natpaknat	human
@BunsAndBuns	org
@LyMbi	human
@Super_Shake	org
@ChemburChapters	human
@ojapurin0506	human
@gillymimizason	human
@LynettePM	human
@IamMissiK	human
@Sophia_Olivia_	human
@NormaRShumaker	human
@movidachic	human
@antopint	human
@BBCLancashire	org
@smbeautyhouse	human
@craftcartwright	human
@iiiicham	human
@peerunthron	human
@WorthEveryFnCal	human
@JEFFRE5E_BOSTI	human
@juanmanrguez	unknown
@TheSpicedLife	human
@lp_lisboa	human
@TheAnnabelGomez	human
@DatDudeKB3	human
@VanzMD	human
@GIMMESUMKIMBER	human
@RendhyR	human
@FrenchToastcom	org
@YosephineD	human
@hani_niha	human
@narumi763_dayo	human
@DunedinGolfClub	human
@ShumAndrea	human
@dytemreuzun	human
@diana_chix	human
@ImLHaruELF10112	unknown
@nicoleforns	human
@mikareyes	human
@tincampi	org
@natalieclayton1	human
@trixycle	unknown
@tt_fitnessfreak	human
@yoicordoba	human
@happydashis	human
@HermesMuatetema	human
@TeamDomherr2014	human
@SexiiBeBe305	human
@romersburger	org
@iwantaPT	org
@RobertPiacente	human
@Got2loveD	human
@coco_ruiz	unknown
@BarronhamPalace	org
@DirtyDicks	org
@wobreston	human
@Mizukiluvs	human
@hodgesart	org
@squarebottle	org
@Elena_Giorgi	human
@nikschtotelheim	unknown
@paal13ameland	org
@IllinoisRetweet	human
@PaprikaePepe	human
@eltenedor	org
@AdrianoMurarox	human
@KenzaSMG	human
@sillydumb	human
@aaumholic	human
@shi_516	human
@JoePranaitis	human
@emmabecciu	human
@NOECRISTINA	human
@NicolKirsty	org
@WholeFoodsFAI	org
@RT_writes	human
@sesliyemek	human
@teardrop_smile	human
@VIPRyan1	human
@Crystal_Elyse	human
@erubeycalvo	human
@581328	org
@EmanuelMontilla	human
@hellokd82	unknown
@LosChilitos	org
@Morgane217	human
@Pechu16	org
@bitoni208	human
@fernandogeoufc	human
@Lady_Mera17	unknown
@resie_25	human
@diano_ghie	human
@JeanKSee	org
@lalunkee	org
@CollinsMcLean	human
@itsannebabe09	human
@Buttr_Scotch	unknown
@JerryTT1	human
@UneVieFrancaise	human
@madetoborder	human
@hasan_haleem	human
@RafaGnlz	human
@LaRada_Sicily	unknown
@BarcelonaBx	org
@katita_sando	human
@nishichauhan	human
@aspiredliving	org
@Link_F	human
@PaleoCajunLady	human
@Tyrshaw	human
@3starsbrewing	org
@ErwinBowo	human
@DGMelekos	human
@AlexandersWinch	org
@CarmeVilaplana	human
@alilea67	human
@riverheadcoffee	org
@papispickles	org
@kanmamistyle_	unknown
@yuki34_0519	human
@Aimeecat1979	human
@DTEugMerchants	human
@pearceauto	human
@Bamblingsofnafy	org
@MANDYCLARK58	human
@NickMag88	human
@JuttaO	human
@creme14th	org
@Shannycwfl730	org
@thedecoratingid	org
@Refectory	org
@rustikacafe	org
@MLeighonsea	org
@TwentyFourKaye	human
@keychaMJ	human
@jennynvh	human
@becca_winner	unknown
@AnnaWootton	human
@Mobile_Meals	org
@TinyIceland	org
@DidieyDoshie	human
@UK4G_Free_TV	human
@nunex_ray	unknown
@chelag82	human
@dai_from_mature	org
@MIZZANNAPHAM	human
@MedicinesMexico	org
@endavies	unknown
@CigarBabee	org
@crunchamame	org
@blog_akb48	unknown
@rustedmind	human
@pouletegallife	human
@mrsshilts	org
@mikebettscook	human
@JEDDaldalita	human
@erika_ann1668	human
@mlhernandez5	human
@Ty_Beauty25	org
@atozfoodreview	unknown
@thatgrlshannon	human
@cookwithcraic	human
@CountySeatMS	org
@philseuro	org
@Helena_Geraci	human
@angprimamang	human
@AriniGunadirdja	unknown
@TravelAndrew	human
@LABLeeds	unknown
@elski2	human
@Assad_D	unknown
@triana_r23	human
@ILi_Stylist	human
@HeCallsMeSaizy	org
@Bbritnell	human
@bonberi	org
@TCMomsBlog	org
@AntDeLaVega	human
@RunsWithHips	human
@chicsassymom	human
@LindseyChassM	org
@milojevicbranka	human
@RGKC	human
@ZhagaMusicorama	human
@Akita_BothTH	human
@ZINplicity	human
@AlVentoMN	org
@frankthepuggie	unknown
@LagosNawah	unknown
@MaryLuzOnFood	org
@AM_AlObaidli	unknown
@soniasing96	human
@KAB_19	human
@liketonny	human
@Teksu	human
@FernTrent	human
@yoko_m0618	human
@StefanoCaracci1	human
@The_FireHydrant	human
@Theannibee	human
@ManassaMai	human
@Flavia_L97	human
@Changing_News1	human
@FHSevents	human
@cany_emo	unknown
@somerset_venues	org
@BrandonBaltzley	human
@GrandHyattMum	org
@theapcrew	human
@LECKER_de	org
@princesspamma	human
@elgwynn	human
@IlSognomidtown	human
@DrCheatham	human
@foodmaster101	human
@inesmiroslav	human
@NykkeyB	human
@RavzaBurun	human
@Lil_swagg_HD	human
@oresthry	human
@basukekanon0213	human
@MoneySavingMay	human
@CremeCaramelLA	human
@ChippyCee	human
@FitnAssOfficial	org
@aupairsuitcase	unknown
@thecafecat	human
@labellavitaa_	unknown
@botter17	org
@renai_Ov0mB	unknown
@lovespell3818	human
@JohnnyPaulVera	human
@bellalimento	human
@lovelldies	human
@loveliNes07	human
@sassyLegra	human
@CleanBeautyTalk	human
@TracyBNutrimom	org
@ItsJorge	human
@harrypurplmonky	human
@CSUKTown	human
@FlavorNapa	org
@SaraQaddoura	human
@FitNutrition	org
@m_tampakis	human
@AyuRiie	human
@JusdePommeraie	org
@ChriSobieniak	human
@HesperiaVE	human
@weenieoneil	human
@_cakegal	human
@katelcasas	human
@RaeYoga15	unknown
@JRafaDelgado	human
@Raul_colon06	human
@thegranarytad	org
@WC_Low	human
@TonyVictoryFit	org
@Leaders69	human
@ginni_me	org
@Foodie312	org
@ayjay_76	human
@ExploreCHS	org
@GuadiB	human
@MartynReah	human
@JaneEJarvis3	unknown
@janejett123	human
@tin23tin10	human
@kofabl	human
@littleitalyst	human
@ivoryvinyls	human
@Oecil	human
@aliasNC13	unknown
@foodenberg	org
@iDocMerge	human
@SamEpps	human
@Lotteria_Indo	org
@itsMissFlyVida	human
@4everPopcorn	org
@LeeMuseBlog	unknown
@Mapc_86	human
@tashababy83	human
@franmarroco	human
@ItsBrookeRyan	human
@rinapple819	org
@Falkirkgal1	unknown
@RevolucionRest	org
@djfade	org
@FancyFranks	org
@cleanfoodninja	org
@GrainHouseNJ	org
@Alielo	human
@MelissaGonella	human
@TheRaz2007	human
@CortadoN1	org
@woodau	human
@Tracy_Chang101	unknown
@PantryPros	unknown
@MetalPhoenix09	unknown
@avinashmohandas	human
@Aldersgatenr	human
@tastingtoronto	org
@hanadahirona	human
@Kaweir	human
@dansamtech	human
@chloe_hautin	unknown
@missmandyylyn	human
@ExpatKiwisSG	human
@GQPrestigeFame	human
@evoid_info	unknown
@TheDeliClapham	org
@DorsetCooking	org
@JackMokison	unknown
@AngelScaflone	human
@CacaZiqra	human
@InformedEdin	org
@MinamiYaletown	org
@piranga	human
@Werner__Venter	org
@Theresa_is_Dead	human
@HorsesandHeels_	human
@emedemarcela2	human
@msvigie	human
@tonnam_siam	org
@luvblackroses	human
@WiganSlimWorld	human
@whisperblog	human
@enjoynorwich	human
@vdotvaldez	human
@PeterLongno	human
@shaunalynne4	human
@Keralacafeuk	org
@homespunatl	human
@LameesStylist	unknown
@MsiBliss	human
@fandeturisa	human
@vroblespac	human
@funkyplet	human
@greensleevespub	org
@AlvinRRivera	human
@_noeliawhite	unknown
@linskyz	human
@BoxcarTavernDC	org
@Simone_Olivia_	human
@LoveandMeatball	human
@kimberly_lyn	human
@Irenekavourias	unknown
@SomewhereH	org
@prettylilthings	human
@designera1988	human
@VoteMeYO	human
@JoyousPoet	human
@Takebacktheciti	org
@danieldeka	org
@LuciaDelPasqua	human
@ittybitty_chibi	unknown
@greatrix2	human
@nagham	org
@P2Binvestor	human
@ckle123	unknown
@DjCalliB	human
@abrilpealoza	org
@HummingbirdHigh	human
@recipedabba	human
@wilson08_natha	human
@honsololam	human
@pinkleopardello	unknown
@SaraAlKhoory	human
@AnastasiaHui	human
@edimontecristo	human
@marianaSMAC	human
@LouiLout	human
@LaScamperia	org
@msngeL	human
@VANESSAILEKTRA	human
@yummeyou	human
@laura_howtocook	human
@True_to_Mine	org
@723a_a	human
@ChrisDelfin	human
@thaithee	human
@DailySkateTube1	human
@kim42matthews	unknown
@JennaRosaberry	human
@krist3n_xO	human
@HealthyDisneyFa	unknown
@Sing2meFancy	unknown
@Winter_zhen	human
@dwntn_rob	human
@davida_chanel	human
@FashShoe	unknown
@thisasianone	human
@Madrones	org
@Arob___	human
@Tannertime	human
@TeeceOfCake	unknown
@theamazingken	human
@karinalmagee	org
@praniglowdayspa	org
@iamptheg	human
@TheCultureist	org
@nizzacamille	human
@giffer72	org
@saucedtogo	org
@Isac_Santiago	unknown
@Rudy221	org
@yasella	org
@TownHouseDuomo	org
@KrazeOvaU	human
@Boulcott	org
@How2HealthyFood	human
@mekenimeckai	human
@wendymzacarias	unknown
@steamrollerstl	human
@pierriangeli	human
@noodlenthread	human
@brnyourstencils	unknown
@helendownie	human
@manateena	human
@ShotieUy	org
@KristiWDey	org
@stephaniepiche	org
@williamdepe	human
@VTrondsen	human
@EricWilkerson	org
@Ohmmarion	human
@scrappily_chic	org
@ZackyAndreas	human
@TCSezerCDeniz	org
@MikeGSanchez	human
@dennishanani	human
@thefunkzone	human
@sisi_kong	human
@sandwich_art	human
@tuinuina	human
@SiphanM	human
@TheDarlingNiki	human
@lemonheadap	human
@playfulcooking	human
@No_Cut_Card	human
@gobernadorhotel	human
@juliaotest	human
@welovekuwait	human
@GaryWiltshire1	human
@george_meza	human
@3187798	human
@laetitiabrock	human
@VoltaStamford	org
@shiratamaco	human
@Quisha_Nicole08	human
@icehockeynut	human
@mileith1	org
@miss_kittyyy	unknown
@Vy_YuE_KhO	org
@baileyjoseph25	human
@OldSoulOwati	human
@ZhafriKamal	human
@kawarasaki1	human
@RJdelaFuente	human
@winawinjessky	human
@Amanda_Mabelle	human
@NutritiouslyBri	human
@MrsBrghtsd	human
@Olisroom	org
@hazrydaniel	unknown
@HollyIndoFan2	unknown
@Karina971114	human
@helenrosec	human
@DoctorM	human
@breakfastwitpat	unknown
@FutureLuvSounds	human
@VitaFaithJejung	human
@DonMuira	human
@victorianteapl	human
@Deanes_Deli	human
@UpAllHours	org
@fruhoffstedt	unknown
@hadkins143	human
@JlinkJohanna	human
@QuintaQuos	human
@ForzaNandino	human
@martyroddy	org
@Pink_Breeze88	human
@bertinbistro	org
@griyakuliner	human
@LornaNzX	human
@ginyil	org
@SNPhysio	human
@elle3180	human
@hsbridalstylist	human
@slips_deli	org
@NYCINYOUR20S	org
@fcustomizacao	unknown
@Patsy_Sparkles	human
@horecaEHV	human
@Matt_RicardoV	human
@lachaykha	human
@ChristmasTimeGB	human
@angiewhoohoo	org
@sahiljassal	human
@CultureCookies	human
@ShunRyder_	human
@pronto4u	org
@tonirasanen	human
@TheCortezEffect	unknown
@mharara	human
@Geo_Martin2	human
@fmtaqi	org
@JeremyLimJaeYui	human
@SarahBlandyVO	human
@RowenasInn	human
@LeBillotMTL	human
@22_kanae	unknown
@ShazPhoto	human
@juliehow_fit	unknown
@VirginiaRJeffer	human
@NewsWithoutMeat	org
@AChoyKay	human
@tetrarina	human
@reneekonan	human
@MsKate89	unknown
@ichocolateent	org
@socialmedia_S2	human
@JackieeAA	org
@CarissaJoslyn1	human
@SammysBeadworks	org
@ruz911	human
@dinner4u2	human
@NicoleGuillaume	human
@BellaOFallon	org
@Mavis100Dollars	human
@cocobun_x	human
@iammartinhenry	human
@aug31am	org
@ShaeRoderick	human
@SamanthaJJGen	human
@arisa_kamata	human
@never4get5150	unknown
@Vincentz93	human
@petits_carnets	human
@italianinvan	human
@BVBusinesses	org
@thegardengate	org
@BirdWithWords	human
@Deeksha_21	human
@Evan_is_Google	human
@bella_blau	human
@LeandroEmede	human
@MahmoodAlRashed	human
@norasegura	human
@alongcameaspydr	human
@LibrarySq	org
@SandymountHotel	human
@PolicherJane	unknown
@TheMegaCoop	org
@LeanCleanBrie	human
@LeedsShooters	org
@BLK_RalphLaurEN	human
@eve_n_odd	human
@michelle_waits	human
@health2hairblog	human
@JamieLynne_	unknown
@BlomquistTara	human
@SofiaSEstrada	human
@iamshinonymous	human
@Operator_irl	human
@marinellacuccia	human
@Vicky_333	human
@BarnabysRidley	org
@pistonova	human
@hallpr	human
@aparnakris	human
@ferkaskas	human
@econcepcion	org
@sammiejane1990	human
@jucy0614	human
@kee961004	human
@JennEveEis	human
@teshchopra	human
@encorebali	human
@ankh_ridden	unknown
@Dale_indigo	human
@fricilia_caroll	org
@LV_Restaurant	org
@ReikoMcNishSato	human
@ShadowRav	human
@VeraandMichelle	human
@Prodpran	human
@KeeZeeee	unknown
@AngeloBalzano3	org
@mutheumbondo	human
@TheRealAMJ	human
@diviacity	human
@JudyBeautyBaR	human
@AllYouDoIsEat	human
@BoeDrWho	human
@TravisGomez	human
@food_social	human
@princessjonalyn	unknown
@marlonmusique	human
@Killakwabo	human
@JLoJR89	org
@muchaskian	human
@ergheizzero	human
@say_what26	human
@bryan0717	human
@Wineforthe99	human
@tennisprincess2	human
@jojorevaldy	human
@searcysjazz	org
@sunnylandmills	human
@DrewKaplan	human
@antujahat	human
@MaryaApgar	human
@cirahcr39	human
@buddiesdiners	human
@LooksieQLD	human
@CornerCafePF	org
@shaddyshad	human
@RaleneB	human
@NajmasSW20	human
@izyanliyana	human
@chaleureuseUK	human
@annabellecba	human
@nboo	human
@LCHFFitness	org
@ExpWestchester	human
@KateyWhitey	unknown
@equihua_sm	human
@yamamura_yumi	human
@MamaAcasa	org
@callen2014	human
@sidmathur117	org
@Stereo_Boy	human
@iiamphresh	human
@ayano_official_	human
@TiffanyBankhead	human
@JohnnyBrownBag	org
@mocha313	human
@ChloeAdlington	human
@Laeksiee	human
@JaredSmit	human
@AnfaalD	human
@CelebrateSweets	human
@malissamarsden	human
@tHeTwisTedGLeNN	human
@cutoutthecrap	org
@MediaCookery	org
@chanmedrano	human
@drsarahsviews	human
@elvnansen	human
@HuntersHillLife	human
@Tribune_Tavern	org
@mypaperpigeon	human
@DJ_KUYA	human
@keywestdirect	org
@MelissaMierrod	human
@LawakKeWak	human
@FoggyDewTO	human
@CalibytheOshyn	org
@XaiaXandra	human
@DBrownChevrolet	org
@bio_nutrients	org
@Carluccioscaffe	unknown
@hkitta23	human
@GasStSocial	org
@iMP_erez	human
@FrenchMeadow	org
@augoutdemma	human
@cvfoodislife	unknown
@33ayu	human
@sherita1989	human
@Morbeg_Queen	org
@shameezkaperyGJ	human
@silviasangadji	human
@LDN_Restaurants	org
@OrkunBulut	human
@spoontangerang	human
@brettdahlenburg	human
@Jasmino91	human
@naz_zeer	unknown
@_ASJEINAH	unknown
@akbsaxyaka	human
@snooowwww	human
@BarEstiloTed	org
@WiganReTweet	org
@ChristinaEApple	human
@babygirl24o8	unknown
@chamelo1	org
@JAMIEPERLOW	human
@Meltrowsdale	human
@AlfnsMujca	unknown
@jewel3point14	human
@BeardToTail	org
@Myboysmum	human
@Easter65	org
@EarnLi	org
@Rukchand	org
@NerdyMcFlyGuy	human
@MrsWonderful32	human
@aperochef	human
@ewren_MRBotanik	human
@Trizzish	human
@IlNorcinoMilano	org
@freshandconyc	org
@missericayvette	human
@capebreton1973	human
@Ctabo2	human
@Imyourherotoo	org
@TheMarkbyJG	human
@LaiLovve	unknown
@WorkingMomCooks	org
@BeverlyWilshire	org
@lucianomachado	human
@milieu_magazine	org
@pj17_billones	unknown
@ako_osedo	human
@Chef_KBradford	human
@50PlusAccounts	unknown
@rawest_dawg	org
@BossC24	org
@tas_anne	human
@The_Greedy_Pig	org
@GreenMarketGirl	human
@VincenciaYue	human
@SuzSquirrel	human
@alice_attwood	human
@AGMelissa	human
@sweetgabby05	unknown
@shelikesfood	human
@oneddarlo	org
@BryanZSiegel	human
@DarinCarter	human
@Eatertainment	org
@BridgetTxRD	human
@goodbadandfab	human
@stilettosnspice	org
@MeelieWijaya	human
@MLizzers	human
@Amber_Applz	human
@shanniejane	human
@Davide_Oltolini	human
@2BWholeBakery	org
@ScotJanse	human
@GardenCafeNYC	human
@FAVEY26	human
@WarwickGeneva	human
@berfendber	org
@brotipriya	human
@DecisiveCraving	human
@smittenxkittenx	unknown
@Ksta4rd	human
@Undefinedling	unknown
@Ais4Action	human
@mcmihelk_brenda	human
@justmagician	human
@Nadirali89	human
@cyntiyasa	human
@miss_tsubasa	human
@skrc909	human
@msbcmc	human
@finnchefdc	human
@nat46	human
@toinag	human
@albanysal	human
@NtrMK1	unknown
@Steph_Blondoner	human
@inspiredglam	human
@AssociateLI	human
@moderndayfreak1	human
@felixmaymi	human
@MyWifesMuffin	org
@calamityLDN	human
@sabeautysupply1	human
@Farhouna	human
@BaaSheeep	human
@walbell	human
@BrickOvenAustin	org
@willlaurent	human
@5THINGSaDAY	human
@pequenossecreto	human
@secretariat1012	org
@jordiloef	human
@StephanieAdW	org
@OMGItsSeeMunSu	unknown
@lozzawonderland	human
@youandneo	human
@campbell_g	human
@Mountain_View1	unknown
@danielkemp6	human
@Annie23703	human
@acoci	org
@Blushion	org
@el_arandano	human
@AltairKai	human
@adamson	human
@yesyo	human
@saul_roce	human
@PicaRestaurante	human
@missbubbles1983	human
@iusquinn	human
@AMANOgroup	human
@jrblurz	human
@lovelyladycute	unknown
@salmondip	org
@rhernandez1205	human
@JaclynPipa	human
@PoireRouge	org
@BWPLamarve	org
@MM12212012	human
@my2a_uv	human
@BrookeSever1	human
@whimsicalwife01	human
@ITheeCook	human
@excel_vittoria	org
@LTDCommodities	org
@duprai_	unknown
@StudyMyWay	human
@ijitheviolinist	unknown
@MichaelMidnight	human
@araabigael	unknown
@Mok213	org
@BrendaIvonne	human
@tekkytoms	org
@Fa_shion_gal	org
@DVL_85	human
@Dead_Lady_Alien	human
@DUMBOfoodtruck	org
@laurasarahdoll	human
@dancingbunni	human
@bluerain241	unknown
@ayuxkty99	human
@MissKayeErasmus	human
@BigHopps	unknown
@marivicgirl	human
@yojeam04	human
@RMRealtor	human
@MisyPigyRabit	org
@zahraljmusic	human
@Tibamboofantasy	human
@JamesDelles	human
@C_Cindycarolina	human
@MWDAtlanta	unknown
@DeadEye687	human
@Fellance	human
@MeadowsCasino	org
@laura4463	human
@JoethomasSmith	unknown
@DanKrueger13	human
@RubyRedCafe	human
@ojwhittaker	human
@TellSpec	org
@patsnaps	org
@dinae3003	human
@W_AIRSOFTGUN	org
@KamuningBakery	org
@electric11blu	human
@pearlywhite2013	unknown
@texastwins2	human
@15StepsMB	unknown
@5Robots	human
@misswhitemoth	human
@divarestaurants	org
@usup05	human
@alinherlana	human
@DarrelJDelfin	human
@iLa_Aranel	human
@BristolWork	org
@LocalSugarFW	org
@andymorris	org
@neechew	human
@texaswitchtwin	human
@AishahNA	human
@sara_diperri	human
@SimoCasadei	human
@MAPWellness	human
@delgwando	unknown
@PataconPisaoNYC	human
@DinnersByDani	unknown
@WayneGretzkysTO	org
@dashlindashira	human
@MeRcAnKoRaZaCaR	unknown
@PareSean	human
@marisa777	human
@alexander0212	human
@NeuvooGrandRap	unknown
@EatSmarter_de	human
@Approach50Fab	org
@edwankurnianto	org
@PerfectLaDe	human
@hwalsh7	human
@madalenabreezy	human
@tRaw883	human
@dellacorte71	human
@joeygiorgia	human
@GourmetMarketEc	human
@wismy074	human
@MaVieFrancaise	human
@akmalkmrudin	human
@TasmanianDevon	org
@DTJAAAAM	org
@Joarvis	human
@NahniNuu	org
@RyuSupakorn	human
@Sly1036	human
@snazzle_tooth	human
@Zowrr	human
@Aleandro_09	human
@nichijou1996	human
@littlefoodco	org
@babithajcosta	human
@rosemarysiemens	human
@Porsha_D	human
@chantallusk	org
@iamyari	human
@ChisouSW3	unknown
@AprilMonterrosa	human
@mchopper_mg	unknown
@5dollardinners	human
@BlistersBBQ	human
@whatrunslori	human
@allysonhashope	human
@Tonetiki	human
@bleubohemesd	org
@ruupshall	unknown
@Crazy4Footbal	org
@FlyerzBlog	human
@JulieDiBocchi	unknown
@The_Jmoney	human
@NunoFelicianoPT	human
@JoachimTiu	unknown
@STR8GS	human
@ShotglassCast	org
@OMalleyJayne	human
@iammsrona	human
@EilirHaf	org
@xxpink10xx	human
@s_dizzle121	human
@SivanAyla	human
@Byfo123	org
@luvmelotz45	human
@henrystavern	human
@eatkawa	org
@idiotskitchen	org
@Andrew9161969	human
@GGCateringDC	org
@risa1157	unknown
@amla261	human
@dorky_les	human
@JordanEMassey85	human
@njaninewoods	human
@abstract157	org
@ichal_bavarian	unknown
@SSararomero	human
@poddar_shikha	unknown
@Nikoei_21	org
@picklesnponies	human
@SERIKAxoxo	human
@LazaroBakery	human
@hikons	human
@noahzndr	human
@MikeyAIR	human
@forkanddram	unknown
@ylvwes	human
@MayangChaby	human
@greenlovedate	org
@TtCarmelo	human
@AntonioKnoxx	human
@OudeRaedthuys	org
@masacomik	human
@kellynda	human
@Claireapillar	human
@wakame_kids	unknown
@Zulhaili_Omar	human
@Sensaatio	human
@world_wiki_r	org
@PinkNinjaMedia	human
@maikkey0707	human
@TheMightyMrM	org
@CANDY090707	human
@RonnieRah	human
@RajSurveyor	human
@enribellinelli	human
@bot44083580	unknown
@AwoMike	human
@ViViWCY	human
@Ben____Wilson	human
@ArnieRuntgens	unknown
@Giulylovesmars	org
@hashtags1isi	human
@jeyinne	unknown
@denicemoments	org
@bundagie	unknown
@Fredo_Olk	human
@luiscurras	org
@CourtneyxKaboom	human
@DavaoFoodTrip	org
@diverjack30	unknown
@truefoodlove	human
@ResDiary	human
@SylvrSsi	org
@MrFatale	human
@hellocreativef	human
@sonomasbar	unknown
@lilopom	org
@lolita_iori	human
@Helen_McLovin	human
@Annadenicola	human
@IamMekaMarion	human
@GINABPHATTY	unknown
@CommandoFitBC	org
@Sahavatchara	human
@furouchan	human
@BrindusaB1	human
@jessramirezreas	human
@BagelFactoryUK	human
@goodLifeEats	human
@BonVivantVanIsl	unknown
@FollowbackMerge	unknown
@Itadakidev	human
@hanasnu	org
@geloroque	human
@sakurasasku	human
@beautyandbedlam	human
@1bdasgupta	human
@AdelaideTurick	human
@AndreaBoundy	human
@danefeldman	human
@ellyani_aliudin	human
@MarvelMeray	human
@amirizzuan	human
@jvargolo	human
@hikari_halu	human
@oldandskinny	unknown
@SouthSideBLiggs	unknown
@m1r1tter	human
@Doriananas	human
@Jenkins_Nik	unknown
@phdquest	human
@beauty_nl	human
@delicharcuterie	human
@I_amShankDaddy	human
@rosswclarke	human
@dedek_ss	human
@gauridetails	human
@Brandz25	human
@burrobk	human
@Minakz	human
@RAYRAELYAU	unknown
@Diva4Lavida	human
@ManxPub	org
@BeveriaRoma	human
@MatthewAnchel	human
@CourtneyClardy	human
@suclupelopez	human
@trannelyy	unknown
@velvetmag	org
@Ooowwweee	org
@MustikaTC	org
@AnnaliseGrech	human
@MarieBGiordano	unknown
@NutriNatura	human
@ctl1192	unknown
@BeatriceBrown90	human
@WLC47	org
@Sekerthsn	human
@anassstas	human
@MrLiquorAu	org
@MiniTigeress	human
@SegafredoOrl	org
@NadiaAfragola	human
@Flight_Lounge	human
@Jikkie_Francis	human
@LuisThomasFong	human
@MHComedyClub	org
@DuvitchD	org
@resumptioon	unknown
@best160491	org
@luislarezc	human
@1989TRE	human
@shereavejauan	human
@_RTDJ	org
@ToastyFace	human
@smith_nee	human
@TastesOfHealth	human
@RedLightzz	human
@aliyacaman	human
@TheBarBeQueMan	org
@TotallyEgypt	human
@pizarro14cuba	human
@Conrads816	org
@CreekSide_Coop	org
@mcooksforyou	human
@2HaruAyu0	human
@david_ja_ramsey	human
@KellzRuKiDDinMe	human
@OneMorocco	org
@DPMILLIONAIRE	org
@ResaxX	human
@barbara_ahn	human
@devranuluant	human
@WorldJikoni	org
@niitsitapii	human
@wherePHILLY	org
@Homestaycom	org
@stefan_kracht	human
@sophie_cayeux	human
@Aynurcool	human
@Sir2F2K	org
@SlipstreamDC	org
@67EuroVDub	human
@NAzKI_TTY	human
@carmona_mike	human
@thespicechef	human
@holycowme	human
@christonge	human
@khimpangayan	human
@thirsty_nyc	unknown
@MilestonesCOQ	org
@unbuttoningpnts	org
@the_miker	human
@RoxyLovesYou	org
@joyfulflower191	human
@nonpyjk	human
@tomas_md	human
@HodgsonMill	org
@rockydapoet	human
@J_Russo3	human
@djleonyangg	human
@Little_CryTox	human
@MaiRiYan	unknown
@yesitsjonathan	human
@christaboffa	org
@OhEmGIL	org
@eubebo29	human
@prettyonheels	human
@ChefColinNoxDC	human
@TwoBrokeLowCarb	human
@PauieBautista	unknown
@solizardosht	org
@FloridaViSalus	human
@aurelijabu	human
@Fanatic_Foodies	org
@miyazaki_mak0	human
@rayelicious	human
@terteFTW	human
@divanaurlopie	human
@Annie10107	human
@EzjheiJoy	human
@drinkqtea	unknown
@taylor_niamh	unknown
@beemorag	human
@TairaKhoo	unknown
@KarlSonkin	human
@Jasmin_Woeppel	org
@Aprikots	human
@SadieMinaj	human
@Dirty_Ones	org
@GlrPnar	human
@RATUALGHANI	unknown
@smuckers	org
@Bryan_Ngang	human
@Faabeeaana	human
@adalRipol	human
@stiloabq	human
@Ros_n_n	human
@sheobiedo	human
@dondon_sermino	human
@MissEharaCloset	unknown
@bot85522954	unknown
@AdamSheridan123	human
@WitWisdomTavern	org
@nickzrulez	human
@ulaidziii	human
@TasteConcierge	human
@NUNAXRUNA	human
@HallelujahAcres	human
@24_kma	human
@VondelHotels	org
@CLUCKITboston	human
@TechWars_io	org
@YOCHICK_AINTME	human
@Angela_Mastro	human
@Sonny_Chia	human
@Jakey_Cakey	org
@lottomavado	org
@ShopPowerscourt	org
@chefjenRD	org
@ajlinares9	human
@SimplePureWhole	human
@NomInNY	org
@TheTeenOpinion	unknown
@MaRiEdiAbLis	human
@lilray_31	human
@GuidoVera	human
@amwalker38	org
@PenneSnider	org
@RestaurantLPI	org
@hartonotandjaya	human
@moshpit23	human
@yoroishi	human
@graciemonreal	unknown
@girlwthatlaugh	human
@robbraga1204	human
@PauSaysHello	human
@joseblanco_com	human
@wildbrewworks	org
@jessevallins	unknown
@tezlaroe	human
@PomsKitchen	org
@BrookdaleHydro	org
@BukuRaleigh	org
@mark_uk2811	human
@ikebanaCT	human
@Lenyajones	human
@carlospache_co	human
@awks_mo_bro	human
@SocialEastEnd	human
@ibbiness	human
@MiszTie	org
@betty_runner	human
@joanolera	unknown
@teenagetag	human
@FreeAztlan	human
@vavamasse	human
@salat_schuessel	human
@SarahGrace93	human
@Nyna_Aryna	human
@DesSoFlyy	human
@meeniex	human
@alicebatoon	human
@Keyliems	human
@sokio	human
@T1MK1LL3R4LL	human
@lovenmeee	human
@FiachraKenny	human
@ImFajrin	human
@IrisInnBandB	human
@FoodbyFirenze	org
@tinnie_gee	human
@emmaorussell	human
@mba_tala	human
@GeorgeCWang	org
@LiquorReview	human
@juls903	org
@damonjasso	human
@feistysandy	human
@flo_life_	human
@nongnesly	human
@chichachikaa	human
@arnol84	human
@Kurtschlechter	human
@rullzmikael	human
@Tami777	human
@AdmeenP	org
@mike_nugesi	human
@masa80392006	human
@ladyleet	human
@Gillianyap93	human
@NickelRae	human
@ARTIST_ONE	human
@MakeupLove2	human
@whitecrockery	human
@marywaldron	human
@0F4NQU3IR0	human
@RescuePoetix	human
@jojo_stanlie	human
@fathersouza	org
@HellzBellz16	human
@MelaBoston	org
@NorwayFashion	org
@albo75	org
@CrossFitATP	unknown
@say_hill	org
@Laura__Lily	human
@RagazziNY	org
@simarjitubhi	human
@Kid_Cosmic82	human
@BarPrimi	org
@stevie_camille	human
@StreetMeatz	org
@Mariela_Rome	human
@HollyBellMummy	human
@inesqsilva	human
@EngrSeanFlores	human
@SerenaScanz	human
@melsenpai	human
@kalories	unknown
@christychan0426	human
@RChivi	human
@RicstylR	unknown
@ShioriLilian	human
@dontbegelus	unknown
@itsMissyJ	unknown
@cinziapedrani	human
@Kandiegrl9489	human
@FabiolaCalixte	human
@GoodMorningPoem	human
@bowlelt	org
@FarahAnsari3	human
@ViNtAgEeMoTiOnS	human
@JesusDCabeza	unknown
@pepspizzeria	human
@valeryechelon_	unknown
@Elisa_Zhuang29	human
@rimaRIMAkd	human
@doahshungry	org
@IloveLutece	human
@SmokySweet	human
@zombieoverdose	human
@adam62139	human
@misstez_inc1	human
@julseykins	org
@momsreview4you	human
@Tucciii	human
@KarrenCris	unknown
@thehappinn	org
@NeashaDate	human
@GourmetGuyMag	human
@cshislop	human
@MagisterBeauty	human
@MiraJnda	human
@Fyurer25	human
@Bar166Bistro	org
@winslow_w	unknown
@GuardianMedia	human
@mouse_mp	human
@DeliciousByAna	unknown
@MrParmo	org
@phsilbr	human
@cryystaaalll	human
@Bartending4Free	human
@AlejandroRiosZ	human
@cheetahfit	org
@ZainabMarji	human
@HappyChef	org
@Changing_News20	unknown
@mom321	human
@BearsPantry	org
@pristova	org
@HolaBarcelonaNL	org
@Aangnen	human
@ItsMoDoxa	org
@SUPERNOVAROSY	human
@SPromoventas	human
@checkpointedi	org
@ParadiseDew	human
@kristenbyers	human
@glutenfreefoodi	human
@Liz_McCracken	unknown
@TheGreeneTurtle	org
@youngyukii	human
@innahanderson1	human
@jmh101377	human
@MsKirstyWJ	human
@PrimeProvisions	org
@SHALYmai	unknown
@EPmagazineuk	org
@MahoganyInk	org
@dukeofhannah	human
@ChefHotSpotts	org
@EventsWithEdge	org
@kimfarr87	human
@NickSamsGrill	org
@S_W_OH	human
@After5Detroit	org
@formaggio	org
@siam255	unknown
@HCarinus	human
@JohnBretana	human
@fisherry	human
@MsMinnie0519	human
@Rock_107	human
@CVazzana	human
@dika3010	human
@chitratyass	human
@kelliecardician	unknown
@amandalyndsay	human
@TAREKIMPEY	human
@eagleBoltbar	human
@EatDrinkToast	org
@giselula17	org
@justcrisel	unknown
@wp_digest	org
@Izola980	unknown
@aqueouscosmo	human
@TheDorchester	org
@thebagelbardoha	human
@maria_j_correia	human
@Geoboymd8	human
@MacAndCheese__	human
@wishingtree	human
@j5c23	unknown
@eatunderground	unknown
@Golden_Fig	org
@piYatrawadEE	human
@schnitzelslb	human
@socialmty	human
@TWHotel	org
@MalangPromoCom	human
@chef_rthompson	human
@Luchessa	human
@tucktogether	org
@UrbanTrekLeader	human
@MissLeviCrombie	human
@nuanakano	human
@john2mv	human
@RacheleDemaster	human
@thenoshery	human
@Keeper85	unknown
@bigfacefiend	human
@DavidALaw	human
@13TwentyVI	org
@misstyler_	human
@The_CountryGirl	human
@JesusTruther	human
@wanielehon	org
@Chef_Charlaine	org
@andrewttetley	human
@ChristopherBLV	human
@_IAMYUKINA_	unknown
@mmikeemike	human
@Eddingtons	org
@RingoRokka	human
@KirstyCat_	org
@PaulTermsap	human
@MarieArai	human
@Sdot_Meezy	human
@Lea_tlbg	human
@hernaldotorres	human
@varekhov	unknown
@Daleboy5	unknown
@AroseMongiello	human
@LoveAmruta	org
@myrecafo	human
@IDUEORFICI	org
@nutritionqed	org
@chanthi_j	org
@Biancaw05	human
@ThatHousewife	human
@midlifecroissnt	human
@ashleylicious_	human
@styledtherapy	human
@mrsballoo	human
@WeAreCoppaClub	org
@icyelliot	unknown
@intenseipt	human
@SuperBudCom	human
@dharshayini	human
@DetikReseller	unknown
@ellierkwade	human
@TheGetFitMom	human
@phantastikorean	human
@YudiPurwanto96	human
@doniman	human
@staceyvalley	human
@SamueleFranzini	human
@DiFotoShoppe	org
@IlProdotto	human
@collincregg	human
@torillo59	human
@luxiz	human
@SShorty325	human
@Hinano_kmt	human
@RoninHighHeels	human
@E_Sbabo	unknown
@TheBeehiveLeeds	org
@hanadiayurista	human
@FollowbackFlake	unknown
@maookg	human
@sonotemo	human
@MARKtheHUSH	human
@NCMME	human
@PCN_Dietitian	org
@DEBRAsolutions	unknown
@rotisserieaff	org
@HKT_gasou	unknown
@TTMobile_ie	human
@stephanieodea	human
@himestyle	human
@yuko10sae8	human
@loveforcoupons1	human
@EMedsker	human
@LowellsMendon	org
@SclubSociety	human
@hurrythefoodup	org
@hermafrederika	human
@Maleniegeorge	human
@1230jackie	human
@SyFyAmin	org
@ZighyBay	org
@medsnax	org
@BarriMedia	human
@LapinRoyal	human
@MelinaAnlin	human
@Mrs_Mendoza17	human
@MarchandEtoiles	human
@GetHealthy_UK	human
@RetnCell	human
@RoytonRoasts	org
@jelsdouma	human
@CoshamBingo	human
@johnhillmedia	human
@VIBE_ub_orange3	human
@TheDutchFittie	unknown
@bradCHANNERS	human
@Vegpacker	human
@mia_low	org
@MissLotta89	human
@Changing_News26	unknown
@SPlDER_87	human
@BellaBaker92	human
@NicAngeles1	human
@PianadiSibari	org
@rominaruizdiaz_	human
@NovithaWijaya	unknown
@CoffeyBruce	human
@great_oil	org
@MothersMarkets	org
@ejtan	human
@dominicpantoja	unknown
@fittenukban	human
@sheikhasrie	human
@CachiaSandra	human
@joe_carlton	human
@duetbrasserie	unknown
@KaitiShea	human
@Bennedict1995	human
@DunedinBeach	org
@JohnnySwaggy	unknown
@TedTorres	human
@Flavor574	org
@WHATZHOTANDNOT	human
@momzcuisine	human
@EmilianoBologna	human
@jepoy022	org
@simplyMIKEL	human
@Timsflavour	org
@KaiSoosNoona	unknown
@mary_nana27	human
@shicetygrl	human
@AmandaDanie	human
@fountainheadpub	org
@aimayhiiee	org
@Sugar_Flours	unknown
@a20sumthngklutz	human
@EatCleanLLC	human
@frozeandrefrig	org
@ComLeonie	human
@sweetykiratrai	human
@FitnessDiva2014	human
@FoxHoundNeasham	org
@MsSamanthaSays	human
@zvezda_s_neba	human
@ManoilovaLera	unknown
@WholeBagel	org
@TamSteeZ	org
@DJREDRUM	human
@gv0710	human
@TazIsomxx	org
@CheLLeZ_aka_Me	org
@DeleonVerenice	human
@tepletta	human
@Oven_Clean	human
@intmariexx	human
@MissLBDressed	org
@VegasStripDaily	org
@NinniU	human
@alf_eus	human
@0006yuki	human
@arantxapoynter	human
@RachaelMcM	human
@Andrea_Zagatti	human
@LAURA__WALLS	human
@alfieslaughx	human
@lxprofitness	unknown
@You_Parent	org
@kitoyks	human
@LizLundblad	human
@FeaCoal	unknown
@SvelteTeaCo	unknown
@HermineLawther	human
@hey_peachy	org
@Clara__Johnson	human
@mimayevangelsta	unknown
@biancagreyy	human
@wokntava	org
@iamlady_luck	human
@dedy_firmansyah	human
@WaterFront_Polz	org
@JRobinsonArt	human
@kioskbudapest	human
@Chrisss_Stg	human
@Todd_Fashion	org
@s00n	unknown
@EatDrinkNorthsh	human
@greggvg	human
@jadeayu	human
@JCKnightley	human
@Lee5ive	human
@BobbiBelongia	unknown
@joseepaul	human
@reserve	org
@thri211	human
@ARoomIn	org
@MamieandMakhis	org
@mya_amri	unknown
@MeatEtcBenmore	org
@theengdom	human
@GerardFCraft	human
@TheMexZican	org
@PGotfredson	human
@HyattConcierge	org
@lilsunnykitchen	org
@GORENGANGIRANG	human
@fuckingtrucker	org
@imbiss25	unknown
@OhSoJuicyJay	unknown
@Benasii	org
@palmzhxr	human
@LaurenWint	human
@inCIANJURcity	org
@lelasari73	human
@SheRuns2	human
@BiorganicStore	org
@WalkingDeadBot	human
@ObvzItsAndrew	unknown
@MissTribu	org
@haciendacantina	org
@Master_Wiratama	org
@ShanaHuff001	human
@vietfoodblogger	human
@barryckushnir	unknown
@jhoanmacpotski	human
@BautiMensi	unknown
@EllenChubby	human
@uche_anatogu	org
@LonsRestaurant	unknown
@Breathrapp	human
@PolitiqueTweets	unknown
@f_bianprado	human
@okbmst	human
@henrique_has	human
@theatricalEB	unknown
@anahigemma	human
@princybijoux	human
@AmilGagula	human
@distaArum	human
@SYODAKEISUKE	human
@Glamwhispers	unknown
@jay_dany	human
@Miss_Natick	human
@QualityWaterSer	org
@NashMorena	org
@CurryUpNow	org
@thebestofbridge	org
@carpey66	human
@keg2014gek	human
@Zula287	unknown
@BummiElf	human
@KISSandTLE	unknown
@livewithdaniela	human
@Abovetheweather	org
@EAhumadaR	human
@tomo_ace14	unknown
@Neza_LadyRose	human
@purple_oc	human
@RuizmoSt	org
@McBridespub2	org
@umakhindria	human
@samjasrin	human
@ginakara9	human
@HotelBaker1	org
@CALGAN_ET	human
@hikonyan8739	human
@MyTrainerSarah	human
@LaMasera_Leon	human
@mrsbanks	human
@Isbero	human
@awanmalangit	org
@witsofsteel	org
@cmadhur	human
@rosebakes	human
@tiara_1111	human
@FASHIONSAGA	human
@famemonster013	human
@GloriasCafe	org
@ActiveTastyLife	org
@donaldhughes	human
@P2PTrainer	human
@_Shortay_	human
@fay7oonfaisal	human
@TeamGymCoach	human
@123violatuner	org
@ProTradesmenuk	org
@taylorcooksit	human
@gottchacha	human
@nerimabot2	human
@AJ_IUC	human
@Sinzvegas	human
@foodbloggersCA	org
@GourmetUncorked	human
@MaguiErrecalde	unknown
@vielkalandazuri	human
@bitchygurl81	human
@fishytuna	human
@tangstah	org
@bigoven	org
@akiraakuto	human
@TimothyZachary	human
@CarolineTannn	human
@mama_natur	org
@trilliyone	unknown
@AlvarezEmanuel5	unknown
@FriLaVictoriana	human
@Niess94	unknown
@ohmygoodfood	org
@COCOPImam	org
@RandyFuhrman	org
@SuzanneHajdu	human
@kmos_fin	human
@BetwsycoedDaily	org
@TammyBoXo	human
@bewaraco	human
@ViBE_ub_berry9	human
@FortCampbellGAH	human
@daddybriefs	org
@TheTealPalate	human
@SunParkVillage	org
@TheMetroArtist	unknown
@LifeJuiceShop	org
@rabia011	human
@merihkoc	human
@davidtfountain	human
@martincotton	human
@mingweifoo	org
@marypoppins68	human
@taeco_eco	human
@chezdanielMN	human
@Gerald_Torre	unknown
@lingsophoto	human
@LvB24	human
@GeorgiesHome	org
@MercaditoFish	unknown
@randomsynergy	human
@wtstablog	human
@BaraSupercook	human
@MJCSerrano	human
@NANA_vonaive	human
@LMRwine	org
@FunkyWVChick	human
@almjoyze	human
@LielyTjhin	human
@ajaxrotary	org
@JmonaReviews	human
@TimonWoods77	human
@itsmebimbee	human
@karouska_	human
@NadegeCooks	human
@iwan_utama	org
@BrnWriter	human
@444hnm	human
@c9andthecity	human
@frey_g8	human
@SealdSweet	human
@TEAMFLEURUK	org
@twostella	human
@Rachel_Nodal	human
@Miamoos_mummy	human
@MedoHamdani	human
@JoabHenderson	unknown
@LanghamBoston	org
@ZinEatery	org
@karlapinky	human
@super_peas	human
@8x10vip	human
@SLDeLaParra	unknown
@frieda_kiswono	human
@ranggalanoberta	human
@odileke	human
@etarelo	human
@MoralesCastro	unknown
@HahnAfs	human
@mariBooo82o	human
@MichaelaDalt	unknown
@chanibia	human
@yuttyda	human
@pinkrebel__	human
@Fabiana75	human
@scottsdalemag	human
@jakemelnicks	human
@AmeliaOesmani	human
@MaikOvhun	human
@SaboresDelDF	unknown
@my4boysand1	human
@Cask15NYC	org
@LoveMyJazzHands	org
@skinnyjeanius	org
@nomadic_vegan	human
@CanvasJune	human
@supermisshannen	unknown
@JustiLi2124	human
@jessbehurns	unknown
@YourTeenMag	human
@notanitboy	human
@carolinachiari	human
@saayamizuno	human
@BluePlateTaco	org
@lunch_food	human
@mschrier	human
@ankotodounuts	human
@comprasyhogar	human
@ProvisionRoom	human
@Ddraft_desing	human
@eatingfoodx	org
@IsyColo	human
@Scott_Barcelo	human
@starofkelly	human
@TAMMY_SILVERS_	human
@MilanBluue	human
@Best_Teen_Diets	org
@IdaLionila	human
@vanessarusci	human
@Le_Grand_Pas	org
@rafasheim	unknown
@NeuvooHosPhi	org
@witchy_s	human
@nurulelani	human
@Author_Swati	human
@dee_alami82	human
@Juli_Pazos	human
@jenthom72	human
@LaPuertaSD	human
@ScalarBioEnergy	org
@whatididnteat	human
@CarloFdoSalazar	human
@MyFairDress	unknown
@guardianous	human
@Christoper1612	unknown
@BBZSOLUTIONS	human
@ZoeyYi1995	human
@_SARAnade	human
@CozmoJordan	org
@passmethedimsum	human
@Changing_News23	unknown
@noshandnourish	org
@Kelloggs_US	unknown
@WhitneyLEnglish	human
@whataboutken	human
@i23st	human
@EMF_CSA	human
@tosendegutemine	org
@b97822302002	human
@tanto_mr	human
@jermicidal	human
@angelicamonic	human
@Entreprenegress	unknown
@goodeats_blog	human
@DTlivingLV	unknown
@Grilluo	human
@EggsOverBaxter	unknown
@ChefBeischer	org
@abrahamchopite	human
@karstenztc	human
@DonyNidiantoso	human
@DoubleDipChip	human
@Agostini_G	org
@LespritRouge	human
@Harukawashiyama	org
@heartukcharity	org
@Xochadoch	human
@BalanceBar	org
@gracefromdheart	human
@waltlove5	human
@P28Foods	org
@pattyfregolente	human
@Mizuki01297	human
@jameahaaha	unknown
@VitalityMelissa	human
@Alz101	org
@EZWeight_Loss	org
@InTheFreshLane	org
@Kelly_Simpkin	human
@jerryim19921103	human
@DailyBootyDose1	human
@SpoonriverMPLS	org
@tastebuds106	org
@juanabella21	human
@yumzchan	human
@baritonekeith	human
@CharlotteMassa	human
@juviance	human
@jan5en_	unknown
@phiiaz	human
@NikkoTolentino_	human
@Afoodiestime	human
@Madame_Bullet	human
@EmilyEtoile1	human
@AdventureTimewJ	human
@JavierTuiran	human
@akaneyurika	human
@jaimack311	human
@sabrehound	unknown
@AQUAplymouth	human
@thirstynyc	org
@Pickle_Catering	human
@GatotkacaComics	human
@nannybrooklyn	human
@PoshFashion_	human
@milkyway1115	human
@dritv	human
@damnedcanasian	human
@MrsReyes_1	unknown
@MissLailaniMae	unknown
@TheMansionInn	org
@Bieeeee	human
@YasmienKurdiFP	human
@alexis121792	human
@CallMeKream	human
@lovepickle_uk	org
@DESIRE3795	human
@AviWoolman	human
@iamk0bemelissa	human
@LMissGlutenless	org
@sandrinamartin	human
@AMAZING_MONROE	human
@TheDockPlymouth	org
@RecipeForPerfec	org
@treeofolivetree	human
@pisangmorepin	org
@fourTwographs	human
@MacrinaBakery	human
@mum_business	human
@5thAveWeddings	org
@mamasayseat	org
@SeafoodRevJxn	org
@sandragough	human
@itsnomageddon	human
@jkeStorey	human
@idachin	human
@zeggzeggz	human
@DrDanMoss	human
@wennisyong22	human
@kathrynpeterson	human
@thepurplefigmag	human
@LuhMaiia	unknown
@HueyPing0402	human
@ghaye05	human
@Mr_Rayo27	human
@NewHavenBrunch	org
@Bobayla111	human
@NewLifeOnRoad	org
@allenati0n	human
@IamClaudia89	human
@suitevillamaria	human
@charleskacperuk	unknown
@Akechi_777	org
@Roel_pinkprint	human
@ramoncb27	human
@ryansiri	human
@m3_creative	human
@houseofyumm	org
@_DistortedSmile	human
@rhorhofabx	human
@dianaleal_89	human
@butter_beans	org
@F1RST1MPACT	human
@Cupcake_Queen90	human
@luredfresh	org
@blissevents	human
@BlasianMedley	human
@DADincPREZ	human
@AnnReTweets	human
@mysummerheart	human
@VulgarViking	human
@cupcake_chicken	human
@nadirkeval	human
@BestBarsUK	org
@TopDogFrat	human
@net_ksons	human
@loulanguyen	human
@RamsonsBramble	org
@LaughLoveLunch	human
@maggiescafebar	human
@vdavidovic	human
@Dashhotelbali	org
@Lizzmaik	human
@EatEastIndian	org
@OfficialTunTun	human
@BarefeetKitchen	human
@ColdSpringDepot	org
@XNikolskaya	human
@Tomaburger	org
@thekitchenbowl	human
@loremipsum666	org
@SamueleSartini	human
@S_Salibian	human
@1061BLI	human
@Ninetiesboy	human
@meersuppe	unknown
@aMiixedBreed	unknown
@vikrant7985	unknown
@Gema210	org
@ameliajusuf	human
@jazzberlin	org
@itybity00	human
@AmmosNewYork	org
@kitsilano	org
@robineaupatiss	org
@MrTeenBear	human
@PaolasCloset	human
@jb_1190	human
@suryaorenji	human
@freeboostpromo	org
@canabalmaria	human
@BossLifeeBabyy	unknown
@NdaroePrahara31	human
@PookieRose	human
@TheHungryPost	human
@thurodahustler	human
@ScubaOfficial	human
@SavannahLodging	human
@SAfoodtrckstlkr	human
@Drea612	unknown
@heatheraplatt	human
@JustinaHadnott	human
@pablolandias	human
@JustynaKoziel	org
@dimsumNYC	human
@romeldias	human
@MrsBudds	human
@manu_gainza	human
@Chutiphon	human
@Rockermom1	human
@e_panpan	human
@ShujauSotti	human
@LYNDONJJSTOKES	human
@carlossilva07	human
@tune4roshni	org
@Crazi_happi	human
@AJdebiteert	human
@CravingOnWheels	human
@VariableM	unknown
@MAUREEN_WHITE_	human
@EtenInNijmegen	human
@Cocktailjoints	org
@DavidsFitness	human
@paopaocarapao	unknown
@PrimeDelight	human
@AmericanTapRoom	org
@cooksgoodfood	org
@BoBoKow	human
@psy110	human
@delirio_freshco	human
@CulinaryLocalGA	org
@mar_tanaya	org
@dwight_everith	human
@reverseg	human
@AellindraEnne	unknown
@jamiewallace27	human
@Dpstillwater	org
@TwistedMonkey_	human
@TheStationWah	org
@awardtour	human
@NashMomsBlog	org
@HungryThirstyK	human
@micchheelle	human
@wendycakeartist	human
@zynemaru	human
@sereinwu	human
@J35SON	human
@thejaxmalcolm	human
@saramuradspicks	unknown
@angeyu57	human
@cedricvalera	human
@dhanismama	human
@eugenesorres	human
@WellofHealth	org
@ibrahimkilinc4	human
@s9a5_24	unknown
@yuling05	human
@5thandWine	human
@ryuka0847	human
@m_chelepastore	human
@shizuka629	human
@VCPHotels	org
@LovedayKate	human
@C3rtifi3d_Queen	human
@IamMorgane	human
@CR8ZofBOMBS	unknown
@zorillus	human
@_hollymadeline	unknown
@maricakrj95	human
@ashleyborden	human
@3DAround	human
@nadbolat	human
@ftk5106	human
@AdamMarrot	human
@SoaringEvents	human
@SarahGauthier88	unknown
@ERNESTZorro	org
@SeldaCar	human
@TheMenIssue	human
@odinav1015	human
@jaidahilog	human
@Kawiria	human
@einou_dennsetu	unknown
@tachakorn_t	human
@TuttoProntoRest	unknown
@yangpao	human
@e_izumi20111015	human
@GaryGardiner	org
@Emily_Carter342	unknown
@BrklynSouth	human
@DuKe_LYH	human
@Sohail_Calgary	human
@SkimAloha	human
@bamskutcher	human
@ANDto_theREA	human
@EwmMary	human
@SachiniEMSPE	unknown
@yogikotto	unknown
@BlendsKuwait	org
@Khunkiwikiki	human
@FoodGlut	org
@monika_teguh	human
@CathyK_Health	human
@steneliee	human
@Deccadent	human
@EloisaDeNardis	human
@KamalTheStrange	human
@RoyalChinaPune	human
@alfianjo	unknown
@amelia_yap	human
@BreadLifeBakery	human
@ProteinDrinksCo	org
@nachitalezica	human
@Ceyyyy	human
@JacquisEats	human
@FabianaFionda	human
@Dannypost72	human
@wanroa	unknown
@SirfMayuR	human
@xERlKA	human
@anninsavokilove	human
@4ever_Sasha	human
@XXL4Life03	human
@RianJMac	human
@DatingAdviceRT	human
@marialend18	human
@cndycream	human
@JazzDiab	unknown
@DemianKishin665	human
@somexxxxxx	human
@cmedders	human
@PatandSTK	human
@nave1107	human
@kainyface	human
@h_praxis	org
@iiamJaylah	human
@sewletscook	human
@imkennbaclohan	human
@OJaponSushi	human
@chuchesonline	org
@EdinEditor	org
@magicmael_off	human
@oliviahecht	human
@delmonicosLA	human
@acheekyelephant	unknown
@iamcharlotte_m	human
@VerdeMentaCafe	org
@goiumuskiz	human
@aurora27	human
@inkaprawirasasr	org
@VitellosR	unknown
@Stefano_trainer	human
@ChrisnJenkins	human
@SheilaElleNg	human
@MelbAUTVRepairs	human
@nibblesbynic	org
@WomensNetworkAU	human
@musumesachi	human
@mariavoina	human
@WileyValentine	human
@choeysmalls	human
@AlSpiggs	org
@MrCaban	human
@GossipPiggy	org
@AnneEsluzar	human
@DineSouthAfrica	org
@BondsAshton	unknown
@deenasays	human
@WaffleCrafters	human
@C21BI	org
@sohmeh	human
@coreenhilde	org
@KitchenGlory	org
@GrazielleCamill	human
@keanrachael	human
@CampbellsSoup7	human
@Othazone	human
@krgrs62	unknown
@peterpanwine	human
@dhrishnit	human
@mahrokhsaberi	human
@Cruzmario	human
@Mikevdlinde	human
@lovelykoko1016	human
@EffiePatelos	human
@MrCid_87	human
@starbear222	unknown
@aikororon2011	human
@MNassar	human
@inkscrblr	human
@amirahisabella	human
@askbahrain	human
@lilitkn	human
@sousstyle	org
@ChristieEllen	human
@LasPalmasNash	org
@ZorroCats	unknown
@byejoespirits	org
@seikooooooo	human
@puput_adinda	human
@meganvtaylor	human
@rochelle_barlow	org
@RufbiiPutra	unknown
@precure867	human
@VilleKaresto	human
@greyciouss	human
@cookingwithkell	human
@capitalseafoods	org
@nolancharlene	human
@depechesmode	human
@LisaTalia	human
@KristieSessoms	human
@GigGobGulp	human
@DinoInShaw	org
@Angela992	human
@ajcriscey	human
@KataleenahStorm	human
@EcuadorAhora	human
@erikatxgurl85	human
@downtownstlouis	human
@signemeilholm	human
@AlexanderHill20	human
@WorkoutBOX	org
@AlysFfion	human
@blkeyedsusan	human
@AJOdudu	org
@HeidiShaffer	human
@Lisahjelm	human
@emoterangchubby	human
@ayacameron	human
@JDavisson9	human
@29kiska	human
@Mina_Argentina	human
@kensuke1961	human
@alice_marie_87	human
@arties_gar	org
@frackleworld	human
@Lightaquamarine	human
@girlwithspecks	human
@_healthbunny	unknown
@theelephantuk	org
@brendaaheran	org
@JanJan_19	human
@WSY_21	human
@feelfreemusicgp	human
@stanekdenver	org
@Littlegolf55	human
@TheJOenP	human
@frank_nunez	human
@plamy18	human
@SouthRidingInn	org
@Azizasalman	human
@Happy_ChinaDoll	human
@fracklenews	org
@ImBaynes	human
@Jingdi8	human
@my_mutya	human
@litflowerpot	org
@Cris_IC1	unknown
@ANDREAS_O_JOEDA	human
@maririn_1411	human
@Annie_Secret	unknown
@Theharrodcorp	human
@MsNatashaLeigh	human
@BaleenLA	org
@MissMillMag	human
@OrganicIL	human
@MYSTERYMAYA	human
@Indian_BomGAY	unknown
@DTFortWorth	org
@Steffany_a	human
@katejane12	human
@blueocean5454	human
@CamilleHoudry	human
@LaurenMinchen	human
@VeganBananas1	human
@NeecoleCee	unknown
@aL_861107	unknown
@we2826	human
@febribusmadian	human
@Ryan_Evans34	human
@bot87462199	unknown
@LeeLeee_69	unknown
@yocomorimoto	human
@ladyshalyn	org
@wishversilia	human
@rsgrandinetti	human
@LorenzoSolanoP	human
@SMMgirl	org
@Michaelbonsor	human
@busrataca	human
@MONsterriffic	unknown
@eventsbywell	human
@michaljohnsonx	human
@chefmattybritt	org
@Joclair301	org
@PhoenixWom	org
@MW_GinaB	human
@StefanySuryani	human
@Trudy_Ying	human
@KirstinHalstead	human
@byjudybloom	human
@daphnejoycee	human
@daveparker_real	human
@aliquisnj	human
@RIEWORLD888	org
@alvara273	unknown
@pfitness1	unknown
@slideee_com	unknown
@MaynardTT1	human
@ThePerchLV	human
@GreatFoodLI	org
@Qmaria	human
@Rynosaur	human
@deerparktavern	human
@listentosalt	human
@THE_ONLY_JCALI	human
@Tr0phy_wife	unknown
@ymountainlodge	unknown
@JyhaLee	human
@whimsymilieu	human
@GardenCourtaz	unknown
@Ksnt0917	human
@skiedreaming	unknown
@jonaustinm	human
@CordonLim	human
@MaikoSucich	human
@naascatzh	unknown
@BerLineCasillas	human
@lauriedoa	human
@iLovececiLLe	human
@setyaniKHS	human
@VIBE_ub_apple5	human
@VanillaCaramelz	org
@PersiaRed	human
@FitFanGurl	human
@bap_uk	org
@Jayalldayaka1	human
@PieceofCakeBak1	human
@Rafaeluxa	human
@JessicaDawn1985	human
@ChyazSamuel	human
@AusilioD	human
@bobbysgarage	human
@iqasuhailah	human
@cornettmsusan	org
@MandyDempsey	human
@CarlinaJiM	org
@OkkaNH	org
@mancath	human
@ocean362stj	org
@Crystalyap_1216	human
@SharonCreelman	human
@ayanoishihara	human
@1TravelParadise	org
@fatlosskev	human
@RoxaneDion11	org
@flashyteatz	human
@o3o_qqq	human
@KidChefEliana	human
@trustatement	human
@ZayconFresh	org
@bot09200900	unknown
@ezgice_	human
@tonneri	human
@RepublicTakoma	human
@vachaki3140	human
@cookingcorps	org
@buttersvelvet	human
@DaveenChadd	unknown
@Blade_theDJ	human
@thelittleteahse	human
@jmj92	human
@blogallmake	human
@azyellaitis	human
@giouin76	human
@OldBankHotel	human
@LeraSandholm	org
@mrconcha69	human
@yomiya	human
@daisyfrancesca	human
@TheDistrictHA	org
@immuneApps	org
@RickFarJa	unknown
@Ibarras21	human
@lowkaret	human
@YouNextYear	org
@richmondsshop	org
@TheJakehole	human
@TheRealFlanders	human
@pajamacompany	human
@coupdepouce_mag	org
@fionathm	human
@PeeplEating	org
@akipur	human
@UrskaOrlic	human
@NOSLEEPgetmoney	human
@WadDaFad	human
@CathyChrisRowe	human
@Freakynandez	human
@RobbieOkada	unknown
@VinPlusID	org
@saykallo	human
@sh_ble	human
@aldondri	human
@MsMissy62	human
@JBarbieJulia	human
@iamrenzoperalta	unknown
@adrianajanovich	human
@marie_voo	human
@HealthyChefM	org
@NaomiTekst	human
@aceworldtravel	human
@sansan933	human
@mattwinward	human
@ruth_hare	human
@VixCrease	human
@euphoria_tweet	human
@yew_kwang	human
@Divarcee	human
@irynastorozhuk	human
@papao_paoo	unknown
@motog11	human
@OCPpittsburgh	org
@CCuisiniere	org
@chefielancie	org
@EmmaUngurean	human
@Zarrarawi	human
@dj_precision	human
@atyo_n	human
@ChefSmo	unknown
@KoniginKat	org
@emmyburns	human
@sedderr	human
@CraigHarker87	human
@HyattBham	org
@Youngwezzy856	human
@IvyBakery	human
@nanase6	human
@FedericoScavo	human
@missy_tp	human
@ElizBarbone	human
@Thamawat	human
@yoshi_7_prv	human
@justmeuae	human
@elisaegil	human
@gardeningbyvr	human
@JennSandra	human
@pawcatalan	human
@play_buzz	human
@ridzuan_rahim	org
@body8build	human
@xandraalejo	human
@AlyseKimsey	human
@mmsuperflyjr	human
@abitabitch	unknown
@_Marta11_	unknown
@MAIMUNAH057	human
@iShedJ	human
@Irish_Bee_yitch	human
@maviicp	human
@andreadjemat	human
@MurrellsCafe	org
@panda150	human
@theRADhero	unknown
@SquareOne_DF	human
@KeziaHallHealth	human
@ZoulFalak	org
@chloediane	human
@XxMangelBxX	human
@DocsPHL	human
@veglite	human
@ShawsTavern	org
@ForkandWrench	org
@AmericanSlander	org
@TheMakFly	org
@VQuynhAnhNguyen	human
@bethanlouisefry	unknown
@anton2o	human
@Gilchesters	human
@LexCiriaco	human
@1127yoshie	human
@v_dallacosta	human
@renai_XGpSs	unknown
@moralesenid	unknown
@HannekeMegens	human
@Mollie_DollieXx	human
@getFlavour	org
@rebelforlife92	human
@CoconutCartel	human
@KoiEvanston	human
@VladRaymond	human
@witchgirlmai	human
@640Meats	org
@LarJphotography	org
@IcklePicklex	human
@sharonLove91	human
@embryonicboy	unknown
@RebeccaRennt	human
@HotelAthena	org
@ThomasSchmider	human
@growthadvocate	human
@vmonique00	human
@admartinezjr	human
@_INhousechef	human
@07Pengz	human
@RYTT12	unknown
@myChiswickLive	org
@GabyMarchand	human
@italianbark	human
@CazMinx	human
@MovenpickDeira	org
@JiselleJ	unknown
@emmaruri	human
@atallbro	human
@MShahab	human
@IPP_store	human
@mvictoriabandb	org
@Takasimakaito	human
@iconsiglieri	unknown
@LeisureTimeRV	org
@AmVIPloy	human
@PF_Sheryl	human
@German_Aponte	human
@xXxn00bK1llA187	human
@rosa_cinque	human
@RiiiitamXxxx	human
@tjakrakembang	human
@NabeNoms	human
@putriangraini14	org
@Mapefoodservice	org
@DeelichusPoison	org
@LucieJones87	unknown
@sammythebrown	human
@Fitcoach24	human
@InstaKramatorsk	human
@hi_rafa	human
@bloodyangel018	human
@swag48plus	org
@SoulCycled	human
@ngoreilskin	human
@le1207	org
@LaurenWinter99	human
@WorkingMomMagic	human
@SerenaTxlin	human
@daisukei6	human
@undead_q	org
@ChefBradSprad	human
@DentalsUK	org
@betatran	human
@HadschiB	human
@kasarkissian	unknown
@melody_low	human
@AndresFBoho	human
@jadedaryl	human
@FruGulbrandsoy	human
@irmasKG	human
@ABK_Runs	human
@CookingParties	human
@spiralizers	org
@cyfranz	human
@Confectionalism	human
@Jessi_lou_87	human
@DJB_Rock	human
@SophieHeron	human
@MTROUTcom	org
@NixSanDiego	unknown
@Tanielle_Powell	human
@j_eating_around	unknown
@Ramybargz	human
@rileymacek	human
@KellyQuinzel	org
@ayunibasir	human
@hestihasty	org
@ChenZana_Za	human
@DMVMayHam	human
@eatsmypleasure	human
@Noshyxe	org
@AihaaSulaiha	org
@Houdaofficial	human
@TheRowNashville	human
@bebekpudrasi	human
@KAPSLOCKISON	human
@Superkronik91	unknown
@akihiroactor	org
@ashypoz	human
@RMG_Qatar	org
@rchaks	human
@kevinvillaera	unknown
@_JayPluss	human
@mspyt__	org
@HusranBuz	human
@CarlosManaca	unknown
@parkvillehotel	org
@Muireanns	human
@whatsgoodtodo1	org
@Singing_Kat	org
@BrandiHong	human
@hatchandsons	org
@MaslakSheraton	human
@Lakeview_Lunch	human
@Ailis_Macc	human
@stevedolinsky	human
@kaitlinram1003	org
@The_Teahouse	org
@tomatom	org
@Tara_LDN	human
@tessposthumus	human
@hughtheteacher	human
@MonteCarloSBM	human
@LeyasCoffee	org
@JamesMiles82	human
@MargeenHolemans	human
@PMEventsBali	human
@marocmama	human
@_XtinaKristina	human
@knucklehead1989	unknown
@LittleLadyCook	human
@blaizstyle	unknown
@Seanmarine	human
@RobynIsles	human
@nirmala_edith	human
@Mariumshj	human
@Firm400	org
@Derby_Arms	org
@WenkywitchHere	human
@photochan2511	org
@AmelianTips	human
@LyanaSu	human
@DorkGazmik	human
@GwynethT1	human
@Paulynou78	human
@VivaPilates2012	human
@RelishToronto	human
@GSF_Grrrl	org
@Hambistro	human
@PizzaNola	human
@QuieroAmarte_Te	human
@Saraveza	human
@nattsu_82	human
@thecrepekitchen	org
@schikiki	human
@executivebhabes	human
@Puspa0208	human
@beyond_thevoice	org
@RubellesMoon	human
@novianiyessica	human
@Eddy_Rosales	human
@Sportsgirl26	human
@Barna_Chic	human
@Fresh_XinXian	unknown
@callecat	human
@SmallVIEL	org
@pageater89	human
@YaGirlChi_Marie	human
@goodshoeday	human
@Clerdy	human
@vintagelynz	human
@EnresM	human
@threadhop	human
@lisa_alba	org
@Naturenutlady	human
@detlistener	org
@tinyhands	org
@iamallanlainez	human
@CaramelGyal222	unknown
@DouglasCoMoms	human
@iAmButterflyG	unknown
@JustAnthrFamily	org
@Victoria_Lima_A	unknown
@Miatriks	unknown
@MadGourmetCook	org
@harrithomas	human
@zeetalibriani	human
@Elizacasanv	human
@DublinMSB	human
@lisellez	human
@bearbops	human
@Pezdj11	human
@boniflorjoy	human
@CatTBowen	human
@iam_yuri_hello	human
@riskle	human
@OficialmenteAMi	human
@vanessa_Alema	human
@total_produce	human
@WavesnCraves	org
@easyjanjansen	human
@DanelleJohns	human
@alison_kaizer	unknown
@Tim_Coggin	human
@ecoinn	unknown
@TandTNutrition	org
@lilianasanti	human
@UpModernPGH	org
@JackyKow	unknown
@nicolasdelisio	human
@LGSpike	human
@checogutierrez	org
@Jikilini	org
@MarkusHilmander	human
@jushrooms	org
@BeccaSurf22	human
@diva_dressage	human
@sarahmannersx	human
@AmysAtGatwick	org
@FFBCN	human
@lovesherylc	human
@nikroybal	human
@EstateStephward	org
@ClassenCurve	org
@BeanAndBud	org
@2JiveTurkeys	human
@OISAramen	human
@AxlJFoley	human
@lipstick_1985	human
@charityjohnston	human
@LeighIngham	human
@mizkinggggg	human
@khibz01	human
@ranoadidas	human
@E_Mayne	human
@DxMatilla	org
@shooguy23	human
@racquel_brooke	human
@kayjay1968	unknown
@inesmasantos	human
@ArborpointSS	org
@tsubuyaki30rou	human
@sarahbrittany	human
@Erikastar	human
@djbuddhaTX	human
@andieestella	unknown
@anggita_adellia	unknown
@CherryAdj	human
@soverydomestic	human
@VvianJ	unknown
@SpaghettiKtchp	org
@VincentALaw	unknown
@manlikeman123	org
@MrMomUK	org
@TCooksPhoenix	org
@spoliedazz	human
@Marioninfernale	human
@TrpdInAFatChick	human
@alexrobinson77	human
@ddneroxx	human
@shivaanastasyaa	unknown
@BSlimTouch	org
@pinktastic615	human
@perpetualself	human
@MACOHAC	human
@angie_kv	unknown
@The_Tweatery	human
@FoodDiscoverybx	unknown
@SMmamashack	human
@joko31	org
@sweetsnbitters	org
@BIOEventsPR	org
@srididieTM	human
@KenjiKikawada	human
@hysmy5	human
@muncheeys	human
@ISTANBUL_THEMES	human
@airwindzone	org
@1YouLuv2H8	unknown
@kellierose914	human
@willempiee	human
@18kari	human
@HealthCounterUK	org
@ihmo0od	human
@lucasviceente	human
@kolkatafoodies	org
@IlanaDevazier	human
@VogelsbreadUK	org
@osmondphoto	human
@MedrandaAndrea	human
@unutkanzenci	human
@cojapacze	org
@breadandbarley	org
@rachaelsforster	human
@gatherandfeast	org
@thecatsaysmiaw	unknown
@dmagan	human
@Girl__Melanie	human
@NorthMandyXXX	human
@hedlingo	org
@Boquiaches	human
@sezgisahin	human
@theprolificoven	org
@rachaelcasey	human
@SittingPretty24	unknown
@janeya45	human
@Sydney96Go	human
@yOfelice	human
@tiwiteawul	unknown
@SaraAlHammadii	human
@HearthstoneLV	org
@ichbinnicole	human
@MyLadyLexi	unknown
@DrewSarmiento	human
@mikichung93	unknown
@DistinctionHR	org
@Steph_alfaia	human
@BoozeMenus	human
@TheRealKyleOrd	human
@MikaKaye	org
@Ivan226622	human
@prinerin	human
@azrulazim	human
@iAM_superhuman	human
@little_baby_d	human
@SeanMeehan96	human
@Madamefigaro	human
@Metrosuperstore	org
@blakserian	human
@naosshi	unknown
@ChocolateBoxGB	org
@MartitaMG	human
@SenorFrog	unknown
@DiYelSy	org
@WCFranklinTn	human
@love2style_com	human
@Cafe3132	human
@chefcolletti	org
@plushlootz	human
@Cinderellchen	human
@BLUCONCIERGE	human
@mikehiller	human
@wijaya_hendry	unknown
@onyxqueenmedia	human
@heyitsme_ika	unknown
@JfaaOfficial	unknown
@sandeemomof3	org
@TheButterflyNYC	org
@TRACEAtlanta	org
@outofficeagain	human
@MsJayC327	human
@fly2steakhouse	org
@timmyhlee	human
@gabe78	human
@ericajayrun	human
@HanzyFish	org
@WellbeingTester	human
@FSNewYork	org
@StarlyMoon	human
@DAJANELL1	human
@CCGrill_Orlando	org
@HorticultorJJR	human
@RonPoster	human
@arora_ateh	human
@TeamSchuco1	human
@ThaSenior86	human
@Sofi_Sheppard	human
@djshandy_jpn	human
@EliseShrock	human
@Bradshaw_Inc	unknown
@Rafael_Graca	human
@IVminoVII	human
@AmazingScorpioK	human
@JDildineMusic	org
@SlimmingKitchen	org
@Abevu	human
@trevorhanson7	human
@damoseoane	human
@OmdetZ	human
@gpstudiosforli	human
@timeandleisure	human
@RyeHamletHub	org
@jackster_93	human
@gocircit	human
@Shruce_Vic3	human
@ZaquiIkaika	human
@bellissparrow	human
@stephyabut	org
@Changing_News24	unknown
@Young_Fame11	human
@iSoyAbraham	org
@Krusteaz	org
@JCGoldenkrust	org
@JenDotDotDot	human
@G_Liberty_Voice	org
@whitswonderland	human
@geanutorres	human
@inBEKASIcity	org
@Marketitalia_it	human
@dustinandrew	human
@Nourishing_Soul	human
@coffeenumber1	org
@TheLisaDavis	human
@jadajakys	human
@DelsKitchenNYC	org
@nf_ric	human
@HopeJasmineM	human
@HungryGoddess	human
@DeelishLife	unknown
@Naiz_life	unknown
@ClaireJedrek	org
@yeeeeeehaw	org
@velazcomitzy	human
@ashleabrittney	human
@CQ_HQ	org
@xshiyax	human
@nataleegosiewsk	human
@cherrypuffgirl	human
@Groveland_Diner	org
@TerrasseDuPlaza	org
@DeAngelisCorey	human
@alittlerosemary	human
@dhegracia	human
@zety_mell	unknown
@samedi50	org
@RinzRihanz	org
@GaryPow3rs	human
@aaronbeckhouse	human
@thispilgrimlife	human
@AshniVara	human
@AgusSaiaa	human
@DiMarkcoChandle	org
@SeasonsOnlineAu	org
@frauvomsee	human
@aqsijason	human
@mariamfantastic	human
@kurtphoto	human
@perasoho	org
@TheJackBarbosa	human
@AdriaticDesign	unknown
@AshleyGAguirre	human
@LOOTSKING	human
@MinellasDiner	org
@tomality	human
@duvalcountyfl	human
@Yunyura	human
@ItssMrsParker	org
@caramelcutie808	human
@Korbel1882	org
@ThatGuy_Ruben	human
@LorenzoDuarte	human
@RitaSpinola25	unknown
@DanCas2	org
@davidkeesman	org
@Cathie795	unknown
@TrefPorthmadog	org
@ThePatioSD	human
@Oitsjohnny	human
@4pureandrea	human
@Tombitchy	org
@nCriesto	human
@etboxx	human
@EricRosenLA	human
@CuriousFoodStud	human
@xingkeeth	human
@RoxanneChand	human
@Joweesantosgwen	human
@tintindanao	human
@0riginalSubzero	human
@AdamNel91305169	human
@koppertcress	human
@lorainepatdu	human
@antonioluisi84	human
@MP27_	human
@Gastronomblog	org
@morganjodie26	human
@juncothebird	human
@BallAriana	unknown
@LuxuryVisionary	unknown
@Lalalaineyyyy	human
@WhiskeyProv	human
@eatroastbeef	human
@AppSEOMobile	human
@IamJunnn	human
@viki_mi	human
@littlebeet	org
@FollowbackQuark	unknown
@amied027	human
@xterclaude25	human
@ChefnBar	org
@GlennTebble	org
@Junardy_xu	human
@skinnyseeker	org
@NeverTrade2013	human
@Kidlutions	human
@itsAmandaNoelle	human
@theorbitapp	unknown
@ActualFoodNash	human
@kingrichtilacas	human
@faizairmac	human
@BhaktisBanter	human
@kissme_xandy	human
@NicolaYeager	human
@amchonticha	human
@mspalesalebona	human
@HBrisasCaribe	org
@Sebastianosfl	org
@chintuchatora	human
@rubenvasquezjr	human
@almalexisesh	human
@ACE_Bakery	org
@renefaustin	human
@Schillecis	org
@basarat	org
@RetroGamerProbs	org
@andimemma	human
@PayWithGather	human
@glorife_s	human
@DreamMidtown	human
@riaangeorge	human
@iampatriciaaD	human
@mylifefoodfight	human
@shelleyhayashi	human
@logansroadhouse	org
@swellmayde	human
@Fa_Aalia91	human
@fabianngxz	unknown
@KeeImages	human
@fernandroid33	org
@Xnoii_Bigboy	human
@DaveMcCormick	human
@ylest	org
@deana_chyntiana	unknown
@wrfarmca	human
@Antarazandc	human
@FittieLovesFood	human
@Blue1Boutique	org
@sojimbo	human
@UNITYRADIOFM	human
@SugarLovingLife	unknown
@eatdrinkroyal	human
@Theflipmasters	org
@JoeSentMe1	human
@siansplan	org
@BBofWexfordPA	org
@MorinEarl	unknown
@shiyuanng	unknown
@readingbookworm	human
@PunkGoneVegan	human
@PointlessII	org
@ChynoFuturistic	unknown
@dawn060861	human
@ArturoTT1	human
@YevanyBerry	human
@vijaymohanp	human
@LayMyKitty	human
@magz15imp	org
@VNOVEER	human
@lisacohen	human
@juiceplusmumo5	org
@wiffee01	org
@sanjeetakk	human
@BellaZulyyy	human
@Shoeville_KL	human
@bwdaly	human
@B_GADDY	human
@15ways_happy	org
@AdrianAmiroSo	human
@vlad17	unknown
@_noonie_kakes_	human
@SymriseNA	org
@Bobmyntmedia	org
@cmebaxter	unknown
@saiyew	human
@NannaB95	human
@iTs_LiLBiT	unknown
@WestThirtySix	org
@jackiegoranson	human
@surreyedit	human
@lauramacdougal2	human
@intervistedalmo	org
@BSnbby	human
@SweetPumpkiN	human
@kellyapearson	human
@brittneym068	unknown
@Carmela603	unknown
@jermi3istitch	org
@morozy	org
@feedingjoy	human
@Raphyde	org
@BarbRuhsRD	human
@KosherArtisanal	human
@woolybobs1	org
@FrenchCook	human
@ipeatmon	human
@RestaurantCnct	org
@davidleite	org
@dukeofsomerset	org
@MarinaSpica	unknown
@turkodru	human
@KibichiRawFood	human
@Discovermoreish	human
@savvyspreads	unknown
@cityQuickerNYC	org
@IyaiishaR	unknown
@LulukinsKJ	human
@VAYDJ	human
@miss_eddie	human
@JoeMaristela	human
@emanueletodisco	human
@QsQueenFe	human
@MangoTomato	org
@marcelmorilla	human
@Piotrski	human
@LoriLeal1	human
@daniekasari	human
@PeepsLondon	org
@YenderZambrano	human
@thomasphantom	human
@NicolaBenedini	human
@ImTroubleLing	unknown
@Victor_Whale	unknown
@sthefyvil	human
@stefalufagus	human
@SugaChef	human
@returnofmisterv	human
@Eduardo1_Ala	human
@JustinBozGroth	human
@david_rash	human
@chinadoll20047	human
@NutritionalaNat	org
@FatemaAjab	human
@Changing_News21	unknown
@winesdomain	human
@Mikiro_Hayashi	human
@enany22	human
@SimpleLivingEat	human
@FreedomHWeekes	human
@mookie_alive	human
@guestofaguest	human
@bshayjones	human
@_FancyyyNancyy_	human
@Rachael	human
@jorse2646	human
@debuurtboer	org
@Cassie638	human
@OSheasPubWPB	human
@Naka_chan813	human
@Nancsue	human
@OhMyGrandeo_O	unknown
@BaharGngrTorcu	human
@BabyDsDeli	unknown
@Jeremiaaa	human
@Innovacia_Biz	human
@MikkoKia	human
@wasabi_room	human
@MidwayHealth	org
@silvia_chien	human
@BRGRwagon	human
@DpAnnelies	human
@TheDR89	human
@NaturalVrouw	human
@Tim_envy	human
@coleentan	human
@wulynne	human
@mikahara87	human
@elnana	human
@WitchOfGombak	human
@russjavier	human
@ronaldpint	unknown
@LauraJeanetteXo	human
@CES_83	human
@luvMichellexo	human
@247beep	unknown
@eceyildiz7	unknown
@LasVegasExpress	human
@jjmax90	human
@Fang_Taro	org
@Tuterlay	human
@ADHD123SUE	org
@osara	org
@copasycorchos	human
@Definiteproduct	human
@carpediemspanje	human
@himechar	human
@LizChris619	human
@redbievalles	human
@laschicasxampi	org
@daniellawhite00	human
@post_manager	human
@HungryBells	org
@5oclockfunnies	human
@DominicHero2	human
@Youmiam	org
@mir_ela_	human
@YoHobbyBerlin	org
@viraputrinovi	unknown
@EmmaJChan	human
@sdotjohn	human
@LulaShopParis	human
@gbh999	unknown
@Ekl_Rose	unknown
@Guisados	org
@uscscott07	human
@GardenCat	org
@SpeedHan	human
@iam_tiadanielle	human
@NutriBeautiful	human
@Eleby	human
@BardotCafe	human
@GracieBooBooHo	unknown
@IrieMi	human
@StyleandTrouble	human
@from_garden	unknown
@SuperV_713	human
@Teeero_Teeero	human
@pogingmabagsik	human
@Jidapalittleji	unknown
@itslondonpark	human
@cookdrinkfeast	org
@JoBlankfield	human
@chibialfa	human
@Team__Caroline	unknown
@GetYourDailyFix	org
@HesterGersonius	human
@berrymtr54	human
@chezevo	human
@communik8e	org
@PromoMasq	org
@queenrachelina	unknown
@keenrod	human
@eva_maulidi	human
@_bunnn	org
@abdullah90q8	human
@Lady_Nyla	human
@mariella819	unknown
@CamilleCamellya	org
@jd_adler	human
@ymunng	human
@VisitDetroit	org
@SFrancestweets	human
@Beefareeno	human
@DTNashEatBeeps	org
@PetrossianUAE	human
@AmandaYSH	human
@AdeLiriano	human
@cparrey	human
@KyraGla	human
@alanlaw217	human
@BLOGBeautyMania	human
@coba1005	human
@whatsinabag	human
@LeandriDeKock	human
@Pays2Save	org
@kutbox	org
@Eatwell101	org
@itsmostlyokay	human
@eduardasousaL	human
@HB_UAE	org
@BiebsToMontreal	human
@kidkidian	human
@LifeLuvLiz	human
@NORMA_2_HOWARD	human
@chloelambert	human
@sena_idrisoglu	human
@Akeem_THEGREAT	human
@hpunktanna	human
@SUPPAH_SOAKER24	org
@brunsmx	human
@thesmashtruck	org
@lovelivesongs	human
@radhikamohta	org
@Classlicity	human
@littlemonk85	human
@travelinggreece	human
@annieperkin	human
@FJ_K19	human
@CrissyCrisXOXO	human
@HeyyoEli	unknown
@FORNObaltimore	org
@fantasy_5	human
@chrissycchung	human
@clairehelene7	human
@anjelajohny	human
@mimu_matsumoto	human
@TJQuinan25	human
@SiscaMelliana22	unknown
@gbeejipp	human
@federicoquiroz	human
@yoanna008	unknown
@kopioeyjogja	human
@M3_Glam	org
@caplongz	org
@countyaycliffe	org
@laauravictor	human
@DaneelBester	human
@Shoneys	org
@mtlguy1982	human
@MirraAmira	human
@kasbahrestos	org
@kn_Lming	unknown
@cizkangga	unknown
@Glenda_Jensen	human
@Lanudry	human
@UFashionS	human
@dani301195	human
@FMBrook	human
@DrMAITHA	human
@dayma28	unknown
@MaeWednesday	org
@CaribbeanAccent	human
@AshDeaNiseLee	human
@WallaceAurora	org
@AnggiMaulanaNst	unknown
@desertorossomuz	human
@stefcolburn	human
@Birdy67bird	org
@AnetteSoiland	human
@Capofitto	org
@TbirdInn	human
@PORSCHE_MONEY	org
@JamaellaSays	human
@247Preapproval	org
@StateOfGeorge	human
@glorie92	human
@ilovemybeagle22	human
@Luxuryshoppers	human
@darenjavier	human
@rise	human
@hedonist81	unknown
@yasmeenhussain7	human
@pamelacatalan	human
@TheTasteLA	org
@drew7167	human
@ABODEBistro	org
@WrawpFoods	org
@Anncredble	unknown
@koppertcressUK	human
@JosephineOn12th	human
@lakesman_1	human
@drsailablog	human
@marthybenitez	human
@JangoZilla	human
@walingly	human
@FoodUrchin	org
@mrugziee	human
@rayn_ren	org
@HjDino	human
@AddyInStereo	human
@MarleahMakeUp	human
@MBdiningOut	org
@soschka84	human
@downtowncalgary	org
@mturner81	unknown
@brook_london	human
@Hijablicious	human
@IdaChua	unknown
@burningzoneclub	human
@TheOCI_NJ	org
@EatDrinkRunFun	human
@dit0045	human
@ShenKitc	human
@PresJrCouncil	unknown
@CharlotteLmy	human
@SNcafe	human
@PatySilveira85	unknown
@CarpeDiemRun	human
@Food101Atlanta	org
@beaver04maeba12	human
@Pe4RL	human
@fuldenyildirimm	unknown
@JohnCalloway	human
@bigcrowbbq	org
@Messina_Hof	org
@thoughtoverchai	org
@visitperth	org
@arctichamster	human
@jambyfan	org
@FeeonaCarbonara	human
@Moor3s_Code	human
@ScarbTO	org
@AllNatural28	human
@emilyannwilson_	human
@fr3d_d3rf	unknown
@JOKERholiz	unknown
@ImSaraKing	human
@thedipnchip	human
@chii0221	human
@x_Anna_Molly_x	human
@LeilaniBumgarne	human
@chambo85	human
@Seeppaa	human
@camilloramirez	human
@PreteMoiParis	human
@marlboroughmall	org
@photosantucci	human
@The_New_Village	unknown
@joeleo078	human
@discobop	human
@_justani	human
@Jheinbuch	human
@ncrystalicious	human
@YedaSilviaDias	human
@village_print	human
@KillerRezzy	human
@JuJuBabyWorld	human
@k3shtk4r	human
@MrsBrown1280	human
@ShawndaCammack	human
@SairzMarie	human
@RedWeirdRose	human
@jlguerreroarcos	human
@ocanabcn	org
@ChefBigHam	org
@itsmeayan0911	human
@Mighty_Mushroom	org
@MiskehDubai	org
@CarCubillas	human
@_DOBINC	unknown
@kevinsash	human
@RealH3ndrix	human
@Patri_Mastri	human
@heasal87	human
@eggharborcafe	org
@maeka_vasquez	human
@SocialAlertsLV	org
@KitchenDreaming	org
@NookAtlanta	org
@shugogy	unknown
@Cooking_Priest	human
@PriBailarina	human
@WallionsCOM	org
@RICARO_SANCHEZ2	human
@WholeKidsFnd	org
@xLittleLilyx	human
@MorganizewithMe	human
@raquelazpiroz	org
@katerinoulak	human
@lifeactually_	unknown
@JairoJoseL	human
@Nightowlmama	human
@amerjit	human
@chuudre	unknown
@northerncali1	human
@Franc3sca_Marie	human
@singleeciuos17	org
@eatloveraw	org
@TheMintAgency	human
@yok107	human
@Bistro33Moncton	human
@PetitGourmetSD	org
@twinmonkey181	human
@cazfromwp	human
@simplyricah	human
@thereisoneM	human
@ArgonautResins	human
@walk1961	human
@Keiih	human
@KhannaOnHealth	human
@100MWiregrass	human
@FemkeVrij	human
@ThePiePatch	human
@ILeyden	org
@MarthaAntoli	human
@decaChicago	org
@marilynnntai	unknown
@S_mariela	human
@Aymansview	human
@ECOnotEGO	human
@nadinenocero	human
@totallysedated	human
@libbylimon	human
@hereisthecity	unknown
@RezaRamdani91	human
@RmMoraza	unknown
@FraserSuitesDXB	human
@jaja_zayas	human
@oliv01	org
@RutaAndrea	org
@ChefYos	human
@Chateau_Saigon	org
@Blue_Sugar_Cube	human
@eatthisft	unknown
@SheldonAYS	human
@margauxsalcedo	human
@BirchLane	human
@shereewrapsitup	human
@JhaBeaNation	org
@EvyChampagne	human
@Kismeture	human
@emospringdaisy	human
@chikae0116	human
@quintenguest	human
@JontaAguilar	org
@amrlhfzhmd	human
@Bella_Ilievska	human
@thegardenhale	org
@8angelsNdemons8	human
@000079Jets	unknown
@CharlotteBurb	human
@ErnstSnchzz	unknown
@henna_rnc	human
@yoginicuisine	human
@GasStoveGirl	org
@NaedNutrition	human
@TABLEPOSTOAK	unknown
@ManzilDowntown	org
@iamchristiaan	human
@Theressa94	human
@emptyplatesblog	org
@MyChefricky	unknown
@MsIngridB	human
@northvalley	org
@trayjayh	human
@singerg2	org
@Motivate_Mi	human
@meatballsand_co	human
@Mishy414	human
@ChiccaRox	human
@rheanne_italia	human
@sailisally	human
@daves_pizzas	org
@KempiDeli	org
@designdever	human
@TweetTheBasket	org
@madgepineville	human
@ttt6990	human
@AyCupcakeHer	human
@zorbash	human
@starcrossedsmil	human
@marielalex	human
@framignemi	human
@Amanda_Pilates	human
@daniellehilker	human
@olazzo	human
@ZacharyGerow	human
@countocram	human
@hassetgo	human
@sarahekoontz	human
@globalexecplat	human
@TahianaJmusic	human
@WhatLayneSays	human
@lyshelly_	unknown
@Smustika	org
@xoTravelholics	org
@susan_chau	human
@AldoGraziani	human
@a4adrama	human
@OctoINKasa	org
@ImproveYou2012	human
@DragonRollGrill	human
@Mom2RyliePaige	human
@_Alethia	human
@Vancityweddings	org
@YaVonny	human
@sitinurfaeezah	org
@geeendelacruz	unknown
@CelebrityBarber	org
@Javier14Deval	human
@teriahkee	human
@RaghdaElSaeed	human
@RicardoSulbaran	org
@Chamberlainsldn	human
@justmin_les	human
@budzy_glory	human
@ChrisRalphCruz	unknown
@CynthiaCan	human
@faragoig	human
@willastout	human
@Naii_Vieira	human
@ScarbellySouder	human
@HippieHooper	human
@1loseweightnow	human
@SaludToday	human
@BrownsBristol	org
@wakabadisney	org
@CeezP	org
@ConBotasdeAgua	human
@LaCHFoodies	human
@Kaushi_v	human
@afiffarhan28	human
@pilipilates	human
@triclairatops	human
@tatsuki_314	unknown
@FSMumbai	org
@azmeer_meer	human
@ChivazG7	human
@secksy34	human
@carlottabarsa	human
@NorthLainePub	org
@yicong1	human
@VaatiVII	human
@samsopzul	human
@n0lh	org
@realcroney	human
@emildillera	human
@KimmieAndrew	human
@AmyJane11	human
@UnionSocialDC	human
@Bleeky8o8	human
@sneezylisa	human
@GeorgeKousouros	human
@trisiaanggra	human
@myfavfoods	org
@remarkableryan	human
@hendyo	human
@AmberRhea4	human
@mdlle_Coco	human
@FMGSurrey	org
@Rox_sarmiento	human
@scottbyoung	org
@fregosoinc	unknown
@eatcakenbpt	human
@oracle33c	org
@motutw	human
@laceibacocina	human
@MriKri	human
@Yuichi_Y_JAPAN	human
@KosherStories	human
@MirnaliniV	human
@OneNOnlyAlice	human
@ash_talks	human
@SexiAsStallion3	human
@DejaVuSweets	human
@Lalaloviinmej	human
@AberArtisans	human
@nrmcfarland	human
@BurlesqueChef	org
@jkissling	human
@karlaraphail	human
@yteetannnnn	unknown
@kimberleyshowes	human
@LyndaMSelf	human
@aprillia_widya	human
@Ms_diGgs1219	org
@tannyzippy	human
@AsellinaATL	org
@UareTalented	unknown
@_Turpinator	human
@ItsLeannaBee	unknown
@scoopandsavour	human
@ParAvionTea	org
@Webb_Alexandra	human
@Chechopanda	human
@JesseniaGiaimo	human
@sexyfoodbyme	human
@johnrayos	human
@jobel25Julio	org
@partaste	org
@3fortheshow	human
@Hyghgynx	human
@richieshan	human
@ElMilagrito2	unknown
@hotmamabodywrap	org
@Chi_add	human
@DMFoodster	org
@jannaletyagina	human
@MSsimpauco	unknown
@CKellyAllen	human
@KarNish_Fc	org
@wagamamaireland	org
@enlailiacevedo	human
@yuurichanword	human
@BusN	human
@livingtheBS	human
@RockinWellness	org
@SYED_HAMIZAN	human
@RedPeppersBham	org
@WWannualleave	human
@sofia2012	human
@hethler	human
@mysafetyfirst1	human
@LifestyleFoodie	org
@Ansam518	human
@Love_Watercress	human
@mikeeecharm	human
@CltFoodieFriend	human
@Sumee_xo	unknown
@shalandassg63	human
@MargHeinemeyer	human
@kidaGK	human
@ProjectChillTwn	org
@Giana9	unknown
@she_ass_ush	human
@PinayFlyingHigh	human
@PoneMamboEnt	human
@FelipeAoiNeko	human
@JoStamey	human
@almusaad	human
@anitacastano1	human
@beckyquan	human
@tanbyshan	human
@Mei_potties	org
@VeggieVegDays	human
@TheCedricFerrer	human
@ElGuapoBitters	org
@RylandPeters	org
@freebie_app	org
@TambotiL	org
@davidkristianto	human
@glitternova	human
@ainunaqilah	unknown
@EzgiiOzcan	human
@TeshKaur	human
@JS_Golffy	human
@BeesKneesCafe	unknown
@ehopefulton	unknown
@Natethoven	human
@Camilles_Destin	human
@LASTCHANCE4LUV	human
@JosephSlaich	human
@La_Myoden	unknown
@adrphotography	org
@dv_vb33dv_vb	human
@cjrthemamiblog	unknown
@ashleylytwyn	org
@MehTaPpkse	human
@LMenBjm	unknown
@HernanArriaga	human
@biteandbooze	org
@dehog	human
@DublinByMouth	org
@mw112233	human
@4474goto	human
@PaulaStaal	human
@AmRiE_oLiSuE	human
@melsoswt	human
@RanaNYC	unknown
@HParece	human
@aien_banin	unknown
@ZoyaMon	unknown
@FANATICALLYSICK	org
@M_Stonesifer	human
@AliaChristina	human
@davecarson	human
@DaftClothing	human
@subcoolture	human
@Diego_1920	human
@kayc024	human
@CoachJennGibbs	human
@KATHLEEN3ALLONA	human
@christientrinh	human
@ThirstyPig	human
@carabonnon1987	human
@tfcornerstone	org
@primalgrapevine	org
@Ewombles611	unknown
@ohiyooo2	human
@FrozenArctic	human
@deboradevyani	org
@popolicr	org
@TonicNutrition	human
@evelynblogger	human
@peperossosocial	org
@JulesMarie01	human
@BoKnowsMortgage	human
@cuxibamba	human
@BakeryHouseRoma	human
@kNamT	org
@thefashfeed	human
@bunny_lv	human
@ssony711	human
@kattyyou	human
@dentastic101	unknown
@mynameisjanah	human
@PieterPeeman	human
@Paulinesmillez	human
@charisexy	human
@MohdSidiAmri	human
@TheBeachHut1	org
@parukami1	human
@TurtleWineGirl	human
@ErlineBoer	human
@dcranon512	human
@UkTieTheKnot	org
@jackiemiranne	human
@MarchingKing	human
@HelloVoucher	human
@IAMjamesturno	human
@RHOODY413	human
@SeisKitchen	org
@aintchongdee	human
@iloveraee	human
@jeensgreens	human
@janisfineart	human
@fashionbloatz47	human
@ToastedOak	org
@MYolandaSegura	human
@HoiNingYau	human
@YBeNormal	human
@Nicole_Ponseca	human
@0livia_ko	human
@breeray129	unknown
@Steph_Christi	human
@kalap_makan	unknown
@magical_cure	unknown
@darylnick93	human
@guzdf	human
@goldfish029	unknown
@hivetoday	org
@superbafb	org
@Sarah_J27	human
@MinaMirkhah	human
@Kanyawat	human
@WestinChennai	org
@JarredLove13	human
@Brazilianhairs	org
@shiporing	human
@Cassandraaaa_1D	human
@LicoriceOlives	human
@JoserlitoGalvez	human
@914Social	org
@coolestofcats	org
@KaseyBThomas	unknown
@sarahleelaughs	human
@paulof_bastos	human
@Aisyah_Hafiza	unknown
@TavernOTCoast	human
@unicorniopretto	human
@HLP90042	unknown
@beckitrenouth	human
@diekuechenelfe	human
@meghanrm14	human
@morningoatmeal	org
@mondomedeusah	org
@LAHOUIworld	org
@lacookiecon	org
@ImSamSquire	human
@hugkazu	human
@paulikuosmanen	human
@AnnieBrown192	human
@jd_jakey	human
@Cyehlim	human
@WholeHealed	org
@CioccolataBella	human
@aGENCY_footwear	human
@MeiLin_91	human
@pro_breakfast	org
@lovelisaserrano	human
@bigjohnwoo	human
@cesspineda	human
@ManChingChan	human
@LazerLenny	human
@GhostKitchen	org
@Nhabitats	org
@AndreStelly	human
@Waids_	unknown
@KitiAli	human
@akenkanalang	human
@ViBE_ub_apple2	human
@runfargirl	human
@PFSaienni	unknown
@JoannemWoodward	human
@Vonnypurnama	human
@nerochaaaaan	human
@Melissa_MSSK	human
@InfinitiAgora	human
@Veronxveron	human
@ClosetFtGirl	human
@zyrene16	human
@repentantslave1	human
@AracelisT1	human
@MuscleMagpie	org
@ABODERestaurant	org
@TheRodrY	human
@ZekraZ	org
@DarrinOakley	org
@Faulko1	human
@indahngapung	human
@MintKetchaya	human
@MsTasha_Music	human
@Fathom_Sphere	human
@WeAreNashik	org
@DwayneZouL	human
@liewcf	org
@JeffersonDiner1	org
@swampynomo	org
@Catiee_Bugg	unknown
@yarocknwitdbest	human
@ORennanSantos	unknown
@IdahoWeightLoss	human
@Rachel_Jordan94	human
@HeyyNicolee	human
@MottoliniSalumi	human
@anime_5JaSV	unknown
@gozbike	human
@4EverBowleggz	human
@sapiredda	human
@SerranaBrava	human
@pgdanhiggins	unknown
@StealingB	human
@majidelbitar	org
@paperplanesca	org
@kanaearai0215	unknown
@irene_ifg	human
@Moore127Moore	org
@verifiedmom	human
@dondy	human
@zonyx1	unknown
@zeppy_cake	human
@BasidioCulture	org
@dezchen	human
@edgyveg	org
@bbcuppylala	unknown
@nesination	human
@jazminhunter84	human
@sophiecgrove	org
@LadySue13	human
@belinda_boadu	human
@DrinkBotan	unknown
@redsauceballs	org
@thrujackie	human
@emjieee	human
@SilaSriya_Stlye	human
@IliaceBallin	unknown
@MusicAndYourMom	human
@steffjharris	human
@jwong1209	human
@CraftsmenTap	org
@KellyKepnerPR	human
@timofnewbury	human
@meliciousmama	human
@InnsOfCharacter	org
@MJsHealthyWay	human
@SH000000TA	unknown
@maoelle1503	human
@Maretta88	human
@techycraig	human
@RaghunathanKand	unknown
@normdizzles	human
@JucyLuSays	org
@_ByAmy_	human
@CassidaZakari	human
@lmir9671	unknown
@TipnTagJo	human
@WickedDistrict	org
@NewellCheatheam	human
@momtograndma	human
@charles_leroy	human
@al_080392	human
@MattMarenic	human
@Va2NYC	human
@jimani	org
@PrilliCrl	human
@RedGravyNYC	org
@nancyabruno	human
@Steaminburger	org
@loukPllA	human
@peggychai91	human
@peterpfischer	human
@andzpoliarco	human
@DillonMcLG10	org
@OWTK	human
@BradSpill	unknown
@ch__Haruna	unknown
@Ozzy_zhay	human
@SofitelBahrain	org
@zhenping	human
@MYNAMEISKHANcdn	human
@yxiong2	human
@ChokCruz	human
@Vespa_Westport	org
@ChisouW4	unknown
@BarryBirkett	human
@TheOnlyApausha	human
@chevluv3	human
@sbizmarketer	org
@LovElla_PandU24	human
@queeniegavino	human
@Tt1Mike	human
@JayTThomas17	human
@TempleOfSmut	human
@gsmery	human
@ashlyn_irizarry	human
@Mayramendez29	human
@LoVinBo	human
@HuneyNguyen	human
@topdealretweets	org
@cetogenicaBR	human
@delyver	org
@Andhy_Putra_	human
@SaladWheel	org
@da1prez	human
@chiaGalimberti	human
@awgonnerman	human
@patriciazars	human
@piggyneo	human
@DevonHeinen	org
@sunterragourmet	org
@vodkaitsmeray	human
@FitMamaLaura	human
@UpTownWaterloo	org
@MelodyGos	human
@jaytherabbit	human
@leeandmaries	human
@Lovethemmilfs	unknown
@thatsky71	human
@tuongvi_	human
@premadepaleo	org
@yvesjohn26	human
@claudioleonipr	human
@MerindaAndriana	human
@mykidsfault	human
@JoshWiccan	human
@MarsLolipop	human
@IAMHIPH0P	human
@Basildontweets	human
@SERAPHIMFITNESS	human
@Edona_EZ	org
@sophiemos	human
@caffevenezia	human
@imGiselleMarie	human
@jennychuangg	human
@sandyfreetravel	human
@TonyMarque	human
@afshan_azad	org
@Blueeyes1504	human
@nitaread	human
@leonstulsa	human
@phoenixsomerset	org
@Alamaliceu	human
@Dee_De3	human
@FayeSassy	unknown
@TheFabulousOne	human
@ShellyHousel	human
@ClaireBoyles	human
@remo_siva	org
@IAM_VINAY	human
@iamrainiel	human
@WeDoItAgain	org
@keliipua	human
@Icarias1	human
@TheDukeW11	org
@EatShopLiveNYC	human
@WanderlustWomen	human
@neekers	human
@adcha_j	human
@ayah_so	human
@AlannaCabrero	human
@KireinaSweet	human
@Yamzter	human
@Boathousecanton	human
@Snowx2k5	human
@pacoadvertising	human
@lushwill	human
@igobyfrankie	unknown
@CandyMilano	human
@nenkgita	human
@OrtaniqueMiami	org
@ohyeahbaj	human
@healthnutpamw	human
@natural_mag	human
@angel_bue1	human
@dizzydianajo1	human
@MeandBells	human
@SSDhanhani	human
@Laurenadshead	unknown
@rubadub130isao	human
@AyannaT1	human
@AmiGraur	org
@cadis_mai	unknown
@DatSickBoy	human
@AshrafRahman9	org
@RealCamChambers	human
@gretachantilly	human
@rachelleyen	human
@HerculesChantal	human
@diane0418	unknown
@CosasDeRosa	human
@WordsAreFood	human
@KarenMarieHub16	unknown
@aserendipityspa	human
@NazOneHeart	unknown
@harbourviewhk	human
@Subriname	unknown
@adna_khanin	org
@Hilmond	human
@alexong77	human
@rufflesnribbons	human
@jakesdenver	org
@ItsJulianaC	human
@SalonsCarlosQ	org
@CityCafeLeeds	org
@EVITnews	org
@mimuluxArt	human
@Ammirrrr	human
@Eat_SF	human
@avannashop	org
@Ayari_Tamai	human
@SweetLilYou	human
@WiseMona	human
@ainbarney	human
@ed_madri	human
@Laura_kingdon	unknown
@Nhieylam	human
@wheretogoplaya	human
@Mery_Mycitytv	org
@sipwsocialites	org
@amontrique	human
@SaraCeballos123	human
@911IRENE	unknown
@coffeeshopvibes	human
@SabryHami	human
@EttoreFra	human
@123hypnosis	org
@healthyvices	human
@norazilahruhani	org
@Bluesician7	human
@vickytori	human
@dtzb	human
@Drink_Portland	org
@MedifastEastBay	org
@relishthetaste	human
@ministermom18	human
@CookingDiary_gr	org
@jfaithv86	human
@francesfrost	human
@FoodieImpaired	org
@DealOfTheDay18	human
@RiwiKiwi	org
@Guitarhandbags	human
@divamom81	org
@PollyPapier	human
@fit_blogger	human
@DublinFunGuide	human
@sirvincentph	human
@FadzBella63	human
@pulsemusic_t	human
@winterlynn1320	unknown
@CharieLackey	human
@SlimmmGoodyyy	unknown
@TwoHungryBirds	org
@odahiro23	human
@viaggibenessere	human
@justin_uriel	human
@kzkz808	human
@natieitsme	human
@NUBY_IT	human
@JirapornYun	human
@JesusLivethInMe	human
@bbyjessgirl	human
@TheOaksPubs	org
@WestwoodLot	org
@cassidyscowgirl	human
@ZaneJacobs1	human
@OmamaXMarzuq	human
@JeeeesiR	org
@dishingoutaz	unknown
@mypinkypia	human
@andriyiv	human
@SaturdayMarket	org
@bot29754972	unknown
@Zevia	org
@ioopanda	human
@Virginia2907	unknown
@R_ArtNinja	human
@bapple68	human
@favoritespizza	human
@Mamy200275	human
@hildahijriah	human
@DatsHappy	unknown
@MayRoseTw	human
@hatteatime	human
@Tygemstones	human
@TryCaviarSea	org
@DiamBankx	human
@helenabengs	human
@luanabartholo	org
@ran14544	human
@bernadethaetha	human
@Lucy_0828	human
@pjs_lifeisgood	human
@NBLmusicSalerno	human
@michdawnchua	human
@YuunaNiikura	human
@masseywines	org
@missremylai	unknown
@efranilagrace	human
@sheenCook	human
@cjbphotography1	human
@RaviGopar	human
@CrewsRestaurant	org
@ashj3nt	human
@BackpackerAhLiu	human
@southbaywellnes	human
@seriouslyrad	human
@TheWhatNowBlog	human
@NatashaaaHarvey	human
@CarlCasagrande	human
@RineyyYan	human
@Chef_LAC	org
@StaffordReTweet	org
@solene__r	human
@pholyfizzie	human
@AaronChen94	human
@mattmortgages	human
@PamPresnell	human
@Jessica73735	human
@lapostreriauae	org
@IsalguezAlex	unknown
@Jaqtweet	human
@Andrew_Davis_82	unknown
@shexx23	human
@akana_mi	unknown
@freeadmission_	org
@LYKAlucky31	human
@lecksicon	human
@FlyMikeMarshall	human
@azad	human
@SchindlersCunt	human
@BlueAnomis	human
@CrispyEgg	human
@Ulaneu	human
@AnnaFilm_FF	human
@chabelabiedma	unknown
@aNnTaLens	human
@PiattoKSA	org
@iTrueReview	org
@magdafried	human
@iamjohnraymundo	human
@glamourcounty	org
@tattoferreira1	human
@baja_la_pantie	org
@CocoMarylebone	org
@Torteditoni	human
@CatalystRanch	human
@TommyFChan	org
@BigBooyaw	human
@iamnikkidianne	unknown
@watervalleyyuyu	human
@DietingMonster	human
@ohsolovelyx07	unknown
@Jen79nj	human
@MiskaSg	human
@MomCoApp	human
@MIConceptsDC	org
@iamjharaxxix	org
@etherealprey	human
@anita_himawan	unknown
@hilstonesoup	human
@BryanCejas	human
@KhyreeQ	org
@jdabhi87	human
@NoLongerVerbose	org
@pizzadad37167	unknown
@239casino	human
@EarlBynum	human
@LuxWj	human
@kuokNKK	human
@alluringchie	org
@PalanceMaster	human
@GreenpointFish	org
@janie_duckworth	human
@BuaHanaFP	org
@alibanks24	human
@UniqueCarmen	org
@Hajerette	org
@nannabachmand	human
@albertreyes128	human
@TTKawas	human
@CucinaCiano	org
@ExpGarzon	unknown
@kennethdesu	human
@SmithaJ	human
@dailyampersand	human
@Robby_Usaw18	human
@elisabetta56	human
@PritishSocial	human
@VeBea	human
@Evaleguey	human
@BoulangerieC	human
@gruener_schlaep	human
@helenahonor	human
@J_K3_T	human
@Kushalio	human
@PuneStartup	human
@everydaysimon	human
@dishesdelish	human
@JuanMaContr	human
@syafitrikartika	human
@VromVromAuto	human
@stephaniesalem	human
@Chef_Vannessa	human
@smnutritionist	org
@feibeih	human
@PhuongHebel	org
@fitcornerx	human
@johnm0824	human
@GirlsNight411	human
@margaretnaw22	human
@bridgeo	human
@tangerineregina	org
@whyiamnotskinny	org
@chandythana	unknown
@shintadongsu	unknown
@faycap	org
@takedatakeru	human
@vegamegame	org
@barchettanyc	unknown
@SundaySupperFam	org
@imkijafa	human
@Fecks13	human
@ArtistsCafeWab	human
@saffronandhoney	human
@delovmarin	org
@JustinaTraining	human
@NinjaCityCLE	org
@JoCael75	unknown
@NathanXiong	human
@fireykitten	human
@SirKeshOfficial	human
@chy1129	human
@EbasLnB	human
@darkspires	human
@guesswhosonfire	human
@guffawgogo	human
@kmillerlib	human
@BlueDaisyCafe	org
@ShefShaun34	human
@JKWON_BROOKE	human
@ThenIshSaid	human
@Pigjess_DB5K	org
@FebiolaGiesella	human
@FlipStork	human
@CowboyALEX1	org
@DietitianAdvice	human
@drummerwez	human
@gmtproperty	org
@sabrosasaltco	org
@Hamilton_ghouse	org
@thefatidiaries	org
@cronoXF	human
@kisses4dmissus	human
@Jmannl75	human
@SindaPi	human
@mzleopardo	human
@_brentan_	human
@The_House_Hotel	org
@lexdrive11	human
@EcoClimateSolut	org
@MariaPenalva	org
@menuboardnet	human
@timoyfrancisco	human
@AfroCookingMag	unknown
@tw3541	human
@chris_wangxin	human
@mayb2real4u	human
@totallynudefood	org
@brianlim_93	human
@mode_aportee	human
@Crissy	human
@DishWthClarissa	human
@sarahbacchus	human
@rosscaneva	human
@abbielicious613	human
@osaraba	human
@platterform	org
@ifrackle	org
@anaskssy	human
@lifeofsosa	unknown
@shellmeeia	human
@suraya2809	human
@mdwinebassador	human
@SofitelRabat	org
@BAO5221	human
@NYBarbieexoxo	unknown
@jordan_nerissa	human
@rodneyloh	human
@poohgiedog	human
@MariosCapeTown	org
@Anniemac24	human
@dikteza	human
@razgabriel	human
@samwellerdesign	org
@ReenceDonna	human
@GarciasPhx	org
@dngkenya	human
@Mixedbaby090	human
@DIADAVETERAN	human
@dreiiswithCARL	unknown
@PlanCheckBar	unknown
@officialdjkan_i	human
@goodkindbayview	org
@DairyfreemeUp	human
@Rostower	human
@dreamingleaving	human
@AprilShowers__	org
@Silverlilymoon	human
@prinzcesz	human
@SufyCullen	human
@paninosme	org
@DiplyOfficial	unknown
@MaricaJFC	human
@PawelKowalskiSJ	human
@FANCE_NANCY	human
@BroadwayinBrum	human
@38247Omr	human
@SallieMarieQT	human
@misskittycharms	human
@AminKhAno	human
@WalkTel	human
@escabrahma	org
@MULAH_MANIA	human
@vojages	org
@MariskaChan	human
@LINDA_MEYER_	human
@TerebellaLLC	org
@teamreachforit	human
@monpetitnewyork	human
@ozieahmad	human
@charmaynechung	human
@iswellconnected	human
@roxybeachchic	human
@thefreevegan	human
@dianewsco	human
@BestofJakarta	org
@GustoOsteriaAZ	org
@HERNaME_RENEE	unknown
@Rickycassagne	human
@ahmadsyauqiPO	human
@cdpiglet	org
@amit_m7	human
@trazylyn	human
@MO_LASVEGAS	org
@JacqGabardyLAc	unknown
@yingtheviolent	human
@noziphozuluOnly	human
@masquelunares	human
@numarillisia	human
@ashaqirah	human
@teresaxdecenzo	human
@mdyoder	human
@blogluribeiro	human
@KeinB	human
@marybolling	human
@Rouge_NYC	human
@RoyTwisa	human
@bslam00	human
@Madam_Coyote	org
@SimplySofie84	org
@JessBlack1	human
@LeedsCityMag	human
@iloveasrnjazz	org
@swapnilagoswami	human
@agustinsantrian	human
@charlesumengan	human
@sardogsnepal	human
@SD_Bancroft	human
@youngmanmusic	human
@jcarlobos	human
@nethan	human
@ElleCanada	human
@hawkster2010	human
@iCaYunisha	org
@VintagePoptart_	unknown
@LindaRcampos	human
@dextext	org
@BelGeorgieva	unknown
@jennilamore	human
@chefcrescenzo	org
@Terry_The_Twitt	unknown
@namakumaru	human
@newsakuradesu	human
@FrankOlsona	human
@zaldycuartero	human
@SulekyREvents	unknown
@CITY1051	org
@SlimDiG_Ns	org
@richardsbm	human
@SanchitaWahi	human
@MarineGuigon	human
@mustachemelrose	human
@FaustinaSLC	org
@Terrence_Rayy	human
@Cornwellp	org
@bot04674988	unknown
@PEI_r_p_08	org
@nicholas_wray	human
@_sriyuni	human
@ViBE_ub_berry2	human
@FHCFoodtruck	unknown
@EternalTaal	human
@Jamericanspice	human
@SaturdayLuva	org
@SimplyTiffanyN	unknown
@nutrifunn	org
@riccardo2707	human
@micheldebruijn	human
@ElfrokeeYokee	human
@aussiebohemian	human
@lizzy_oldershaw	unknown
@msjackiepage	human
@mycitychennai	human
@gibran_22	human
@LaCasiCris	human
@koapancakehouse	human
@patjosephramos	human
@egbertconrad	human
@rizanoia	human
@LettuceCart	human
@MelissaJuco	human
@DCBruins	org
@mon2mona90	human
@Jethrotay	unknown
@m_711x	unknown
@JayyG619	unknown
@natalienaaman	human
@addiebutler83	unknown
@Tralhas	human
@KitchenMason	human
@tinamuir	human
@arod1886	human
@DanaiBarka	human
@HealthyKidsCook	human
@st_ramune	human
@KUWTLF	unknown
@thatbrunchlife	org
@DAWNDAWNNNN	human
@Borinquenlunchb	org
@kantaraw	human
@desiredtastes	human
@AllGameBot	unknown
@behgopa78	human
@djgetloose	human
@serena_n85	human
@bethsaii04	human
@SpicyAhi77	unknown
@HillsboroughFL	human
@Blahogany	human
@BUTTERBOI007	human
@HGC1968	org
@iamsupererika	human
@oishiiomayo	human
@mira_929	human
@Marketitaliano	human
@GourishDesai	human
@Healthspodotcom	human
@elf_exoul	human
@VivaGlasgow	org
@Osmara	human
@Sther_Garcia	human
@Ecail	human
@Les400Coupsmtl	org
@IamJamesDavid	unknown
@MarlouJake	human
@NeonBeaver	human
@GossipGirlChesh	unknown
@LVas_Official	human
@chveyaweaver	human
@JoyceDuboise	human
@TFAStarWars	org
@WOLFStreetFood	org
@KingSmakMan	org
@handslanefoods	org
@metaco24	human
@carneytrain	org
@poetrysweatshop	unknown
@KillHill	human
@LCSNY	org
@RenatoTT1	unknown
@loladenver	org
@lovingadventure	human
@kristyidea	human
@eatchlavitsef	human
@kt02sy	human
@komeg	human
@TashaSoto1	human
@silvanagl	human
@whmsicalcupcake	human
@mikobonbonn	human
@EnricoLIC	org
@bwrockingham	org
@DanceWithSJ	human
@Sassyhotelguy	human
@SangKyanaMarie	human
@Tracykawaii	human
@DianaP0	unknown
@Jconsumo	human
@SheratonBahrain	org
@Swifty_Gere	human
@antonelafossati	human
@travelme198	org
@kaybickle	unknown
@RashiNaresh	human
@AbigailSixx	human
@doordork1966	human
@mnojmj	human
@fly23_butter	human
@iryanisarah	unknown
@Napsterson	unknown
@Mahou_DC	org
@fcastore	human
@TashaWenderlich	human
@RoppongiLaJolla	human
@isabellabaker51	human
@HariJaja_Barbie	human
@other_J57qU	unknown
@ArabianNotesAD	human
@DayJobNightLife	human
@TheRealAOM	human
@cultureshock35	human
@dearmoonjune	human
@CooLPatZ	human
@RLeeMusic	human
@69luvanibble	human
@NeetaTarway	human
@Kuroyume0	human
@frannywanny	human
@xlilynicholson	org
@richardGroenewo	org
@foodporninnart	org
@nsane11	human
@SophieEnever	human
@KelaWalker	human
@UllaPirkola	human
@NeuvooReginaSK	org
@wilthony14	human
@mrsprindables	org
@heylightheart	human
@fieschi_indri	human
@FernandaHorta17	human
@Jerzeyeatz	org
@thehadyhady	human
@saorin0912	human
@carlospi28	human
@ImTheKing	human
@FluffyMonkey1	human
@CASINOMONTERREY	human
@TynaKubesu	human
@eatbocce	human
@burakerdir	human
@NordischNobel_	human
@HelloCortney	human
@caioherrero	human
@Cairo77	human
@mspeggii	human
@Orafon	human
@iLuvMagpie	org
@slaintenyc	org
@eattweetrepeat	human
@JBarnesWilliams	unknown
@sazza2008	unknown
@ann_ueno	human
@E_AlHamdan	human
@BoBenzon	human
@Karolis_Roller	human
@yumekung	org
@ktownmangia	human
@easonsum	org
@MillCityPicks	org
@Fbrownie14	human
@Matteopieracci	human
@laura_woodworth	human
@ta24_t	human
@_funwith_toki	human
@ChauncyTalon	human
@irmanorthklamp	human
@Crimson8honey	unknown
@chelanolin	human
@beadedhearts	human
@centrestcafe	org
@siscahosanna	human
@InTheWeedsWBR	org
@SweetApple_1122	human
@Lunch_in_Truro	org
@kmns_m	human
@ksak58	org
@TabernaGiralda	human
@iku626	human
@BostonGeorgina	human
@AnneCutler	human
@mhykeedavid	human
@taochan8787	human
@Vuko	human
@chantel_boffil	human
@thebRUNcher	unknown
@lightandwhistle	human
@muserebelle	human
@emanuelaneri14	human
@Adindaawardhani	human
@BerrutiGiulia	human
@TopWeddingTips	org
@sekai_omosiro_	unknown
@kenishiro	human
@jcgrestaurante	human
@brokenearthwine	org
@AnaMarbiellys	org
@saeifzghoul	human
@WKannen	human
@MarvinT_03	human
@marciawestbrook	unknown
@vithadess	human
@jyboy95	human
@ArnaudPRCo	unknown
@dryousry	human
@pluspack	human
@vivalsvgs	human
@TIGIEricMoon	human
@VineMeUp	human
@ocean_view_dxb	unknown
@ShareologyBook	org
@WhiteflagEnt	org
@lissette_romina	human
@TheWheelerGirl	human
@Vegginspiration	unknown
@KatLucas2	human
@MrsLaRue211	human
@Brunelsquare	org
@wfmavalon	human
@CavatappoNYC	org
@chrishitchens8	human
@Mellowed_Outxo	human
@ami_ameth	org
@Awiekeren	human
@SBHwrapsNdesign	human
@LaurenOjeda	human
@anindya0909	org
@dalriadu	human
@ataranai_shinri	unknown
@chriswinjay	human
@DowntownStoon	org
@CompaniesList	human
@DjBigReef	org
@SmileyMcflyGirl	human
@Silentbx	human
@mr_napie	human
@sightseethecity	org
@natgoeswickless	human
@EmotionalWealth	org
@saroshmody	human
@gkarthik25	unknown
@VILLARISRL	org
@SIMPLY_LADY_K	human
@LinhsFashionWor	unknown
@NeuvooNashville	unknown
@zacharyparore	human
@LickItGelato	org
@ChariseT1	human
@Fortekitchen	human
@Starbeautypage	human
@wellness4thewin	human
@cafeunotoronto	unknown
@mello_raf	unknown
@umadatye	human
@iatitap	human
@Fanskifan	human
@Aaron_Wesson	human
@lisa_borg	human
@m_muchakun	human
@MeeRuX_Hh	human
@Staisha	human
@Khot_Sampada	org
@rosatistucson	org
@caferazzo	org
@swallowcoffee	org
@stephenfung	human
@Sumosan_London	org
@SayItAintFro	org
@Eyesagreen	human
@LivPeicanni	human
@razhash	human
@Puppetonia2	human
@RecipesKingdom	human
@AddleEratat	human
@sweetcataleya	unknown
@JMoniqueSanchez	human
@LadyKi628	human
@BrianDivaCox	human
@shinchaaaaaaan	human
@EwaTrusewicz	human
@EvaCamposOlmo	human
@lord_ishus	human
@BodyStyleGuide	org
@OSSMadison	human
@UrbanDinerYEG	org
@MirandaKitten	human
@SunprideID	org
@kelandkate	human
@MzBossDrippa	human
@Kitchen_Oracle	human
@mommalovebaby	human
@rachelombok	human
@boracaysun	human
@PurpDalia	human
@tali_30	unknown
@aizad_ali	human
@DebbieCanova	human
@AhmedAshrry	human
@SeedammPlaza	org
@heathertanchuck	human
@LilEdri	unknown
@scottydogfan01	human
@EviaYoghurt	human
@David_ChangSang	human
@pattsa	human
@idho_M7	human
@xESHAxBADdx	human
@leehansheng88	human
@ZestandLeisure	human
@KelliRenae13	human
@Saveyrcarlos	human
@StefanHolmPHOTO	human
@kenlowkahloong	unknown
@NailphoriaSpa	org
@Remodelaholic	human
@hashuhashu2	human
@tanyabalas	human
@DarkDraculaura	unknown
@_KiKiBaDD_	human
@fairuzmaggio	human
@38shop	human
@amie_woodward1	human
@RockHouseBahama	human
@GreenBEANky	unknown
@zkharmaz20	human
@CulinArtLiving	human
@noricm	human
@JMIheartBeer	human
@Claytonsdiner	human
@gokcebiberciler	human
@VM17_Vigo	human
@sixsteps	human
@JFPMusician	human
@superkame	human
@svolkova108	human
@okayamapc	human
@MarketingHerTO	human
@DBKitchen	human
@elifqur	human
@CRCDLDTHSPD	human
@gaganjeet	human
@c_faten	org
@kotodama_bl	unknown
@CarmaloTweets	human
@kin_jinno	human
@LACESINC	org
@trappezepub	org
@JihanShanawaz	human
@FoodJunkieEA	human
@aplekz	human
@zahrelrouman	org
@RomiBarrojo	human
@kitnkboo	human
@YeLLowiFah	unknown
@wembleypark	org
@KennardoHolder	human
@MissTaraTee	human
@wanztv	org
@mikhailjcg83	human
@sheliders	unknown
@VegasBiLL	human
@emonmitro	human
@AboveAverageA	human
@JeffreyMalcolm	human
@natachabeim	human
@AndreBhatt	human
@DusitD2Phuket	org
@carrieellen1010	unknown
@OliveaShure	human
@omiwasan	human
@PanevinoGlasgow	human
@Barlows_B	org
@justlovepaleo	human
@RoachRampino	human
@Aarriizzuu	human
@phakkaphol	human
@Andorinha_Feliz	unknown
@BenjaminSteakWP	org
@ifarahahmad	human
@ZeynepBGuven	human
@Moogys	human
@Vaslov1	human
@nonuskroos	human
@JolandaPike	human
@evih_odewoq95	unknown
@SashaJohst	human
@PranitaBalar	human
@YamRumay	human
@Hayshaun	human
@SavvySnacks	org
@BobbisPoleMsia	org
@Fitness_4Her	human
@N4omiRyan	human
@GigiDeLuxe	org
@robotmunky	human
@publinie	org
@FDLeagueTwo	org
@DMVStacey	human
@MonPetitChum	human
@MNB_YVR	org
@ConveyAwareness	human
@JIGGYISJIZZE	unknown
@hellothmushroom	human
@Boniface92X	human
@JosefinAnderung	human
@MACleverley	org
@mikki_cohen	unknown
@McMillanLeila	human
@kitty99876	unknown
@Sweetsillysara	human
@MargarethaJulle	human
@cncaparas	unknown
@ChowBellaPHX	human
@Changing_News25	unknown
@Jane_Lovett	human
@ChefJulieBasset	unknown
@FranciMorroni	human
@oakleyoak	human
@3D_Vitality	human
@DanDanFlavor	org
@PataRussa	human
@JulesAlloggio	unknown
@RevistaMesayBar	org
@gestupidas	human
@lilmissbquick	human
@daphneconst	org
@zyleryan_dublin	human
@kharise	human
@m3ngyu	unknown
@AmyJBrink	human
@PerceptionFood	org
@fukuokacurry	org
@seohyun20120316	human
@FutbolyAlgoMas	human
@MARTINpalits	unknown
@_kentken	human
@chefkenna	human
@WestermansFisk	org
@silfavaretto	human
@DancingLexi	human
@mathewsbambina	human
@zophy08	unknown
@nnanovelea	human
@juiice4u	human
@morganklein	human
@manilaprincess	human
@taylordawnn	human
@LoletabyLoleta	human
@Xtro718	human
@jadring	human
@ONLYDA5TRONGSUR	human
@AdornedFromAbov	org
@Cushena_i_Am	unknown
@sabudbob	human
@EatDrinkRewards	org
@Mcrazycuzs	human
@Dah_Agaton	human
@nuutrii	human
@Trucchis	human
@stephmarie212	unknown
@InaNuvo	human
@TheDuckKingID	org
@remstuff	human
@BlueHarmonie	unknown
@USApears	org
@zkharmaz14	org
@Cocojor	human
@IoffeAngela	human
@BostonBrunchers	unknown
@itsmeDJyouNOT	human
@therealmaye	human
@nw_27ym	unknown
@urbanenvy	human
@SterlingNetwrks	human
@kate977	human
@moviechick707	human
@Mysticstation	org
@titabarrera	human
@slothlacrosse	human
@ArtFulmOOn	org
@SushiRokuLA	org
@FoodFood4u	org
@isaiah_tubbs	org
@Danny_Tang	human
@kikuchinohills	human
@NEASHAGARCIA	human
@natalieellis23	human
@RayReilly	human
@R5Lover1996	org
@LittleItalyGrp	org
@MyIronAddiction	human
@britwoollard	human
@menubyvicky	org
@shewhobakes	human
@IAMALICEWANG	human
@BryanFauth	human
@WilliamGaleazzi	human
@Frikis_Woman	human
@urskicastye	human
@1stormboy2	human
@dakotakim1	human
@organicmovemnt	human
@beyerbeware	org
@deamorrielle	human
@OMaquet	org
@Katiedowning94	human
@DoubleTrbl	human
@mami0381	human
@Fitness_ID_DE	human
@NKYAggie	human
@MsElenius	org
@chickrawker	human
@HunterSJones101	org
@SamDevro	org
@bubbymama01	human
@theonlyjlcnow	human
@Brianhowlett	human
@sp_kabegami	unknown
@startinova72	human
@ancientscripts	human
@BethkazV	human
@sorentotoronto	org
@AljordiYvn	human
@Rumi_dubi39	human
@thewandringkind	human
@bara50	human
@bhummas	human
@crazyzel10	unknown
@alex_cox13666	human
@rp_zona	human
@niranjansawant	human
@_NiinaK	human
@eLuncher	human
@Carita_H	human
@AshleyBassar	human
@HafizMDaniels	human
@peakfitnessGT	unknown
@SweetEscapeCake	human
@lost_girl	human
@onwiththerhythm	human
@zzazzazza	unknown
@MissPaulaFlava	human
@WhatsOnBodzMind	unknown
@Enmicocinahoy	human
@kizaken_44river	human
@kimmaples2	human
@fiebigershoes	human
@smutt1929	human
@laurabethbeard	human
@Tiana_Bench	human
@BangBangMongo	org
@AwanAnbar	human
@RealSunshineluv	human
@kittylovestea	human
@Mcartsymike	human
@TroyBakerAuthor	human
@miriam_calleja	human
@ChoppingBlockFT	org
@__toriex__	human
@foodchick101	human
@mizerupo	human
@parkersLH	org
@A_MsComplicated	human
@amytwinxx	human
@ParkPlaceProd	human
@alexafiggs	human
@Dan_salves	human
@AgustinkosOK	human
@rennai_etc	unknown
@FSMilan	org
@puurveluws	human
@ParmaHillcrest	org
@mrsnovak777	unknown
@PScafe	org
@marekwilk1	unknown
@CoastRoastCoffe	org
@camillegrandxo	human
@OurNameIsFarm	org
@FarmhouseKraut	unknown
@PjRollinson	human
@cindyblackie	human
@chinatownlad	human
@AcademyStBistro	org
@Neilkater	human
@ovalparkgrille	org
@angelsscream	human
@BennigansUAE	org
@toccodizenzero	org
@HRHyland	human
@maunsellb4	human
@Krissy_Krash	human
@Honey2rock	human
@whateverasia	human
@BronzeDeo	human
@HarmonyalaCarte	human
@ChevelleCaterer	org
@islinnda	human
@foozhiming	human
@bibizhaicen1981	human
@Oo_Loicia_oO	human
@nomthatsushi	human
@SpoonerDrive	org
@melvs4	human
@Cantina1511	human
@_David_Ng	human
@OrigFeyg	org
@Ucdmgm0125	human
@TheSophiaNash	human
@mYpolitan	human
@CrushOnDiArts	human
@CHELEAUTORE	human
@gkasenda	human
@rrraad	human
@ABSOmarilyn	human
@hkjohnson	human
@Ms_thebetty	human
@HerbalOne	org
@DREXXI_KIDZ	org
@emilyzying	human
@lesgourmands_mu	human
@NeuvooTulsa	org
@phaulsabino	human
@hskyet	human
@Score_Online	human
@EmmaElizabeth5	human
@WestOnWestern	org
@takashi3236	human
@jlstreck	human
@RogerMellens	human
@yvonnechow87	human
@rachelprgirl	human
@loveworkoutNJ	org
@FreelanceItalia	human
@BibbaDs	org
@SpeedHunter34	human
@GisselleDiazLo	human
@AnnLouweezy	human
@Nicaayloves	human
@CarambolaKidz	org
@NoThanksToCake	human
@KylaZanardi	human
@TFHartgret	human
@rikayukimasa	human
@katerinakaralio	human
@TommyNakas96	unknown
@HyRkapb	human
@ClubKourtney	unknown
@abigailwrites	human
@yeoshihhan	human
@KlooklReview	unknown
@fifithefoodie	human
@AweenRosely_28	unknown
@Brewing_Rob	human
@viitrannn	human
@FreshFoodFashio	org
@RadissonPark	org
@oreginensi	org
@nottacafe	human
@andrewhelge	human
@MetroMallPH	org
@ifoodchef	human
@VeraceIslip	human
@EinarSvindland	org
@FranceM21	human
@cass_k20	human
@TicTacTrendy	human
@mcl_ink	org
@matthiasmerges	org
@casadiseno	human
@marylounewnham	org
@RonGamblePR	human
@relishibiza	human
@Nigelyen	human
@UKissKissU	human
@kipopo1103	human
@socialmedia195	human
@angiedepue	org
@chabely_chabz	human
@Cindytjes	human
@BrandyBollman	human
@endreams	org
@monfal	org
@iamnotanegg	human
@TyCatty	human
@CityDough	human
@whereBOSTON	org
@RhezaJoon	human
@khusbugauchan	human
@BDExcel	human
@hashtag_babe	org
@rosemary_gomez	unknown
@LaylaNorthern	human
@kosupureoishii	unknown
@AlisooonMK	human
@KayDobson_	human
@samskara01	org
@drpeel	human
@Lobo1612	human
@cecaroliena	human
@kinkyoctopus	human
@theelijahtorres	human
@PinkCandleLady	org
@ylmzozturk	human
@JeffryOno	human
@AshleyNicole916	org
@Msdalloul	human
@vidoyen	human
@TavolaeViaggi	human
@YogaLean	unknown
@tiings90	human
@ommorphia	human
@JackLinksEurope	human
@tiny18Heart	human
@MamaMeiaa	human
@Dolphinncat	human
@celebritymads	human
@kathykaun	human
@SkillzTurnItUp	human
@NostalgicDream1	unknown
@Laurajaneatelie	human
@MIAMI_HIGHLIFE	human
@secretlee_	human
@MarvelousViXEN	human
@BLVDsf	human
@f00dies0ul_	human
@actorAttila	human
@heyfoodsister	human
@iopeel_0302	unknown
@AlbertsonsNW	unknown
@Avery_LR	human
@Nonsensika	human
@kianmin123	human
@Milanosecrets	human
@iMudassir	org
@dezcoal	human
@visitphilly	org
@buaberrynine	unknown
@ferryjr	human
@CrissV	human
@zerella	human
@ladysara84	human
@cynbreyes	human
@MeganChobaniuk	human
@AhweJr09	human
@KJosTweet	human
@REDHOTPRSOCIETY	human
@Manitobagal	human
@ddheartsjohn	org
@lsang_	human
@jared_martinez	human
@ArtlessAllure	human
@sluttyfoodblog	org
@WillZzang2	human
@rubigupta811	human
@alimentartefcv	org
@TriciaFitHealth	human
@nia_andina	human
@si_ritche_ako	unknown
@Gabgoub1	human
@jaxmay0223	human
@rakistangnars	unknown
@Nmktbusiness	org
@lucienium	unknown
@CShelly_CaterCo	org
@ChienFuei	human
@Lacintha	human
@CliqueCaerdydd	human
@WindowHackneyRd	human
@mjjejungyj_	human
@OSPemployment	human
@ttt6988	human
@SaladWorksFL	org
@Mosmarina	human
@rhlnjf	human
@Phyllis_Nobles	human
@DisneyFoodBlog	org
@masterconcierg1	org
@joylinechai	human
@lucas_sebastian	unknown
@deedeemeetsfood	org
@joanneisafoodie	human
@tweetjen73	unknown
@PHOEBEfluffy	human
@AwesomeNewark	human
@UncleBacalas	org
@nisa0530	unknown
@AgathaCWangsa	human
@Zellyanks	human
@KalSings	human
@Diner_OnMain	org
@Tharie_Stark	unknown
@_king_t33	unknown
@AngiesHandmade	human
@jajabulous	human
@tomnizo	human
@da_hawes	org
@mightychalie	human
@Geordiebird_DXB	unknown
@frmscratchbecca	human
@ZacTheHippie	human
@carotte_bleue	human
@MidoEats	org
@laceylew1	human
@SoyHelvetica	human
@aliciagrobelna	org
@el_sedtogonon	unknown
@teamdaveandmon	human
@DarcRose22	human
@Seridlin	human
@rasg28	human
@Catarina_M	human
@LOVEMADAMECHIC	human
@Changing_News22	unknown
@SteriousTweets	human
@ColbyKolpen	human
@FlySpoonStudios	human
@ICGAFIYLMON	human
@juanluhoyos	human
@michellerestani	human
@scottyjardine	human
@zeppy_seaside	human
@bugoyprince	human
@MystiqueBNYC	org
@KimberlySusanLa	org
@Anniek93	human
@GeeBaby_59	human
@alesanchez_90	unknown
@josteper	human
@takdrums_tsv	human
@fidajacob	human
@KrushLA	org
@RefVinnieLax	human
@hermitudinous	human
@jayexfalcioni	human
@shanesamson1958	org
@hweige	org
@CRPRestaurant	org
@BlueBitchBarSXM	org
@PrettyFitMom	human
@TBJRoadShow	human
@metalrunner72	unknown
@lyckatill	org
@MatildaEats	org
@eloursnz	human
@Shabz_2012	unknown
@noseyparkyn	org
@THEGOONEEZ	org
@b138oo	human
@Florettesalad	org
@FollowbackUrban	unknown
@Dee_____Xo	org
@OscarCorreaOD	human
@ishholmes	human
@m_mediouni	org
@JennylouRaya	human
@Smilegirl777	human
@bubbleteahealth	human
@bitcheseratbp	human
@patty_lising	human
@simyosim	human
@RuthBonner11	org
@jentotskie	human
@ArtistLucyChen	unknown
@porkoricobbq	org
@asterisque_5	human
@virginialissi	human
@inapap	org
@Iamreddeleon	human
@jethrosalapare	human
@iloveamericandy	human
@EverydaySarahJ	org
@Coobaadoo	human
@StevenageKB	org
@iAmLenaRo	org
@JimmyzPinecrest	human
@ThePrintupList	org
@GrandCafeFL	human
@midnighteskye	human
@Bebellaaaaa	human
@Ashley_Dyson	human
@AndrewSkipper2	human
@IndriWuland	human
@facc_connect	org
@alyndley	human
@AlexTharme	unknown
@SamanthaGOTV	human
@bLahTeaBayYeah	human
@AdrienPerrin88	unknown
@moliv877	org
@AllisonHek	human
@CafeDiStasio	org
@jujusma99	human
@yolizzles84	org
@MattVaughanBT	human
@fridaysdurham	human
@bhavinkpatel_	human
@RokaCanaryWharf	org
@PoetInThePantry	human
@Nowgetdaniel	human
@MuluLiziBand	human
@Vick0366	human
@VeruKaTrip	human
@DJJAXMIAMI	human
@byMandyGirl	human
@NapNBMusic	unknown
@AngelaMarchelin	unknown
@FierceFitVegan	human
@SasySouthrnYank	human
@FrankvdKok	human
@comicalblonde	human
@_M_T_G_	human
@kaori_rinsei	human
@darkahuna	human
@Elyse_smyls	human
@sheslosingitnet	human
@jgoode	org
@LylinHong	human
@Messiahs_MISFIT	human
@applewoodny	org
@theGoldenBun	human
@ThckRedz	human
@ThaiShirlington	org
@JennyMeeDance	human
@Juliesjumble	human
@theJsanz	org
@aixprovencienne	unknown
@JessicaM7111	human
@TOfestivalcity	human
@shortiiburnz510	human
@vickydegroof	human
@RachelNotHere	unknown
@FornoShortNorth	org
@Marktz1	org
@TheOriginalNeal	human
@aDreamersWaltz	human
@cathywhite10	human
@Chyna_mari3	human
@JulianHWong	human
@_brittanyy9	human
@UtilityHelpline	human
@dizberiq	human
@saaaaara41	org
@SegafredoBrkl	org
@Cameron_Cordell	unknown
@MindfulMealPlan	org
@prahrancc	org
@ReclinerJockey	human
@ectorpra	human
@heidimackin	human
@mrsdash	org
@merchoow	human
@emtwigg	org
@youarechef	human
@waheedaharris	human
@Trazlersgal	human
@mfalconi1	human
@camillaackley	human
@rontuazon	human
@chillibananawlm	org
@Yettaman	human
@p_huizenga	unknown
@othrwse_incomp	human
@MARRiED2theGUAP	human
@blabim	human
@DietCenterkw	human
@Naybug82	human
@AromasCafeIndia	human
@lifeofvicki	unknown
@tbush	human
@xxxelliebellyxx	human
@dwmassoni	human
@SweetLemonMag	human
@wcraigalsh	human
@laidlondon	org
@I_am_Solobitch	human
@peteprieto2	human
@AndydeCzar	human
@BistroChatNoir	org
@yuaxxx28	human
@Qarnain28	org
@nffc65	human
@lindsasaurusrex	human
@kenkerron	human
@Mimi_Cuisine	human
@thiswkimloving	human
@dietdetective	human
@ClanzShady	unknown
@DiningPlaybook	org
@LBConventionCtr	org
@ella_114	human
@vibgyor70	human
@trev_c	human
@thathaikugirl	human
@Lisa_417	unknown
@EAEkshibKontr	human
@kathygori	human
@Fittie4Life_	org
@CertifiedLS	org
@EkenMagazine	human
@LEADRSDO	human
@polpolfil	human
@LAcciaio	human
@PrettiKlassii	human
@adison_evans	human
@BeatVintage	org
@rodny83	human
@AfghanKabobhous	org
@SammiDarcy	human
@tinadigiuseppe	human
@JamburritosKJUN	human
@ArmyWifeyDebbie	unknown
@Kassandra_Wolf	human
@ItsChiaraLomu	human
@julesdoyle	human
@Provocolate	human
@AnnaSwan78	org
@darrylhurs	human
@Fitnessfreak75	human
@GemmaAmandaa	human
@cmarcera	human
@MauraLIbba	human
@alesiabmartin	human
@_warriorgirl_	org
@Sale_Fox	human
@nickykylegarden	human
@almudenaalcazar	human
@Marckenstein	human
@gfreefoodie	human
@Dallatorre	unknown
@WhoCare__	human
@JessintheAttic5	human
@IPhasen	human
@MagPubAus	org
@ByronBaque	human
@ArenaSINY	org
@andra_damian	human
@fukurouza	human
@Romik515	human
@sookieluvchase	org
@WendaAdityawan	unknown
@fabiostefano	org
@ViviiGutierrez	human
@str8realonmyend	human
@jhuskersam	human
@tiajkim	human
@threesixtyspace	human
@sincerelylizb	human
@ProBioSkin	org
@zeppy_muppets	human
@shirosapporo	unknown
@KildaresWC_	human
@epicsoul	human
@LaLove10	human
@juliehourmant	unknown
@MelvilleDeli	org
@djdelro	human
@MSVTKOVR	human
@hotlightgirl	org
@PillowandPlate	org
@Anjalaf	human
@driftwoodgarden	human
@joseph_padro	human
@nishingeppo	org
@eme1ie	human
@WangCandice	unknown
@Pan2arkYC	unknown
@ESkiBBM	org
@haruchan92	human
@DaNnILiUX	human
@MariangelaAbeo	human
@ForeverFungry10	human
@cazgriffiths	org
@Theeehalfapple	unknown
@MelisaValentine	human
@Ginger2Claire	human
@paulinedaniels	human
@nafzabigail	human
@_KLangley_	unknown
@cuppajyo	human
@balamoda	human
@eims_walsh	human
@Office_Ocean	human
@kanon311131	unknown
@lauryllane	human
@ArteSanoBlend	human
@haveyoumetter	org
@ladivapizzeria	org
@redjarcooking	human
@bodyandsoul_rev	org
@melygreen	human
@SunSophie1990	human
@Noman_Ahd	org
@ChloeChang22	unknown
@jakeyboi901	org
@MillionMomMvmt	human
@sophiaz927	human
@Dior_143	human
@summerwaters89	human
@Chris3Kings	org
@cuteja_el	human
@cjlampad	human
@nadeyamystique	human
@ThePlateCoach	org
@LiMotionLimo	org
@ananprayz	org
@khangerman950	human
@unikairish	human
@MichaelHarberg	human
@Wisethedome	human
@GJGunit	human
@thefrontporch2	human
@ElCapoNQ	org
@katieviancourt	unknown
@copycarla	human
@starckieee	human
@IamFFLL	human
@SenorGrandes	org
@TheRealLaLaTroy	human
@SixtyMileSmile	human
@BrandaChesbro	human
@cherrymilk93	human
@FatimaBeatty	human
@hgroastery	org
@julia_anatasia	human
@Thoromeo	human
@SophiaPitaCafe	human
@MeatsMarinates	org
@DevourJunkie	human
@94Clarachong94	human
@djfafakhan	human
@nourishedpsych	org
@dyo_anne	human
@jennmercer29	human
@Broomykins	human
@biboyherenthere	human
@HopsmithTavern	org
@dorakusushi	org
@Sweetdreamsdmv	human
@RianSalyers	human
@Shaun_here	human
@jeannieonmaui	human
@dancerswish	human
@Blakwitstamina	human
@Vinasumitro	human
@BelandDragon	org
@PhillyToDo	org
@Vheronita	human
@tin_foil_hatter	human
@Undead_Paladin	human
@HappyHemp	org
@alChigi	org
@Taj_Restaurant	org
@OlivWellness	human
@BucilUhuy	human
@DineNewport	org
@Mr_OneClick	human
@IlDharma	human
@luux_lu	unknown
@tbarrios47	human
@drz_lah	org
@1clevercupcake	human
@thefananiworld	human
@YessyTan	human
@BecauseGb	human
@ItalyXP	org
@nmeg21	human
@TravelStyle_Mag	human
@RITUJAINSINGH	human
@MihoOhno	unknown
@ProdTip	unknown
@TurnUpForLunch	human
@noonoodlesuk	human
@waldous	unknown
@Flowonit	org
@terencezou	org
@PunchRestaurant	human
@Jenni_Lioness	human
@EbisPlank	unknown
@Search__Social	org
@EdithDourleijn	human
@roofsushibar	org
@StephanyKhalil1	human
@notorious_not	human
@LifeTrickscom	human
@mcreekspices	org
@teju_iyer0598	human
@pablos_cafe	org
@iloveerikaerick	human
@benson_elite	human
@Arizonian2014	unknown
@Beckenham	org
@indigo_0916	unknown
@orangeyouclassy	human
@TheDreamBoy305	human
@echyybohty	human
@Zafrina_AR	human
@Shpadoinkle_	org
@LousNaturals	org
@madetoglow	human
@mom22girlz	human
@106BakerSt	org
@tabitha_ezra	unknown
@AmiAoyama	human
@kaayehambre	org
@AmarisJones	human
@heartlove090	human
@Daniela_S_blue	human
@Meryjo84	human
@VivoAustinTX	human
@SamuraiSams	org
@ch426	unknown
@SmilexX_1117	unknown
@LordPEvents	org
@SpanoOfficial	human
@foodforlifeau	org
@kaijb357	human
@tannerlawson84	human
@iggy1981	human
@LilleConf	human
@TheQoFE	human
@GobeJr	human
@sandersstyle	human
@hisyamirul90	human
@kissthepanda	human
@maltcross	org
@currents_tarpon	org
@hphood	human
@cyseewhy	human
@suziberi	human
@DowntownBarrie	org
@REALSFAN	org
@TipsyToboggan	org
@deairis88	human
@popeye_doyle	human
@SmileySoSerious	human
@pikorisako	human
@kt_omg	human
@FashionUrbanite	human
@sonounamelma	human
@dervipo	unknown
@sannyshan	human
@rockhardmama	human
@heartOFqueens	human
@edgaarzacarias	human
@bbalthaser23	human
@vandalesa	human
@CoryHaze	human
@tastingpages	human
@fannyevert	human
@joicetoh	human
@suttonimages	human
@lebleoficial	human
@yunvnk	human
@amirabhdin	unknown
@BarTomaChicago	human
@HattiesChicken	org
@mit_mit0705	human
@Aerated	human
@iLoveAnneTing	human
@LeoPereznegron	human
@CurlsNNails	unknown
@yancelotti	human
@JJLoXclusivo	human
@Juaaguilar22	org
@Jorgeear_	human
@schlechteIdee	human
@yuniievariesta	human
@soulinBrooklyn	unknown
@ElifBilgeEder	human
@OhSirin	unknown
@jamelyno29	human
@LaCorona_mr	human
@chelseabistro	human
@F1_Rowlands	unknown
@apetravichx0	human
@paparazzimetro	human
@sagebagel	org
@jeremywomack	human
@numstheword	human
@yoko_sakai	human
@salvagedkitty	unknown
@BlackbirdinBXL	unknown
@cristianpavezd	human
@karowren	human
@Austin_Grisham	human
@ALKinfo	org
@haziqhizal	human
@jess_escalona	human
@ntv7	org
@tyfc1028	human
@abhijit_menu	human
@chocolateslopes	human
@niche	human
@litomleee	human
@ricardodinns	human
@type4naturals	org
@jerre09	org
@jeffwar314	human
@omargotkicks	human
@msahikooo0	org
@EssenceOF_LiF3	org
@babylalat	org
@diathao	human
@ChloeG_PR	human
@MDee14	human
@QuisKing	human
@__HannahChan	human
@52182281	human
@egakasos	human
@ruilockhart	human
@FirebrandBBQ	org
@missfoodie88	org
@Brianna0312	human
@alessialiistro	human
@ej_castaneda	human
@AwesomeNina123	human
@deweller	human
@Crafty_Veggie	org
@bratbrown	unknown
@AmiraAlJariri	human
@mrssivi_kiki	human
@ovee84	human
@donnamaemorales	human
@abcddesigns	human
@serendipitastic	human
@emyyanase	human
@CDeMeloBooks	human
@Firyals	human
@RirinLoll	unknown
@cavallicaffelb	org
@tyeolson	human
@LucyMLL	human
@ProfssnalHobbit	org
@dwaejieolgul	org
@lamyingwai	org
@theladymash	human
@carlomagno4	human
@gitaFPS	human
@Yosh_10	human
@Tasty_Mutkitch	human
@caren_chastanet	human
@Preeti_PCH2004	human
@camloverme	unknown
@FutureBistro	org
@loudeaters	human
@CypressStreet	org
@NathJDixon	human
@RafflePrizes	org
@cristinamassei	human
@CMLobsterHOU	org
@adoredbeloved	unknown
@MrHerget	org
@cathrinelysters	human
@An_nowed	human
@BreatheEatLive	human
@MikeBergmen	human
@fashion_isha	human
@BlueMooseBoCo	org
@Pixi_Jasmine	human
@aussielollies	human
@eyesofangie	human
@MuseOfPowers	unknown
@minamasotina	human
@ToTravelToLive	human
@pets12251	human
@RinnaAngPan	unknown
@vitaladvocacy	human
@SmartBowl	human
@Sasha_NY	org
@runmom262	unknown
@DJPurdysLounge	human
@DaRealBigRussco	human
@EmmaTey35	human
@Gastrogram	human
@Jasmine___zc___	human
@dra29	org
@vintagegwen	human
@TF2lovesBBBeast	unknown
@TiaOktarani	human
@TheThirstyKoala	org
@norainihashim	human
@iberostarmca	human
@ColoreItalian	org
@paycompliment	org
@angelmasungit	human
@despedida92	unknown
@msmoozy	human
@Hank99Costello	human
@jupinkorea	human
@CRyanMFA	human
@neon_moose_	human
@ColcordHotel	org
@peacecereal	org
@brittany_foley	human
@WindyIDOL8	org
@believe2knowing	human
@ZizzlingHottah	human
@POPCORN_A402	human
@JWKingdomPoetry	human
@cotton0828	human
@thetriplefblog	human
@casa_russo	human
@eatmaldives	org
@Eri684	unknown
@life_h4cks	unknown
@VegaSlager	human
@Hooper27	human
@mysuccessmind	org
@fercro	human
@dantenicogarcia	human
@roronoa_zoro92	unknown
@avyoga8	human
@rihannafreedels	human
@UrbanZenNerd	human
@xiaoyingxmm	human
@crissyf7	human
@Kurniawan_Ekow	org
@LaBorsadiMartin	unknown
@NoFussLunch	org
@coolbeanscoffe1	org
@TheBentFork	org
@Corie_NLFTW_	human
@mjj315	human
@kimaru_es	human
@MonikitaLop	human
@CGroveAcademy	human
@Rob_iTussin	human
@Darshnoosh	human
@DonAntonioPizza	human
@vanie_wh	human
@A_Gribkova	human
@runnersworlduk	org
@jackuce	human
@NanisCm1	org
@saka_bistro	unknown
@diamondd6	human
@Joss_Lopz	human
@DandyEspresso	org
@Mlle_Mode	human
@MermaidLimoMiss	human
@mnott71	human
@3frina	human
@THEALEXISSTEEZ	human
@1065Logan	human
@daidasnda	human
@Elyana_Mazlan	unknown
@zvenalot	human
@RichFlavored	human
@Dayi_RD	human
@nose_uio	human
@SwingSwingLui	human
@buuzach	human
@SMakeupArt	unknown
@KoffmannPierre	human
@mrxfresh	human
@ionele	human
@3lface	unknown
@nightsunkate	unknown
@JenLamparek	human
@ConsciousMax	org
@AxelMoschella	human
@anais_chapel	human
@joshv22	unknown
@fol_t	human
@Tee_kzn	human
@cf6fig	human
@katmedinanino	human
@ORAtynemouth	org
@SuziUrell	human
@WarungLombokku	human
@_Samra_	human
@FSBuenosAires	org
@jimspul	human
@twrintter	human
@travelwok	human
@angeliqueaddeo	human
@BlackBettyYYC	org
@Crasher7	human
@ecememecan	human
@Winsome_Wench	human
@HungryLittleOne	human
@jerrymai78	org
@MsPrimaDonna92	human
@KitchenColumbus	org
@nadeeya_aziz	org
@MomsAMCoffee	org
@MelanieDelcourt	human
@MelisaWidya	human
@ManlyManKitchen	human
@anirbase	human
@etriggNews	human
@sophiestanek	unknown
@bettamassari	org
@Panorama_Hotels	human
@NeuvooCambridON	org
@Teedo_Bee	org
@eseanhaff	human
@josephalara	human
@Ping1375	unknown
@mariecoronel	human
@yuuscafe	human
@PENNIE_MA	human
@vvakita	org
@zhpzhp	org
@LLWrapStar	human
@Michaelxfc5	human
@Ojibray	human
@Karls_Cabin	human
@segakei1969912	org
@cherubicluv	human
@ArliciaArgraff	human
@earlstinpalace	org
@DYOpizzas	human
@bambiniCLV	org
@SheMcKnightMare	human
@SocaDread	human
@NanaBanda6	human
@gebunaire	human
@mrlang30	human
@ChikPizza	org
@doux_hvit	human
@PrettyGirlyXO	org
@WinterCobb1	unknown
@enzorreal	org
@UpfrontFoods	org
@riana_rina	human
@BaxStar23	human
@ikayuwanita	human
@caezarsalad	human
@iwrapandroll	org
@eltanto	human
@ariana_galvez	human
@barrila	human
@KEWOMEDIA	org
@adomesticmomma	human
@GramercyCafeNYC	org
@MeowMaisy	unknown
@tomsrestaurant	org
@myMusicalSeoul	human
@LizHealthCoach	human
@toffeesy	org
@InnCaptain	org
@gokhanersan	human
@HotelArtetxe	org
@nabillajeffries	unknown
@kutnup	human
@kauaiianSun	human
@ntk_0620	unknown
@absolutJOEyang	human
@galeycious	human
@ombremadame	human
@MGMGrand	org
@lilimoun	org
@neilgallegos24	human
@theReal_Rebel	human
@TaniaFNav	human
@moxiefitnyc	human
@TylerHerman13	human
@PacciSavannah	org
@Bridgeways	org
@SyamTigerSy1	human
@Cris_Gomide	human
@urrrecords	human
@DoonanRoss	human
@DeniseTye1	human
@HungerBlogger	org
@chefryanscott	human
@AlienJunkyard	org
@NothingButChicc	unknown
@Hungry_Hounds	org
@Volcano_View	human
@AlanazizAlan	human
@alperlenger	human
@thatageguy	human
@maaya0118	human
@DocWaaaaaa	human
@Bandibros	human
@NatNi_cole	human
@Savenors	org
@TongKarina	unknown
@ividfw	human
@PedicabColumbus	human
@itsgii	human
@zontee_hou	human
@yuuuqing	human
@portia_shaba	human
@restorandoarg	human
@kenz_drummerz	human
@ffarrales	human
@MiaElanda	human
@cri_francescon	org
@SCGPrinceton	org
@JmCastillo91	human
@Lilily17	human
@filipinofood	org
@Jeff_Liranzo	human
@Krista_Ra3	human
@FaVeMom	human
@nisharawal	org
@SundaraBali	org
@ClaudinhaStoco	human
@TheFoxhaminn	org
@SAMIRISMYNAME	human
@Photo_David	human
@aboutherts	unknown
@Mission_Inn	org
@kogidsagdsa1	human
@LukasAtWork	org
@xiansilva	human
@stellabass	human
@StefanoPaddeu	human
@haute_coutureB	human
@ShantyFries	org
@nadt_dia	human
@ijaffery	human
@oneOAKpgh	org
@ninab00b	unknown
@RonnieSDeMesa	human
@JWCostaRica	org
@Virrency	unknown
@FelizFe	human
@benjaminquirk2	unknown
@PatLaFrita	unknown
@1BarbaraJohnson	human
@hndgn	human
@FrenchBakeryDXB	org
@sha1live	org
@brooklynsupper	org
@Sapph1que	org
@mglynnphoto	human
@omienadiem	human
@deborahjoelyn	human
@glossupparis	human
@AngelasHappyFam	org
@lorirampal	human
@lasarahbihh	human
@TheBarn_LC	org
@NicolaBlane	human
@pjpike	human
@rahulp1983	human
@SuperDustin83	human
@AnneStull	human
@Al3x_3	human
@TheCLRadio	human
@prada8heidi	human
@Kidfrom1981	human
@mallfreek27	org
@EStrawberryKane	unknown
@Uhlalabeachwear	human
@topherlytle	human
@teresuz	org
@Monique100307	human
@ClaudiaScholtz	unknown
@toms_deli	org
@CallmeJhony	org
@jienzlouvanne	human
@KathZilla79	unknown
@OffersAfrica	org
@Chocho_Bass	human
@AgdeVoyeur	human
@Hotelsverona	org
@JenniferTapiero	human
@_aurianeB	human
@Black_twiiter	human
@ClubMelia	human
@BuzzyGabbs	human
@BestFoodInMTL	org
@zkharmaz12	unknown
@CourtneyLoveNJ	human
@GeeReyesDawal	human
@captgray2000	human
@SunnyYummyUS	human
@fatguyonfood	human
@diva_diplomatic	org
@HeeyGer	human
@albriantimbowo4	human
@AmeliaSugiarto	human
@rafalmlifestyle	human
@izadnoorshafiq	human
@edwordspark	human
@quchun82	human
@wehehehek	unknown
@Anthony_K86	human
@41Sanitonbiz	unknown
@SayWellness11	org
@NikolaNovek	org
@kvinod	human
@katculver	human
@BeefRD	org
@rhh	human
@TheRealFlawZ	human
@BagasSwibi	human
@ealingcooking	org
@RitaLouren	human
@zafarwestern	human
@riailano	human
@michelesavery43	human
@GlamNiki	human
@MoonElleisback	unknown
@Charlie84Dee	human
@DNaJN	human
@VegGastronomy	org
@RogerSoven	human
@TheAlbany	human
@KenyaPhonevilay	human
@unita_salvator	unknown
@DAngeloKate	human
@yaelyraz	human
@NicSandman20	org
@CasaPanzaCafe	human
@MyriamAuryner	unknown
@andreacassara	human
@IrmaG	human
@bolshie_walshy	human
@judyogana	human
@I_PR_THINGS	human
@Chi_DMB	human
@LaylaWei	human
@miyashito	human
@TableFiftyTwo	org
@CFA_Rivergate	org
@SofitelLeLouise	org
@madeleineteacup	human
@Vishayne007	org
@harpsjax	human
@JakusSandor	human
@devilpleng	human
@MaxFerrara	human
@loeakaodas	org
@jamindie01	unknown
@XWoman54	human
@naruhodo_love	unknown
@AliceGarsideX	unknown
@JHomes101	human
@IMNJude27	human
@raj_madhuri23	human
@micko2eight	unknown
@tuuur_k	human
@gingerpop3	human
@TapHouseUCity	unknown
@EllieEllisa_x	human
@SerchiLara	human
@Ali_Sabah90	human
@DAIMYS	org
@CookitSkinny	org
@kozue58106	human
@13360016ka	unknown
@laila_jane	org
@sayapocha6	human
@tatandtrat	unknown
@FollowCampano	org
@yoannajames	unknown
@GEE_VIVAS	human
@CLbycjt	unknown
@sellrestaurants	org
@ThGdThBadnUgly	human
@hanslicker	human
@ATWShoppingTour	org
@knitrunrepeat	human
@ninangablak	org
@_MichellePa_	human
@Han_Stubbs	unknown
@homelifecomau	human
@nickye94	human
@VirginiavBlair	human
@KaramellaBelo	human
@ryanleinonen	human
@NgJocelyn	human
@angelbuenano	human
@t_jasonrigby	human
@TweetThis_WA	human
@sentralpudu	unknown
@KittyCrackHouze	human
@DiMantilla	org
@fitmarkbags	human
@ToBeFitForLife	org
@AilbheC7	human
@juarezruben	human
@kate_chout	human
@katherinequiel	human
@Sangkwanmeicen	human
@CaribbeCuisine	human
@mayito92	human
@Kipseys	org
@jeannebee	human
@GameOvR_	org
@GrainandBagel	org
@ciput26	org
@shanluvlollipop	human
@BUGATTIE1	human
@__JMX__	human
@PRHTH	human
@gulzeynepoz	human
@marcograjo	human
@NeedBrands	unknown
@ROMEFM	human
@MFetalHealth	org
@danielealbieri	human
@dewysue	org
@AyeSonSon	human
@MOLLYMARINE46	human
@shafna_eunhyuk	human
@katberries	human
@citrameiliani	human
@WestbrookMall	org
@SantaBarbaraXO	org
@imeci_s	human
@eddieacoustic	human
@sweetcsdesigns	human
@helga_cassandra	human
@vale_costabella	human
@janejudykitchen	org
@margotmood	human
@tasentimentoita	unknown
@VSChris14	human
@CindyLo91	unknown
@myfashionbreak	human
@AllisonRivas	org
@HeightsDC	org
@TC_Albright	human
@kojitter_h	human
@pwgnq	human
@enmicolombia	human
@SayWellness32	org
@5SeasonsBrewing	org
@LulyNahas	human
@ArleneConde3	human
@OTEsuperfoods	org
@jessbeachbody	human
@nsaplan	human
@christy92374	human
@foodprofits	org
@TheBalconyBrum	org
@stevemanning15	human
@HarleysBelfast	org
@salinasivannyxx	unknown
@Shortnique	human
@BionicBecky79	unknown
@TheMarkCompany	human
@wepe_here	human
@seiji4645	human
@TonyFernandez71	human
@FairleighJessec	human
@mufasa487	human
@ClubCreativeArt	org
@ski_57	org
@La_Caprichossa	human
@BigDawgTravels	human
@SuperNcl	org
@chinosskie	human
@TheRealHJC	human
@Jinchaya	org
@Cheryl_Schwerd	human
@Leanarmesto	human
@richellemabell	human
@jaciebell21	human
@eri_0908_	human
@ACBLive	human
@antjones87	human
@LobsterNYC	org
@SamiraClabburn	unknown
@melissabastos	unknown
@Benefitsandrisk	org
@AriQueenOhearts	human
@torri_lounge	human
@JohnDoe_JBurg	human
@jenzy93	human
@presidiochicago	human
@TheSandstone	org
@BonniePena	unknown
@AnneMarieDinard	human
@07mealsaday	human
@Moussa_Hamzeh	unknown
@Liebiet	human
@IronSpringsCafe	org
@hide_pad	human
@DNM_Aus_Bars	human
@antique_fukiage	human
@nita_vann	human
@FlamingWingsPH	org
@ChefBillyParisi	human
@chris_dee_chris	human
@madikeeper12	human
@PastaVinoMiami	org
@mintwalkoflife	org
@CbijiCollection	human
@EmaJoyC	human
@may14luvS2	human
@paulvangura	human
@LamborghiniRell	org
@always_shem	human
@BerlaA	human
@EykieMicky	human
@Maroush	human
@bunnygirl793	unknown
@bellinstitute	org
@SashaVK	human
@Sc7girl	human
@joe_toh87	human
@glaiza_pascual	human
@Aljaadi_A	org
@zahidahmy	human
@BAYSIDEIMPORT	org
@showta1212	unknown
@KilikyaResort	human
@KioskKingsCross	human
@Niki_Chin	human
@DJBARTOCH	human
@_wuvlee	human
@parkavenuenyc	org
@532_943	human
@HiSarahLinda	human
@yongz_here	human
@casaeglys	org
@Block34Kitchen	org
@YanairaHazoury	human
@KirstinPMG	org
@pghcrepes	org
@cyndo_bish	human
@atelierBB	human
@thedhakagirl	human
@Fanny_Laetitia	human
@Nintendboys	human
@HoneyBeeDinerMD	human
@mixxytwixxy	unknown
@DjHarout	unknown
@JessicaLThomas1	human
@ClaireS_LDN	unknown
@LorraineJDion	human
@MelonPlatinum	human
@Yayi_Dlc	human
@MilleFleursRSF	org
@mrsharrison1971	human
@sylbaranowska	human
@lisanicoled	human
@annabieh	human
@FIT29205	human
@MarvTheTrainer	human
@DragynAlly	human
@JamesMullerPhot	human
@OliverCarnay	human
@AleksandraS_67	human
@karlaavh	org
@njd_alburky	org
@HOF_Chile	human
@me_rna	human
@bonbitenyc	org
@heatherpavlik	human
@DilaraAdiguzell	human
@mummynewton	human
@ZenofFood	human
@tessathetiger	unknown
@_Jai_C_	human
@Laurenmxoxoxo	human
@patrick_hair	org
@macboi29	human
@ElizThomasPhoto	human
@AnnaMariaJans	human
@_iam_chad_	org
@d5g14wm8	human
@PsychoJho	human
@PattyCakes_65	human
@christianewalbu	human
@muslin_fai	human
@asianemoboris	human
@Arinn_Romteera	human
@Lady_15anne	human
@Ines_Howi	human
@aubrylybbert	human
@SmartHotelRome	org
@JJustine_MUSIC	human
@DTownBostonBID	org
@Graziella_a	human
@TheThirdie	human
@TeeYang93	unknown
@manna_bakery	org
@trickyvondickie	human
@njlilo	unknown
@africanfiesta	org
@Sushi_Flower	org
@asimoalex	human
@hooomit	human
@careykking	human
@foodieoncampus	human
@1UKTogether	org
@ivana3j	human
@eatspinrunrpt	human
@SoleePintos	unknown
@CstoneGuelph	org
@aliyahhhalleyne	human
@arielpoems	human
@noopwanii	human
@Jorgecanetes	org
@bullbythefork	org
@x_Lady_Lunge_x	unknown
@angeleocasio	human
@davidyii91	human
@beatrice_clay	human
@DidaNadira	human
@chojejee	human
@ngorges	human
@PizzaEastChi	org
@NetaTT1	human
@BrianPinaud	unknown
@chipnorteas	human
@jozzy78	human
@AnneThorpNZ	human
@miss_tarynbain	org
@Onlybadchicks	human
@franlorenzz	human
@BlackBarbie818	human
@Mars_MUA	human
@denicedal	human
@thisara8	human
@jonnahmyrielle	human
@RicoNOTSuave	human
@timbetasame	unknown
@JMK9575	human
@axelescuderoPR	human
@ricettamorevero	human
@GerryCupido	human
@PamelaSimo	human
@imasinnersaved	human
@SAM_COLLINS23	human
@chercherousse	human
@mouselink	org
@johncharles39	human
@indirabart	human
@The_Papilion	human
@diKiRei	human
@missstephgetfit	human
@jackiefitgirl	human
@TravisTT2	human
@tairamichan	human
@MouseMonthly	org
@Edesia_Kolkata	org
@jdbdf	human
@restauranthour	org
@jtownsendphotos	human
@princessj24	unknown
@karol_arenivar	unknown
@OrtegasTacoShop	org
@bluediaz	human
@aldoM0R3	human
@pinkviixen	human
@prestigecater01	org
@MyTravelPicture	human
@itsmeVA5N	human
@tatsuyaishie	unknown
@NorainAzlan	human
@yumieSENDAI	human
@JustJennDiaz	human
@Bibbers93	human
@Cosmonauty	human
@anhromeo	human
@CopyThatMPLS	human
@dellchanting	human
@RinVeganland	unknown
@Takyla10	human
@AlCanyon	human
@pochi_zz	human
@Maria_Pescrilli	unknown
@Parispelemele	human
@CupcakeMOMents2	unknown
@Chef_Shellaay	unknown
@solmansallu	human
@HarvestKitch_TO	org
@MailMovement	human
@BryVerified	unknown
@FitnessJOQ	org
@86Thousand400	human
@thebuffster03	human
@MundoveganMtc	org
@nethergreens	unknown
@BonaseraZee	unknown
@localsseafood	human
@Bidwelldc	org
@NinjaStephen	human
@rococoalamode	unknown
@achefcareer	org
@TheStonehaus	org
@MC_Sam93	human
@TZeibert	human
@NationalMiami	org
@ThinstringAsya	org
@CookingCin_	human
@MRestaurant_PHL	human
@DrFoodie06	human
@lucymurphy14	unknown
@parv85	unknown
@LDNBestBurgers	human
@MelodyCorp	human
@stylecartel	human
@heirloomhouston	org
@mayahmh	human
@jordanobinger	org
@YummaNumma	org
@YasKhiari	human
@ankitrajdesai	human
@vxdollface	human
@LilliSpice	human
@LaGourmandise_	human
@kokhui95	human
@We_Love_DPC	human
@wilsonjim	human
@craigwatutu	human
@LeClubVoyage	human
@thatchertime	human
@tmcn521	human
@TV5MONDEapac	org
@MisterRiemann	human
@DwightsRecipe	org
@AuntRuby	human
@Victoria0464	human
@SylvieTse	human
@atelierFeliz	human
@teeco71	human
@skateinstagram	human
@mipolilic	human
@JacintaNgobese	human
@RobertoGroban	unknown
@holgersupper	human
@Giampanet	human
@noorhal	human
@Rethink_Healthy	human
@magalhaes_zeus	human
@betinho_santos	human
@ShekinaPlace	human
@LeiLeiClavey	human
@ernestyboi	human
@dannythehoofe	unknown
@nana1392	human
@rossanacamila	human
@kevinmeyerson	human
@ViBE_ub_orange4	human
@kamisini	human
@CarringtonFarms	org
@lc_torres	human
@_kdLyn	human
@mady_marrez	unknown
@DJsayurita	human
@VillardMR	org
@foxylady2KX	human
@pinkgulz_p9	org
@VapianoUK	human
@JacquelineM96	human
@Toscano_DOC	human
@SayWellness2	org
@manitobachicken	org
@NIK_Laus1607	human
@MeatMeAtHome	org
@Chrissstiani	unknown
@Gev4r	human
@KristenCarlucci	human
@gizelethakral	human
@JoeyisSexyrobot	human
@c_argasn	human
@trehaushinka	human
@ztemelkov	human
@hirokikumakun	human
@MasterChefPK1	org
@batinojayvie	human
@IRdina824	unknown
@pherlhaaguilar	human
@OnlineSandwich	human
@harmjob	human
@VicSpiritFitnes	org
@SabBess7	human
@mudcic	human
@GoodLittleMom	human
@debatma_m	org
@SupaStaxx	human
@masumin	human
@VEKSLERS	org
@miasarafaizal	human
@IfatRajaMUA	human
@RenAlburo	unknown
@terriarcelia	unknown
@oliwkagrochal	human
@Gazzaroonii	human
@innatelychatty	human
@MackeyX2	human
@Oliver_Bonacini	human
@ilovegreenbean	org
@dj_kazuhiy	human
@jfair243	human
@MichelTptkn	human
@jojosylvie	org
@AdhaOnline	human
@JudittMoreno	human
@zkharmaz24	human
@zoelfa	human
@dv1005	human
@TopSalesTweets	human
@zkharmaz15	human
@KimChapman82	human
@MSCMommyLife	human
@yvonneb1412	human
@asiansoundradio	human
@minmo_124	human
@chelingiov	human
@WHWNKrista	unknown
@EBFbyashley	unknown
@Pure7Kandii	org
@BestMom007	human
@free_retweetbot	human
@RamenDaysApp	org
@Modakanali	human
@UrbanHypsteria	human
@waseemwsm	human
@MissSydVicious	human
@nascheisnasia	human
@Newtons_Clapham	org
@axpad2013	human
@vishwamenonn	org
@DJLadyDVA	human
@GarrettWorth	human
@mathones	org
@LadyZolza	human
@my2ndbreakfast	human
@IvanGrcevic	human
@XxCrashQueenxX	human
@JimenezMamon	human
@llawless27	human
@farrisrashly	org
@Angie_YO	human
@toffeemilk	human
@thewannabefoodi	human
@SailorATO	org
@BoltonLovers	org
@Whiteliphant	human
@phoebe_cheong	human
@patrippicatoste	org
@yumi_219	human
@Gummy_Bunny	unknown
@clairemel_81	human
@Edw140	org
@Ecco_Pizzeria	org
@LipzSo_Dope	human
@That_girl_me	human
@AminBaydoun	human
@JakeonFoodBlog	human
@positivefridays	human
@vivSanCristobal	human
@FeliciaAmar	human
@coolbeansweb23	human
@ToniaBuxton	org
@Fm1fmradio	org
@RonetteNyhan	org
@CardiffEvents	human
@cafe_loyal	org
@Eddduardo93	human
@BEZBZ1	human
@WLHolistic	org
@Social_in_SL	human
@blackwoodbbq	human
@RobertaRose18	human
@jopuxiqojap	human
@gabymorag	unknown
@zkharmaz21	human
@_teenadee	unknown
@MacHale_lunch	unknown
@HotelCrosskey	human
@AhxrhS	human
@OfficialENPT	human
@Chiffoncake	unknown
@NYphillyD	human
@elisaprits	human
@Swathirishi	human
@martinezhotel	human
@PhilJohnsonNYC	human
@artisthepassion	org
@lafromagerieVA	org
@EatMoveBe	org
@CFlsvh	human
@NickErodotou	human
@GreggakaGrock	human
@marielyzorrilla	human
@NEBOUTROSELINE	human
@SavourySweet1	org
@markiebittner	human
@_AidinIsmail	human
@YunetBanget	human
@MAZWOFOOD	org
@DominiqueHornig	human
@whiskandknife	org
@whimsiclejoann	human
@jolynntoma	human
@Jehad_Omaar	org
@underdeskloser	org
@LisAmelow	human
@BettyAbas	human
@DusitPhuket	org
@ChloeCountertop	human
@glessygreat	human
@__Herzmaedchen_	human
@Agne_Egan	human
@Michaels_Deli	org
@eumom	org
@LaBohemeTurenne	unknown
@Fifi_Light	human
@Kristy240	human
@pmcchennai	org
@KnockoutJames	human
@myezplan_HAPPY	org
@SwtGirl7	human
@DaddyFunk_DF	human
@GladysPrasethio	human
@cynpark13	human
@joyceszuan	human
@4theLadyGatsby	human
@designnap1	human
@joncrosshound	human
@caiferrer	human
@ZarasFishbar	unknown
@JPSTURSA	human
@CafeduMom	human
@ValerieSweeten	human
@EnterateChi3LS	human
@ThatSuperStar	human
@FondaRestaurant	org
@amitace	org
@GingerHill13	human
@malikahii38	org
@akosupermark	unknown
@SexySupermom84	human
@mrsbaggybakery	org
@ReniaEats	human
@uehiroy	human
@corinthianspune	org
@Meenakshi1Singh	human
@Subterraneanbug	human
@JPcrazylady	human
@RasmusOrsen	human
@HypeGirlHerself	human
@SayWellness8	org
@GiHFoundation	human
@anaa_machadoo	human
@FYAH_Hawk	human
@Joesphangel	human
@yolkery	org
@korinnyn	human
@Minesapintcoco	human
@angeloeliapizza	org
@matsullica	human
@litwinenko_ai	org
@m1exxx	human
@gloriawalthour	human
@GrannysPoultry	human
@NRandCo	org
@hengsun0309	unknown
@RN2radio	human
@MzNay414	human
@Gamers_Account	unknown
@styleonpicture	human
@_Lamillarenee	unknown
@VivaCardiff	org
@mochilol	human
@Fradelia	human
@roastwinner	org
@6abrielle	human
@lamonasevistede	human
@ReneOct	human
@TheOldCrownPub	org
@AndreaTorrielli	human
@ColleeCupcake	human
@JCopeland_1	human
@gofanly	org
@FunkytarraDoc	human
@AndrwMario	human
@Marty2202	human
@katcapistrano	human
@MahanLees	unknown
@DeeJayVenus	org
@_LoveAleph	human
@realbrandnew	org
@SIMHQI	org
@LadyFra_	human
@mohapatrapratik	human
@DocCoast2Coast	unknown
@BournemouthLuv	org
@aucklandpt	human
@KMJerrod	org
@tythebarnhouse	org
@welliestorquay	org
@gra5105	human
@Hy_poten_use	unknown
@CFsnackco	org
@hoodster85	human
@Bodyholic_AT	human
@MessyBakerblog	unknown
@naaaho28	unknown
@RealMomTime	org
@el_ware	human
@OrleanMarket	human
@CosmicBali	unknown
@60littlepiggies	human
@YYCPUBS	human
@teddynanabear	human
@Faith_Wilsonx	human
@Sunny_Kupcakes	human
@tibits_uk	org
@KerBoomKaFit	org
@RhondaLaurel	unknown
@DaBlaznAzn	human
@NajwaHijabi	org
@Marco_Bruto	human
@vikayasmina	unknown
@kandikalistar	human
@interimpool	human
@Kindform	org
@aacostaa	human
@BlindSarcasm	human
@Christinedeb	human
@LC_Hamon	human
@Lovely_Boiser	human
@KGB	human
@ranja28	human
@mora_negra	human
@OriGourmet	org
@HeavenlyFoodCo	org
@DrTarekTawil	human
@Beauti_Brit	human
@farahlee0808	unknown
@lifesagna	org
@Tamsalee	human
@MlleOnTheGo	human
@GDS_SKATE_SHOP	human
@mulchand	human
@Lee5787	human
@richard_larue	human
@akn10111	org
@AtieyPinky	org
@reallyrockyb	human
@ModernMom	org
@joancamile	human
@HerbaCrisGutz	human
@LeCoralHideaway	human
@pptsearch365	human
@TipsGuideLisboa	human
@xvickicullen	human
@paandooraasbox	org
@theheatherbrown	human
@gokibeatbig	human
@ZyraNazri	org
@FaJunqueira	org
@chefbevhk12	org
@LauraKellyPifer	human
@NewYorkPizzaBar	unknown
@megancalveley	unknown
@jsebapereira	human
@stephaniebcaron	human
@carrieeigbrett	human
@elegantcoretta	human
@Jessng0205	human
@JordanHowe314	human
@RedHead_Yogi	human
@LinnRedLine	org
@sangeraldortiz	human
@ConciergeBoston	human
@coeur_plastique	org
@ArySetiawann_	human
@StyleLobster	human
@nuitsocial	human
@sk_chu3	human
@_charliescrib	human
@SimonaTeDice	human
@WilmslowBusGp	org
@losingweightall	org
@tweetkzaman	human
@BizConnect_	org
@CHEWIII_	org
@knchobi	unknown
@LeslieMarket	human
@AuntyDanni	unknown
@VladimirLJean	human
@nadyzirah	org
@___suo___	org
@happyindulgence	human
@newportwinenchz	org
@katieturner1424	human
@ItNoUse	human
@Parisiantouch	human
@TheGFreeVeggie	human
@DrEdwardKo	org
@_twiKKer	human
@Shabestan_Oman	org
@ItsBrianD	human
@DennisJIrizarry	human
@PuresenseHealth	org
@77Noni	human
@gizli_sin	human
@sameashim2	org
@emrnbichu	human
@ciscopacheco	unknown
@chiarabenavides	human
@kalechipkitty	org
@sweetkieb	org
@51JKC	human
@leek425	unknown
@sis51551	human
@Sixces	unknown
@AlineTeston	org
@taataa_XD	org
@chubby_chaddy	unknown
@lisamercy	human
@nagynoora	human
@boatsmantornado	human
@anjaleeab	human
@casadofrango	human
@Gordana_S_	org
@madhasher	human
@arckelaus	org
@JenniferVuong	human
@roconn91	human
@reina828	human
@JADORemYCiTY	human
@Rosiewilding	human
@Boars_Head	org
@lTuPhanl	human
@zackarias95	human
@CaturraOnGrove	org
@dxbct	human
@Harude	org
@forgottenseason	human
@TheGrangeNew	org
@NicoMcLane	org
@ogu94n	human
@ROPoynings	org
@NoToOysters	human
@katehall66	human
@daizurui	human
@fayechan85	human
@Ashtonlee25	human
@guaderrama_04	human
@piano_luca	human
@VelmaT1	human
@amyleda37	human
@nycroom	human
@WonderG78	human
@MisFyd	human
@HeleneFanUK	human
@AnnyRdgz	human
@Solaire85	human
@ItzYaBoyNique	unknown
@thomasblythe	human
@bcnutritionista	human
@narrationbygeo	human
@AllThings305	unknown
@DETTALOVE	human
@SayWellness35	org
@PolenGeneration	human
@littlflo	human
@cheechakotaco	org
@pippo1101	human
@citygirlwriter	unknown
@arpanramtek	org
@GrandHyattDFW	org
@esmer_cedric	human
@MurgatroidTO	org
@a_toon	human
@SonicTheCobalt	unknown
@LeQuid2	human
@Nainerian	human
@CopWhoLovesCars	org
@juicybuffy	human
@Rivieracool	human
@winwithmarcusj	human
@kaylaloveslife	human
@Co_Bottani	human
@Instagnam	human
@ShaRealMUZIK	unknown
@ScentSlinger	human
@GeekGirlBrunch	org
@Asugar_spice	org
@b_felicidade	unknown
@ALIEN_vs_HUMAN	human
@LoveHappyHour	org
@TengkuMahfuddin	unknown
@foodprojectmex	org
@AbdullahMosaad	human
@SinnamonLove	human
@CFynn	human
@CaliLiliIndies	org
@mako104927611	org
@triciaaaxx	org
@AznLover4Life	unknown
@TheHolyTroller	human
@tintonisback	org
@ClaireBarrien	human
@SunTimesHNL	human
@24kryoxy	human
@Yates_Queen_SQ	human
@RedwaterYYC	org
@thedomesticfour	human
@chan_rayray	human
@rmz_arturo	human
@matsuke	human
@MyNameIsLulka	human
@ALEXPUJOL	human
@AlsPizza	org
@chaladeras	human
@bmthbot	org
@SiriluckMim	human
@nanaka9	unknown
@Oday324	human
@jeiveeChew	human
@L1Lbigbro	org
@thirstyreveler	human
@niradnab	unknown
@gourmond101	human
@KMIkkersheim	unknown
@BmoreRestaurant	human
@ISayDrellen	unknown
@JasonLittleDigi	human
@i_am_darvs	org
@lange_1989	human
@BoxParkMiami	org
@DenizSelcok	human
@foodcuriousblog	org
@winetimesES	unknown
@ExecutiveTI	org
@ChrisHideMusic	human
@mataveel	human
@MoinaRa	human
@ilfanta65	human
@kurniawanisme	human
@SEXICARAMELBAIT	unknown
@rachellehoward_	human
@NiaziKhanUmer	unknown
@Miss_Kjane	human
@DirwanLapaa	unknown
@jeehyekimpak	human
@onyxbeauty1988	human
@ozlembilis	human
@giovannifedel	human
@FinValko	human
@Es_Small	unknown
@girlieval	human
@kaz4thlife	human
@FGMGuk	unknown
@adnanprimi	unknown
@hrc_k5	unknown
@jensemilla	human
@tinker86belle	human
@thisisalter	human
@_KingMal_	human
@Kochhelden	human
@LeGourmetGirls	human
@KeaMotlokwa	human
@_JoshuaYo	human
@cathlynmay	human
@hktcap39	unknown
@anassstasss	human
@pacificmerchant	org
@publickitchensp	human
@LiverpoolLoverU	human
@MonPablo	human
@djOdyssey	human
@Beth_Tris	human
@MotherUnadorned	human
@ralefever	unknown
@bot08955520	unknown
@SorayaBSarcos	human
@TheSosChef	human
@YUI_WOMB	human
@Baxeriaso	human
@sky0804	human
@JoJoKittell	human
@WildCabaret	human
@AndresDavidRs	human
@amnos_kmkmk	human
@DaniellaSobers	human
@1dlegend	human
@TheRarmy_	human
@festejoselite	human
@jmpayet	unknown
@sydneycafes	org
@judy2357	human
@cookiescookiez	human
@Flambos1	unknown
@LinziLyn	human
@Blendhappy	human
@ncekk123	human
@Cesca_Louise	human
@privatesalemi	human
@DinnerLab	org
@KhunKaeMania	unknown
@nawalangintsik	unknown
@OpenTableCanada	org
@2525_Jculture	unknown
@SlimAkaCity	human
@conduitofhealin	human
@ROKAcanarywharf	org
@ahmadpiten	org
@JPCKuiper	human
@VlaamsArsenaal	human
@health_meme	unknown
@biggee122	human
@GetyaLiips_Wet	human
@cujilla	human
@JamaicaPegasus	human
@Jon_Herbalife	human
@GloriaMoncada	unknown
@Nutritionista14	human
@PNikolinek	human
@andcutecom	org
@shelbydelfranko	human
@EnriqueBlancoC	human
@hasithegirly	human
@Kelseypanter18	human
@NancyLowell	human
@REALJSILVEIRA	human
@minnowmep	human
@egemaltepe	org
@AQmkhq	human
@JoaniTaLaiton	unknown
@musclebabe91	human
@DevilOfASon	unknown
@wakanyan	human
@simpson5921	human
@morninglaurie	human
@Paul_Fogel	human
@tachachacil	human
@KeepinUpWithCDJ	org
@EpaoyDay	human
@zahirahud	human
@angielomo	human
@Alexander_UP	human
@Sheshadrie07	unknown
@lepointresto	human
@IslandHeatShow	unknown
@missannajune	human
@ChefGeovani	human
@JustinGomezland	human
@jhedcarl	human
@Holabk23	human
@snackwakochan	human
@parentnomanual	human
@SmallBizNetwkGr	human
@elihunter88	human
@NeuvooFairfiel	org
@AmyFashionBlog	human
@KarmenTahmasian	human
@StyleExplorer	unknown
@teerapatb	human
@oselubis	human
@amyorvin	human
@AmpnnCovun	human
@mikmakpattywak	human
@BarNine	org
@necoleferg	human
@DjLeeButler	human
@MalbecToluca	unknown
@FaFitSake	human
@laurapcalle	human
@AryaVintage	org
@Sacha_Visualize	human
@Bonechiller21	human
@SavouryFoodPorn	org
@valentinads9	human
@wnkqw	human
@_Izzny_	org
@stephs852diary	human
@HomeOfGastro	org
@slobokan	human
@Blakhopela	human
@BlacksburgStuff	org
@brigittesan09	unknown
@ssmeimei	human
@Naisenya	human
@el_tapis	unknown
@freshdinner	human
@NYCMERCEDES	unknown
@honeynation	human
@joiga32	human
@compassgroupuk	org
@PoundandPence	org
@CarlyLynee	unknown
@JeabWara	human
@keiichinitta	human
@JenRamos	human
@LidaBand123	unknown
@addict_xx	human
@DanishRabbbani	human
@barbarosa1	human
@Fit_Fresh_Happy	human
@AnswersDotCom	human
@DougCookRD	org
@JulieHyld	human
@Meribu1	human
@AlejandraAnson	human
@MNCBariatrics	human
@HoneyVillah	human
@kellie4inchey	unknown
@lottybrouwer	unknown
@ScampisCuracao	human
@majuzub	human
@caerleonlass	human
@stooffi	human
@SophiaIv	human
@FrolicChocolate	org
@cindy987620	human
@EmmaFisher34	human
@almati2011	human
@angel_soe	human
@QueenNgozi	human
@workoutwithdi	human
@e_janeen	human
@ViGo69	human
@aaaki222	org
@henrikmaass	org
@JoseVallejosII	human
@deedeelawlaw	org
@tampppmat	human
@davebegin	unknown
@WantonFairies	human
@eatahfood	org
@roxeehasmoxie	unknown
@BookofAdele	human
@luaana	human
@thejoyofcaitlin	human
@VANEATSca	org
@dewizulliana	human
@Cso_Productions	human
@Coolzster	human
@howtofeedaloon	org
@murthism	human
@barefootbysea	human
@3_shewee	unknown
@zongxianwong	unknown
@BandBLiverpool	org
@SoSoulfulENT	human
@DanaMoos	org
@memememere	human
@SophistiXindo	org
@TiaDDiva	human
@honeybee2780	human
@sweetmausepaul	human
@JeffreyJah	human
@dotsandhoney	org
@imjessrose	human
@mary_swisch	human
@chefgusep	org
@GabrielBoisen	human
@alan_sommerman	unknown
@DIYTOUR_	unknown
@TheSistersCode	human
@uskeda3mm	human
@beiLeY	human
@NatalyaAndreya	human
@USATrek	human
@lewisjmcrompton	human
@claypix	human
@Parpiglia	human
@Promo_art_deco	human
@henrygayle	human
@opusca	unknown
@EAThardPLAYhard	human
@jmajeerseo313	human
@extremesb	human
@TweetsShopping	unknown
@jliaiv	human
@saraloves_26	unknown
@Jamie__Wang	human
@ingridsantos	human
@DealOfTheDay05	human
@RomanGlos	human
@UrbaneSeattle	org
@yhellows	org
@NicoleBrites	human
@onarres2much	human
@6sec_warota	unknown
@KeumJoonFei	human
@EnZinEcreations	human
@Kingstonfirst	org
@EatIt2BeatIt	org
@HIWashington	org
@BrandyCole	human
@l00ners	human
@39Sanitonbiz	unknown
@CetinNaciye	human
@criluna	human
@LunnFaye	human
@LusciousLana04	human
@SayWellness5	org
@kwbobear	human
@GlutenFree_GPS	org
@skpcnn	human
@SAlexanderia	human
@SBbyMM	human
@AnaMargaridaLR	unknown
@theposhblog	human
@LOOPSANDCOFFEE_	human
@GuildfordTalk	unknown
@republikaonline	human
@Emeka_Oka	human
@FiliniChicago	org
@WeiSclou	human
@harsha85	human
@MightyTravels	human
@CloverFieldsKY	org
@ElGarmento	human
@rbmdk	human
@chris_JoNeS42	human
@MommasWondering	human
@doganabuongusto	human
@HotelXeniaLND	org
@lavoz206	human
@AinulFathilah	human
@JBrick1020	human
@sitareceylan	org
@alku	human
@_JudgeDredd_	human
@djmodshowtime	unknown
@Ashleys_Tube	unknown
@yourjelai	unknown
@ItsPerfectTen	human
@Maegatron	human
@aleruga	human
@CompassCoffee1	human
@YaBoytheFee	human
@TekoYoungCity	human
@ChadVonStakxz	unknown
@foodisourfriend	org
@koleenoreo	unknown
@suunnymatharu	human
@ChutneyChefs	org
@PhilSuccessful	human
@Msgogin	human
@konglt_eric	human
@bodydynamicsfit	org
@EatVeg	org
@mamalik7	org
@SexiDimples1969	human
@mhplp	human
@jlathegodsson	human
@TMJofficial	human
@Gilla01	human
@edanherg	human
@phdavieswriting	unknown
@Playm8z	human
@mystarlight22	human
@321SpiritFit	org
@WMprmf	human
@melbaby42	human
@yuzirneyms	human
@primanirules	human
@kumiko_takuiji	human
@krsphan	human
@soniaestebanEP	org
@SamerMawed1	human
@collsdishes	human
@DecadentDiner	org
@rai_gene	human
@iamlegaci	org
@officialsouthst	org
@NoeBucks	human
@myhellodesigns	human
@lisawingate37	human
@hidy_her	human
@MilesDavis510	human
@malena_floress	org
@Abdemx	org
@alexacology	human
@ViBE_ub_peach2	human
@iuliana_fs	human
@bcapmc	human
@bubupearr	org
@chellemalle	human
@NicoleMSenior	human
@NBnutritionist	human
@Almacabred	unknown
@ChangoEmpanadas	human
@Snkoot	human
@jomacasa	human
@karenstl	human
@PinayStyle87	human
@AkimasQuality	human
@cyberchickgeek	human
@jlittle3010	human
@danjames04	human
@TurnersYard	unknown
@SamanthaBlair78	human
@ShaunTwaz	human
@AndreHansen	org
@KateMantilini	org
@biew_	human
@NancysYogurt	org
@tkybaking	human
@LovelyMama6996	human
@quatresprincess	human
@Im_Javerl	human
@valleygirl32	human
@RadioRobC	human
@keira1978	human
@SarahKaminski1	unknown
@AaronRaj14	human
@RossettiValerio	human
@xtinevanadero	human
@MissLolytha	human
@Mr_GO_Rilla	org
@Lauren_S_Clarke	human
@ReneePeterson	human
@AniTheTechie	human
@gra55garcia	org
@SBGstyle1	human
@easydetoxjuices	human
@ezafahiza	org
@madeinbelfastn1	org
@EchanningBlog	human
@kikcal	human
@omnidesigns	human
@Health_Focused	human
@nutsaboutveg	human
@pameladiana373	human
@allybeesunny	human
@EnhanceCCTV	human
@KishoreRF	org
@Hightech_girl	human
@Ernestongch	human
@dongdepoysterqh	unknown
@MrsSJHarwood	unknown
@Queen_V71	human
@heatherthurow	human
@WriteRepeat	human
@zkharmaz6	org
@AprilGHudson	human
@See_her	unknown
@Im_Cheaper_	org
@rettagec33	human
@EmInSpandex	unknown
@marijntjuh89	org
@getrawvegan	unknown
@ulissedeluxe	org
@robinbatra123	human
@ausmican_eats	human
@shaurasar	human
@hjamesdesign	human
@JoAnneRowney	human
@jv_ht	human
@BrittBanks15	unknown
@peeledjuicebar	org
@luciesafarova	human
@wayne138783374	human
@cristycamachop	human
@NutritionMyWay	human
@1BillOsgood	human
@PeteC1981	human
@saminthestreet	human
@celine_mueller	human
@BestAppLists	org
@woahsuzy	human
@galactic123now	unknown
@its_foodie_time	human
@princesszaga04	human
@chiclona	human
@eternal_75chika	human
@DeLasCondesCL	human
@maxmak7288	human
@beckietran	human
@dinedelish	human
@Shifa_Afi	org
@AlliumFW	org
@dancingmeemay	unknown
@DappaMike	human
@kelliejansen1	human
@JulieMWinch	human
@WotzenTiger	human
@oliviayuvina	human
@2Night_Nyc	org
@Kajkkaa	human
@Cavalier902	org
@adayeung91	human
@kawagoe_bot	org
@TanayaMarcia	human
@vpinoychick	human
@AMILIES_WAWA	human
@Hariz_Hasnan	human
@ismaOng	unknown
@EmiliaLucia	human
@MrsKhatwani	human
@k8droste	human
@SpiceBoxMumbai	org
@AgourasDeli	org
@Nell_Wulandari	unknown
@CulinD	org
@yayietorres	org
@JopetPesigan	human
@franchisedunia	human
@rajakumaari	human
@magellan_ret25	human
@DJDELVE	org
@electroSteveJ	human
@De_Cos1972	human
@pinkspanannas	human
@mnista0503	unknown
@kwliulam	human
@lisa_austrian	unknown
@Nectar_Amrita	org
@navygimlet1793	unknown
@rushykin	human
@_SHiiyA_	human
@JohannesLuckas	human
@lysann22	unknown
@RothCheese	org
@CellarPass	org
@YuliaLida	human
@bijabijoux	human
@RosesAreRed1903	human
@iluvhotnelly	human
@modenmarie	human
@jaszywoo	human
@Carmgoestoshows	human
@Maxitoso	org
@21StepsMichael	human
@BenFong88	human
@NYCTBusStop	unknown
@TheCuriousBaker	human
@Pippi_Dust	human
@itsfromTLD	unknown
@KennethFDavis	human
@PhantomCanyon	org
@yoshipandaaa	unknown
@danaycatalan	human
@ViaErmala	human
@Kate_a_roo	human
@P_GoddessMommy	human
@ZarineMohideen	org
@LisardoVivas	human
@aley_ayupab59	unknown
@veronicakhoo	unknown
@marcoiapolo	human
@starfishsammy	unknown
@Magdalenaschoco	human
@DymeDawn	unknown
@KitchenFun3Sons	human
@MopsaAndrain	human
@BeerzHerez	org
@Kawasan_Megamas	org
@SmallMarketi	unknown
@InnonthePark1	org
@ManuelaFreem79	human
@17Becks17	human
@CoCoMaRk1913	human
@yewtreebarn1	org
@la_vida_vegan	human
@kenmeeei	unknown
@Theccvillage	human
@yongfook	human
@RIDEOUT163	human
@mominluxembourg	org
@hornbillrestaur	human
@jonmaram	human
@notdjAM	org
@Faattyc	org
@DaleTalde	human
@koji49491	org
@Ri_go19	human
@dadadatcho	human
@DelauneySophie	human
@sheilastefani_	org
@SPressOnline	human
@OverlookDining	org
@CuriousDiversio	org
@DjGohon	human
@dynamitri	human
@ChiBoys	org
@RendonLabador	org
@fetedujuliet	human
@ArenaDistrictGR	org
@Misstikuss	human
@5borobeer	human
@melgrosser	human
@rafidahyahya	human
@emajudd	human
@nedmaddock	human
@CambridgeStCafe	org
@sharemycurry	human
@JoelinWong	human
@Chan3Judy	human
@jahirmz	human
@conelmorrofino	human
@Florencia28	human
@GoodFoodMagIn	org
@_SFPR_	human
@ChrisLiew07	human
@Delnada	human
@BluRySooNW	org
@Zainabk1983	human
@LALynns	human
@4kidsactivities	org
@Cutlos_Supreme	human
@cuppow	org
@tannahhs32	org
@TheJasmineAdele	human
@SartoriaRest	human
@BiandaE	unknown
@Andre24Social	human
@PamRoJO84	unknown
@iconiite	human
@LovelessCafe	human
@TetleyTeaOOH	org
@GlynAbbey	org
@Chloe33Williams	human
@ChickadeeSays	human
@AmieEverest	human
@MrRyokoYuuki	human
@MeBlieve	human
@maripon0311	human
@PolinaSchlicht	human
@primal	org
@LampugaMX	human
@BatuKarang_Bali	org
@ingridleonard	human
@charlieq142	org
@BJ_HARMstrong	human
@philv86	human
@texastwins2004	org
@ResourceCafe	org
@HeyItsMsChelle	human
@stefanywu	human
@bleedingbtrfly	human
@FrankaSimpson	human
@griffmedia	human
@arie_yayo	human
@SwitchKickinUSA	human
@LaUrbanaSF	org
@DjMadOut	human
@MilagroGrillAZ	org
@ecigitesztek	human
@Phatabulous75	human
@MiaRakovska	human
@Ricorobin	human
@anna_woo5	unknown
@nando_415	human
@jinglelalavienn	unknown
@skipthehousewrk	human
@tericapearson	human
@CeriKitchen	human
@holistickita	human
@LoaFyDawg	human
@Udis_UK	org
@Michael_Serna	human
@DoYouSwoon	org
@evgrrready	human
@ImADanceStar	human
@ssujitdube	org
@djspontane	human
@Trey_de_loke	human
@lumaflux	human
@trez_93	unknown
@erinfingers	unknown
@ablokeseyeview	human
@La_Faglie	human
@Msphillydutch_4	unknown
@LeRouxCreole	human
@Boulder4Lunch	org
@nine_zero_four	human
@_LovelyVal	human
@raagwasgood	human
@cushrinada	unknown
@FirebirdsGrill	org
@NellaBalda	human
@jenelyndc	human
@fatinsyafawati	unknown
@behealthsydney	human
@mynameistintin	human
@gossip_mode_	org
@pinedatwo	human
@Moha_bourlem	human
@iGhozax	human
@Woady100	unknown
@WavaClopton	org
@StarbucksCanada	org
@djsdmv	org
@ChrisguzmanLV	human
@yudiahartawan	human
@Chen_Tongzhi	human
@steenstory	unknown
@Dani_Beaar	human
@deandurrance	human
@HostalSport	org
@theholliesbb	human
@Ricette20	human
@vindisk	human
@CharroMexican	org
@achiemawu	human
@MistaMOB	human
@campus_upharsin	human
@ThriftyFoods	org
@ErinMargolin	unknown
@juancruztuma	human
@americansoda	org
@izmanramdhan	human
@KrispyNCrispy	human
@Pinoobe	unknown
@WellWithLight	human
@Farah_Venus	human
@belixota	human
@RebelofHumanity	human
@sprinksnsprts	human
@p28rd	human
@tlkingsland	human
@Dannerzme	unknown
@jenniferlbacon	human
@GvsFish	org
@frysaucegrits	unknown
@AmyBennettKane	human
@dancerboy89	human
@420PartyNow	human
@raneroandres	human
@yuri_7280	human
@winzuton	unknown
@ConcoursTwittos	org
@bijagirl	human
@tapanbhargava	human
@TonyYnot_	human
@Cwebi	org
@gbpackfan4ever	human
@LaurieLauriane	human
@TotalBodyToner	human
@50Nads	unknown
@BestMeCommunity	human
@OSUDining	org
@rosietexecano	human
@batuguldogan	human
@slayerkm	org
@diehlish	human
@392Caffe	human
@ChadRothwell	human
@SelenaLucinda	unknown
@ChiaraCirce	human
@nuttynadya	human
@mammemagazine	human
@Our_Hale	org
@CandleBarkCards	org
@DJDecybals	human
@aboutredlands	org
@sypuhihibero	unknown
@Undeezonline	human
@Runtastic	human
@k8sarsfield	human
@37DawsonStreet	org
@AGST9X	org
@Diwon	human
@Aleres_2206	human
@LaurenMorra	human
@KBalenovic	human
@00zero_zero	human
@Emily11949309	human
@ImJustCeej	human
@karenw4n9	human
@PinkChickmia	human
@Ana_Ailed21	org
@ChefJoeJ	human
@Willardddd	human
@mnuffins	human
@this_dude_josh	human
@blue_guest	org
@aLieynch6	unknown
@markerwins	human
@sea_prince_	human
@kaanaslan_	human
@CarlaBl4ck	human
@laina_marie	human
@JustSmarties	human
@Duong17Mary	human
@TavernWhyte	human
@WhatsOnEastRen	human
@TheLifeHouseTX	unknown
@PrimaryTimes	human
@sweetnessdorset	human
@GaphieltheVoid	human
@francistorreira	human
@itsnykibitch	human
@LIFTandGLITZ	human
@candyole	human
@evydesuiza	human
@_investor229_	human
@16eedua_0813	human
@TheLucyEdit	human
@PommePalais	org
@FelonyFlavors	human
@pupazzagnappa	org
@stbrookshire	human
@NapaValleyTesla	org
@Food4Nutrients	org
@dannyjosiah	human
@pecintakopiID	human
@mulatacuisine	org
@tyoko_tyokosuki	unknown
@redredlittlered	human
@Andreavba	human
@dionisiaaldora	human
@1belle_	human
@TenderRomi	human
@VerdeMiami	org
@aSk_fflynn	human
@EmbersBK	org
@VeneziasPizza	org
@artshelady	human
@SagraAustin	org
@trOyandreO	unknown
@Rant0r	human
@Astha_benevolen	human
@wtfburgerchef	human
@diongideonw	human
@PerfBaconBowl	human
@mariose95652285	unknown
@RamirezRyce	human
@HerMagCan	org
@silge_casanova	human
@deria_zatty	org
@jollycoachman	org
@nelaism	human
@byHSP	human
@GinaRWise	human
@PutriSischa	human
@WineORL	human
@chamerizka	human
@GraceAnggg	human
@dance_tweeter_	org
@DiaperDungeonD	human
@bellebarcelone	human
@BekaGough92	human
@fwgh46132	human
@buneata_vegan	human
@TulleAndGlitter	human
@highwayrocky	human
@Leduc	human
@Hillwan	human
@natashakufa	human
@richinflavour	org
@agnesx	human
@recovery_fittie	unknown
@AgouraDeliCA	unknown
@GHioco	human
@ndhaeliza	human
@TrnPizza	human
@HyperParanoia	unknown
@kei70tokyo	human
@michele_fuoco	human
@HedgeFunNY	human
@born_a_petite	unknown
@SocialSouthside	org
@BethanyHexom	human
@whenitravel	human
@jha_siddhus94	human
@BBQcookn	org
@Brother_Tunechi	human
@zkharmaz16	human
@shinepalonzo	human
@laPerraVargas	human
@Mike_Virata	org
@macacha_wayar	human
@VEctormiNUS	unknown
@BigRockUrbanYVR	human
@Norris_Wife	unknown
@smitaj55	unknown
@antonio_fuso	human
@jasminetalksblg	human
@lmdFusc890	unknown
@simplyweixin	human
@Alvernia_KP	human
@TTTGiftBaskets	org
@franchidsp	human
@AllenMoraless	unknown
@ZoundsFlux	unknown
@fff3fs	org
@saboo89	human
@PenchoDuque	human
@REBUQ	human
@KZF	human
@BigDaddysSTL	human
@shigy_cule	human
@GYMBUNNYBIMBO	unknown
@koutsaftakisg	human
@alessandra_mari	human
@angelito420	human
@Healthy_life4u	human
@swimmer_dude181	human
@eiji124221	human
@Hanne1982	human
@FoodieDailyNews	org
@princessu1	human
@laurenfjacobs	human
@MDAlimonte	org
@LionKingSte	unknown
@PistachioHoney	unknown
@TastyFindUK	org
@RiverCityRest	org
@Maryam_AlDoobi	human
@SonOfTheNyks	unknown
@silviahoooo	human
@cacMaricu	human
@NaijaMane	org
@nhaacklv	human
@caromonsta	human
@chiutips	human
@melvillecastle	human
@SUAHour	org
@Cathyoc54	human
@ScottSwanberg	org
@RogueEccentric	unknown
@BrownCarrieb	human
@C_YuetSum	org
@rEDhANDEDiMAGE2	org
@LAURA_S_BURNS	human
@VenusThermal	human
@Luwenya	human
@MusicIsL0v3e	human
@artnazcom	human
@yuka5846	human
@nepamoraindum	human
@CabbagetownTO	human
@newnsixty	human
@gelicapickles	human
@AllForUSophia	human
@Magnumtonicwine	org
@JNTDestinations	human
@_pyon327	unknown
@kylilmama2	unknown
@Petlover144	human
@William_EFlores	human
@Jasmine_KSM	human
@ctlazaro	human
@mcafebar14th	unknown
@DaneMichaelT	human
@AlexandraMileva	unknown
@ellenlitz	org
@Fatma_asad1	human
@RosannaNLe	human
@GTHNOX	human
@jgffe	human
@hellorita24	org
@MentalFitness	org
@livewellco	org
@re_girl_s	human
@agso0707	human
@nonoemuhammys	human
@KingJuicyFruit	unknown
@RicksRoadhouse	org
@VanessaMorton	human
@dimplehisaye	human
@itsmetataquiso	human
@pitchdeals	human
@g_ack	org
@HBatInnholders	org
@charlottelsw	human
@madoqin	human
@pattyhilt	human
@blownkillabee	human
@dramalessfood	human
@BobbyGriffing	human
@pequemarlon	human
@sineKKB	human
@BreatheBlog	human
@ArthurWood_UK	human
@Angelbirdbb	human
@cherng86	human
@perryhomes	org
@forbesriley	human
@RPhillipsChef	human
@teresa_dbl	human
@tinathefinn	human
@thelukeirvin	human
@StuartTelfer	human
@TheSinglelist	human
@kellyjames1235	human
@Sup3rchubb	human
@Socapub	unknown
@VeroMartz	human
@MyKidsHave4Feet	human
@AboveRestaurant	human
@Torcianowinery	org
@RCrabbers91	human
@tessatamin	human
@unglu3d	human
@TheFreshEditNL	org
@DigitalGeekGirl	human
@createwithkla	human
@cafevivapeckham	org
@Grainne43	org
@SirMaple	human
@vinnelim116	unknown
@remyspice	human
@Signing4theLord	org
@whyilovetoronto	human
@Pepesplants	human
@SarraDally	human
@thePainFulOne	human
@Wilson_NoName	unknown
@aikensre	human
@PremCFCPatel	human
@nimin__mccuttie	unknown
@KismetKebabs	org
@kanachoco07	human
@MichaelJordanYo	org
@MesAventuresHAK	human
@RoseDrageeblog	human
@drienarene	human
@Jasonlavar	human
@TiTryanto	human
@RosaPalermo	human
@ChielsinKo	human
@mcdonaldspecial	org
@Calvymuscle	human
@wlshealthcoach	human
@yuriyanblack21	human
@badassvenus	unknown
@Jeff_Angcanan	human
@rachel_yourpt	human
@RBA_suzy	org
@NaughtyCandyz	org
@AlexDavisMedia	org
@katdearing	human
@MFalland	human
@ghotelmajestic	org
@l1b3rtAs27	human
@SheWill_PURR	human
@blackjacket_cl	unknown
@MyCloudByLu	human
@dezadrienne	unknown
@JerseyNE	human
@jfish1976	human
@RachRegina	human
@marifleur7	human
@leanfitness	human
@CherieAG	human
@monetdarbz	human
@fyqalove	unknown
@TexasSentinul	org
@RoscoeKleinloog	human
@firstunrest	human
@simbocLtd	human
@ENDYGOTBEATz	unknown
@e512xo	human
@Danny_Lee_Golf	human
@Tina__Gallo	org
@bistromontage	org
@SadlerDaniel	human
@FungTuNYC	human
@f6or_faris	human
@CamiiOlivieri	human
@dukedinero	human
@SonitasKitchen	org
@khairulsayali	human
@NaqieuddinSobhi	unknown
@RameenRN	human
@SayWellness6	org
@AnthonyElika	unknown
@rindupolii	human
@TheSpanishFood	org
@Chefrichcooks	org
@hanasfavourites	unknown
@Armandt_R	human
@MartyneH	unknown
@discodrivethru	human
@ParkHyattGoa	org
@CovunFrazier	human
@abidi_habiba	unknown
@DelishKebabs	human
@lincolnho	human
@ibhadzcarbonell	unknown
@marilitazisimou	human
@nikimin328	unknown
@KRAFTYkitbar	human
@CaliLean	unknown
@gbtkf	human
@melyana_gunawan	human
@kanameya_3daime	human
@simoncrane1624	org
@beckyboo1988	human
@SofyM	org
@SayWellness27	org
@pravin_7	human
@mitchbetito	human
@pandagreens	human
@zkharmaz9	human
@EmpordaEvents	human
@ceftandcompany	org
@Kdubbz19	human
@HaseebIqbal2	human
@getInsertPic	org
@Digital_Vix3n	human
@TiffJohnson91	human
@melissaleg	human
@Craig_Ahrens	human
@MarcelleTT1	human
@chickweed79	org
@MZenWong11	human
@KellyGermain1	human
@_1_l0ve_	human
@office_fruit	human
@NetworkLondonPR	org
@DJJAE_EL	unknown
@caligirlmel78	human
@livelifejuiced	unknown
@ohwhiticism	human
@Muratokr	human
@Kyleighlazarus	human
@jonathan_ardis	human
@Riverside_Cafe	org
@LucaOvrezzi	human
@CinnabarHrtford	org
@BobbyTrendz	org
@JackInDai1271	human
@ImJus_Dominica	human
@victor_mthobisi	org
@Elyalmanzar	unknown
@REDBELLY_ORANGE	org
@KitchFellowship	human
@TAPvillage	org
@KyungAe_CW_96	human
@dadanamthip	unknown
@VeganLifeAssoc	org
@Angel_Rhayne	human
@AlexBracken1	human
@BHWTOfficial	org
@Robbmatters	human
@g_mrssassyb	human
@jessica_pippen	human
@ElliChan2	org
@LoyoFk	human
@Bennyhiday	human
@MPWRestaurants	org
@ProwlTV	org
@rheinesanandres	human
@LuxuryRoma	human
@LeOnAzOs	human
@DMarqueHall	human
@AmpnnCpilf	human
@lifeneedsmusic2	human
@ThePkldCarrot	org
@HELOfood	human
@AIWF_NYC	org
@LolaEspanaFoods	org
@treasurebaycoll	unknown
@guide2athens	org
@TEdwardRedd	human
@TOMI_E0518	human
@HiteJinrousa	human
@veglovelife	org
@TheFarmArizona	org
@uygai	human
@Eetgelegenheid	org
@AvaMillet2	human
@NostalgicRose	human
@HusnaIsa	human
@Smiley_DJHana	org
@jasonazevedo	unknown
@TopAmericanMp3	human
@arjay_navarro	human
@pugs_and_roses	unknown
@acon15	human
@MannersDreams	human
@DowntownStJohns	org
@MaryamHenson	human
@FoxiiLea	unknown
@ellaquinnauthor	human
@MichelleStieb1	human
@mdemartamartins	human
@jubassanelli	human
@kaffeobelfast	org
@lmssmith19	human
@Pekingbath	org
@timotiusfelix	human
@jiorama	human
@CoreyLearn	human
@RoyceSaayan	human
@TheBashfulOne	human
@KosmonautMCR	human
@kaorintsuchiya	human
@Tatianadia	human
@PiatsaKalamaki	unknown
@adriux	human
@ryan201977	org
@ronyeap	human
@OneMans_Kitchen	org
@watacoronic2	human
@PlateCulture	org
@WINforum_org	org
@MagsNCheese	org
@CarlosGil83	human
@TheRoseHotel_sy	org
@jtagtweet	unknown
@touringkitty	unknown
@Nazuki_MNLCS	human
@bitchfortin	human
@Proudjam	human
@AntonioBran91	org
@sjuliaintheair	human
@foodandphotos	org
@intolerantwife	org
@adilsbhatti	human
@DowntownMaps	human
@CecilCapriotti	human
@VauxhAllOne	human
@OuchAndy	human
@TheWetWhistle	human
@Eudaimn	unknown
@wiwingman	human
@RoccosTacos	org
@artistrycafesg	org
@ToriDeGiosio	human
@ignacioaramendi	human
@ParkInnMuscat	org
@amsterdamfoodie	org
@zhang55y	unknown
@FaireRaleigh	human
@EatingAlive	org
@wiki_LIKX	human
@Baijie_Piggy	human
@Fit_Becca	human
@JacquisBlogs	human
@evasally_Hay	unknown
@dianasformula	human
@YelpLA	org
@Victoriaparfit	human
@MediaArtsReview	org
@DivaZillaRemy	unknown
@TinaTassels	human
@dolcedebbie74	human
@browniiebunnii	human
@valpinkfuzzy	unknown
@sociologistt	unknown
@chiongeee	org
@WeChatZA	org
@ShelleyLondon	human
@ekaSumarwata	human
@AntheaSanna	human
@zchrymendoza42	human
@ChicoAJBIII	human
@DaraJTaeb	unknown
@NewishCityHOU	org
@NgenesPedia	unknown
@SSillah2011	unknown
@yukospirina	human
@WhoreBlitz	human
@beneboy702	human
@QueenBeeMB	human
@jtasafari	human
@renai_Y9GmX	unknown
@Foodbanditsblog	org
@Dr_DLDixon	unknown
@StGeorgeChris	human
@Morgan_Ember	unknown
@RCNNYC	org
@FITSNAX	human
@laragostablog	unknown
@MsTosciMarie	human
@jccarden	human
@shivisubero	org
@EsthaBamboo	unknown
@erikasaenz	human
@sirentsiren	unknown
@blackjamesss	unknown
@chigochanyasu	unknown
@NMtennVOL1	human
@JoyfulSocks	human
@GoWhiteBearMN	human
@cabana_brasil	org
@DealMonsterUK	unknown
@homestyle68	human
@NicolettaMix	unknown
@morimoriyu0302	human
@eugeandrues	human
@MariaNataliaG	unknown
@louiseddyer_d	unknown
@allibian	human
@DaisiesandPieUK	human
@chooeric	human
@HackneyDownsFA	org
@kaesnattaya	human
@irenesuhw0n93	human
@HackNScript	human
@sigalit31	human
@BK_MUA	human
@BiDoubleON	human
@Antomakeups	human
@ThePureBar	org
@adriiiRmz	human
@Hendrybun	human
@anime4ever1	human
@ameeshaprabhu	human
@littletaphouse	org
@thymeandtides	org
@Tn1stminxmaster	org
@TavernBowl	org
@itscardiffboy95	unknown
@dreazurin	human
@SayWellness33	org
@francoise_1204	human
@ERINA_2122	org
@FastCasualTV	org
@sakiciii	human
@jhansikarthik	human
@shuLiway	human
@AkanFatia	human
@HeroSpread	human
@Bayoucrafts	unknown
@lolo_play	human
@StephNaumoska	org
@nurul_azmah	human
@Samproof	human
@kiminikrikket	human
@RobertsChapman	human
@sayaya0111	unknown
@Nanistrange	unknown
@katybuggy	human
@rokurosuruhito	human
@GastrotecaBar	org
@RbmdkJ	human
@diyho	human
@zkharmaz13	org
@TheMoralMunch	org
@Smeagolsteaks	human
@FullBodyTone	human
@LeahMcGrathRD	human
@SunAndAsphalt	org
@CantinaMUAE	human
@chaiandpieco	human
@ClaySagKid91	human
@sciabby	human
@leencredible	human
@instaslava	human
@DeRuijsbroekjes	human
@simoneconnola	human
@ViBE_ub_apple1	human
@JRMY4	human
@KareliaKitchen	human
@jfizquier	human
@Kacirw14	human
@kstewfannayd	human
@dfelleman	human
@BlackWhite0224	human
@WhoresPlayxxx	human
@GOlDieSTYLinG	human
@runapii7	human
@miajulia11	human
@thejenmoff	human
@GaeMiKyuSJ89	human
@PreppyDude	human
@demetriusp	human
@swayszceyk	human
@thanhdanhtran	human
@JohnPaulJakub	human
@a_grand_cru	human
@Aprinc3ss88	org
@GerardNisperos	org
@clement_law91	org
@JenatPBandP	org
@MahoganyTreeJa	org
@MightierSword	human
@kgiisky	unknown
@brazenfox	org
@goosebucket	human
@3lin___	human
@Tuzz76	human
@ehmandah	human
@justchui_	org
@MyHartEnt	human
@FEAKINS	unknown
@cherry_ave	human
@AntoHorn	human
@RarestJade	human
@mamitagami0924	unknown
@jubaershish	human
@loren_lieberman	human
@youhasegawa08	human
@CrisValenzuela2	human
@benselwyn	human
@ayelovelyyyone	unknown
@HeadVape	human
@deena_style	human
@Kairax	org
@theforagingfox	human
@the_next_food	org
@breaktimeID	unknown
@Eryn_Alexandra	human
@JakartaPlaces	human
@vegan_gyozude	unknown
@SlowDownFood	org
@FifthStBrewpub	org
@Sparmeister	org
@anaparisi	org
@demarcusdevonte	human
@nyctacos	org
@MelodySangs	human
@davidromanphoto	human
@reys_pizzeria	human
@iheartdjkstyles	human
@juancblue	org
@kicauvthree	human
@MattJohnRyan	human
@YenilyAlmeida	human
@JunnAdrian	human
@DonzHard_	human
@haluliu	human
@HengistThe	org
@jon_doe_kid	human
@JacqsOrganics	org
@tinyterror406	unknown
@cochiver	human
@DerynTilouche	human
@chachaposada	human
@julescooper1	human
@imPRessmedia	human
@wilson_handoko	human
@EnjoyTossa	human
@mynameisseda	human
@cjjohnsoon	human
@oku_coo88ool	unknown
@txquw	human
@uopcg	human
@BabyFox_Love	org
@iplaywithmud	human
@TuggyTucksIn	human
@Cristiana_22	human
@VeneturPLC	human
@SumaiyaAh	human
@thesheenzz	unknown
@VinceTheKoala	human
@Mizz_Q	human
@BiancaArgana	human
@Kay_Carter	human
@LilMsSophia	org
@PleazureNinja	human
@jnstewart15	unknown
@mprmf_w	human
@JET8THAILAND	org
@CharmTravel	human
@chrissophiie	human
@norio1118	human
@JaySunBorn	human
@HelgaTomann	unknown
@DJRookieTraxxx	org
@NataliaLaurenFi	human
@meerastar1	org
@villageprimenyc	org
@readtiw	human
@skadet_27	human
@KissesForUsAll	human
@spectacular_is	human
@oranus786	human
@BrooklynWBagel	org
@JAfjpv	human
@_KrisGoetz_	human
@MelissaLovesHOU	human
@AdrianaSassoon	human
@mrmicthevoice	org
@fork_tale	human
@SayWellness39	org
@HumbleTart	org
@ParmaHam_USA	org
@tanameracoffee	human
@HarpersCLT	org
@Sequelcast	unknown
@MoritaOkada	unknown
@jessicajfurey	human
@riongo1011	human
@zkharmaz19	human
@kayalimerick	human
@KristelVivienne	human
@SamNeades_PT	human
@angelica_yessy	human
@aliasPaolo	org
@brandonterry909	human
@BiereThaiNissan	human
@yashica_m	unknown
@ARCarrington	org
@unique_angles	org
@thepantrydiva	org
@MagoGrill	human
@flavor_rd	org
@blaublickde	human
@VEEFIESTY	human
@T1NK5_84	human
@PaleoWired	org
@novaleeza	human
@FreyjaRealEstat	unknown
@OmahaBuckys	human
@yusjulie86	human
@hungrynhamilton	unknown
@sinri_kyoumi	unknown
@Von_Kitty	human
@runningwy	org
@theextravagant1	human
@marketing_eazy	human
@3m_WIN	human
@WeldonOwen	human
@5_ih	org
@_VividThoughts	human
@ACBrennerGmbH	org
@stoneridgefruit	org
@KeithHenryJr	human
@mallorypfiester	human
@LondonWorld_817	human
@RACKSMIZNER	org
@BocaMarinaSXM	org
@SayWellness3	org
@f0686f6ed142435	human
@OudeWellingtonR	org
@funkyberrypr	org
@keith_xiaopang	human
@travelgluttons	human
@zoekrobb	human
@GoingOutRI	org
@SMFoodtrucklot	org
@NutritionDose	human
@inumeev	unknown
@MrDOLPH	human
@piyonZane	unknown
@MattesTH	human
@Caramel_Geisha	human
@amritaraichand	human
@T_spotter	human
@Loyisonebe	human
@nickigreenwood	org
@mollyobrien2010	human
@norzellabokhari	unknown
@kookslam_Hks	unknown
@UstadHotelDxb	org
@jasminaparade	human
@TheTostiClub	org
@ElSegundoSol	org
@Mokka_ID	org
@LB3blu	human
@MyTBPrincess	org
@maxtucci	human
@SaroshSings	human
@hariboza	org
@agcooper88	human
@comebackmum	human
@ugurkarabayir	human
@ArwenBL00M	human
@ZaaWii_Walaa	human
@lydiakorol	org
@Debora_Aruan	org
@ace_james1	unknown
@deniseangel55	unknown
@ElleganciaWeb	unknown
@lemon_piez	human
@raggedcanteen	org
@wellyington	human
@fideliarguello	human
@pyxxie0703	human
@johnydecali	human
@MsRenee143	human
@MellySamantha	human
@spark_jewelry	human
@SweetBeaming	org
@NickyAllado	human
@joonasv	human
@_EdenChiang	human
@thapanee	human
@Scorpio35Cindy	human
@FRYEDARANDOMGUY	human
@Marghe_15	human
@poshpickles	org
@marvitaa7	org
@queenwifey10	human
@JesESims	human
@hamdeemenor	human
@ChuckBurgerBar	org
@TonyLeeKimber	human
@dreamchefllc	human
@MissJadeChantel	human
@MeliPaFlorez	human
@SparLlanrwst	org
@Michellaaaaa	org
@sameldrum	org
@TinchoTesini	unknown
@henrirouen	org
@connvoyage	org
@BNTVosburgh	human
@TheBoldGroup	org
@LoisLePard	human
@PLSR_official	org
@athrhbux	human
@reformatt	human
@Danish_C33	human
@MichelleWu1992	human
@_simonkhan	human
@TitanicHotelLiv	org
@kiannadestura	human
@JennySook	human
@MyMirrorWorld	human
@RondjiRestoUbud	human
@bAi_cRusherz16	human
@yunata_R1	human
@bot80136391	unknown
@Pembrokehk	org
@squirrel83	org
@zkharmaz10	human
@CinemaPub	org
@LevyMakwala	human
@susanwiggs	human
@Sivuple71	human
@MichelleGossip	human
@Quetez7	human
@HucksDining	human
@B_macck	human
@ChristyG_28	human
@TheRedLionAlve	org
@McDRochesterNY	org
@OOOCatering	org
@ManhattanRdam	org
@CenturyBham	org
@Kellymaublog	human
@aaronestewart	human
@OpenTasteUS	unknown
@SophieSerenity	human
@annaojbee	human
@ChelseyHelen	human
@MLouiseLove	human
@Dixons_yyc	org
@joeoctavianus	human
@denizpekdas	human
@iamdankaufman	human
@chefandy_09	human
@akhmahanim	org
@Emma_Lynch_	human
@vickyvette	human
@RedRidingTruck	human
@BriGarcia07	human
@EmineUlucay	org
@EastThirtySix	org
@eponineyap	human
@i_gromova	human
@JoePezzula	human
@FaizBinRahman	human
@FabioZanetta	human
@GunsNRosesTX	human
@iam_Sandy	human
@HAUlMEAn	unknown
@J_David_Ramos	human
@16stepsofdoom	human
@Husin_Leung	human
@ImaginaryNora	human
@vennstmarket	org
@Mouy_Hok_Tang	human
@Amy_Nail990123	org
@Aleesias	human
@PRIMAMC	human
@mauricetalton	human
@janapearls	human
@Venj_SG	unknown
@victoriatomasin	human
@josegomezgelp	human
@QeewithBYJ	human
@LadymiaMicky	org
@GuestRanches	human
@My_A818	human
@Gabulienta	human
@DessertsRecipe	org
@ummusalamah_MW	human
@Chocoreaper	human
@AmirahAini	human
@rebekahkinnaird	human
@zo_boniita	human
@xjapan_weare	unknown
@ChaophrayaLeeds	unknown
@Blueeyes2412	human
@evalenty	human
@AlexBracetti	org
@CornerShopGym	org
@styletraces	org
@BigGreenEgg	human
@PurpleDinnerCom	org
@Omchavarium	human
@italy4people	org
@noyuckystuff	human
@DingoDawgUSMC	org
@DingoDungeon	unknown
@biGMaCkNUgG_IT	unknown
@ThePearsonRoom	org
@minakaiminaauao	human
@ThinkMahogany	human
@HyundaiSouth	org
@mikthemarketer	human
@DirtyDivaReina	human
@pohpohperisiiii	human
@goNIKATNITE	human
@ChinookLearning	human
@westendwellcoop	human
@SouthernHarlem	human
@Frenchimalvi	human
@Nekarman	org
@ButtermilkLips	human
@ana_navarro89	human
@jalongano	human
@NatStudCoffee	org
@os1_5	unknown
@FittAndStrong	human
@bestdownload1	human
@CallumNicklin	human
@pellicanohotels	org
@adriane_zuniga	human
@aperture24	human
@DrAnhPharmD	org
@Goesting0570	human
@elishaedwards91	human
@heatherrmarie01	human
@JosPedroCordeir	human
@sumcara	unknown
@Ashraf_Rahim35	human
@wouisy	human
@Sophie_P_R	human
@FrancyLukasik	human
@marpop	human
@asimplepantry	human
@TrainerHeatherB	human
@Dunkin_India	org
@Capsicana	org
@ORB_BKK	org
@NinaSay	human
@Modeyez	human
@chooseurcarrier	org
@TonyTheTVGuy	human
@tonyspizza415	org
@Phr3sh2death	human
@Brandin_04	org
@BananaLoveMuff	human
@LoafDurham	human
@victoria_gadsby	human
@KevinT2014	human
@TyeMars	human
@jcreportglobal	human
@monica2sett	human
@0806yes	human
@eyesoffashionbm	human
@Omrdhri	human
@goodcentskc	human
@aimwide	human
@mintymudslide	human
@ChefAndyO	human
@officialtieups	human
@MaxGFXGenius	unknown
@crazydayzoflife	human
@SayWellness30	org
@JennaMucha	human
@torayoshiki	org
@Georges_Coneys	human
@My_HedGehoc	unknown
@NoTw1tterDan	human
@SHaNPrinXess	unknown
@SarahGriffFit	human
@zozynawaf	human
@bigrigbrew	human
@Issask	human
@AliviaHopeHite	human
@ChrisPLucas	human
@dcymg	human
@Nalyylee	human
@OneDeliverySW	org
@king_moooon	human
@LamatLifeWell	org
@A_BinKaram	human
@Aaliyah_Russon	org
@Midou37	human
@SapiLadaSnack	human
@bromleyfl	org
@ayiekaswag	human
@exchangenb	org
@suzebraeman	human
@annema_8192	human
@22TheSquare_	org
@killercam57	unknown
@RedAmy	org
@Yuuka99	human
@LeaDesignca	human
@rosaramirezHN	human
@Bennyoke	org
@chrissywisheart	human
@yk11080929	human
@Aly_Stepanova	org
@kyliebrincat	human
@LunchXpress	human
@austinfoodmag	org
@AcaciaBlooms	org
@8rockaholic9	human
@ArtemisLeblog	human
@PLATANOTV	human
@BroadcastKMS	human
@Augustine_Ang	human
@witheveryheart1	human
@Andolinis01810	human
@unicahijamaria	human
@Choclette8	org
@wienmitkind	human
@akosiJepoii	human
@luzdaryquionez	human
@floren99	human
@PiwtyRamsey	human
@getbiggotowork	human
@mml2000	unknown
@mela9ie	human
@alischeinfeld	org
@OpelKrub	human
@TNicky	human
@ElenaRego	human
@NGnola	unknown
@UnitedCinemas15	human
@PlayPokemonRPG	unknown
@Fernetera	human
@westsidemags	human
@tuveuxunpoulet	human
@tivolivillagelv	org
@TTanyaTracy	human
@lindaanne_pinky	unknown
@simplymsmorrow	human
@tottii_	unknown
@tony_zabel	human
@oliveoilworld	org
@djerick26	human
@Nefots_	unknown
@staceyeatsit	unknown
@itsjustbrian	human
@24_834	human
@Celestial_Gem	unknown
@roo_claire	human
@owen_author	human
@BellaMiaMa	unknown
@Heyitselliota	human
@pinnynoy	human
@AndyBatesChef	org
@LinMShah	human
@ChromaticWit	org
@WahidHalabi	human
@Patinya88	human
@RikAs2o	human
@iamldaniels247	human
@WoShiAhQ	human
@8Bit_Ramos	human
@churchill_dan	human
@FPSNewDelhi	org
@electroperfecto	human
@GuiltFreeVeggie	human
@BeefandLambteam	org
@ciksaloma	org
@Francess_x	human
@CipqxO	human
@Gzdalp	human
@kpsantos1	human
@Mike_is_full	human
@MrDimKR	human
@cpbanks3	human
@LovableLuhv	human
@rieccha	human
@vivhealthyme	org
@inpaddington	human
@antoniosanti	org
@smallletter_g	human
@otaru_aobato	human
@DialMforMoms	org
@LoveLifeLivFree	human
@LucieDesmond	human
@MattiaNaletto	human
@AD_architect	org
@blorichca	human
@yababaya	human
@sindivanzyl	human
@LallisseBistro	org
@MoonliteDiner	org
@mealpit	org
@MrsTweeturbiz	org
@officialmfuller	human
@Czr_Mendez135	human
@muchynmuchy	human
@dizah_elegant	human
@MaenJay	human
@JospmeryGS	human
@annezkie17	human
@SylviekrawecBio	org
@NeuvooWinstonS	org
@prettybroker	human
@espclay	human
@SAuerswald	human
@murcielagero	human
@owuxg	human
@pistl	org
@wattlepub	human
@andriakbarratt	human
@TheBlaqAsian21	human
@CharlesPejeau	human
@Telmaguiar	human
@oliviamesquita	human
@erinfrances26	human
@Victoria_Midori	unknown
@nao_Xjapan	human
@deekangrga	human
@JPartyCreations	human
@natsupurin	org
@rubengarrido28	human
@Caramel0131	human
@visuals4u	human
@marion_rdz	human
@RhandaPaleoCook	human
@sandylicious010	unknown
@afiqmdariff	human
@Jaraads	human
@Dana_Stargazer	human
@Courtlove98	human
@MrNattt	human
@GQ_soriano	human
@JmBsBeck1311	org
@Lau_LPQP	human
@MariiaGarciia25	human
@PieCorpsNYC	org
@SciPhoenix	human
@LiasKitchen	human
@megzzw	human
@MaychelinTan	human
@DevrajNiwas	org
@indira108	human
@ELLi_jp	human
@officialtata	human
@MiszBlackanese	unknown
@TheBlockSB	org
@sanfordisherwoo	unknown
@iyalucia	human
@FancyNancyT	unknown
@rentweets	human
@Saz_mey	human
@Princesa_Michi	human
@Luckystavernla	org
@VRMcCoy	org
@Qbookshop	unknown
@RippedCream	org
@ski3kimo	human
@Ahmadnasser55	human
@Nicolaspedemont	unknown
@categorywoman	org
@AndinoCC	unknown
@agnesdde	human
@hwrc1	human
@myfoodiebaby	org
@alidaskitchen	human
@la666sa	human
@yukiko_berry	human
@mr_ochonogor	org
@SeasonChee	human
@Burrrrr_	human
@jzercher	human
@ElWombato	unknown
@CFAWardParkway	org
@zkharmaz22	human
@Paris__Kim	human
@KhalidiyaPalace	human
@djmisskriss	human
@MAAtrainingUSA	org
@pikapikashop	human
@pwagb	human
@NeuvooFortLaud	org
@JyeWoon	human
@bettyrahmad	human
@ChaskaCreations	org
@thewriterist	human
@Yonikbe	unknown
@MyCookingPots	org
@AM00O	human
@bajuarorarora	org
@selwyn06	human
@uandiespresso	org
@joelito2028	human
@albertofvsal	human
@elinorplo19	human
@OTCafeOwasso	org
@KirstinWalters	unknown
@MaldivesMV	human
@morlalezar	unknown
@leondecuento	human
@rfoceanus7	human
@letssMultiply	human
@meigen_d_soccer	unknown
@LeeMingJu	human
@Jtown67	human
@foodographyHI	org
@mdjonline	org
@k_chavez1989	unknown
@chopitupsundays	org
@TableauBistro	org
@GreenPapayaRest	org
@e357rocka	human
@dheidherill	org
@1UPMayito	unknown
@Wilson_Lum	human
@niisgourmet	human
@JaqueAntoun	human
@StephHoalcraft	human
@onlineciaobella	org
@MonicaPoo	human
@erick04171977	human
@stephi_ke	human
@kam_goraya	human
@LudlowsOfficial	org
@inesdeaguiar	human
@NoumanP	org
@cerinesdotcom	org
@VirginiaMdz	human
@_JustAlyC_	human
@ACESJ2	org
@Click2Heart	unknown
@kjejercito	human
@BarbaraStelloh	human
@preethz	human
@paulinefashion	human
@MustSeeIran_Ru	human
@takeshi19620209	human
@mahninomiya	human
@SueanneChong	unknown
@Mrs_APcrisis	unknown
@sharkette707	human
@CJRedneckCookin	unknown
@EmmaUlrick	human
@bluebay700	human
@Uptown23rd	org
@architectdrolan	unknown
@insurcompanie	human
@MichaelSchlow	human
@Shonda4s	unknown
@jsscwss	human
@izniesyazmeen	human
@ferdelavega1807	unknown
@RichBoysToyClub	org
@BrokenCoffin	human
@geekgoodgirl	human
@tommy_scarpetti	human
@NoLyeNaptural	human
@AudreyDiler	human
@meeshsparks	human
@marianorinaldi	human
@MEfood_biz	org
@montemusicgroup	org
@CremedelaCrepe	org
@LucianaBianchi	human
@TiltedKiltChi	org
@ppk_fukuoka	human
@MegenCiel	org
@CRISTINAGALEOTE	human
@PFFTitsMah	unknown
@CrumbsMag	org
@JavaCanizares	human
@helpdeskace	human
@GrangeParkSW	human
@jam_5minsalone	human
@IamChinee05	human
@Reina_Gaga	human
@Glamour4fashion	human
@BenLCX_	human
@LondonDrugs	org
@btogirl	org
@ctiekatak	human
@iamAFernandez	human
@m_akiron	human
@JacopodePrete	human
@InnDC	org
@GPIsenberg	human
@siskasiss03	human
@jenniewallden	org
@RipCurrentPhoto	unknown
@SoYangHernandez	human
@tephanieunike	org
@LoveLaughMirch	human
@eiyqajye	human
@MySoulSetsSail	human
@ms_baozii	human
@TundeSwain	human
@LVPsangria	org
@booniebabi	human
@TheMaitreD	human
@AvocadoAthlete	human
@catherinelsm	human
@SalehudinSuradi	human
@MomDivulge	human
@Liv_Health	unknown
@NikkNazsty	human
@elrober_tuiter	human
@CHICANACOOKING	org
@Khaoapp	org
@Stephanieee125	human
@ampchada	unknown
@teamjuicing	human
@EatMeDrinkMeMCR	org
@BigLarryVIP	org
@SteamboatLeelee	human
@nyndiy	unknown
@frankscanteen	org
@MedSeaEvents	human
@PeterSBurton	human
@MiguelDecina	human
@macky_kikoy	org
@KhalisNB	human
@PricyPipoca	human
@MisSdeK	unknown
@addieskitchen	human
@healthisuzyv	unknown
@CamilaStewartME	human
@kmclark2008	org
@icyrhap	human
@TEDvancity	human
@MsMaralen	unknown
@NanaBeth18	human
@Deals4Worcs	human
@EasyHeezy	human
@Gabiously	human
@RVandeweerdt	org
@JVC341	org
@cravegoodfood	org
@clarapariente	human
@seulmarc	human
@nat1153	human
@TravelJoyIndulg	human
@URANEismyname	human
@cmariegoodrich	unknown
@MICHAEL_CRONK	human
@robinbonswor	human
@KarlasSports	human
@MLouise20	human
@janis_423	human
@inubelle	human
@MissChopra	human
@Ariosacoffee	org
@PaprikaParis	human
@PalomaDeFrias	unknown
@PaoloQuilici	org
@YaMonRedstripe	human
@Roxwriting	human
@AlisonJ3771	human
@annalenaboehm	human
@TwinsPlus1_74	human
@imthebeginning	org
@graciedukes628	human
@phantasmicdawn	human
@CubittHouse	org
@itsmealexzajane	org
@RyanSasson	human
@devyvox	human
@ClaudiaRawr	human
@odidavid	human
@mellymelz23	human
@MissKittyKat25	unknown
@CorradoCafe	org
@AnHwang_	human
@VALERIO_WILLIAM	org
@mafomasa	unknown
@emjayare021486	human
@Ranz_9	human
@myonsto	org
@mrtsstyle	human
@dale_pinnock	human
@HardingsNYC	human
@woonin19	human
@MelissaMuii	human
@MystikRaintree	org
@followJJ	org
@Ecochickie	human
@rdindore	org
@sotnichek	human
@MISECYOJ	human
@SophieLMcD	org
@GoddessAshaKutt	human
@yesilvadicafe	human
@themueslibar	org
@JelaiBorre	human
@courtneyadriane	human
@Firstfera	human
@imdbest110	human
@theHopandVine	org
@CrownePlazabei	org
@laceydena	human
@kikigroth	human
@bigpandesal	human
@HotelTeatro	org
@sarah_allenby	human
@SnugThe	org
@cafedipTO	org
@Hamayan007	human
@RaisaTT1	human
@SereSarno	human
@jaspoptheart	human
@My_HomeUS	org
@ShaneTrumps	human
@SeanJ411	human
@ItalianGardenKL	org
@zenberrymix	org
@herbieruns	unknown
@AlamoEatBar	human
@imNOTkerby	human
@hirokiri75	human
@EisQuosAmo82	org
@HarryCole1908	unknown
@LaParisienneRVA	org
@virginia_wong	human
@ohjoy_1985	human
@k2jm95	human
@DaphneN7777	human
@malinannasofia	human
@CherryBlossmKit	human
@scott_tolliver	human
@theumamiblog	org
@joeatslondon	human
@NoKidHungryVA	human
@NamMint_PnPPhaT	human
@emalopez88	human
@evalistianas	human
@Gapohlrossi	human
@popcerise	human
@FriendsofMine_	org
@RellNice12	human
@MeeriiSs	human
@SuzanStrang	human
@MissAnaXB	human
@UNE351_	human
@marjezzlee	human
@IAmZainaMuzic	human
@Nshivnan	human
@mikebelindo	human
@Otley_Exclusive	org
@jamiezoob	human
@WatermarkGlen	org
@ike__0928	human
@Awygirl13	human
@xelsnap	human
@ShinNishimura1	org
@kmichellesuazo	human
@WFMWilmington	org
@LadyinLace_Mel	org
@Kayfucius	human
@TWBGreat	human
@holmesw83	human
@JessonaJourney	human
@NicholeCecilia	human
@justmustard	org
@Radhikamisra1	human
@EmiliosCasaTosc	org
@Neondra	human
@bbdbbdboooo	human
@welsh_sport	human
@irishgirrrl	human
@Pixelfish	human
@20Milagro	human
@Julia_632	human
@SonjaSkyGatlin	human
@VodkaCornichons	human
@estzleez	human
@itsnicerhere	org
@MeatPorter	unknown
@tween4	org
@cla_aranguiz	org
@sarahyi543	unknown
@uglykidjoey	human
@LAFieldTrip	human
@KellyTeruko	human
@mochalot	human
@TeaTime_Blog	human
@Ruth_OrtizGil	human
@TimmyGrocott	human
@ZelRam	human
@JamieLeeA_Life	unknown
@WHampstead	org
@MprmfW	human
@theraizins	human
@zumba8zum	human
@pabloserer	human
@paoloisoni	human
@ResourceGirls	org
@VWCDining	org
@BlastedChurch	human
@matt_meilak	human
@caro_hulli	human
@ClearGrip	unknown
@erleneamat	unknown
@SandraGabriel_	human
@LowCarbFoods1	human
@dancinkd	human
@YorkshireTiger	human
@xxxcharr	human
@ComfortandJoyuk	human
@HSujeta	unknown
@wholetastes	unknown
@designtrodden	human
@martininow	human
@valley2390	unknown
@mqyva	human
@PaladarPasion	human
@6286qsm	human
@madobenohana	human
@sunislandbali	org
@RxAndi07	human
@JoshTorres26	unknown
@RevolutionLeeds	human
@Kaitlyn_Maness	human
@annamphoto	human
@nguyensean97	human
@chrisbautista	human
@pt_anthony_j	human
@aziancheetae	org
@i_amCess	human
@Beer_Knowledge	org
@aurelia_lau	org
@Rif1109	unknown
@fullthymestudnt	org
@princesnipes74	human
@zkharmaz1	org
@DescubreZac	human
@J3SS1CA_M_BABY	human
@alttekit127	human
@Shhaannon	human
@Faborit	org
@ika_atiqah99	human
@joyieness02	org
@SIRecipes	org
@I_AM_MISTER_V	org
@stutisinha11	human
@discolyssa	org
@gurusplace	human
@felisitasdee	human
@gochgazette	human
@Nick____Jones	human
@arie_pit3	human
@patrooshy	human
@hjchinie	human
@zawalounge	org
@flyboobie28	unknown
@Off_The_Cook	org
@markorin_yz525	human
@thiinu	unknown
@hally1989	human
@DiscoverMarina	org
@Sarah_Moritz	human
@Funfitdad65	org
@jmatthewmeiers	human
@DesyIntan	human
@Nuolai	human
@DocBriBots	human
@Pimparis	org
@spotsdotfm	org
@jess_benoit	human
@Ch33ch_Ch0ng	human
@ChinaChinaOk	human
@naicox5y	human
@GaudiBakery	org
@stilliebeblog	unknown
@LivingstonatGT	org
@TTMikki1	human
@vicxzric	unknown
@aPhotoAngel	human
@Veggie_V	human
@ItsMeDYK	human
@veganfitnessls	human
@clairejy26	human
@YazbeckMaria	human
@2PMphan	human
@LaVeraFra	human
@truemira	human
@erinalbano	human
@PuneFoodAlerts	human
@gethealthywithC	human
@SeymaShabbir	human
@tengku_mimie	human
@Source4Women	unknown
@maggidekat	org
@BogotaMania	human
@ShawnElliseNY	human
@satovich0427	unknown
@temporary_local	human
@winchris	human
@lili_blues	human
@kapooklook_00	human
@raipeee	human
@bertgarcia75	human
@gcbjx	human
@gtat56	human
@NAOYATRIDE	human
@SarahOrtega454	human
@imattmypants	human
@camillenieves	human
@ChefSeng	org
@thestudiokw	org
@SDVTG	unknown
@LeePNgo	human
@katdigman	unknown
@fleur_sun	human
@ShrubHouse	human
@inole_	human
@vakas	human
@esonakin	human
@world_of_kris	human
@RuthsChrisSA	human
@FastidiousLife	unknown
@slickearon	human
@1kyaoD	org
@mag_rogers	unknown
@thatgirlhanan	org
@saraza07	human
@ripcity2020	human
@jgadban	human
@Writer_Foodie	human
@thekelseyale	human
@nJerseyboi_212	org
@MsDianeG	human
@ron_alarcon06	human
@casalerario	org
@DCDiningGuide	human
@rintnps	human
@kaijunman	human
@loves_breakfast	human
@yashodhararoy	human
@DiariesofBella	unknown
@sicacar	human
@carolmalouf	human
@AjaDehitta	human
@glanaberhotel	org
@connectordubai	org
@vika_boy	org
@blendid	org
@Shed5NZ	org
@SkintDadUK	human
@travel4tastecom	human
@tonygates44	human
@BerRieZn	human
@denisdirtywork	human
@jesschirps	org
@poshfruit	human
@TimeaTimbo	human
@Flakkylabella	unknown
@CSmithConsult	human
@Chemfusion	unknown
@sarsar1231	human
@weightloss2016	org
@CYuuum	human
@kellyyale	human
@Ms_May_Salon	human
@franz_artryxz	human
@worldpremium	human
@Gourmetbyjo	human
@Caramelgyal222_	org
@Solomomtravel	human
@themrbanane	human
@Queen_Nyke	human
@barbieloovee	human
@LenkaBerry	human
@williama2507	unknown
@jezz_one	human
@RoaaSica	unknown
@yourmomeatsmayo	human
@inging906	human
@Bar145Toledo	org
@anjubalani	unknown
@CHERRYGORICO	unknown
@RimaZanoun	human
@Lukat87	human
@DebCrazyLady	human
@bluepromocode	org
@GrilleonMain	human
@omo_fish	human
@oxsrf	human
@1dental	org
@kris_tynaa_	human
@onindthird	human
@ckinhanif	unknown
@picturemeclub	org
@petrorosel	human
@eatwholly	human
@courtneyjade85	human
@k7kt027	human
@WilaminaD	human
@KLSCENTRAL	human
@jenniferek	human
@falloutgrl00	human
@gaitelyrique	org
@abela_here	unknown
@coldhen	human
@EdmundCheo	human
@Galleyhorning	human
@Venistine	human
@SunDeckFtMyers	org
@StephWithPh	human
@APacetti	human
@Pairedejumelles	human
@qtazntpaboi	human
@100s_and_1000s	unknown
@SweetTeaTVshow	org
@AceNatural	org
@SueLeeJones	human
@CravingToBeWild	org
@EsiturTravel	human
@stevecac	unknown
@ArckTheAssassin	human
@siewlee1803	org
@natsumi_0410xxx	human
@haaaruka1001	human
@EbbieCham	human
@iamjohnchryst	unknown
@jasmine_oconner	human
@JaneChilman	org
@frantastic_fran	human
@ima_loca	org
@TheCosyCup	org
@DKCification	human
@CaputosMarket	human
@MrAdrianCabrera	human
@tinyframe	human
@Faruhs	unknown
@BBQDelights	org
@Stephpearcenz	human
@crossthaboss	unknown
@mamaneedsarun	human
@schmunck	human
@Tribeca_NYC	org
@debsdustbunny	human
@madhvikumari	human
@LuceroSan_94	human
@oldwvpoet	org
@cacaoavila	human
@rigbysdeli	unknown
@foosye_dev	unknown
@BostonFab	human
@FashionEdible	human
@TweetSouthwest	org
@oscarescarraman	unknown
@KimRivalland	human
@Stylekiu	human
@albinoculars42	unknown
@MDVAMilk	org
@TboneTalbot	human
@De_Mon	human
@TopOnlineMMORPG	unknown
@OORtheBeginning	org
@katay_nick	human
@AlvRJ	human
@rhack__	human
@LossBato	org
@NotesLeeds	unknown
@KEYTNC3Meredith	human
@ktkatrina	human
@gratissimo_shop	human
@OatNewsletter	org
@harrisonroadie	org
@ToRecycle	human
@InstaNorilsk	human
@demonwrangler	human
@jaimeriera03	human
@muarafatan	human
@aaronswapnildeo	human
@JuergenWest	human
@143fresita	human
@Uruha_Sir	unknown
@Jazprouse1	human
@dortheaekawati	human
@LiquidlunchCT	org
@YorkdaleStyle	human
@bellasheart143	unknown
@deesquared16	unknown
@ranjitashaw	human
@remilioch	human
@ClairusMaximus	human
@rpa	human
@klskbc	human
@mommaoftwoboyz	unknown
@EacClark	human
@Cinnamon_D6	unknown
@zingwen_	human
@GSarkisyants	human
@ItsjusmeRhondaP	human
@RocknRollAngie	human
@VeneziaAndrea	human
@cyclingmedic	human
@toni_marciello	human
@beth_dunham	human
@WorkingMomof2	human
@JuanCandeal	human
@NeighbourhoodEV	human
@IgniteTweet	org
@Littlenansbar	org
@MrZackeryWalls	human
@mwibowo88	human
@LuisaLuciaStyle	human
@GelatinasSayes	human
@Mymski	org
@angharadlconway	human
@AROOJ54SATTAR	human
@twixie_babes	human
@KaeNBDBChef	unknown
@iamjakeuytiepo	human
@SayWellness10	org
@aaron_de_silva	human
@AllThingsMeaty	org
@olivefooddoyou	org
@Paulinealacreme	human
@zsharman	human
@virtualhomemade	human
@gissi_manzanero	human
@sandorbcn	human
@MairaGoncalvesM	unknown
@GOLDsushiclub	org
@McEddyent	human
@JFUNKLA	human
@WithinBoutique	org
@CAWoodley	human
@nikki_triff	human
@Jogjaiklan	org
@Andydolla	org
@CB_Chicken	human
@lychala83	unknown
@franckajoseph	human
@missshopaholic2	human
@VictoriaPuleo10	human
@BelviderePlace	human
@MCHomemaker	human
@NATASHASTV	human
@eatthisinKCmatt	org
@jesslloyd_96	human
@redanchorchartr	human
@ScoffersDeli	org
@tagsthoughts	unknown
@__icon__	human
@ykwmt	human
@shyshyla_me	unknown
@gege_geisha	org
@kitchtablepro	org
@DRodd36	human
@Toony_Castilloo	human
@bredehoek	human
@temparajantar	unknown
@ComChiam	human
@HaiStKitchen_US	org
@msmj101978	human
@HockeyStickWkly	org
@nanuwins	unknown
@thebeachhousek	org
@ketuzyoumazin	human
@MsWright1987	human
@ChevalMumbai	org
@ShannonSmith75	human
@a_mels19	unknown
@ChefPigot	human
@AnnysaLaMantia	human
@iConversations	org
@MrLittleKing27	human
@AnnPorcelain	human
@michaelbabic	human
@sofestive	human
@DanielleRambler	human
@spokar	human
@janergherardi	human
@HNC22	org
@UnionParkChi	org
@RuthGnR90	human
@khersahib	unknown
@OliviadeGala	human
@MemoirsOfAMommy	org
@HotelArnhem	human
@RudeboyentLCG	unknown
@JaquetteRAF	human
@_lhomedecor	org
@typicaltypeuk	org
@andrew_shin3	human
@Vitacost	org
@CaffeRoM	org
@phatzplace	human
@electrifyfit	human
@migumerawajifu	human
@ohohcyrus85	human
@lucyleoorganic	human
@ChristyResca	human
@dajadadisuqus	human
@_OnlineStylist	human
@sibrobot	human
@NeilTT1	human
@luuny777	human
@ClaireAshMeadow	unknown
@cpcoffeehouse	human
@foodie_goodgirl	unknown
@FitnessGuide112	unknown
@DusitThaniAD	human
@MangiaPaleo	org
@robflorivera	human
@Lucygmnice	unknown
@hvnscyld65	human
@Cheryllynncox	human
@pnuttybutty	human
@ShardaT1	human
@Mallas6	human
@Chris_Callanta	org
@therealjpmm	org
@JustJustin1910	human
@Champagne24Kt	human
@CLworldtraveler	human
@onderrakay	human
@just8doit	human
@secretagent212	human
@thesaintpooven	human
@mariajat	unknown
@soahinst	human
@dr_babu	human
@clumsysmiley9	unknown
@gleekynorland	human
@KELLYNDORSEY	human
@SayWellness31	org
@KarlaLilianaent	human
@storyshucker	human
@look4planmiami	human
@jerewall	human
@mikelaagan	human
@VincentdeWeger	human
@kim3rs	human
@SuttonRevs	org
@ailena04	unknown
@ampnn_c	human
@AKGB	human
@glooxo	human
@RibsnBierCo	human
@Suzannah314	human
@gerawlbean	human
@Q_is_awesome	human
@kevin_1607	human
@olivezarate	human
@yamanekoshokudo	unknown
@MissMegasaurus	unknown
@MyFoodDiary	org
@baltzco	org
@townandcooking	org
@IAmKicks7	human
@aparna_jain	org
@cherrrah	human
@brettjuliano	human
@bigeekay	unknown
@IBlocNotes	human
@LouisBass22	human
@JokevanOo	human
@JWalkComedy	human
@AnamStyle	human
@OFiespub	org
@zunyip74	human
@JoanneGreco777	human
@oeei_	human
@bluebleuazul	human
@mayurporwal	human
@CallMeLeaa	human
@vinzska	org
@King_Temptation	human
@Charrrr_G	human
@ndrhos	org
@ShamielSham	org
@TheSDLifestyle	org
@yousmiling	human
@Infinite_Kels	org
@vaprestony	org
@ttaylorfitness	org
@tomateyamor	human
@hillaryfrank17	human
@kellenwhaley	human
@bertystenny83	human
@hanyamo1008	human
@gnssaaa	unknown
@ReaHadziabdic	unknown
@Nenny_Irianti	human
@hertyparty	human
@courtcourtxx	human
@7chicavenue	org
@Bellerants	human
@iHeineken_	human
@Semih_Hazar	human
@hackernewbie	human
@charlie_cova	human
@SissySuzan	unknown
@miu_mochizuki	human
@adamramsey1	human
@Laur_Vigs	human
@itsme_rose28	unknown
@siobhanisblyss	human
@TiniChef	org
@GaHuiNho	human
@notSupermum	human
@DanielleBallard	human
@AM_Hayes	human
@alihammadnaeem	human
@M0D3L5	human
@florafauna9879	human
@hastinatasya	human
@MariteDeJesus	human
@JORDAN_N_LEVEY	human
@Dusin23	human
@NeuvooMiamiBea	org
@BadosPizzaGrill	org
@HowdahFood	org
@hankjustice	human
@olive_anne	human
@jaimegeeg	org
@TtownTasher	human
@andy_wedge	human
@ENC_Health	human
@KarenHapuks	human
@buddlakequilts	unknown
@Wdalecreamery	human
@empleoclick	human
@AnothWoman	human
@Mahmud_93	human
@MyBaybah	human
@Cellarmistress	human
@MarshasBakeBlog	human
@SaintBarthcom	human
@FirecrackerUSA	org
@PhilipMarie	human
@FortSmithEats	human
@xnfhv	human
@andylemaire	org
@PolishQueen2	human
@eat_n_joy	human
@ayaxtwins	human
@elephant747	org
@orkubomban	human
@ElisabethsMusth	human
@dishtales	human
@penuy	human
@ChuckyC14	org
@_ImAngiee	human
@fespinoza21	human
@genkozuki	org
@sergeantkero	human
@annteewhyzac	human
@RegenceUtah	org
@yuiko_yyy	org
@that_girl_samii	unknown
@weareoskar	org
@Davemantel	human
@GospelSWAGG	human
@deekayy__	unknown
@oldcar_photo	human
@c_vasquezg	human
@MelRuetsche	human
@DeeBananas	human
@KeyaFoods	org
@FlorRFitForLife	human
@akosichellogs	human
@GemmaGarwood1	human
@MaithiliK	human
@chipmunk_chic	human
@GrouponMag	unknown
@Lifefood_en	org
@KaLaniSantiago	human
@theerikroq	human
@Becbata	human
@jayellehouston	human
@iTrestles	human
@Mrkelly_music	org
@Thys_Smith	unknown
@pippa_milburn	org
@porchettanyc	org
@vindeset	org
@xoxoday93	human
@MariaTailor	human
@Yacolchones	org
@FriedDandelions	org
@sondry	human
@stephynam	human
@Downtown_Chtown	human
@marloisthatgirl	unknown
@SaveursduMarch	human
@jennlynjariol	human
@JaclynEaston	human
@adlina_harun	org
@realashstreet	unknown
@MAG_mushi	human
@cduthoy	human
@Tofflisen	org
@GoodBeerTweet	human
@notsovanillasuz	human
@Traveler323	human
@HotelPortonBog	org
@OllieJessop	human
@ki__a	human
@LeesaDehass	human
@geminichin	org
@IntanEzreena	org
@sasd230988	unknown
@yellowcumbrian	human
@bella_taurina	human
@fkfrn	human
@anhavana	human
@GGrillSoton	org
@BedazzledZazzle	unknown
@eh_ness	org
@NEWtasim	human
@QuinoaRocks	unknown
@BearMarketCo	org
@LivingRosy	human
@NiCHOLASxF	human
@zkharmaz4	org
@dina12345643	unknown
@Ru_chan1994	human
@Missme84	human
@iAmeliai	unknown
@SubhuTech	human
@OC_DolFan	org
@kenjoslin	org
@brunapedrosa8	human
@simplyhealthjp	human
@PicklesNHoney	human
@PhatThaiSF	org
@royalkrg	human
@PatLingSY	human
@Meyos21	org
@alexjuy	human
@Helroy	human
@Yang9657	human
@JRBaldy	human
@SelectPlatinum	org
@4M1	human
@Hillyne	human
