@Wagstaff_SF	human
@tlwenyi	human
@HeftyBrands	unknown
@MiaFamiglia1	org
@LangChops12	human
@DietitianOlivia	human
@Vanbanares	human
@CorneliaandCo	org
@estebantwitt	org
@monaaaxx	human
@FieldsHighbury	org
@FoodieCycles	human
@shyaditi	unknown
@kuyan1	human
@3MommaDuke	human
@hirotwt_uk	human
@maaamin0308	unknown
@ArgosInn	org
@CharlinRei	human
@DineOutNKH	org
@TenaxTime	org
@KeeKeeana	human
@Thickythick2002	human
@eyecandy3699hot	human
@ChrisTheJeweler	human
@Marsha_H	human
@twotooty2fruity	human
@Inquisitivephx	human
@Snack_Porn	human
@Melly_Del	human
@GemsHolistics	human
@RedDonutInLA	human
@beaishappy	human
@dukeofrichmond	org
@Edgar_Vieira	human
@BAMBI_GRABOW_	human
@Artigiano_WS	org
@_Murder	human
@Juanrigrat	human
@jeffrsmall	human
@Skazie	human
@tatteredstones	human
@hiro23_okubo	human
@nicaveronnn	human
@DaniellaChanel	unknown
@Im__the__truth	human
@martinmic	human
@juliawhiting	human
@305LUHOUND	human
@camdenrotiss	human
@djestyleznyc	org
@HangoutGetaways	unknown
@CriestoFM	unknown
@JulietAmaZOOM	unknown
@FABflour	org
@mikeshulman	human
@JapsDioknoFull	human
@theBKgorbals	unknown
@TheSaltyToad	org
@pallyxie	human
@JulieMutLA	human
@MKKwoodenstuff	human
@TenderBelly	org
@ZaraCabanyes	human
@Noonernoonz	human
@MelsCafeBar	org
@drasticfresh	unknown
@wearecityTweet	unknown
@luciepaimblanc	human
@DacchiesL	org
@FitFannies	unknown
@only20something	human
@Suryaning_wulan	human
@jearuh	human
@SusyOnTheRocks	human
@ViviGuerreroG	org
@vantemajika	human
@Tommywindsor17	human
@Laura_B_R	human
@LaBodega47	unknown
@vcspice5	human
@Katiebrandner	human
@LPridgett	unknown
@WindaSofiya	human
@MarikaTania	human
@TheFoodJunkie_	org
@ayaxgogo	human
@DawnBurgun	unknown
@_MsLL	unknown
@VegasLitUp	human
@Shmobo	human
@MadAlix14	human
@SEO143	human
@sproutfromsoul	human
@felixthecat86	human
@SaraDISHnyc	human
@LuxuryDreamer	human
@IsmailHJIbrahim	org
@LucelyBrigitte	unknown
@robbiediesel420	human
@JANNIKPAARE	human
@iDivaOfficial	org
@vicky_vogue	human
@Nersvenerly	human
@MallZonaDos	org
@Albee1023	human
@jemappelle_jc	org
@lepelletierc	unknown
@holidayinnmumba	human
@LaCosechaPaso	org
@folwbck	org
@MARCOPAC_	human
@DeMandarijnZwol	org
@Tony_Romas_UAE	org
@chubbyhot	human
@OsmosedMiko	human
@JohnyAction	human
@themiketerrell	human
@AngelAnn95	human
@griffinlisa985	human
@TheSoundCup	org
@MIRUU0716	human
@TheZeeJames	unknown
@lbs2027	org
@PalomaMarum	human
@JTPINNA	org
@abdoshawky2442	human
@queenbee75	human
@Live1Wellness	org
@_getfried	org
@twinkyenriquez	human
@primal_glow	human
@LazyGirlVegan	org
@nshahizahn	human
@Tun_MatGyver	human
@MAJORLEAGUEBAR	org
@TraffordHub	org
@brewy_chris	human
@incubusetta93	human
@Hospitality_Jas	human
@MzJessieLove	human
@BrettaAdlen	human
@IrenaBerrys	human
@lyminervino	human
@RainingFood	human
@damycool	human
@martian09	human
@Nudistbeach_s	human
@rennatuster	human
@peepz78	human
@CeleneTolentino	human
@paperandpen20	human
@hamburgero	human
@Rachele8050	unknown
@360FitFood	human
@sokty	human
@emilyarts	human
@disaieeryr	human
@yellowbee2002	human
@Nancys93	human
@myFoodblog_nl	human
@JbBelieve121	human
@Springworkout	human
@MelloMucchiello	human
@1Dager	human
@fymamuvitoxi	human
@kireiswitch	human
@foodpanda_th	org
@LeeRosa	human
@chefklb01	human
@PHONIK4Real	org
@torabou_tiger	human
@mzkimberz	unknown
@MerryAnnsDiner	org
@CP_PRR	unknown
@mummy2monkeys1	human
@mattkingham86	human
@CedarTavern755	human
@rininas	human
@FinkelsteinFL	human
@lushuan_Kam	human
@Meantmiint	human
@barrettlane	human
@weiningaurora	human
@OliveriGabriel	human
@WorldHirotaka61	human
@WestOnCentre	org
@MissLight_AnnA	human
@DianAyuShafira	human
@bgrooovy	org
@gomack22	human
@hekdisium	human
@GraceFortWorth	human
@Ali_Buttiglieri	human
@xoxoski	unknown
@VillageDanceMp3	human
@sirensheree	human
@neilsean1	human
@Jperezoso	human
@urtransform	org
@bluespotsapp	human
@blurlollipop	human
@NadhiaRaraKhan	unknown
@rekhacha	human
@santana76cm	human
@D1zg	human
@ratnafaradila	human
@Via_Cibo	org
@fragilecx	human
@GokcenGokyer	human
@privatecheftci	human
@Wallyography	human
@GospelHighway11	org
@AAlwin	org
@chipmarjoe09	human
@HarryyouMe	unknown
@veganchao	human
@TreePlantingbot	human
@WickedCreative	org
@lizd31	human
@vicky_iceblue	human
@KatyHaveYouHurd	org
@lordlenard	org
@visitparma	org
@aguissuarez	human
@MelissaGLife	human
@RobsonStreet	org
@MeryMadSev	human
@Foxyfon	unknown
@correajulian	human
@rimahi1	human
@ricnfra	org
@maverine3	human
@bophoto	human
@FleurtyGirl	human
@ClaudiaCasadio1	human
@carmilina0427	human
@becauzeniall	org
@CountNotte	org
@JmerdaJuve	human
@ednadeguzman	human
@kovacs_eva	human
@malaga29640	org
@Sachoza	human
@zureets	human
@tman84	human
@vaMpiire_Meii	human
@BrinisFashion	org
@BabsieLus	human
@EvieTheCool	human
@tomokokira	human
@ffabulousdiva	org
@OneUjena	human
@JennyHacks	org
@rickym22	human
@FarmStayUK	org
@EleniPolites	human
@my8one3	human
@VisitYork	org
@tessiie24	human
@SeptiChanSsi	human
@SUNRIZEICH1	human
@Buddy_Galaxy	org
@KashAcosta	human
@travelwith2ofus	org
@lydamyp91	human
@muaythai4women	org
@KrissyHines	human
@HellVolcano	human
@RangerMofo	human
@MaMOOK_IN	human
@IsamaraCC	unknown
@mariashaw558	human
@meals_heels	org
@THE_TINY_REBEL	unknown
@superflyspice12	human
@faeriesdream	human
@AlyssQuynn	unknown
@jeslynlimrj	unknown
@VTaybronEvents	org
@proxxies	human
@do3aa2	human
@yephoneru	human
@Chef_Aaron	org
@BonesZooted	human
@andthenMelissa	human
@TomSiinek	human
@ToothFairy10	human
@hubnet_se	org
@belinaysevim1	human
@barbieeandKENN	human
@2collegefoodies	unknown
@The_Groove_Gard	human
@Rossygarcia21	human
@JeanWinfield	org
@ogiiieee	human
@elisaokt	unknown
@princesscsi78	org
@CorinneHotel	human
@RachelynJT	human
@ImanRAISE	unknown
@RyuRedwings2	human
@NikhilFalari	human
@BuongiornoB	org
@PepperoniDH	human
@mjc0930	human
@kazuyo29	human
@ggerasme	human
@JPHazelwood	human
@Foodspotted	human
@jojoandeloise1	human
@issa_calandri	human
@hitomin0604	human
@trpizinth	human
@MyCommunalTable	human
@AliceBoolkaka	unknown
@BiteJunket	human
@TheSanctuaryCR	human
@MicaRestaurant	org
@PrincessWaawaa	human
@Lavender_B	human
@stephCastl	org
@ZeGrillJT	org
@Mr_Posh1	human
@Dr_Ofboli	human
@anstiny1621	human
@nleats	org
@tie_yahoo_	unknown
@tanzoy	human
@indy12IF	human
@OHlovex	unknown
@EBeck4Real	unknown
@iamcrystelleB	unknown
@Woww8loss	org
@MoffatMok	org
@NatalieHaldeman	human
@goobervision	human
@jvozsol	human
@JogjaHoliday	human
@organicweek	org
@pampopperchng	human
@okair1	human
@FunNFiber	human
@robertwhite2012	human
@hoobabob	human
@yucco_sade	human
@kamigro	human
@DilanaMusic	human
@DrMahraLutfi	human
@jadorelesresto	org
@vandana061	human
@_mspablo	human
@DiegoGarcesTV	human
@Good4UNutrition	org
@loyiso_mtoba	unknown
@BudgetEarth	human
@theSuens	human
@posh_desserts	human
@CinelliRoberta	human
@nikkitmy	human
@James_Shelby	human
@inabatakayuki	human
@_AngelsBlood	unknown
@mylife_bio	org
@SEPHIROTHnjz	human
@WebsterInn	org
@Chaos_Cooking	org
@cachaoprimrose	unknown
@SoStylicious	human
@IvanDaigle	human
@OlioRVA	human
@ChaophrayaThai	org
@RevolutionDG	org
@jcmapaofficial	human
@JColeDroid	human
@HafizSaimi	human
@Awais16	org
@helens_keto	unknown
@RachieMara23	org
@zochiluvskemp	human
@babybabyps	human
@AliseBelcher	human
@Mzrawwfash	human
@anndelmonico	human
@Kaylaux	human
@sjmburu	human
@EBSirBoss	human
@jabell86	human
@jodyvance	human
@SmoothieKingCS	org
@amybgeorge	human
@ginzeh	human
@BootheConn	unknown
@AneesaV8	human
@blondbmovement	unknown
@ms_at_ak	human
@valerieyeo14	human
@Khadija_ag	human
@_Viou_	human
@My_Name_Is_Doug	unknown
@CheckersSA	org
@the_haute_list	human
@bluepupula	human
@ExecPConcierge	human
@babynov	human
@NedalgagaNedal	human
@xciokkyx	human
@apriliasiilia	human
@MommyWithTwins7	unknown
@Nymph4981051	human
@trontavius	org
@RobinBarrie	human
@Eksadgeeee	org
@glendalandia	unknown
@dayday8610	human
@Anggix_nggox	org
@ABURRILL	unknown
@PILAKO22	unknown
@thefitnutter	human
@PinoySongsVlogs	unknown
@digitalrgorilla	human
@_MissMusic	human
@coconuteclipse	human
@leduch74	org
@nanalanapeep	unknown
@RaquelPeche	human
@Andresco9423	unknown
@Alexis4Alexis	org
@Manucin	human
@Mariogarrido30	org
@sarahxXx1990	human
@FernandoKhim	human
@lei_dat	unknown
@avon_chandra	human
@kt_gurl	human
@MeBeEmz	human
@NeawB	human
@yuliawidya93	unknown
@LED_Sign_Truck	human
@LadyGouldian	human
@klharris30	human
@animalHathletic	human
@MsMt86	org
@2HungryBros	org
@AkshneesKitchen	human
@the_davioli	human
@MyMishion	org
@Sadlerandco	human
@GirlieGirlArmy	human
@raden_cherry	human
@vsantiago911	human
@nimapshah	human
@ksavaliya	human
@Slimshk	human
@nicholechai	human
@sakumaRYOKO	human
@EllenArmstrong	human
@itowoche	human
@sassEden	org
@LBsMeatMarket	human
@CandypantsMarbs	human
@maeflores8	human
@josephrileyland	human
@steph_tly	human
@Lasse_Larsen	human
@Good_Time_Gabe	human
@MarleyMartin	human
@PabloCarreraCba	human
@MatthieuNOLA	human
@StephSibbio	human
@travelfoodiary	org
@AnneliseReid	human
@kamilyaaaa	human
@wisaalh	human
@Sai212NYC99	unknown
@Shokk1	unknown
@Amanda7785	human
@nuuupii	unknown
@luvmycreations	human
@whatsgoingon31	human
@templeofbeauty2	human
@The__Amazon	human
@PearlPortland	org
@ankitaasthana	human
@NIXSHartford	org
@kevinlcyeah	human
@MamaKtreats	org
@ahmad_raha	human
@Bella_Mason_	human
@highganglotto	human
@givenchie0187	unknown
@LifeasLeels	human
@KBNFinance	org
@jayla_12	human
@zeppy_geocach	human
@itsmeRRJ	human
@WiYown	unknown
@semangaART	unknown
@kenniwyzdm	human
@NidineMann	unknown
@khanessam	human
@samesiders	human
@hicca03	human
@emelienystrom	human
@HealthyForLife2	unknown
@eugeeniegaga	org
@helishmelon	human
@MarleySpoonUK	org
@Chel_Marui	human
@AllyMcGlam	org
@williamyeny	human
@Zaxbys591SMP	human
@afath89	human
@Ballplyr_India	human
@Donjuanrafael	human
@kenrickbautista	org
@Qiptia93	human
@georgie_joseph	human
@MeaghanAlisse	human
@rebellomilton	human
@HiltonEugene	org
@NjFoods	org
@kyndl_fire	unknown
@radiodeeside	org
@therealncpeach	human
@iAmMsDJ	human
@margaux1030	human
@r1529y	unknown
@CHOCOAJ	human
@Max_Well_Ness	human
@makeandbakeblog	human
@KatiesBLKBoards	org
@dominicanpadre	org
@mizjelz	org
@ForkYouPgh	human
@ChihiroKelly	human
@simonzster	human
@ANimalesh	org
@edtritton	human
@2bagsandadog	human
@Rohitha_Perera	unknown
@CurlAlyLove	unknown
@AmberlySilverio	human
@MartinaRosso	human
@albertalanmadr	human
@HouseofGreedy	org
@snoppy_pink	human
@Lily_Chandra	human
@BeyondBeauty15	human
@Alvinleongs	human
@ddeajovita	human
@mikoweii	org
@homingtam	org
@rachmontague	human
@roseguy64	human
@King_Khuzwayo	human
@ShehanWicks	human
@eatfeedlove	human
@caprichohelena	human
@shazzy5353	human
@Epicera_global	org
@healthylnb	human
@rosariossa	org
@Mozartraga	unknown
@MancBierkeller	org
@MaestraCoast	human
@SharnMc1	human
@Nupinkiez	human
@ChrisGlitsos	org
@JelenaKandic	unknown
@FotoDavideDiego	human
@StfnNvrSlps	unknown
@TribalWaves	human
@russellalvind	human
@MadameMagazin	human
@JenalleW	human
@TriahJireh	unknown
@CocoPokohoran	human
@1110_hey	human
@silviettaqb	human
@rlam_	org
@TNNRaleigh	org
@CatSaporiti	human
@mevebl	human
@ATropicalAffair	human
@kimikahayakawa	org
@Danish_Badboy	org
@SKRipstein	org
@NoKidHungryLyco	human
@Emy_Flores	human
@kvplates	org
@EzequielGr	unknown
@Redondo_Indo	unknown
@remarkablenblue	human
@LipsticksStyle	human
@Remax_accion	human
@SoofiaC	human
@wanie_redzmann	human
@periyakulam	human
@danceottanta	human
@bvg26s	unknown
@MammaChia_NY	human
@banz69	human
@FiveStar_Cinema	org
@aipon0619	unknown
@KURTifiedd	human
@MariadosPostais	human
@RunMikeRun	human
@luzalvz	human
@dominicsmart1	human
@PrincessKris89	unknown
@jonatz1028	human
@EleonoraScafaro	human
@AshLucia1	unknown
@SpottedGuyCT	human
@aj_baldwin	human
@boytitarsole	human
@HTML5Digest1	unknown
@KLEEN_MEDIA	human
@BBColumbus	human
@mariana_lovita	human
@benaim416	human
@PaulineSeban	human
@MINniiz_mp	human
@mariaflaviac	org
@tykqer	human
@DMHorobin	human
@melindahamori	human
@zelclarianes	human
@H8JoeKlesey1up	human
@safamaryamsyed	human
@bonnlee29	human
@RaichelRobinson	org
@RoadTripExplore	org
@michaelmarmora	human
@raraqyut	human
@giftbyliz	org
@adam_rab	human
@camille_bRose	human
@EatRepublix	human
@ChipsRestaurant	human
@RawELF	human
@MadonnaPeterson	human
@LibertyBellzzz	human
@SenzalaBrixton	org
@coachandfour	org
@les_sou_les	human
@lepontdelatour	org
@agporta	human
@RachelVanDunk	human
@thejoysofmyboys	human
@KellyDeXie	human
@elenaschiavon	human
@bSCOLer	human
@Emimilie78	human
@brasseriechavot	org
@Terrywindian	unknown
@que_phin	human
@gourmeted	human
@sophierose_Ox	human
@ForeverMrStarr	unknown
@Fake_KatyPerry	human
@WilsonWashburn	human
@herrmicrowave	human
@MAYASEIBERT	human
@kupizzashuttle	org
@BriannaLaRouche	human
@ReeserPieces	human
@MartiEHines	human
@mfunatsu	human
@Katwic	human
@postapokalyps	human
@WillytonRH	org
@theexoticjewell	human
@Thanagolf	human
@t2telegraph	org
@IamPengers	org
@trufood8	org
@Babynamfony	human
@Veg_Kitchen	org
@AnguSTay174	org
@KyouYurono	org
@swalshbrown	human
@sun_hiromi	human
@GoldStandard88	human
@UrHealthyWeight	human
@peta2	org
@Elena_br	human
@Glaoua_Diane	unknown
@JohnnyCarino	human
@AmeliaPhotoAme	human
@hniie	human
@Mandsmillie_	unknown
@Stefanie0926	unknown
@JujuSprinkles	human
@MsRamyiaValeceS	human
@Agologist	human
@MoiLuvelle	human
@marliave	org
@IwanHernawan_	human
@team1mc	human
@mrsblakehall	human
@laurenkra_ww	human
@BonMarieFood	human
@BBBauM429	human
@ArnoldAustria	human
@NurseLizJ	human
@cherry_twist881	human
@VisitWilmington	org
@SamPullandBuy	unknown
@QaliStacks	org
@allboutchocz	human
@HobnobLive	human
@GreenTangerineH	org
@SparksMPLS	human
@urnotwelcome	human
@tulipe_fragile	human
@linafazliyana	human
@bubbysbest	unknown
@jackielamalice	human
@ATRENDYLIFE	human
@MINTWOODPLACEdc	org
@FabrizziosB	human
@farahjanis	human
@stefmissshoes	human
@gloverpark	org
@ringochiu	human
@Notmomsclos	human
@MelissaDaSel	human
@BriSeeley	human
@chinamethyst	human
@MissEP_Ciara	human
@jOseMiguelOquen	human
@cappypopp	human
@ReginaldLigon	unknown
@junkycosmonaut	human
@dbronxkc	org
@yadzrein	human
@itsmandible	human
@ASparklyThing	human
@charity_chris	org
@Tinnnnu	human
@elric14	human
@brittlucas12	human
@sabahatpilic	human
@nairritdas	human
@Pacharapapon	human
@MakeUp_S	human
@hexxchocolate	org
@Vicenta764	unknown
@Vincentelife	human
@dennisrocknrod	human
@aoixuw	unknown
@movementspeaks	human
@kraftycheez	human
@LukyKnightRyda	human
@plakdubumdumtss	unknown
@asha356	human
@PigseyArt	human
@futurecode	human
@BurdockAndCo	human
@VegasBlast	org
@Solmyr73	human
@whysocutegaily	human
@leblogdecocotte	human
@eatingforsanity	human
@dabonster	org
@lmsgwu	human
@ClaudiePierlot	human
@upsydaisybakery	unknown
@MZSH1	human
@Boozaruskey	org
@charliepederson	human
@karentonka	unknown
@FloorEsmee	human
@brumotta	human
@megapoenya	human
@sventology	human
@Kheiren	human
@LuCarranzaM	human
@CoraRestaurants	human
@anita_bakes	human
@ApplewoodCheese	org
@DIARO7	unknown
@COBHPub	human
@QueenJayL	org
@S_YvetteLynn	unknown
@Bluebelle0505	human
@TheNakedLabel	org
@DinaAl_Ahmed	unknown
@ksdiaries	human
@tomo_minmin	human
@affordafashion	human
@TheBoxBar	unknown
@modernadjevojka	human
@SweetSpreads	org
@veganfoodshare	human
@SubbaraoKeshika	human
@AngeloHoran	human
@kweehonjin	human
@nina_delrosario	human
@aga_aa	human
@Mark_Gounden	human
@rhodesbread	human
@Cicajoli	human
@alwaysaterrier	human
@jenhumphreys5	org
@MenusInLA	org
@SnttgAglarr	unknown
@VickiArkoff	human
@lexisips	human
@LeckaLecka	human
@SamanthaJacq926	human
@Jubilantkid	human
@nicocalvivar	human
@yarlene_rivera	human
@albertassens	human
@ferliloo	org
@Coraliegreen	org
@windidaha	human
@citybibleforum	org
@birdersue	human
@PatriziaRametta	human
@mzcathz	human
@Thurston_Taylor	org
@chubbyrina_	human
@ging_y	human
@Jestferlaffs	org
@syamimi_s	unknown
@es_jay08	human
@lillyhols	human
@QIANscarlett	human
@Karlien_V	human
@Beca1982	unknown
@Domitila_Mode	org
@oppiepw	human
@ShafiqaSarban	unknown
@jcrchuvaness	org
@laboomistanbul	human
@JorgeOrea	human
@jasondbaillie	human
@y__u__p	org
@munchiesbarkery	org
@CI_Minories	org
@jenjamestan	human
@ZLokah	human
@Pepperplateapp	org
@Mamanfrancaise	unknown
@Kimaya8301	human
@_electro_	human
@jedidaslinsky	human
@Je_ffree	human
@Ahadjz	human
@MontrealAddict	unknown
@xox_Andi	human
@OlivaBistroCafe	human
@MarisaEveline_C	org
@DenisaDelicious	unknown
@nourishfastfood	org
@Soprananas	human
@Mickskarmabar	org
@Chloentichers	human
@badoquecafe	org
@filtercoffeelab	org
@nachoalbo	human
@YKMagazine	unknown
@CG94	unknown
@adehogan	human
@Macchiatocafee	human
@phylc_author	org
@jamie52305	human
@ChicagosBestTV	human
@ekoseptiriadi	human
@cozymodjo	human
@MohamedSheta	human
@jhashe17	human
@chefcindyhutson	org
@Idyllwilddesign	human
@LorneFade	org
@dearyouloveem	human
@RoyAL_mannY	human
@kaio0601	org
@Sherlocanny	org
@cwslsnowy	human
@smizedivat	human
@LFDT	human
@Sucisung	human
@VangelovaNevena	human
@bianxbautista	org
@PaintYourDays	human
@toolboxluis	human
@CollagenShots	org
@AsgaardP	org
@ESTEPHIIA	human
@myezplan_OCEAN	org
@mfakhrulmaulana	human
@trackerem	human
@ccbid	human
@MaureenMcHale	human
@RM_Torani	org
@saifulsar	human
@denvercommerce	org
@satomin76	unknown
@amtortora	human
@Ysaaaww	human
@CCY45	human
@davidbrier	human
@missioninnhotel	org
@Dailygrinderr	org
@harrincc	human
@ChefKenya	human
@rumrunner43	human
@SerpilTuse	human
@PositivelyFlo	human
@SMMWilliamson	human
@blue_decamax	human
@sfleming777	human
@HeyMundster	unknown
@BeatrizGV89	human
@Onitsuka_ReMix	human
@cdr255	org
@twincklet	human
@LeBoucleeSalon	human
@edlau	human
@Mommy886	human
@AuliaTirtadira	human
@nana_stationery	unknown
@markbealpr	human
@lemonipizza	org
@spaceball1	human
@aurolayton	org
@jimmystahoe	unknown
@square_moultrie	human
@X_MICHIGO_X	unknown
@alessiarux2	human
@f_dopey	human
@UltraBrasserie	org
@maxwel_10	human
@taroow74	human
@alederuiz1	human
@KitGSanchez	human
@ButchertownHall	human
@MartinaR93	human
@magz_dc	human
@KhikiChyko	human
@gabbymonsta	human
@Tastebuds4you	human
@Xiiaodiing	human
@lien_minh	human
@lara_msaed	human
@lyssaleigh718	human
@sbstnjck	human
@tw_905955	human
@MrNigelIan	human
@singleeyelidgal	human
@MelodyGoodell	human
@cubanazo24	human
@fedebodyfitness	human
@larrylove617	human
@Evelynnette	unknown
@donnydoit	human
@cybelegarrucho	human
@TheGlutLife	human
@OneChocolatebox	human
@m_jennifer_	human
@anon82828	unknown
@IamJesusSanchez	org
@BeckieBrooks	human
@SunsetMag	human
@RynaZain	human
@stvnsknnr	human
@TheBurpBlog	human
@MandyThe3litist	human
@TwistJajaCool	org
@ItIsF1710Lynx	unknown
@CarenBeth	human
@nocandybaby	human
@jiajesss	human
@hhiltonz	human
@t0919yamtrd32	human
@caffeinated_mom	human
@jonnystannard	human
@Weddingscancun	human
@aimee2621	human
@elino4ka	human
@JLouiseArtist	unknown
@nikolinapapa	human
@revonilly	human
@dannyboy91706	human
@PheonixTaylor88	unknown
@jimhairphotos	human
@EdsonF0007	unknown
@MissKendraV	human
@Dat1tob	human
@nikmistry91	human
@DeniseSung	unknown
@thepajamachef	human
@SophianFikri	human
@LauraTheFanGirl	human
@urmarketeam	human
@rhirdes	unknown
@SavageNightLA	human
@BondirConcord	human
@PointeOrlando	org
@VictorKidd1	org
@garlicshaker	org
@askpRoy	human
@lucianoparis	human
@macquesquared	human
@TonyMangia	human
@PassionForPork	org
@Ellas_Den	human
@JMariangela	human
@JuvenileBureau	human
@uncle_bens_	human
@Aenighma	human
@YTABEARUKITAI	human
@EdibleMiabeach	unknown
@cindyluvTop	human
@CtOrAcCePt	human
@icolacandy	unknown
@RamonLnrs	human
@dellykyo	human
@overachievers	human
@tinabeana12	human
@shavida29	human
@IRunNY716	human
@A_Hyp	human
@ninonindra	human
@shesyira	human
@uiweeeeelou	human
@TjutFarah	human
@zeppy_superman	human
@yuNishi0910	human
@kp012v15322	human
@UrbanEatsAkron	org
@kevinkerseyduno	human
@anthonyspantry	human
@ramonsalas671	unknown
@Shinta_Fionita	human
@iampaolocayco	human
@lennylcabral	human
@special_hamburg	human
@Viqui_Lifschitz	org
@kikiramelia	unknown
@beckahyael	human
@TrishCausey	human
@skeemixck	human
@barrossaaaaaa	human
@hgomez_88	human
@RgeresBagdad	human
@jamiebakes_mtl	org
@blehlovesfood	human
@That_Girl_Ray	org
@notesFcaroline	human
@gucchooooh	org
@tobelikealady	human
@TinaHeat	human
@Mazilique	human
@ShamiraSuhaimi	human
@MinttuPyrhonen	human
@BlackHalo39	human
@cocinandoconpam	human
@ErinJCraft	human
@NYPickleDeli	org
@MafuccinnDavis	human
@BoltBarra	human
@VanaNguyenHo	org
@AMartely	unknown
@mickeydownunder	org
@kuechensprint	human
@SabrassRD	org
@Genesisbarnyc	human
@WTOP	human
@Misog_Ks	org
@EverydaySpices	human
@aaibshc	human
@flaviacru	human
@BigPacifis	human
@iluvlookinggood	unknown
@herzenmarkrej	org
@MashaParisi	human
@Peter_S_Becks1	org
@JaviBennett	human
@enviehalifax	org
@RainierFruit	org
@bekuish	org
@AnnaAmeriMolly	human
@HAPPY_FEET_0327	human
@TamarMakeUp	human
@RoysterBlake1	unknown
@chippi_na	human
@LaBellePhia	human
@ReallyGood_com	org
@speedytacosrr	org
@H_M_S_H_M_K	human
@JosephGettright	human
@xdaminiSolankix	org
@hanakhadijah	human
@itsallstyletome	human
@ninobe27	human
@kazu_ak69	unknown
@BaneAura	unknown
@grace_kelly_A	human
@tiab1988	human
@galoisbaobab	human
@Dee_Chauhan	human
@StecaSanHz	human
@champ_eon	human
@McnelliesNorman	human
@tinytiny_bird	human
@marysue_s	human
@beemers1	human
@geniushyde	human
@hearhannahhagar	human
@ThaiPilin	org
@SpazzingHanee	org
@TheLunchGirlsIt	human
@luckeguy	human
@ClassicHedgie	org
@swensonmember	human
@DrSteph64	human
@AlmostSupermom	org
@ArushanaS	human
@BodyArchitect	human
@trafalugar_law	human
@xpress90	human
@connie_chiang	human
@Fitri_Queen91	human
@megfit	org
@BlanchPalermo	human
@SanPedroScoop	human
@Pamthomasm	org
@SaMiPoOoO	human
@Banoffeecassy	human
@DivaFoodies	org
@kittykeih	human
@bearbearchild	human
@merrileepan	human
@PortiasKitchen	human
@mrdybvik	human
@Muthu51167171	human
@rajghai	human
@Pyrsan	unknown
@jackmise	human
@Benjisaur	human
@NapaChats	human
@sissisonik67	human
@AndreaBeltranTW	human
@yazzyphillips	human
@frandipan	human
@petermb78p	org
@vivremieuxmag	org
@mikaelcool10	human
@MyCareerExpo	human
@KymBastock	human
@openhandSMACK	human
@industrialboy	human
@CharliesPizzaSS	human
@ElizaGarciaa	human
@SkinnyYouWraps	human
@hoadley_amanda	human
@The_Primal_Geek	human
@LaPlakaBurwood	human
@BarnetteJason	human
@SandeeJatti	human
@doqueeupreciso	human
@DocDhonz	human
@julieluccy	unknown
@JuicyLipsJW	unknown
@mskenkai	human
@MIBPharaoh	human
@josetexter	human
@athenacalderone	org
@cerebro84	human
@theexplorateur	org
@thelabcafesf	human
@saucegifts	unknown
@Amisha_Mazerati	unknown
@davidsounders	human
@cistolic	human
@kaileyQ_92	unknown
@misshussey	human
@djam9191	unknown
@domacineozenise	human
@TheAdultBox	human
@BeausicBlog	human
@elmoheartsyou	human
@chirihane	human
@esongla	human
@RiordansTavern	org
@SoundTelecom	org
@k8ekeen	org
@pinaahtong	human
@EvaCVincent	human
@BellaMilano	org
@Ynegg83	human
@hgicarlsbad	org
@DJTRISHA	human
@PatsyenMadrid	human
@KhushrooLal	human
@bobXcore	org
@heresaheart	org
@Roc_Raiff	org
@zbellamy33	human
@Canvin118	human
@MirandaMorrison	human
@rrtnhady	human
@k4thew	human
@ConKarant	human
@MouseFanDiane	human
@IgnaciaBenita	human
@hueynwah	org
@BlueBellLove1	human
@Shadisaid	human
@chicksRVA	human
@sylvvaughn2008	human
@FaisalShahOne	unknown
@Palaharam	human
@AmenStreet	org
@hashmi_an	unknown
@justthegoods	human
@OccasionsMag	unknown
@aqcmoni	human
@Ruthspoof	human
@skylervarrick	human
@SaraMundtWeiss	human
@Bella_Vasquez	human
@gcmaw	human
@errabund	human
@emagen_nz	human
@vegdesign	human
@anicolaidou	human
@silvrgurl	human
@pasadodeamor	human
@rafaellemd	unknown
@arnelilagan	human
@jinalee927	human
@HoneyBaked91602	org
@andrewtotravel	human
@maligue3665	human
@Chez_Tonton	org
@Brian_Lavoe	human
@somenmondal	human
@jascescos	human
@HackingSeconds	human
@Run2SkinnyFit	unknown
@djbphotography	human
@3ScoopsPlease	org
@ckeenan7	human
@marcifair	human
@ToastCafeCary	org
@HolidayInnDubai	org
@FadlyConspiracy	human
@preFABsd	org
@gourmetclub	org
@Bettypage669	human
@GansevoortMPD	human
@MoiraFurlong	human
@yuuchhi	human
@punk_nad	human
@shylla_navarro	human
@Novalirungan	human
@JaMs13M	human
@TomatoSherpa	org
@Tee_Nelana	unknown
@speedjrfan3888	unknown
@MarcelaPonce	human
@Mr__Craig	human
@4DreYul	human
@JapangoSushi	org
@glzcf	org
@C5E_TV	unknown
@bodywrapgal	human
@MalathyRama	human
@AmerQADRI	unknown
@KosMoney	unknown
@Criscrash1	human
@elreddian12	human
@andy_joan85	unknown
@BarbelPeppers	human
@king_atlxs	unknown
@Dafox1992	human
@BiscuitCLT	org
@MilanCache	org
@Fount_London	org
@Trinity_City	org
@batuhanbth	unknown
@pauligaya	human
@AinaYap	org
@FriedasProduce	org
@Asya_Kamalova	human
@AStarNU	human
@klynch201	human
@Th3NaxX4	human
@Nobuli	org
@SalahIddinDXB	org
@t4mi3	human
@agentRNrosey	human
@N_anggaS	human
@astridzeng	human
@cafe1930ab	human
@L77Manda	human
@tikanofianti	human
@JuanitasCocina	org
@slimsit	human
@AndyMarcolin	human
@AMR_MHMD_37	human
@JonesDairyFarm	org
@Kjosy	org
@AllFoodDetroit	org
@meganittasty	org
@LaFontanaCHS	org
@THEREALAHYPE	org
@Yogland	org
@keonhoward1	human
@Lendoxia	human
@nahberlin	unknown
@treatyoselfaus	human
@BrianAnand	human
@Terre_Blanche	human
@nguk	human
@offseasonman	human
@dannielc14	human
@chairsandcoffee	org
@GCoGroup	org
@ecyojANNE	human
@HDfromAbove	human
@bs_bn	human
@KalterKaffee_	human
@ElektrikBoutiq	human
@azhar_kamarudin	org
@iKandee79	unknown
@colvin_v	human
@atemalem	human
@miliyah_mnk	human
@thewoodmanla	org
@pinkybuki14	unknown
@traelynn74	human
@diningwithdusty	org
@brooksteak	human
@Organicduckeggs	org
@Moomu_Boo	human
@My_CoffeeShop_	human
@DChealinghands	org
@HOTSMART	human
@JonathanDRogers	human
@onslaughTree	human
@beginagainanna	human
@xx_yelah_xx	unknown
@farhain2	human
@NaFst	human
@GraffDurand	org
@CeciliaScg	human
@zchizzerz	human
@pipe_perez4	human
@RahimiHadzri	human
@DANASTORM	human
@janneclaudian	human
@WalkaboutBS1	org
@PlyJantima	human
@acanteen	human
@TheBigERock	human
@shiellaregina	unknown
@JevonnRasan	human
@MRDALE1	human
@Splice_Global	human
@JonkerRMMR	org
@nichsinlei	human
@jannahMDISA	human
@PhoRestaurant	org
@aliwaks	human
@Radha_Ramalinga	unknown
@TheBullandLast	org
@geekfitness_me	human
@MRehnuma	human
@JestinePizzano	human
@jpasalagua	org
@CadillacRedAnG	human
@DesiRohayatii	human
@OscareDaily	human
@Stoner_UOENO	human
@BelyuGiralt	human
@mz_triizte	human
@daddypj11	human
@bearnaisedc	org
@miapauzi	human
@narurururuuu	human
@xxxLOTxxx1	human
@nickcharmeen	human
@tavoleromane	org
@Project_Sushi	org
@aryanna__a	human
@iamlliw	org
@fernyd90	human
@JJMakeUpFinch	human
@ArAr_Reyes	unknown
@ChefGailsokol	org
@kalvarina	org
@leoloca92	human
@pagnatep	human
@AmitBadal	org
@DamianaMateus	human
@kay_jay007	human
@MeesookLe	human
@Bartoshqa	human
@SabrinaGhayour	human
@CDNfood	org
@BalansMiami	unknown
@Stacey_Kitchen	human
@brandonpark81	human
@ConfidentialCap	human
@canoe_red	org
@julia_doughty	human
@MazlinaAManan	org
@1342880898	human
@CurlsandMo	human
@sparkle_bella	unknown
@ibraa_1988	human
@GiuliaCorengia	human
@macero25	human
@lil_idah	human
@panenlamaleta	org
@Kyliescourage	org
@almasaa_cafe	human
@foumami	org
@MichelleL_Smith	human
@sarona__92	human
@haitianswagg	human
@BathFoodies	human
@Darya_DN	org
@terry3386	human
@JessicaAbigailL	human
@TommyeFabro	human
@FSBangkok	org
@Sellynvr	human
@bigdippa914	human
@Vicki_92xx	unknown
@BrynMD	org
@AisaBeautiful	human
@BatashBarabash	human
@1shakentogether	org
@MorinagaTofu	org
@AdamPT_	human
@KRISTI_L1PENNIN	human
@cmaferrell	org
@vellaFAB	human
@GCLebanon	org
@Natvegetarienne	org
@MJGhajar	human
@lujuheard	human
@Zeemeervrouw	unknown
@hendrixderosas	human
@YolkLondon	org
@itsjakers95	human
@luxurydutch2	human
@GogiChicago	org
@guycassidy	human
@EmilyBolivar	human
@me87ry	human
@KatefromScratch	org
@Devil_kungz	unknown
@ruth_delosreyes	unknown
@Danthemancookin	org
@yyp8_15_30	human
@stephaniesaxon	human
@ThreeTeaAustral	org
@09EmilyC	human
@YesPeas	org
@ShitChester	org
@ArCaDiA_82	human
@jeremydizon	human
@jmfmiggy	human
@Medsmex	human
@foodemoiselle	human
@10milewalk	human
@SKBSoho	human
@valoria_L	human
@lwasowicz	human
@DeliaCXG	org
@budaquan	human
@Caravents	org
@EHHMALEETAH	unknown
@WholesomeModern	human
@haveyoumetjc	human
@gutfeels	human
@curiositytotheo	human
@Esther_Guerra_	human
@DreamNails01	org
@AdvAKAtor	unknown
@IamPaulBradshaw	human
@AnnaChanaii	human
@jonathanmiami	human
@TonyRomaRibs	org
@Tanzy_Westwood	org
@iamTongueNCheek	human
@Mkocman	human
@familjepussel	human
@pirorororo_____	unknown
@p_vishnevskaya	human
@poor_salieri	human
@CJanes94	unknown
@g3mmal	org
@RobPetroneTV	org
@AshRealty	human
@Echi1128	human
@BBofMiami	org
@ThoughtsByMike	human
@EvaZimling	human
@marmaone1	unknown
@CoreraMoon	human
@_iAmJJones_	human
@ChikasFoods	org
@ndriecyntia	human
@danhussey	human
@robbiedeezle	org
@BalDiGhent	human
@SlugYork	human
@BKlaege	human
@Marty_Tina94	human
@rafaeeltomaaz	human
@terencemulder	human
@CarmelasFoodCo	unknown
@SwanNFirkin	org
@leandrodefreita	human
@andreapeixinho	human
@grahamwesterber	human
@SoutherlyCHS	org
@wh0pe	unknown
@auranmichi	human
@BiteMeFoodBlog	human
@AngiePaiva	human
@GillBoyd	unknown
@CJFoodBlog	org
@chhuynh	human
@andrewttj89	human
@JivePR	org
@iifoodie	org
@alexclarke1981	org
@_erik_garcia	human
@DachasCooking	org
@katiewaissel24	human
@HeidiByNature	human
@juanjogama	human
@shhhfon	human
@kriskas13	human
@Lmsusi	human
@atmalogy	org
@MrFashionYoung	human
@mskatoygeorge	human
@merrynaa	human
@le_rifkinator	human
@djsergewar	human
@ytkn_81	human
@yaaantiii	human
@OnkenDairy	unknown
@SunShineSsong	human
@MacBurst	unknown
@rsandonaz	human
@ImamuraSaori	human
@shintaartam	human
@Sunshinesj15	unknown
@TrampCook	human
@Clobo_Clarke	human
@whitneyvalverde	unknown
@HeavenArtisanGF	org
@Rouyee_91	human
@jazmynjade2326	human
@alejaquino	human
@raffy671	human
@lovelymari89	human
@TanLeHans	org
@l2dab02	org
@IamAINZEY	org
@irenThamiichan	human
@michellse5282	human
@maahikeee	human
@localiyours	human
@wiedia_setiani	org
@Amycoxwilson	human
@MerlyDC	unknown
@BargamesAG	org
@TinkerbellFit	org
@blancetrougesf	org
@LetsEatIn_ie	org
@AnnaSpallina1	human
@ItalianMktHfx	human
@Lynn_J_LeRoux	human
@Liwern	human
@hlonimosia9	human
@JustoneEBBE	human
@FumiSomehara	human
@MissTaylor000	human
@jeffreyreley	human
@club_HARLEM	human
@puishii	org
@BexRP	human
@ksldeals	org
@pulehh	unknown
@NeroWaffleBar	human
@HobokenRestLA	org
@ty_mhqr	unknown
@woanchiun	human
@Norn_ireland21	human
@KatieCubs	human
@LovettEmma	unknown
@allysanutellaaa	unknown
@MaryStankevich	human
@NoBoMagazine	org
@TerraceCafe_B	org
@kirtneill	human
@FredBarnes18	human
@L77975479	unknown
@imamofoninja	human
@PrinceOTNBOO	human
@lisa_hydo	human
@dalinlin1989	human
@BlackBerryClubs	org
@vmohit91	unknown
@carrisagrace	human
@worsi35	human
@T_UrbanPhysique	human
@heidijbenson	human
@Escobarigaston	human
@DabbertKnives	human
@heriswita_riana	human
@michiTWEETie	human
@TropicanaAC	human
@DeShaunDuron	human
@BurgatoryCanada	org
@Rahiee	human
@R0XYL0VE	human
@PastorDLHill	human
@ashyaj	human
@Trouble351	human
@dannyk1m	human
@MrKlements	human
@redcycle316	unknown
@RefineryHotel	human
@InggrianiPL	unknown
@JudeaLioe	human
@nastya_muller	human
@smr172	human
@moonmiho	unknown
@meals_hackney	org
@abicyclette_	human
@LimBertrand	human
@AmandaHaxton	human
@tenzeronine	human
@taizainoyado	human
@nousha_salimi	human
@bet2blaz	human
@BackyardSoCo	org
@3GP112HS	human
@yengh2ngol	unknown
@IdentityMediaCo	unknown
@MissingHandle	unknown
@deli_tracey	human
@jtw8	human
@Darlingveg	org
@_HandsOn	org
@IWHCmanchester	org
@lena_lamorena	unknown
@FoodooInfo	unknown
@callmeyeo	unknown
@romahito	human
@GyuKakuBrickell	human
@DinaCampbell11	human
@DCTotalSports	org
@FoodieFresh	unknown
@JVinRVA	human
@chapperspmc10	human
@WestinDXBMina	human
@GreenIsleHotel	org
@bombayglutton	human
@ScotsLass183	human
@xdbabiix	human
@FoodPicsByJ	unknown
@FoodSmyAdction	org
@LadySamm08	human
@BrewologyPub	unknown
@candybednar	human
@FayrosPhotos	human
@DanuckInUSA	human
@claudiaXO2012	human
@VChloeK	human
@mtchknght8	human
@russell19776	unknown
@SkyYun16	human
@NamieDoherty	org
@eceeozden	human
@shima_lucio	human
@snappersbb	unknown
@TheThreeDaws	human
@kamigata0	human
@mandari6	human
@Tindrodip	human
@oggipaneesalame	org
@celenagtn	human
@TTwilightggirl	human
@Kelseyrequin	human
@TeddyShinyu	human
@PTigre78	human
@todo_yoga	org
@bjamesmac	human
@downingarms87	human
@ArmanddelCorral	human
@sharednoms	human
@xxxochy	human
@yukishingai	human
@haruhi_mori	human
@csmatila	human
@IBotox	human
@flynnlhea	human
@MyraLatifML	unknown
@uppereastcafe	human
@mydiycrafts	org
@diveshraval	unknown
@meryl_go_round	human
@EuniceStarks	unknown
@twisted_aussie	org
@eatthroughthis	org
@kimkelani	unknown
@juniejocson	unknown
@missJeanete	human
@SaintBoogie	human
@CJLimvalencia	human
@TheEmporiyum	org
@seilazalikah	human
@belcasale13	human
@Gavrilo64	org
@SeedsofChange	org
@CarolinMildner	human
@Henna1705	unknown
@sausirhi	human
@CoachBrianTass	human
@rosebettsy	human
@katiefairycake	org
@CelebTVnews	org
@Historina	human
@alaxlp	human
@gladysrenata	human
@alfersuarez	human
@delfinofoto	org
@Brasserie214	human
@iREESEsistable	human
@FitnesstipsN	human
@Meatheads_balls	org
@StanMimix	human
@studiokime	human
@secretweddingb	human
@BritaniaMendoza	human
@raissababuino	human
@gc13182	human
@ghabdor	human
@jennifer_marcia	human
@aussie_girl1981	unknown
@Sincity_Carter1	human
@LGadz	human
@byefeliciaxo	human
@rizshaayumi	unknown
@bud_of_chaos	human
@sinkakuteruz	human
@StarvisAU	human
@DavidFJeannet	unknown
@jayzugal	org
@AndrewFit4Work	human
@Mehmi_S	human
@NovaGrau	human
@CamiMascheroni	unknown
@sarenraj20	human
@jp_makinen	human
@__Marsy__	human
@seasonsofphilly	human
@CoopPaula	human
@VyneNitsuGa	human
@SilverCloudChi	human
@GwinsTravel	human
@dEeHallwayProdz	human
@bananables	human
@dinglefood	org
@Georgi_Goddess	unknown
@BadBreathStinks	unknown
@tashamads	human
@MariaLuv44	human
@masyipeas	unknown
@tivi_mayu_0331	unknown
@Jose_Bermondsey	human
@PegCityGrub	org
@MyMixologista	human
@Sledger_Don	human
@Vivi_Sat83	human
@FatihaLemsi	unknown
@gbcreque	human
@fractweets	org
@aimstar_vz	human
@CATALDIFRESH	org
@mikeyhasabeard	human
@kram230	unknown
@dimassetyoo	human
@DJ_RUFFTY	human
@mardylady	human
@antonellafazioo	human
@teresamcraig	human
@pomoBohoMedia	org
@zeinthesecond	human
@quttie_quiana	human
@susan11parsons	human
@_loveyoumeanit_	human
@ChefZare	org
@muule0126	human
@StephBartolome	human
@pbkulkarni	human
@zeeshanasim	human
@StrawHatJimenez	human
@ecel91	human
@petticoatandpie	human
@mari_laza	human
@placestoeatinw1	org
@jvong1120	human
@jamiecarmelli	unknown
@adrianng87	human
@LauzonRob	human
@akasha2503	human
@Chesterbam	human
@dontgivenofukk	org
@spagettinet	human
@AnimTweetBot	human
@miyu5382	unknown
@WFMBoulder	org
@TheFoodieCorner	human
@gonzalospixel	org
@Sibberi	org
@meowscare	human
@samurysam	human
@yukgou6778x11	org
@madambabols	human
@loos_marie	human
@irischn	human
@VikasR07	human
@tweetingtaryn	human
@mochachuin	human
@FoodishBeauty	org
@AnokiRestaurant	org
@IamBEH_Girl	human
@FestiniFitness	human
@Yung_Jokez	human
@nonyteguh	human
@Boschettina93	human
@FelicitasTT	human
@JessicaPagan93	human
@Louisawalker94	human
@veganistheway	human
@legit_jakee	human
@LoveLiveTr8n	human
@dieticianshreya	human
@AllenTaylorFoto	human
@Shoprite_NG	org
@CCentreMcMurray	unknown
@AndayaniYP	human
@MissNataliela	human
@Thegraincanteen	unknown
@Beasoccer93	unknown
@JessieJames556	human
@JardindeEpicuro	human
@Chef_Dustin	human
@MsElaineJayne	human
@swaROBskie	unknown
@SafeCatch	org
@SizzlingWagon	org
@TatevikT	human
@HEPennyP	human
@CountryBinge	org
@vanillamagazine	human
@SchmidMagda	human
@FBiening	human
@arwin14	human
@martinluney	human
@fmartin3	human
@LATTE_Te	human
@cynthia_truong	human
@IslandEssenceJA	human
@rainelow85	human
@JuiceGeneration	org
@lizzlenkizzle	human
@aleste37	human
@GirlsGotSole	human
@myrsy3801	human
@mikebulten	human
@MsSarroyaLynn	human
@LieHarman	human
@travellerthor	human
@Melohello	human
@isurvivalskills	human
@rmendanya	human
@traykitchen	org
@Damn_ItsMike	org
@BlogSantaMila	human
@TraceyHayman	human
@huebschie	human
@myhealthyselfie	org
@sissidianaworld	unknown
@Lyonys	human
@JAYFABPAGE	human
@monkeychamonix	human
@ASirenSpirit	human
@shell1207	human
@OdochiEwuoma	human
@StoreMapleLeaf	org
@Ables76	unknown
@AndyLOrtiz	human
@Serg408	human
@VivaceSandton	org
@ron_rompies	human
@MarvinBethel	human
@pidayrt	human
@DeLoftWijchen	human
@eatallanimals	org
@jennyyhoangg	human
@zoekhollister	unknown
@BrittaGunkel	human
@iPinky_iBrain	unknown
@thesmu	human
@BBF_J	human
@BackAtSquare0	org
@fr8d	human
@InaDurian	human
@MyThreeSonsCafe	org
@Chouettesmarais	human
@bento_ninja	org
@DaraFeelingFood	human
@LaelaBoutique	org
@PrimalPantryUK	org
@xMr_Clayton	human
@NachosFiesta	org
@sunkeepsmiling	human
@Lumberyard101	org
@KurtZierlein	human
@GetFitToday2014	human
@nataparis75	unknown
@jaymeeluuWHO	human
@PMLEGEND	human
@salizzar	unknown
@JiDBearIslam	org
@Dechagas83	human
@OemahDaun	org
@crstyle_	unknown
@HealthyNannies	human
@JosephinaRayer	unknown
@denchx	human
@shurleeshell	human
@chellewilson	human
@FirehousePete	org
@erikaloca	human
@craloiaMPH	human
@LadieLoka360	org
@TuningForkLA	org
@PhillySoc	org
@nuracell	human
@GlobalAndys	human
@truchocolatellc	human
@GordonW76	human
@BiceGroup	human
@VictoryEdge	human
@CouponsHere	org
@ChesterSlug	human
@rprachie	unknown
@Minsera	human
@cedardean_aman	unknown
@fulbeckbread	unknown
@RiverleeHotel	human
@Time2VentHere	human
@CasperMagana	unknown
@mid_sleep	human
@thelilgreenpea	human
@HopethePlanPony	human
@InEasternTime	human
@byloom	human
@pictureme41	human
@OohBabyDesigns	human
@mzsaintsational	org
@ChristianRaw	human
@GlutenFreeLbls	org
@ZeinaMShehab	human
@kurt_henry	unknown
@thedailyroar	human
@NessaCrzz	unknown
@SayWellness	org
@SteffiRg	human
@AlenaKobzarenko	human
@JasonEmerMD	human
@besthealthmag	human
@aliciakent	human
@WillowLawn	org
@LotusAndApples	org
@MedinaWish	human
@HarryT135	human
@mommy_mak	human
@toricchii	human
@sheratondxb	org
@_Bistra	human
@dvandermerwe	human
@nellyagbogu	human
@TrueJaneCoke	org
@JPKC	human
@denisermt	human
@CHAZDEAN	human
@Me2Morph	unknown
@TheRealChicago	org
@Asille86	org
@Dee_OSullivan	human
@moony394	human
@shawtyMeleana	human
@KwangTiny	org
@damie1390	unknown
@RaniaBatayneh	org
@ABeautifulLie_	human
@mad_margarita	human
@jasongoodboy	human
@Jay_jeed	human
@CristhianRules	human
@CHEZDREcafe	org
@ArabianEscapes	human
@NikaTijing	human
@EricaLShort	human
@Kutacphotel	org
@Primiagminis	unknown
@PrettyLadii_G	human
@m33dra	org
@ChinChinBristol	org
@ILamahorseya	human
@ohhileval	unknown
@ariatrattoria	org
@JuanTapia13	human
@Craigisst	human
@markparton	human
@NikolaiNuthouse	human
@dancefloorfreak	unknown
@amoremaldita	human
@PicnicBasketME	org
@baconandbutters	org
@breadboozebacon	org
@girija_kriz	human
@GastroWise	human
@mayi_angela02	human
@kaifengtan	human
@TonyaBoicourt	unknown
@JessicaFastball	human
@tyris109	human
@Le50eme	human
@FedericaDeFalc1	human
@JKCJewels	human
@ChucksNastyx10	human
@elmstreetbakery	org
@Petite__Chou	org
@WhiteGyalCook	human
@JacquelineLev17	unknown
@MzBeverlyMillz	unknown
@BrindisiCucina	org
@JimandJenn	org
@FettyFatimahNor	human
@lesliewii	human
@sogichan	human
@fugamx	human
@tru_beautyblog	org
@aidan_haswell	human
@GenoSouthington	org
@MsXXCLUSIVE	human
@sweetangel86	human
@0415dc65e2464b5	human
@byMissTakes	human
@CasaNegraLDN	org
@miss_randomness	org
@PJZafra	human
@Scoogis	human
@ashdavis1987	human
@ymohapi	human
@radhaLorenza	human
@joslimmin1world	org
@touch_sapporo	human
@trinity_lounge	org
@TangyTouty	human
@vabeachquilter	human
@thebestfoodstor	org
@PerfectPearJax	org
@bellaNINJA	human
@MainHangar	org
@Kis_Lisa	human
@fazlichenko	org
@theHalfStyle	human
@LMarieD3	human
@Suriyel	human
@Juls_hglez	human
@MrShikharMisra	human
@EatingItaly	unknown
@LaurenDavidsonX	human
@ms_bombshell	unknown
@TylerTowers	human
@vialaporte	org
@slowsquirrel	org
@LeonX0X	human
@SariepdoL	human
@andrejprokes79	org
@MaggiBiebs	human
@DivaNWonderland	human
@miguelpin	human
@AHealthyResolve	unknown
@CherryMarie6	human
@msjag	human
@Emary_Preston	human
@LuzerneGlobal	org
@Danylaaa	human
@SadiaOfficial	human
@KaritasM	human
@IamRatedKay	human
@derekL94	unknown
@ty49_meguchin	unknown
@imichellejensen	unknown
@seziskitchen	unknown
@morisdance	human
@zapatitoscharol	human
@Sparkles4Smiles	human
@foodessdotcom	org
@hitomi1199	human
@SimplyLovelyIAm	unknown
@LaItalianaEC	human
@Jothipala_Bot	human
@chaadudd	human
@PVDMonthly	org
@MeganAdair5	unknown
@socialrevmarket	unknown
@ParisKimWrites	human
@colmenarespjj	human
@estee_st	org
@420iloveweed	org
@Courtesy1	human
@TavoMoya11	human
@cheezeplaza	org
@ipekdkr	human
@TourismBengal	org
@TomGoering	human
@QueenBDeb	human
@beautieful_mess	org
@SimplyKay22	human
@KoivuHalko	human
@seanhardyphoto	org
@AngelesAgenda	org
@DJELLE	human
@MatrixConcierge	human
@sarahdeesarah	human
@KINGPIN117	human
@KatieKrisbian	unknown
@mocadazu	human
@ColoradoMom	human
@CblocHD	human
@melissa_varela1	human
@Rabbaniamal47	human
@Adaduygukyn	unknown
@PrincipeDelSole	human
@ElGrasshopper	human
@NuriaaRG	human
@rodanyao	human
@Pisces20_316KSU	unknown
@boeyyyyx	human
@ekeknyanchu	unknown
@syazmibrooklyn_	human
@kyontan0825	unknown
@Xalkie	org
@EverPure_	human
@SherryAWright	human
@befedagain	human
@SharaPaula	human
@coraladler	human
@GlendaPixy	org
@mannaepicure	org
@tysantini	human
@sorayamustamu	human
@penasdore	human
@hipandhealthyuk	org
@AdheLindhermann	human
@drlouw	human
@lama_lawand	human
@ahokie	human
@adelia_angela	human
@Amy_Steinbeck	org
@n_norseva	human
@HubertGadel	human
@kentchongwh	human
@JaviLinares2	human
@wowiezie	org
@FodderHarrogate	org
@whutdachuck	human
@BabyRural	human
@HBumbalough	human
@LettuceSpoon	org
@HOLLIUCHI	human
@SierraJN3	human
@sohma_1115	org
@fanatikdj	org
@GEHASIE1	human
@zalecuidatebye	human
@MrLins	human
@livelifelovecak	human
@nicholaswaikit	human
@Silvine_Koes	human
@thisgirlisjaja	human
@TomatoWellness	org
@bewaswere	human
@JemGrrl5	human
@OhMyGiO	org
@kiss_tsup	human
@Tendencia_BCS	org
@victorrealista	human
@OliFelixPT	human
@thedcma	human
@tkhrshny	human
@KJMidday	human
@SkunaBay	org
@yvettediangson	human
@Marco_ElChab	human
@SuzyNewhouse	human
@OneOfAKind13	human
@EmmaBlogJml	human
@breakfast39180	org
@TiaraHotels	human
@Ardhydoodle	human
@lifeofglen	human
@MetaJeshika	human
@RicardoYas0	unknown
@LucineAyn	human
@martyArds	human
@aliffrockk	org
@BexFay1	org
@Amna_Aldhaheri	org
@Colindarbyshir3	human
@mizfebby	human
@su_aidan	human
@ModernButtery	org
@LeilaBags	org
@carolakasaka	human
@rileksBohh	human
@hotrev	human
@We_eat_steaks	org
@DianeBarron67	human
@RyMac818	human
@katiedaisy921	human
@yukii_meow	org
@lucasgil	org
@robertofaucegli	human
@aksk_nn	human
@evelyn288	human
@jmgonzaga0617	human
@NickParkerLive	org
@WoodWhisperers	human
@CheekyChicago	human
@tonylukesbah	human
@7_nami	human
@zulaihaZ	human
@FuryouCheey	human
@atableconCarmen	human
@BlackjesusLS	human
@clo_assi	human
@DotyDesjardins	unknown
@DallasMorin01	human
@EllasKitchenCo	human
@BlueBellsCS	human
@SelinAntalya	human
@Sevenmilegoku	org
@NinaMulia1	human
@LAsTopCuttie	human
@DanielaVlv	human
@BettysLove	org
@SpiritedPurpose	human
@jackieroseb	human
@igoryek1979	human
@pu3mawar	human
@CDefThom	human
@noblehealthsol	org
@caffemadhouse01	human
@kouichi_at_tky	unknown
@CWLroda	unknown
@sushiexpresspty	org
@heyimtweet	unknown
@IAMCousCous	unknown
@ViBE_ub_cherry2	human
@lullapus	org
@seydencardenas	human
@MyasahQ	human
@Deepak_sharma89	human
@ihsanozturk34	human
@RoulaChamieh	human
@abkutz	human
@THE_tarynege	org
@RenataSijanas	human
@AnnieElozano	human
@Juliana_Andia	human
@robbie_robsz	org
@sharrychin	human
@Muscle_Maker	org
@NigamPrerna	human
@CentMex	human
@raedalal1	unknown
@MakananAbg911	human
@ivxiimmx	unknown
@cremblog	human
@AppleLamm	human
@neilonradio	human
@CAFE7MCGRAWHILL	human
@ikowats	human
@Touseef_TAZ	unknown
@sp120	human
@LauraMelanie	org
@elsortidor	human
@niwre0426	human
@jesstse406	human
@JoshuaHeathAU	human
@SidM_Official	human
@UKWeddingParty	org
@QbaraDubai	org
@yogajaya	org
@nikkiprovocate	human
@ANNzkee	unknown
@PrincessofArgoz	unknown
@ImoHendo	unknown
@MathematicsTREV	unknown
@fatimarazz	human
@ChatrineGilbert	human
@rachsarabassett	human
@BantumBanter	human
@badawtikki	human
@PinoyKusinero	org
@missjustbe	unknown
@boetenten	human
@nataliaocha	human
@tygrrrr	human
@gregg_strick	unknown
@dulzmuhammad	human
@KellyKatharin	org
@cri_sev	human
@angiemcglan	org
@TwatchNLearn711	human
@Nikaletachka	org
@TinaBsays	unknown
@Doodlersrevue	human
@waynegeer	human
@choicefmghana	human
@_Elisha87	org
@jessicashammond	unknown
@Katuhrina	human
@MollyOliveTree	unknown
@broadwayyale	unknown
@da_opie	unknown
@aChelseaThing	human
@nazmeezahid	unknown
@_FRabab	unknown
@PrayLoveYoga	org
@angie_poo	human
@ladywanderluxe	human
@SB_Johnston1	org
@beautandbiryani	human
@alliemarchesani	unknown
@BiteMeeh_	human
@XCortes20	human
@sidneyreuben	human
@fathiyaazzhahra	human
@SchaumburgParks	org
@PDXYelp	human
@NurNisrinah	human
@Nephi_Garcia	human
@sarabird26	human
@LambdaGirl	human
@domijoy_	org
@indah_decil	org
@Womens_Forum	org
@CharlotteNOW	org
@Ashley_0891	human
@NolchaFashionWk	unknown
@yahkimseonggyu	human
@mminthecity	org
@sisiwah	human
@cindylev	human
@mooonamin	human
@LandonMD7	human
@Santarsiero_M	org
@YogCulture	org
@matthewjblair	human
@NidaBaloch	human
@JulianColvard	human
@sunshine4378	human
@Afro_D_199	human
@CamiFigueroaDF	human
@flyergrad09	unknown
@Mr_S_p_i_k_e	org
@soyabean617	unknown
@RoCkS21	org
@Sidecar	org
@Poppa_H	human
@_Leftfield_	human
@anneizuaf	human
@TapeoCafe	org
@EmilyFeliciaM	org
@anuarpop	human
@iheartfluffy	human
@Tivoli_Dome	human
@fiona1alice	human
@wheatonfwi	org
@PiggyBankSavers	human
@VisitBankside	org
@AJBPhotostudio	human
@kuczun	org
@Nix_Fong	human
@jade_daily	unknown
@the_jepot	unknown
@annasappetite	human
@TheMurrayfield	org
@wannnlin	human
@pizzaten	human
@Recovering_Life	human
@bairdashi	human
@meggy4786	human
@davidoshiro	human
@hanniballessie	org
@promoteindenver	org
@EmoHotti	unknown
@epicbeerrider	human
@darlinafirstama	human
@single_newly	org
@YayaCurly	human
@patrylondon	human
@MABurke10	human
@AyeshaJawad786	human
@faniaste	human
@natashainoz	human
@400Beach	org
@TheMexVillage	human
@AideenK	human
@DeliciousChef	org
@mon_barcelona	human
@SidselLillMy	human
@UptownMarketAZ	org
@NiniWellz	human
@BriarhurstManor	human
@JaimeHD2	unknown
@MatijaRaos	org
@UNDERGR0UNDCHIC	org
@abdullahsulehri	human
@JadePLJade	human
@bazebee	human
@PrincessAlexs	human
@AlexJosephVD	human
@MelissaLev	human
@SebTirant	human
@aisuuuu_r	human
@courtneyleg	human
@jakoporeturned	org
@michaelangelotu	human
@rremi_0702	unknown
@thegorbals	org
@joiedejude	human
@OptimistPrimal	human
@reinaelissandra	human
@MelissaMattioda	unknown
@ritchey_ritch	human
@hauptstadtpuppi	human
@ivanyubero	human
@TwinsTakeonLife	org
@jordanwillcox	human
@Thyme_England	org
@sassytime	human
@georgannyara	human
@kira_thika	unknown
@AmalAlBalooshi	human
@BudsTalk	unknown
@BettyluCullen	unknown
@goldenboysteve	human
@CookSocialIndia	org
@YiannisTaverna	org
@ivanchristian07	human
@kansascrappie	human
@momwifebusylife	human
@iKarenGrace	unknown
@sundayroastdins	org
@CPaceConsulting	human
@MelissaYnz	unknown
@LivvyConstance	human
@NaturalBeaut__	human
@NielsenHermawan	human
@lydlouis	human
@onLyAireseLyn	human
@kein_1808	human
@odessaclub	org
@CaraChapelA	org
@Pauly__Nguyen	human
@RealEaze	unknown
@LilianaSacaza	human
@AdrianneJohanna	human
@AlmaRodG	human
@LuckyKeira	unknown
@heablalaria	org
@MichelleAgent98	human
@camjohanzon	human
@prosam	human
@AnarquiaVIP	org
@triadlocalfirst	org
@cookingpandaID	human
@WTBeSomethin	human
@kwhiite6	human
@mylove_avemaria	human
@Dj_bebo_27	unknown
@detoxifybar	org
@ikma_82	human
@illindividual	human
@lian_moiras97	human
@AmairaniSls	unknown
@rosieg2013	human
@iPoL0	human
@PerdanaCava	human
@ForeverJuice	human
@fiezawawi93	unknown
@LiamRDSaunders	human
@___Ella	human
@nasstiness	org
@Fotunaa	human
@nkaujntses	human
@EstrellaCortijo	human
@MinnesotaLovers	human
@KnollwoodGolf	org
@Magical_Matt1	human
@BootsBourbon	org
@kyrestaurant	org
@LuisCabelloC	human
@cineflixer	org
@angelynkoeswara	human
@mayby_tarroja	human
@coco_lawrence	org
@ek_at_t	human
@caroline_ketta	unknown
@billiej33	human
@Vanessaanne___	human
@thesweetesttart	human
@farmavemaria	human
@vishelleg	human
@maya_ko	human
@ReneeGaile	human
@SergioJValentin	human
@TheUrbanSpice	human
@CharlottesSDR	human
@poouahipack	human
@Luckymcdanno	human
@fati_elbahloul	human
@bulbaseok	org
@marco_origenes	unknown
@HildyMay	human
@nanamiiiin0202	unknown
@eekhaiee	human
@kaz_noko	human
@eatingasheville	org
@demelinacecilia	human
@kristalamb	human
@4725magazine	human
@ALadyAndHerDogs	unknown
@cheffrancolania	org
@bilyotoy	human
@GossettViChamp	org
@naptimeblogger	human
@boncedrick	human
@UniquelyVicki	human
@rodrick009	human
@xHARRYxPOTT3Rx	unknown
@tikiruss	human
@enochwu7	human
@foodiechinita	human
@ZaZaKooo	human
@jaiofrt	human
@yo_she	human
@TjasaBosio	human
@SherrillIvey	unknown
@jetsetchick	org
@yukky_464	human
@WarOnLOVE	human
@rndmadventures	human
@Rach00Pear	human
@myxmscxrlxtt	human
@Shane_Simon	human
@PlantationPinoy	human
@Harmoniouschick	human
@food_writer	human
@Stassiworld	human
@Meh777Mark	human
@NouvoEnCuisine	human
@Marianocoaching	human
@MamaLans	human
@AnmayrRobl	unknown
@yelizgulege	human
@CookWitWalflowr	human
@moregood2690	unknown
@ahealthyelf	org
@lagoonca	human
@VinceBayard	human
@Jackson7270	unknown
@franta9	human
@todayinsavannah	human
@aStoltze	human
@StaffordJimmy	human
@sellysilviaa	human
@duncanc1216	human
@breekelscastro	unknown
@FabiolaMaria	unknown
@KaseysNY	unknown
@Lya4na	human
@Huxley_sf	org
@nuttbolt	org
@c_87mgn_j	unknown
@ExpressHarvest	org
@SteelToadBeer	unknown
@edibleessential	human
@KtownNightMRKT	human
@SJFunkyRhythms	human
@invybc	org
@kaho1021	unknown
@feminazi94	org
@CeeKaia	human
@KamalKitchen	org
@curlydolltati	human
@MarjoleinvDop	human
@misslynn86	unknown
@Velvet_Magazine	org
@LindsayCowie	human
@djMarcoMei	human
@mr_andrieka	human
@tomomi69kl	human
@kerryisrael	human
@Paloma_G_A	human
@sin____saju	human
@stefmannis	unknown
@PacificRS	org
@SouthbrookWine	org
@IMxsOnx	human
@5DegreesOfChaos	human
@CharlieHypper	human
@thomgore	human
@_CrownVictoria_	human
@manulingdindong	human
@Franzwcom	human
@probinsyana21	human
@3vi_83	human
@SeanOooizzz	human
@sahya_horie	human
@MCFUSA	org
@stephkonkle	human
@Loopy_Lacy	human
@JaimeLloydJ	human
@LSEcatering	org
@jemcro22	human
@johnpalermo12	human
@Pride_Evesham	org
@andintanta	human
@miinverness	org
@CFineFoods	org
@RasterAffandi	human
@B_Maren	human
@CookandCollins	human
@PaulanerJakarta	human
@WhiteNi99a	human
@missfm_fmiller	human
@AYALA_Hele	human
@popoygarsya	human
@heritgegiftshop	org
@shescarmen	human
@jastacio	org
@xiao_zheey	human
@bycorroh	human
@shellym1978	human
@amigomarti	unknown
@WTNresearch	human
@florinda_3rs	human
@acethegeneral	org
@mreddpromotions	unknown
@JennyJens822	human
@errrcap	human
@LivingChic	human
@Evisusanty9	human
@baby_elephant13	unknown
@GuardiaEsther_	human
@h3ndr4sw	human
@alfredfieno	human
@AngelFeliciano	human
@camelcitycovet	unknown
@AbrLauren	unknown
@atown_apples	org
@AverageJIM65	human
@YuliyaStecher	unknown
@jrad911	human
@emfernandes	human
@ryanmedia_de	human
@FrugalFreeGal	human
@I_AM_PEISHAN	human
@ClaireFedorova	human
@poem1985	org
@PoppyinMcQueen	human
@KanikaKarvinkop	human
@RestaurantVoila	org
@abcdefransiska	human
@cookiescleans	human
@MrMoose1892	human
@niki4nu	human
@CherylandYasmin	human
@meals_johnswood	org
@kodatski	unknown
@TihomirMihalic	unknown
@nick_sipun	human
@JacquieDolly	unknown
@omoshiro_rcqCM	unknown
@sohamanda	human
@OmegaAppliances	human
@rachael_gurney	human
@fit_wed	unknown
@NashMarriottBNA	org
@gilestyles	human
@BryanStever	human
@prettyHaler	human
@theauthenticgir	unknown
@MrSpiderFrog	human
@TheDIYLady	human
@biglenlittlelen	human
@Seph_style	org
@apesnacks	org
@Joanna_Soh	human
@yummyspoonfuls	org
@CamillaTes	human
@riezdgalz	human
@PathakAakanksha	unknown
@ChaChaCham	human
@TheDuchessN7	org
@sassysue87	unknown
@JessinCharlotte	human
@emilycoultas	human
@AjaayStylez	org
@sebastiengaudar	org
@edgarzuniga	human
@FabulousFoodie1	human
@PrincessKashmir	human
@GalvinPompadour	org
@_WILDGIRLS	org
@AylaKLee	human
@mamalatina	human
@talha_selayang	human
@BrandonKDukes	human
@FatiiChi	human
@Ev3rythingSFine	org
@POLLIEBOI	human
@DreamSacred	human
@h_tucks	human
@ModernBachelor	human
@HuddsReTweet	org
@ErkanKiraz	human
@OMGPerrylicious	unknown
@BhadouriaPankaj	human
@no4blakestreet	unknown
@HelloKittyLimit	human
@BeRavenous	org
@rsbarton87	org
@SophiesCubanDC	org
@N3r3n	org
@JRDProduction	human
@manuegeada	human
@LozCarnegie	human
@hornybottom2	human
@DealzNStealz247	human
@SouthParkRandom	unknown
@VivastyleNb	human
@NMB_gazou	unknown
@McTristram	human
@NaserAlBarghash	human
@SuJin1101	unknown
@WhoreFix	org
@fredericknchgo	human
@dee_galz	human
@TIU_Sarah	human
@Liz_G_Franklin	org
@Mflare808	org
@spencerleeder	human
@MijnValkHotel	human
@bartelsvleis	human
@UniFoodTrucks	org
@echill4692	human
@sebitas1990	human
@NadineCarvalho	human
@Mylvstyle	human
@OUNTIM	human
@BeautyzGeek	org
@2roc4sure	org
@lizasantana	human
@CMCfood	org
@luniederauer	human
@mhardal53	human
@flowerwheel76	human
@Victreebel21	human
@ElifSu010	unknown
@dazroland14	human
@Visakha8	human
@aldinapika	org
@JigKae	org
@Pipitciw	org
@katdebu	human
@ronnie_el	human
@Ms_FitnessDiva	human
@AuNaturallyMe	unknown
@yesitsahnj	human
@TeamDeliciousF	human
@tatsuya_nakaz	human
@beckycobos	human
@NelsonSalazar90	unknown
@gracelynchin	human
@jamrockQT	human
@frunch_fries	unknown
@vendab	human
@HobokenGirlBlog	human
@ParsonsGreenery	human
@aziz_alhulaibi	unknown
@danlacanaria	unknown
@livingrural	human
@Emyarg99	human
@John_Venado	human
@elcabezon121	human
@AThompson1525	org
@reveriecapetown	human
@GloriaBeba	human
@Commarglo	org
@jerimarborela	unknown
@BiancaRey	human
@ChefDrew1978	human
@secuteness	human
@livdariv	human
@dodoyganesa	human
@JesseHuizar1	unknown
@ShaifulKAzzam	human
@emisdesigns	human
@GensThoughts	human
@Caarloz83	org
@GareyGarvin	unknown
@mhaeeagustin12	unknown
@archinterim	org
@PearlDiveDC	human
@jennyslippers	human
@alexpinzon06	org
@lovjoyxce	human
@AbqJCC	human
@anammatute	human
@AngellaLuedke	human
@azi_koime123	human
@DMBballnBBQ	human
@glitterpeaches	human
@beverlytci	human
@DJNicoletteSG	unknown
@EliYPark	human
@GeorgeTsakas	human
@allison_wongsw	human
@Xynn_0203	org
@Quinton701	unknown
@gabri_ella_	human
@SOKiSZME	human
@jamesy0026	human
@CesarReynosoR	human
@saratempleman	human
@MeloPapillon	human
@MelanieDurrant	human
@Yuni_Prihatiana	human
@MrsCMansfield	human
@__IAmWoman	human
@StreetBreads	org
@Meito_Lebanon	unknown
@homerobligacion	human
@yandellnick	human
@RoyalSpady	org
@MariahBoo94	human
@FreshSince1999	org
@BassIsland	human
@_huiloves	human
@appetasty	org
@novisugiarto	human
@allangeiger	human
@Ivana_Stranska	org
@maniacapparel1	human
@foodporntho	org
@leannefowler	human
@ndudhleeya	human
@AcostazNoe	human
@liisann	human
@DFoodTrucks	human
@LAChannelFans	human
@adriahernandezg	unknown
@technologyminds	human
@RaulPicon	human
@c_suberox	human
@jayrille01	human
@myemcalendar	org
@apolloism	human
@Hotelsportsbar	unknown
@nikihung0912	human
@Brent_Dumler	human
@GustiaFood	org
@cltbrewandchew	human
@spudmackneasy	human
@313Rockstarr	unknown
@joshmirm	org
@textureweaver	human
@denvchristkindl	human
@TurfPhx	unknown
@kwill4419	unknown
@91tan	human
@psymami	human
@LordPham	human
@yoco710	unknown
@likealocal	org
@SofitelMarseill	org
@Speckerna	human
@star2331	human
@Conzuehernandez	unknown
@wanderlustwomen	human
@firefliesdelray	org
@VictoriaRMaslin	human
@tatchee_	human
@squeezychanel	human
@gretabagup	human
@Orked_roz	org
@xHighJinx	human
@BaronWestoe	human
@acidburn68	human
@DBFabrick	human
@Laurii_Rocha	human
@MauroGGomez	org
@librarydurham	human
@KedaiSeoul	org
@AurelieDurandMx	unknown
@ElissaTt	human
@grainhopcam	org
@harmonyswank	human
@GreatHarvestSLC	org
@Delisha_Renee	human
@gcapps2	human
@Evonchanyw	human
@TIBURCII	human
@igors_pastry	unknown
@bubbleybooloz	human
@DoC_OnE	human
@ZAKna1	human
@Dpsunny22	human
@TifLester	human
@SelenaSways	human
@MatteisTavern	org
@volteetorres	org
@ajreinhart	human
@CanAndCook	org
@Josnooki	human
@TravelwJohanna	human
@kullake	human
@uptownmcfly	human
@JosephHemphill	human
@MissLGraceMaher	human
@SalaamNamasteUK	org
@luckyslounge	org
@GemmaFraser13	human
@700VOLVO	unknown
@BlueLabor	human
@WGNOtv	org
@NaddNerd	unknown
@Marv8	human
@thriftybelow	human
@Justina_Low	human
@LindaQOFE	human
@GulaTweets	human
@anraspop	human
@chewtonglen	org
@priyanikki727	unknown
@ARMORDJ	human
@Fiamma41ny	org
@BHILILA101	human
@sweetsnsnacks	org
@lbukhov3	unknown
@BACCHUSBrisbane	org
@PEplanning	human
@Rannzy	human
@BLAIRED_OUT	human
@_LouiseIsabelle	human
@cristela_c	human
@blueeyedmzungu	human
@NicolaMusictime	human
@beVegt	human
@Fashioncorneryc	human
@masato_now	human
@leonitanerisa	human
@YogaPublicNews	org
@Daminous_Purity	human
@IBeautiful_Mess	human
@iM_deokeneth	human
@RalGhanmi	human
@StruggleWear	human
@emmabreschi	human
@monnaelma	human
@azeeez1144	human
@thesavoryth1542	human
@PaparazziRob401	human
@RachMace	human
@TANWArazzi	human
@e52an	human
@ndkfan	org
@megangentry_	unknown
@winwintingson	human
@jorgenovelo33	human
@paul55649	unknown
@FranchescaKlase	human
@ginzanokanazawa	human
@alexxrex	human
@MarcoFRosa	human
@FritesGranville	org
@NewTomsLondon	org
@BlairLande	human
@WineFoot	human
@1111_ri	unknown
@AP_FitandTrim	human
@hao0928	human
@micxinn	unknown
@carolinechan_	human
@saddletrap	human
@carobcherub	org
@shanniemarshall	human
@TallyConnection	org
@JF_s	human
@corybreeze	unknown
@SimplySaDiees	human
@AngieGraceLA	human
@khizThigh	unknown
@maurelita	human
@KeepaKreep	human
@iklanjualbarang	org
@mashuqi1	unknown
@callmeThirdy	human
@AmyButters1	human
@LadyOhNoir	org
@nikkoandrew	human
@1950shairdo	human
@rssaltweet	human
@eazymoney	org
@jmdale01	human
@luvalana	human
@harishmustak	human
@tdamnrich	human
@Josenigro	human
@GansBakery	human
@semmyth	human
@nunuxiah	human
@NocciolataUSA	org
@PiccadillyPlace	org
@akane_3830	human
@ImLluvia	unknown
@san_wenur	human
@P4tch4riyaholic	human
@giulabacigalupo	human
@SpinachRecords	human
@E_Twa	unknown
@WeAreZizzi	org
@leahrobyn89	human
@GJerrel	human
@aqeelzafar	human
@ChekmarkEats	human
@FigsKuwait	org
@uniquesomewhere	org
@Tingyn	unknown
@heathfish	human
@FlipDBeats	human
@AfonsoV_	human
@foodeonline	org
@BRANDONGRENESKO	human
@RummyHersheyz	human
@steppiness	human
@milkandroses	human
@_tr3s_i2d_nla	human
@RoyalRumbleJosh	unknown
@Leovanii	human
@AisarSabli	unknown
@ishigamimiho	human
@erielynnie	unknown
@emollieh	human
@Hooverr1	human
@johnkamagaling	human
@FashionchickUK	org
@Victoria120298	human
@FranciqueCarib	org
@azimullah89	human
@LinaMariansi	human
@Bsweets18	human
@LavilleAnais	human
@adelesmith_	human
@joyjoy85	human
@TheSummitRoom	org
@BBchocolatiere	org
@cyeah11	human
@NihsanGun	human
@SonyaAngelone	org
@inter_fitness	human
@changinghabits	human
@stp_line	unknown
@MissVickyNL	human
@bernardjprevost	human
@23mitter	unknown
@Trading_stocks_	org
@puedoadelgazar	human
@atlaspizzapdx	org
@Gladje_LaFla	human
@lindsay_theresa	human
@DublinSquare	org
@djTWIST	org
@snowflake202	human
@airaKat13	human
@yappaCar_ii	unknown
@PURLIM	unknown
@BTemptedHQ	org
@chiho_smilelove	unknown
@Sharsplash	org
@PeterKPChan	human
@sandersonnaidoo	human
@StreetSeanan	human
@HMEEventProf	human
@CoffeeRevs	org
@churchJQ	org
@lucy_inthesky10	human
@AMRITAbars	human
@jariyayahyahh	human
@Lauranna13	human
@perezvgp18	human
@toonboomaddict	human
@thamkongyang	human
@carlaleeball	human
@BluRSuN	org
@sundip81	human
@AsCutie	human
@NubiKay	human
@LisaFrancois	unknown
@LeliaTT	human
@Damaris_Bee	human
@JuliaBoccanera	human
@HitaliaWadio	human
@yourchefvee	org
@iKerima	human
@FDfalie	unknown
@gumbrianroy	human
@TamiAlexsis	org
@bianca_tx	human
@HarveyNichols	org
@IVIryom	human
@craftscouture	human
@Meadow_Farms	org
@invigilat0r	human
@HannaBello	human
@lijing7	human
@Gl_Betty	human
@MISSLAVISH	human
@AdelinaCyl	human
@kronfollebnen	human
@lenawong218	human
@quinnCeNation	human
@DTB74	org
@zankevich	human
@jackpxt	human
@winnerona	unknown
@PIGROUP1	org
@JillSimonian	human
@GiadaOcchiuto	human
@bicoastalpanic	human
@nayrPrz	human
@Bibiangel	human
@BrowardBrock	human
@Mantitlement	org
@UniverseBrands	human
@peterslobsters	human
@MarhabaMiami	org
@ItzalyfestyleFT	unknown
@_scream_queen	unknown
@TheCornerStable	org
@iOnCharleston	human
@Jusluvsyk	human
@Moxie_Moments	unknown
@BillsLunch	org
@KaineofTermina	human
@sourirelumineux	human
@Majosuki	human
@MarianneP89	human
@DubaiFoodie	human
@vetyluckytee	human
@RunnerBliss	human
@hiba61423125	human
@playarealtyexec	unknown
@TheGoldenBoyNC	human
@kawaiiizz	human
@Angiepooos	org
@elizabethmagdha	human
@henirusmiati	unknown
@holleyalex	human
@Rawbeaux	human
@Afiq_Noh	human
@bodyfitmag	unknown
@PEAR_Delaware	unknown
@benihkenih	unknown
@SNGLong	human
@DreamiSmiles	human
@0o0nel0o0	human
@chickiephi	human
@ItsSeema	human
@ladiespuree	unknown
@Limi_gossipxxx	unknown
@RedSpoonDiaries	org
@osmyk9ice8	human
@ChicagoEater	unknown
@NARD232	human
@Christcharm	unknown
@scoutmob	org
@almilanazodabas	human
@lola_kitchen13	human
@rian_shain	human
@TheMarketOnKoke	human
@cinnabubbles	human
@LoveHomeBird	human
@rolledpants	human
@BostonMusic1	human
@k_m_penny	org
@MoZaic	org
@TheVioletStreet	human
@TedGrills	org
@jaxon_hudson	human
@Triplesei	human
@fooddrunknola	human
@Carbonell_USA	org
@icepam	human
@VeggiesMadeEasy	org
@TJ_BRIGHT	human
@xiomeeks	org
@nadokser	human
@ShoppersWebsite	org
@witt17uk	human
@Avenged7Souls	human
@camigenna	org
@Nightwolf1325	human
@KooPALs	human
@Porkopolisbbq	human
@iAmLordRico	human
@IamDUMBB	human
@stylejunction_	org
@ChelseaFritz13	human
@ZzDragonPR	human
@BlonDTroit	human
@motowten	human
@leialia	human
@kamekoi0704	human
@pipermechanical	org
@foodstring	human
@EggandI_CH	org
@StDavidsHotels	org
@TanZata	human
@Familyrecipeny	org
@MBLosey	unknown
@Remain7	unknown
@renai_FQeYn	unknown
@HotelZaliki	org
@HorowitzDempsey	unknown
@midastouchcraft	human
@msmalifestyle	human
@EvaOppel	human
@benchmarcevents	org
@PreachersKid_PK	human
@MINOLI6	org
@MokiBaby_	human
@LilyCastillo86	human
@Recipe_Treasure	org
@McGregorAccomm	org
@dreamlifelivin	unknown
@1Girl2Cities	human
@JornUrbain	human
@newenggarjunia	org
@MykeeSkeetz	human
@lechienfumant	human
@toshi349	human
@davidjpq	human
@Lizzieee_xD	unknown
@StLouisBuckys	human
@imriskariska	human
@samtecsmith	human
@goldengategrub	human
@WalkerYamile	human
@YesItsDom	human
@FalsettoSlumber	human
@AnnaMietta	human
@MVoltaggio	human
@jamaicansdotcom	org
@calvinjunichiro	human
@sibyllesuley	human
@Lbeeloo	human
@StarlaSilver	unknown
@jabbaduhhut	human
@chiiiyyuurie	human
@NOT_BEE	human
@StyleSurgery	unknown
@KrisColvin	human
@MineNaBiLa	human
@lovelovekitten	unknown
@BostonBetsey	unknown
@BrainBalanceMA	human
@MadameNhu	human
@TichaSmt	human
@aishitemazu06	human
@SophiaLorett	human
@JJGhatt	human
@backpackbees	org
@julesverneresto	human
@LondoTrembel	human
@jamesbriones	human
@clerence_1993	human
@babepigmilk	human
@AnnaDutto	human
@DZSEATTLE	human
@JulsKitchen	human
@LuppieLissa	human
@ChefBianco	human
@MOHNOCHROME	human
@hperdomo	human
@amydaniel7	human
@Inlocalnola	human
@ruben_a_gomez	human
@joao500	human
@HeyyItsRachh	org
@syaifuljaafar	human
@Octavia_Indri	human
@MinHsuang	human
@JohnRexEndeno	human
@SweetLaRayne	human
@trainingforfit	human
@Ejikaaa	human
@rachitkapur	human
@maz_h_q	unknown
@LorraineHaldane	human
@Chicagoings	org
@overberginfo	human
@chaplainjwill	human
@OutFrontExec	human
@cissiesun	org
@herkied	human
@cutiepuffbunny	human
@perksuarez	org
@therealmrmac	human
@BigsBar	human
@GeorgieHodgson1	human
@holly_simple	human
@vivakits	org
@liljuny	human
@AnneWiesNL	human
@Sergio_RamirezR	human
@misenplacedc	human
@LUJING92	unknown
@ReTweetQueen86	human
@AgusMachadoOK	unknown
@FlippersPizzaUS	org
@WaltonandAllen	org
@jamesthemower	human
@cotton_woo	unknown
@TheMissMissyV	human
@oahTailadA	org
@AntonioScarnati	unknown
@FezSyed	human
@GeneticSupp	org
@Choizzes_ES	org
@edujairley	human
@TheVermontLA	human
@TheVaultFiles	human
@JakeMok92	human
@Texas_babii	org
@tinygarcia12	human
@fefabernal	human
@thatReemaDivya	unknown
@ChefLekker	org
@Boutique_Hotel	org
@threebutchers	org
@ScottyPKCCO	human
@kuruma_gazou	unknown
@ematthewsphoto	human
@ElAndresRobles	unknown
@dluthor2	human
@bcarrascal87	human
@krish_hrd	human
@erinmclaughlin1	human
@TheTinCow	org
@codysfairytale	human
@KarinSundquist_	human
@frozenmoonjpg	human
@candyclip	org
@tomdangerhuynh	unknown
@NY_Resident	org
@liamolia13	human
@asakoito	human
@kchocolat30	human
@agnes_chau	unknown
@Razieman	human
@MoranteIt	human
@JS_GRILL	org
@rn0625	unknown
@NicNicoleSin	human
@kimilykendrick	human
@theDickTater	human
@RoronoaZoro4889	human
@CherrylynDy	org
@littlemorecafe	human
@schizo_freak	unknown
@VeganChessie	org
@brilaurenbela	human
@tinalovespinot	human
@GLShoulders2	unknown
@AmariRC	human
@the_modman	human
@SignFlipping	unknown
@IM_A_TEXAN0232	human
@VerlassoSalmon	org
@shakedown_ratio	human
@mypresslab	human
@sammy_oda	human
@pinandtack	org
@TaiRawati	human
@neptali_allane	human
@rojval20	human
@TashaRomanelli	human
@DagoLpz_	unknown
@mofoschiani	unknown
@GeorgiaEllieS	human
@adamdhamanhuri	human
@NAOzm96dsm	human
@comengetitbbq	human
@Flarobb	org
@nylakayel	unknown
@BkSketter	human
@CHARofjackson	human
@stefanolenfant	human
@GinaMason1250	org
@thousandofwords	unknown
@_vtan	human
@Khaledtron	human
@sumo_wattpad	human
@redcat_06	human
@YayaOliveira3	human
@ErinCWoodbury	human
@chelseacathy	human
@friedalloyd	human
@AngieScribblez	human
@bethencourtAMS	human
@Kai_Gil	org
@cantinalaredo	org
@SeamTan	human
@chrisgcordova	human
@fabrianauz	human
@parsonsjmelissa	unknown
@eMsouls	human
@SilverSmack	org
@aceloveszcrazy	org
@MMedrand	org
@stichtingviia	human
@adnan_samia	human
@NashayKandyGurl	human
@DelangeAngie	human
@0nlynae2	unknown
@smiley070868	human
@AchieverDean	human
@DeliciousMartha	human
@OlmoArmas	human
@AnthonyJiawan	unknown
@SoyerNilufer	unknown
@esenaksoy35	human
@alexatavdur	unknown
@marcelich	human
@agandic	human
@AkoSiLiryc06	unknown
@SarasTonedSmile	unknown
@special_zham	org
@ginaruiz	human
@adelmyeolchi	human
@XIMEVILLARREAL	human
@ShujaaAlqahtani	unknown
@canaribird83	human
@iamLordDylan	human
@buddhabyoga	human
@eyahnism	human
@barisadL	human
@Lil_Epicurean	human
@madridritchie	human
@Arnold_Soetanto	human
@BloomingBoo	unknown
@PshapiroWine	human
@woodenbowlmaker	org
@nnn202080	human
@LeeDonaldElite	human
@TomYamThai	org
@JamesFLauber	human
@boliveirakari	human
@KristinaFlynn	human
@IngridTToday	human
@SammieBabyyxo	human
@E1Ton	human
@stilldexi	human
@mio_dio	unknown
@jessly626	human
@chadatwood	human
@lucinda_fortin	human
@MadMub	human
@NateWillis313	human
@gimgra	human
@deanarekay	human
@MissCoxNorris	human
@Mia_Koko	unknown
@CharMaslin	org
@Mama2Jude	human
@WayOFtheDOVE	human
@FloridaKeysGirl	human
@bpresentstudio	human
@96fmBreakfast	org
@kellanskitchen	human
@nextwaveoven	human
@HoeLum	human
@sidneytambin	human
@SamHarding18	human
@fi_sharil	human
@MariniShen	human
@SassyHotLatina	unknown
@PamellaDunn	human
@GetWinesDirect1	org
@traladadie	unknown
@keikosuminoleb	human
@ejtegs	human
@ReemAfterDark	human
@TonyPerone	human
@hwglamour	unknown
@rey1712	human
@HiltonAnatole	org
@KeithsComics	human
@DpaC_85	human
@DominiqueMissCH	unknown
@vermilionroots	human
@GetChada	human
@Ranch99Market	unknown
@HelloTuckers	org
@marielmnoriega	human
@lilithofbalkan	human
@Feuza	org
@MoneySavingMom	human
@redappleinparis	human
@littleallygator	human
@JettPizarro	unknown
@ppppliefone_	human
@lunarosso70	human
@SteakForkBville	human
@TheRoaminNose	org
@MiniCooper886	human
@dfa73	human
@Soycdpf	human
@puterisheryl	human
@ainedesu	human
@kyorco	human
@Pix2Flix	human
@Irinkagoodgirl	human
@BillorBeak	org
@NCamarena09	human
@wolfeandco	org
@G00D_Neighbour	org
@DAINFAMOUSDJKG	human
@mianicolehall	unknown
@wanderingcart	org
@caschil03	human
@AndiZack	unknown
@SantaBarbaraFP	human
@gulatiambica	human
@MegGregory	human
@FunForFoodie	human
@JabaOAldez	human
@geefreefoods	org
@koichiphone	human
@julio_davis434	unknown
@casino183rd	human
@MirandaMalisani	human
@Noblescafebar	org
@kalinichenko7	human
@izzat_ynwa	human
@RoastRestaurant	org
@wahyuseto	human
@cathykyritsis	human
@minNAAN	org
@Sohappy28	org
@melanieamorim	human
@Izzii4you	human
@mycandyprince	human
@mywheypt	unknown
@Mohammed__AlQ	unknown
@katenajib	org
@KebapciMahmut	human
@ajimargera	human
@CantinaCHI	org
@Melonicoco	human
@pixinwanderland	human
@chicken_fiesta	org
@chia_foods	org
@Nieniey_Erniey	human
@DineshGermany	human
@NOMIN_RDN	human
@ChrisJW1987	human
@iamboolach	human
@PuckettsGrocery	org
@CharlineDeLucaC	human
@JustAdChzOrBacn	human
@Vixbrix	human
@lennardlagata	human
@NutritionBeet	unknown
@TwoOneTwoWorli	human
@hectorstexas	human
@wearenavimumbai	human
@jhonnerfekun	human
@READsalads	org
@DesDrone	unknown
@yhamziibabe	human
@killerrobotarmy	human
@phgoh	human
@nerdcer	human
@LicqueensTv	org
@fionakennyantiq	human
@nval1995	human
@meaghanclark	human
@erika_fdez330	human
@Dj_UtA	human
@ElaineP14	unknown
@DanAlport	human
@prasadja	human
@TheFakeVanJohn	human
@SavannahSky0803	human
@SaintBroadway	unknown
@kaler_hae	human
@TeresaAGuadagni	human
@SoloDiskons	human
@CFAMtProspect	org
@shaeyd	human
@SergiosCuban	org
@BogartDexplorer	human
@casaoui25	human
@FORESTCITYTV	human
@cartwrij	human
@aRenKun4869	human
@sarahkim_11	human
@niknak__	human
@kerbeylanecafe	org
@wtccstudents	org
@jennywill_	human
@lauranatalia19	human
@WrappingChristy	human
@kuheli1	human
@lia_cinderelia1	human
@KAMRATH_FAMILY	human
@tinamernspiker	unknown
@ShalaynaShining	unknown
@adiyadoni	human
@MealClubDeliver	org
@Ozil_shAlin	human
@yessicicilia	human
@BOP_DenizYildiz	human
@SandyCasp	human
@VincsonTeh	org
@ranranjet	human
@ILonaB1980	human
@JessicahRabbit	human
@missdesai	human
@SbcSbcSbc	unknown
@HamadAllghaz	human
@Vicky_Marpaung	human
@BichhooMontreal	org
@FieldTripMom	human
@SilkAndBrocade	human
@tastefulapp	org
@GuangTing	unknown
@roxasnico	human
@danniwhitburn	human
@IamJaVonne	human
@jesciidane	unknown
@chriscutaneo1	human
@camillegabol	human
@yodathechef	unknown
@ara_dino	org
@KT_Studios	human
@hotel_giulia	human
@CheesesteakG	human
@chmcmaster	human
@TweetRSummers	human
@tombeachhotel	org
@Jgracey92	unknown
@ewajunio	org
@YANGyatao	human
@DowseKatie	human
@PruChambers	human
@DonnicoBarcelon	human
@RealFoodScout	org
@jenkedwards	human
@mpwglasgow	org
@luisottola94	human
@XxJane_21xX	human
@19crazygirl91	human
@SAUGAvoice	human
@Jareezyland	human
@nishasangeeth	human
@Kaylie_96	human
@Welsh34	human
@InnerMind_Music	human
@KimSupan	unknown
@HaifaDTrainer	human
@Tiina_Smile	human
@LadyTaMaNa	org
@starbell22	human
@RASofiana_xOxO	human
@FreshDirectUK	org
@nivedithg	human
@KieferCrosbie	human
@MzDiegoGirl	human
@Benz_Jensss	unknown
@UrbanGem	human
@SouadMMFans	human
@aurelianobvs	human
@got_TiTTiES	human
@rustysheba	human
@_Battousai	org
@belissimouk	human
@DTsirekas	human
@RoughHouseStyle	org
@iammassarnowsky	human
@OMOTG	org
@ComfortAwA	human
@lburgcouponmama	human
@TheBigFatShetty	human
@blogsaycheese	unknown
@meg_tv	human
@marcaoude	unknown
@ItsJustFoodllc	human
@joeldeal	human
@nongtang0407	human
@WilsonPrayoga	human
@FoodPorn_UK	org
@Yellowbellybrew	org
@sid12123618	unknown
@ScorpionJoe10	unknown
@Donburi_CAN	org
@poettttttt	unknown
@ci_Nezious	human
@CiboCalgary	org
@titaniumfit_kk	human
@JasonAlstrom	human
@BoSsLadyGabPac	human
@JemmaAlexandra1	human
@KiwiAppleSberry	unknown
@PerfectSNAQUE	human
@LeChelleTaylor	human
@TujPatton	human
@CipuJapan	human
@AlexOppRD	org
@mags2milkyway	human
@HHALHAJRI	human
@lauraP59191	human
@OHchrYsouLa	human
@WellnessScience	human
@WCScrapple	org
@Bo_Fitness	human
@LauraVerzeletti	human
@SalwaCAzar	human
@mp754	org
@HSuperfoods	human
@chasesoon	human
@yaofeng1989	human
@HealthyOnHudson	human
@FootyConference	org
@ritakml	human
@yvrPG	org
@MidcenturyVegan	human
@DionysusYeo	human
@ricco_yohanes	human
@YoyaLikeDuh	human
@PSonTap	org
@JujuBee220	human
@BandH_Grill	org
@OlehTyukov	human
@RajiGourmet	org
@raphiesaid	human
@janejjtoh	human
@crispidiamond	org
@tepchaannn	human
@LanchasterLynto	human
@iamdickjohnson	human
@caitifornia	human
@hotpinkish_24	unknown
@sopalto	human
@AuctionHouseHFX	org
@AnisaMubashira	human
@klo_ommy	human
@Khai_danvers	unknown
@valxbaybeex3	human
@elliottwright_	human
@DanielleASB	human
@melydc	human
@ackyy	unknown
@sexyaquarius40	org
@LittleJasFlower	human
@bakedsalt	org
@kichie_dicaprio	human
@FemFatale151	human
@morganmoves	human
@Monica_Walker17	unknown
@isabelsmithrd	human
@lotsofolives	human
@alipreeves	unknown
@iamTwala	human
@SoulCafeLIV	org
@WharfPrattville	human
@Yuwen_hom517	human
@itmix	human
@Blubuttrflye	human
@SuttonPlaceHtl	org
@LauranPeoples	human
@luvkcfansite	org
@EdwinLee10	human
@RabUmaguing	unknown
@AVilhais	org
@milkataniea	human
@omoshiro_Gzk3A	unknown
@DieguiMatias	human
@BarziBrand	human
@Franschhoek_SA	org
@LaughStashTV	org
@GMAlWahda	unknown
@xiuwen2609	human
@Baking_Emporium	org
@sauriel_sam	human
@Korenetic	unknown
@nicolettish	unknown
@junior_sau	human
@Shog4Min	unknown
@sreypov66	human
@PonteFitRD	human
@xficinox	human
@Pantarts	human
@CodieKemp	org
@blogchicanormal	human
@buruguduy	human
@Theshoegawker	org
@RousseauPatric5	org
@paula_casal	human
@DJWarrenYoung	human
@brodiejr4real	org
@StacyB573	unknown
@Little_Foot95	unknown
@shevioletfish	human
@MarieSevan	unknown
@daohaus	human
@XxObseSsiOnsxX	human
@bot_kuruma_	unknown
@timberyarduk	org
@caferedvelvet	org
@Arpitaappu	human
@salaichatchat	org
@Passermeaglass	human
@sneakychef	human
@TheSTLDiner	org
@SidormeGranada	human
@Bowties_Caviar	unknown
@SteveDashOh	human
@Nongtuiinarak	human
@LilSugKreament	org
@LAPLUS_ME	unknown
@chelseafan50	human
@grojas89	human
@LilysFunctions	human
@HeatherUrquiza	human
@ButtholeBoogie	unknown
@moirabrunken	human
@Sunflower_844	human
@torijoy09	human
@Natwilson1985	human
@SkysilverSlim	human
@RedRabbit6	unknown
@GiveMeAFork	org
@4mycyrus	human
@Rygo601	human
@Senas1982	unknown
@MandalounSW10	org
@MondayMorningCC	org
@justintime4bed	human
@OfficialNoVaHH	human
@cialina	human
@GreatHouseBerks	org
@Niveen_Alami	org
@amicatonic	human
@Mrbrightside_RR	org
@varsanyimartina	human
@brushstrokeNYC	human
@stephtantillo	unknown
@YaChi_TW555	human
@ricettedimisya	human
@ZyadMajed	human
@djsaori_	human
@CharlestonDPZ	human
@gramboshares	human
@TammysPorn	human
@ilikebrokkoli	human
@FeedARevolution	unknown
@GokayOZARUN	human
@Winebarkensi	org
@jacquiafoster	human
@Modzyh	unknown
@virtuouswoman83	human
@MoniqueYounique	human
@ChrissyFrissky	human
@ImJessSanchez	unknown
@JMAdejesus	human
@scrappiedoodle	human
@BRICHISUPNEXT	human
@ClaudiaTheBratt	org
@chansaya_s	human
@NurHish	human
@garrethowyne07	unknown
@nopungg	human
@mollyhbuchanan	org
@FestivalFoods	org
@SaigonSizzle	org
@83naHalf	org
@A_Guevara	human
@CoconutsKettles	org
@Vinolia_Lia	human
@PlanetaUTO_	unknown
@HorburyPeter	human
@bradtwaddle	human
@iiammsjoyce	human
@aylavyum	human
@handsom13	unknown
@SpringGlitter	human
@YvonneLReynolds	human
@Dimalanta29	human
@kinalikha	human
@MisterCommodity	human
@iammaimayfeng	human
@nightplannerdxb	human
@theprisoners1	human
@TheInvsibleChef	org
@YourHealthyInfo	org
@alibshelikes	human
@EHVtweet	org
@CandyMuses	human
@mattsmithsaid	human
@paulbarlow1983	human
@pigletNessa	unknown
@BridaliciousHQ	human
@limzikai	human
@IrmaSincera	human
@MelisaPizzuti	human
@love__song_	unknown
@AlMalfunction	human
@LyolyaOlya	human
@Christiane01Ab	human
@sitirahimullah	org
@NatHealthNut	human
@asburydunhill	org
@rvbernaljr	human
@RawGorilla	org
@GoRiceGirl	org
@ArunaMaharaj	human
@Ewdot	unknown
@Twelfy12	org
@mskay2day	human
@andivap	human
@PourhouseNYNJ	unknown
@funky_pla	org
@sovhiii	human
@thekylebailey	human
@preci0us43	human
@caamy_a	org
@lunlun23	human
@FrivolousMrsD	human
@HillPlaceBlog	human
@xx_autumn_xx	human
@slainteonwheels	human
@lovelymely23	unknown
@ATLOshun	human
@EinardTec	human
@clara_veera	human
@ePrintedBooks	human
@EATLUNCHRVA	human
@1997Gonzalo	org
@DCbottomless	org
@Tek_Christ_	human
@AnnaleeArchie	human
@letitiaclark4	human
@cho_ong	human
@Nelgatsby	human
@FairWindsPress	unknown
@sweejason	human
@rundleplace77	human
@_leamkaile	human
@TaniaBunic	human
@tamewolf7	org
@trademally	org
@CDRamirez	human
@vinpon	human
@jperezkc	human
@PRDX_nagoya	human
@aitzbautista	human
@KleinLiliana	human
@nohitter23	human
@IamPolo513	human
@shino_bino_mono	human
@LisaEllis115	human
@arshiIPKKND	human
@hanahanahanappe	human
@whatsupguides	human
@ecyoung	human
@tukkura91	org
@80Reynold	human
@swertnalouis	human
@NiloufersKtchn	org
@TheRachelSy	human
@BMoniQu3	unknown
@gustodidsbury	org
@Adveta	human
@parmarkavi	human
@Rlppinky	human
@Living4DaLuvOfU	org
@NikkiCamillerix	human
@sneha_b	human
@nickphillips97	human
@JNaquins	org
@MuskokaSpa	org
@AffordableFashi	unknown
@jelaforever19	unknown
@DayviewMusic	human
@RDNutritionTalk	org
@PeanutsCanada	human
@amysbread	org
@AshwiniGee	unknown
@Superneha83	human
@hayden5ive	human
@escapeskyblue	human
@MC_Russell	org
@onwestcoast	org
@itsgottobegf	org
@Phil_Bonna	unknown
@RegentFoodsCorp	org
@Emily_Ellyn	human
@azzi_84	human
@dnapizza	org
@achaaanxxx	human
@ShannonCluteis	human
@_mhariannah	human
@nellcote833	org
@NYSPHSAA	org
@EsmiderZ	human
@SheIFAH	human
@DiscoverKale	human
@kletitia	human
@MomsChoiceAward	org
@iLuvDaii	human
@BenFenlon	human
@BangDon	human
@rachaelamy91	unknown
@hattydaze	org
@CarbonesKitchen	org
@melissyk	human
@FYC_CLT	human
@AlexLim16thbb	human
@KhaledTalib	human
@LeanToRecords	human
@judemichael	human
@LisaBurbach	human
@rmdiana4	human
@texastheband	org
@donniealexander	human
@joshuachoishere	human
@saltpepperhakka	human
@MLComm	org
@boywonder22	human
@amierulhasan	human
@mosstraveltv	human
@sushimatsuresto	human
@Karenluvslife	human
@nia_rellyanti	org
@boywithaknifeca	human
@inforesellerADS	unknown
@CGREDNECK1	human
@MicolTesolin5	human
@infoAPbali	human
@Chlo_Chlo_J	org
@naturekitchenco	org
@PandPkitchen	human
@SunsetGrillKits	org
@lisao823	human
@Alibox08	human
@marcospitaleri1	human
@dasootas	human
@ha_fa54	human
@kikaykimy	human
@Anyiskgf	human
@SamKWhitaker	human
@TheExpGourmand	org
@BocciBar	org
@VitayaMaandblad	human
@matthewlmorgan	human
@verychary	human
@danielletyer	human
@jlaley86	human
@goodlakefood	human
@FifiMarika	unknown
@ishang1991	human
@BIJAKKK	human
@MrDanHerrera	human
@MGRondilla	human
@7SpringsWine	org
@GD_paris	human
@Fat_GirlSkinny	human
@rafaroldan93	org
@GLOWSTONE_GIRL	org
@Dreamsofjamaica	human
@ChefAshleyJames	human
@Kai_Ci	human
@amandavmulyana	human
@vdewan	unknown
@kodigdsfgs	human
@NuNuS2TA	org
@DashaChesnokova	human
@ParmaHamUK	org
@olivervidrio	human
@Clairelwc	human
@Ran0227	human
@andis_slaitas	org
@TomPriorActor	human
@RhiaFerneFaiers	human
@iluvfoodtrucks1	org
@theluckyvixen	human
@TurksCaicosMag	human
@icySTARS2	human
@HelmBar	org
@pablodiazlarez	human
@06and10mommy	human
@Isabella2807	human
@stababedotcom	human
@Venushew	org
@Beth361	human
@Creolebeauty82	human
@yosoyhondurena	unknown
@jennifersboody	human
@TnTacosTequila	org
@Gorj3ss_	unknown
@gourmelita	human
@GourmetGifter	human
@ChefHamletG	org
@AmyyLouise_xx	unknown
@bodasdepiluca	human
@laurafrelink	human
@RTFASAHMblog	unknown
@Vintage_Fever	human
@SharingTourism	human
@Ideal_Software	human
@j_allenRN	human
@LavaLanes01	human
@JamjarDiner	org
@ayienkingking	human
@LaMusadelaModa	human
@Rena0830M	human
@back78pack	human
@miminpro2jak	human
@Creasy45	human
@SopranoKatie	human
@justyn_lfc	org
@potatorolls	org
@IamDAndreFraser	human
@LoriShemek	org
@IvanDurham	human
@CattLovins	human
@TysonTweets	human
@capitolfilemag	org
@PizzeriaRustica	org
@MizNandi	human
@_Damon_Price	human
@OVELIALim	human
@ricopaborito	human
@KIGASJAPAN	human
@CayceClayton88	human
@2itterist	human
@MICHELLE_GARRON	human
@MoorishBlueSYD	org
@LaoZBoy	human
@adipose91	human
@RicettePerTorte	human
@newtrition_SR	org
@MiamiHeraldFood	org
@EduardoStone_	human
@grupofourmidia	org
@KatieTSB	human
@Birdstar7	unknown
@KTCupofTea	human
@iguanitza	human
@DonDatosCl	org
@AliRawala	human
@ParadiseUnbaker	org
@av2son	unknown
@fromhair2toe	human
@ShellyJun0830	human
@aztambunan	human
@MarcoMercy	unknown
@mylktoast	human
@RidzuanMohatar	human
@MostBestUSA	org
@dinnosoar	human
@ccsfitness	org
@mahmudahhh	unknown
@davidakhoa	human
@gooeysmama	human
@RaynardEnt	org
@whitney_bottoms	human
@jewishfoodexp	org
@HeyCharleneSaid	unknown
@sandraapl	human
@Rafiq_Rafqi	human
@jessyunkier	human
@llonaespinosa	human
@wickeddiaz	unknown
@azilarisse	human
@Fauzan_Fadzil	human
@JuanEmilioNunez	human
@BCastleCentre	human
@thinkmolecule	human
@Eyra__Athirah	human
@cristianbruschi	human
@EvertVanArk	human
@goddess_kate	human
@frietamia	org
@SugarDown	human
@NCMSocial	human
@ALBERTOCASCANTE	human
@hernh0485	human
@ME_with_a_B	human
@poshinprogress	org
@BasixWeHo	org
@corrinrenee	human
@MondayRemedy	org
@nav_albert	human
@JessieHoleva	human
@katherinelaurio	human
@iremotuz	human
@SergitoDamico	org
@Sunita__	human
@SourcedMarket	org
@LePachaWest	unknown
@ci_mac	org
@MrsRogero	human
@Yinnie_C	org
@Bipolar_QueenB	unknown
@elisagioia	human
@AngelaWoody	human
@sashahoture	org
@ShaunSoPanic	unknown
@mcguink86	human
@LUREvictoria	org
@Emsterdamn	human
@NenaRohana	unknown
@steven_banks1	human
@Moein_pz	human
@meridienhelio	human
@praTiiiWiii	human
@jnewsome213	human
@mo_cco	human
@trueluxurylife	human
@ArtSchoolLpool	org
@Boqueria	org
@aypinz	human
@rv356	human
@TrueF1Fan	human
@Miami_Network	human
@Chef_Henley	human
@khor_winnie	org
@wbaca24	unknown
@dRuNkDaLmATiAn	human
@jonelorante18	human
@thehappyeggco	org
@RodRipped_er	human
@BBQTeamsList	human
@andrea_mr10	human
@mummatoldmeso	human
@ExoticallyCC	human
@LoveChicStyling	human
@Iamasromwell	human
@andreamonicahug	human
@MissEssynce	human
@Isaacyong95	human
@eg_veronica	human
@NeuvooPTChi	unknown
@bundanya_fasya	org
@ButcherBlocker	org
@ICTorontoCentre	org
@iamkeithchua	unknown
@BizzzNasty	human
@Brussels_Food	org
@SlamSounds	human
@CultureTripPAR	org
@Azwarhabib	human
@sc_translations	unknown
@WhiteDinnerBS	human
@yoorimarti	org
@drunkin_life	unknown
@pmidesign	human
@maldita_marie	unknown
@MindDisciples	human
@bungabungii	human
@Naaaaiiii	human
@arasefutib00	unknown
@Adelle1504	human
@andreamydoherty	human
@Kuranoku	human
@cariluvs	human
@ArcyMUA	human
@TrekResto	org
@MikeeMalbarosa	human
@k_villafania	unknown
@kmagnus1	human
@40ishMusing	human
@YummiAffair	human
@PikalilyFood	org
@mohitgupta018	human
@Roshan_rss	human
@EggBreak_LDN	org
@LydyGagaa	human
@Mayura40	human
@ZaraMcculloch	human
@Jeonyoojin92	human
@TheShowOff85	human
@SnackFoodAssoc	org
@hguy21	unknown
@CorkDC	org
@wongeroos	human
@JenniLeeLondon	org
@fabre_ludo	human
@MzM0nique	human
@kellyanneharmer	human
@OvertonRiseApts	human
@Reen8a	unknown
@echiezo	org
@djjoenobody	human
@CristinaDirnea	human
@bambiwu	org
@DenverListBiz1	human
@travelwithraf	human
@tyum3i	org
@gamehead200	human
@tianlii	human
@RaffaellaGreco5	human
@Hestyara	human
@sugaryspicyswan	org
@HappiJar	human
@borjalgaara	human
@TajBostonHotel	org
@LizTorman	human
@soysauce714	human
@naoko1727	unknown
@Jokerha13	org
@15409yagi	human
@cotrangel1	human
@ciaobellaxoxo_	unknown
@pipin1788	human
@kitsiee	unknown
@gourmethotdogs	org
@tat2edprincess_	human
@NathanaelGJC	human
@mizqreshiadl07	human
@AlyTyghter	human
@LavaFloFood	human
@adriannapizz	human
@AnnaMsFA	human
@rated_APG	human
@diamantilv	human
@indy407	human
@IllistBishAlive	human
@JO_JoyceOrena	human
@dancingpandor	human
@johnnykillen	human
@GhyslainBistros	human
@nancy4y	unknown
@MONDO56	org
@94Pipe	human
@Max2179	human
@HughSnoozeULose	human
@JenALambert	human
@eatsweetpeaches	org
@NaBriX_NaBa	human
@Mason_Jar_NYC	human
@AngelleBatten	org
@FlavorsofSJ	org
@JonateLealea	human
@m_pikari	human
@chalzable	human
@fatdaddywhite	human
@LaurellaRose	human
@LucaTerrenzi	human
@nicolagibson80	human
@JulieErikssen	human
@wildhorses1206	human
@MakylaMunroe	human
@Jason_Milo_Raso	human
@GOTAlove_LIZ	human
@CafeFiore	org
@MrCej	org
@FangirlLife_x	human
@PlantstrongDeb	human
@griegapalopoli	unknown
@peitylo	human
@zoom_magazine	org
@ArteryP	human
@Recoverstrong	unknown
@QuestWatford	human
@jamalbates	human
@goodtoknow	human
@anahares	human
@rorikero	human
@aah1604	human
@Soup_Guru	human
@HeyYoBecky	human
@redlionyoungs	org
@calpizzakitchen	human
@ALuxuryApproach	human
@shase7en	human
@hans12022	human
@AgentofStyle	org
@McDonaldsMeats	org
@novaegourmet	org
@JessieLopez8	human
@SaldunaBeach	org
@jomztheONE	human
@I_am_OJ_	human
@Maria_Fusco	human
@BadBoyNMD	unknown
@reverendscoffee	human
@kellylundberg	human
@leohizon	human
@karmalolmama	human
@hinadamaco	human
@NetworkSocials	human
@jessicanelsonxo	unknown
@BrandnewNelly	human
@DrPetteruti	human
@MonaLisaAdli	unknown
@kitle_cekimi	human
@jana_obermaier	human
@Graciy24	unknown
@DeniseCop1	human
@NurAthirahHalim	human
@flychicsajazz	human
@vale_ndina	human
@katiekachina	human
@stanislavabrnk	human
@LeFollador	unknown
@_ang	human
@cakevscales	human
@thebellandpot	org
@domz_bernal	human
@itsmejulia_g	human
@TracksBarGrill	org
@Lafrrrra	human
@MaiaYogurt	human
@SmileSunshine92	human
@RingoStarWars	human
@hana_pia	human
@VLMFitness	human
@eat_drink_moose	human
@Bristolunique27	human
@jpkarlsson	human
@TroyWizza	human
@ItalianTable1	org
@yuen5	human
@jec_calalang	human
@idellealist	human
@EscaffreD	human
@AlbaSeguraE	human
@LoveToLiveBlog	human
@RezaPasdar	human
@maralyns	human
@modelscorner	org
@CAVPproductions	human
@AgentScully64	org
@IamDannyChung	human
@21212Edinburgh	org
@missesluvjones	human
@lalex123	human
@MIKE_WELLS23	human
@JBsglutenfree	human
@CritneyClears	human
@bodegavillavila	human
@mireanapibe	human
@IceDeliveryLDN	human
@ClarkesCorner21	human
@DevourBarcelona	org
@emarahim	org
@crazyluis_75	human
@Jhon96896289	human
@clairewalton7	human
@Takarilondon	org
@MediaVixen	human
@IneesTn	unknown
@j3Tjy	human
@a_s2_chanpi	org
@AlisaKanechi	unknown
@santiago_omario	human
@Irishsmiles1966	human
@Can_thisMendoza	human
@donnamcgeary	human
@DemaliaMaharani	human
@reachdebjani	org
@EatPrayCook_	org
@LeanChefIndia	org
@aiyanaquino	human
@CasabLuciano	org
@bodybynixx	human
@Van2VIGALO	human
@maibuzz	human
@MsKrezalicious	human
@Ary_Lorenzato	org
@nae_olivia	human
@ka_bino	human
@TillytheMilly	human
@SBrilus	human
@arianemae143	human
@Marcussw1	human
@lorymes_lolly	human
@WeszMadz	human
@AphroditeNYC	human
@TravelBlggr	human
@yosoydenocilla	org
@stacysimon13	unknown
@musiclova212	human
@majalajanegaba	human
@PascalRecoleta	human
@NipunK	org
@GitaKurdpoor	org
@emiliatuarez	human
@Nacho_Alonso96	human
@a_c_huang	org
@jeancsant	human
@legendsofstone	human
@_xxxKENGOxxx_	human
@TanjaSulic	human
@ratetheplateut	org
@CymaAmir	human
@HilmaVanan24	human
@musachan808	human
@lauriloris	unknown
@zaogmpdhw	unknown
@forumROL	human
@FirlanyMalik	human
@HowBeth	human
@CypressClub	human
@Tan_tannam	human
@ray8426	human
@abenton1	human
@TailoredInNYC	human
@mentormommyof2	human
@akiho872_barbie	human
@FrancescoFacc	human
@Giorginos1	org
@souqplanet	human
@abitofbrownsuga	human
@SanazArjomandi	human
@MichaelBreum	human
@tracyknixon	human
@WhiteheadDeatra	human
@DamianVanore23	human
@__kankoku	human
@KenEsta	human
@NorthsideK	human
@katlocaylocay	human
@Renitherecia	human
@pitayaplus	org
@shee_tah	unknown
@fahadalthabty	human
@StreathamFood	org
@agoldshop	org
@cathacaliao	human
@ccnyg16	human
@GeekyBrew	org
@MONLongBeach	human
@JewelsHRH	human
@TanzilSilvia	human
@barntiques859	org
@BestSpirulina	human
@lkorp	human
@thefrugalmom	human
@rabihabu	human
@SSHHOLLYWOOD	unknown
@kloaisdgdsd	unknown
@SanRei2801	human
@AmetsaArzak	org
@flamengrill	human
@OldFashionedSus	human
@udon_kameichi	unknown
@humanjung	human
@vinnyverse	human
@925bistro	org
@AndyWibowo_	human
@TipAM	human
@LabellBoards	human
@taximagic_DC	unknown
@icexxcore	human
@naemahramli	human
@SarahJFotos	human
@0ctavin0	human
@Appleby1019	unknown
@liberatospizza	human
@DFErwin	unknown
@Elpresidente23	human
@Etsy_Team_LOVE	human
@princessfizoxD	human
@ericacal	human
@JessicaHC_Tan	human
@ImbiberyLondon	human
@Brackelmann94	human
@Sommelier_Mary	human
@djidenaty	org
@PJBillingtons	org
@keyshabass	human
@LaLatamaki65	human
@Kitchen519	human
@VohnsVittles	human
@Jia0192	org
@_travelproject	human
@Piyal_DXB	human
@PopSteakPasta	unknown
@sashaminister	unknown
@LouLar68	human
@MartynTichy	human
@StAlbansTourism	org
@annadcooper	human
@Ryan_D_B	human
@kristinjade	human
@IvoryHotels	human
@parkkynnyeol	human
@Melisa_C8	human
@Walkiiz	unknown
@Juli_Gentile	unknown
@FarmacyVictoria	org
@HMMTtenki	human
@TheXaviers	human
@jessicajannenga	human
@TrophyBoston	org
@CheAdriatico	human
@DianaWalker12	human
@BarioOo	unknown
@Princess_JR	human
@IamOrbeL	human
@TheyCallMeSuh	unknown
@CynGagen	human
@thelifebyvilife	human
@BrookTsiminis	human
@BoxMeMommy	human
@Madelein0405	human
@757LiveNZ	org
@djdani979	unknown
@MissGiaD	unknown
@markocipcic	human
@Tavern1757	org
@RaveenaMehta	human
@Jasmine88xx	unknown
@morsels_perth	org
@syysvilja	org
@giselle_tweets	human
@SkyNKatesMom	human
@sarahbb1	human
@LPanacheBistro	org
@jenayy13	unknown
@iZZAshleyWhite	human
@michaela_bob16	human
@bboytuko	human
@EmilioVzquez	human
@studentrecipes	org
@lb20131005bot	org
@eka_pi	human
@roxiehwang	org
@DUKESHOTEL	org
@edajyelyah	human
@AwesomeVibes7	human
@welshandy	human
@Mama_Shelter	org
@WingstopNMB	org
@denisenfyffe	human
@hanaminamori	human
@JTbeatsNYC	human
@LancastersBBQ	org
@fiona_beeee	human
@chrChristo	human
@Train_Crazy	human
@Swati_Guyy	human
@Kaymanzine	human
@PoppysStyle	human
@JOZ_MMR	human
@OurSkinny	org
@bennyandbula	human
@SugarHillsChi	org
@DianaRamirezMon	human
@sharonachia2202	human
@dahliadumont	human
@hungerynyc	org
@Spadellatissima	human
@alwayzfresh	human
@Miz_Teri	human
@iam_armaine	human
@_Prinz_Ludwig	human
@daily_parenting	org
@SoraFanJoey	unknown
@go2hlth	human
@BrielLight	human
@MrBookieboo	human
@thndrstrck34	org
@InterConDFC	org
@ApothekeDF	unknown
@Mom24rugrats	human
@katrinawarner	human
@TheUnitedBE	unknown
@_Island360	org
@balduinjauise	human
@spaventi	human
@OrganicLiving_1	unknown
@_rick_john_	human
@iamsuperpaopao	human
@parestailor	human
@littlebartlebee	human
@kazukimaedaJK	human
@Jaeda_Teoh	human
@kwiae530	human
@invisiblezebra	human
@Ruth_Sas	human
@adrianasanzf	human
@missaya07	org
@ToriShorts	human
@Drdaveandcallie	human
@piink_matter	human
@arnav__	human
@hillsidesupper	org
@daidojii	human
@PedrooGuedees	unknown
@TristanDiamon	human
@nivyy_sy	human
@stellarafl	human
@Miss_Mel181	org
@A_Maiden	human
@kedama_melb	org
@Sky_Williams	human
@NyanGabe92	human
@gencam	org
@Realitychick948	human
@LorinkaPearl	human
@ValentinLucas9	human
@christinearazzi	human
@leng_lui_jenny	human
@the_links_site	org
@Speakeasybootle	human
@windsoringsara	human
@citrahariz	human
@JBGMusic	human
@gsqrd	human
@isaac_iR10	human
@Wan_Elly	human
@Tia_Ramadhantia	org
@FlexciaDsouza	human
@petiteoiseau	human
@cc1904	human
@GoodEatsChefSer	org
@miima99	org
@Mydetoxdiet_UK	org
@nickyhackman	unknown
@M1214Sue	human
@STERLINGMHOLMES	org
@camineroimarie	human
@vberriesv	human
@asianorgasmxxx	human
@jhaleauthor	human
@umamibound	org
@kimhyunhak	human
@JLT_Residents	org
@dionbp	human
@OwenZhong	human
@MrSurovek	human
@Uniek81Books	human
@ThaChozenOne324	human
@ThoseWhoNose	org
@ILSOTRANTO	org
@btrmindbodysoul	human
@VIVINkd	unknown
@WellnessByAllya	human
@PrincipeNewYork	org
@nurissmad	human
@leepromise2016	unknown
@mynamekree	human
@coachsd421	human
@KenwoodSA	org
@EachGrainCounts	org
@ShakemHaters	org
@3Chiss	human
@redsox_chick	unknown
@RandVIslington	org
@TanikaNxDr	human
@jack_spi	human
@mizzdevi	human
@TripleH_Heidi	human
@CuizineDurban	org
@MsLibra82607	human
@abokadomark	human
@SkinnyMintCom	org
@zechdz	human
@IreneWHQ	human
@jlindahlj	human
@lia_nne	human
@ActorDavidChen	human
@tdmathieu	org
@EntireMagazine	org
@MercyDelta	human
@Rick_C1111	human
@ankitgarg43	human
@AtoosaHariri	unknown
@Frazzle44	human
@merchantstavern	org
@AngieOtey	human
@AshleeAlexa19	org
@Easypiso	org
@GheeEnriquez	human
@BelgraviaHub	org
@realfoodSJ	org
@abbfie	human
@chicopiermann	human
@4everDanni	human
@kslatz	human
@TheLlangoedHall	human
@kariintosa	human
@iAmPeah	unknown
@toastiesfactory	org
@anjourestaurant	org
@cavegirlwarrior	human
@SalsaandAgave	org
@north_017	org
@28ayca	unknown
@VivianChow5	human
@tamarakho	human
@clarefraserpt	human
@qbnaith	org
@marathehelper	human
@rosswell11	human
@raymsocampo	human
@ATLBread_Forum	org
@LadyRevenant	human
@poopadweck	human
@DanielMuoz3	human
@miltenacious	unknown
@shinynu	human
@anitaroberthina	human
@athomewithalice	human
@VeronikaKhen	human
@meatheadTFD	human
@ICMKoolina	org
@Hearty_Nut	human
@cwabSA	org
@OlafFrozen__	human
@FAKEHOTFRIES	unknown
@SidoniePandora	human
@masterchefmom	human
@HottestDaniel	human
@Riyadh_Amaken	unknown
@forzawin	org
@theoteom	human
@JWMarriottLV	org
@Phillytoya88	human
@lovebreakfasts	human
@tasteofbeirut	human
@GFORCE_JORGE	human
@marlylouwho	human
@zuzi___	human
@seattle_foodie	org
@agirlandherhome	org
@papajepoy971	human
@ori0918	human
@TheCoffeeTrav	org
@Aaron702	human
@belind02	human
@VerdizWong	human
@XandiEleazar	human
@Herrold_Doser	human
@FRANZanity02	human
@anneee	human
@mhkaizenpt	unknown
@Wcoastrwannabe	human
@siinta_	human
@FerrariRetweet	org
@EykaaPendek	human
@lisavuongbb	human
@ChefCandyAdams	human
@tFollowbackList	unknown
@nikatyler	human
@TheDessertDiary	human
@aaronlinares300	human
@ars_ayk	human
@nazgulrffc	org
@KatGrullonRD	human
@risnawati686	human
@sukina_senpai	human
@restaurantvosje	org
@mjsimplysmiling	human
@ervansugino	org
@Kiterinski	human
@imasoodmalik	human
@RihaZdenek	org
@Gizi_Dezso	human
@jenny_531	human
@LowisPowis	human
@Nkamphorst1	org
@marekbute	human
@DreadPirateDavi	human
@Michael_Colman	human
@Youichi0041	human
@SaraViti	human
@ShararehDrury	human
@FalihinKamal	human
@iamjonstar	human
@hafeez_amin	org
@MatteucciJ	org
@tere13ya	org
@TwoBrosOnBlyth	org
@Rebecca_ebb	human
@beefbrandy	org
@technokitty09	human
@GrowVertically	human
@AldonaPrzylipia	human
@FusionCareer	org
@LovingBlogs	org
@OurChic	org
@pet1713	human
@BabyYJ_is_Real	human
@tasteofbytown	human
@reypanama	unknown
@58Gin	human
@x_kirsti	human
@InstaTula	human
@LuisLD1	human
@ruthkemple	unknown
@sally_shiu	org
@travkindl	human
@radio704	unknown
@apriansyah_48	human
@NORAbrew	human
@viveytpyan	human
@syrielh	human
@toribee86	human
@JadoreJoslyn	unknown
@geckoo66	human
@Ljn_mdq	human
@undesiciveone	human
@Lourack1	org
@KidChefsCoach	unknown
@louise_soender	human
@piensaBananas	unknown
@TGDJAM	human
@we_flexing	human
@kukaimonstah	human
@diodelano	human
@FoodTrucksVegas	org
@ItsYair	human
@meow173	human
@JimDavianTan	human
@TGPGoldBar	human
@giftzyka	org
@pinkwellies79	human
@LennysAtlanta	org
@DanicaPelzel	unknown
@misslouisakwan	human
@aaramadhina	human
@gabrielgurrola	human
@wcangel23	human
@CrystalLeon	human
@Chez_Christophe	org
@Tunacan27	human
@CountryBoyBrew	human
@BornPink	human
@Bluenotemilano	org
@omarmolinam	human
@marycmcmahon	unknown
@FitMomLifestyle	human
@massueqla	unknown
@tokyobubbletea	org
@IanOcampos	unknown
@rikkarp	human
@Yakamo3x3	human
@CharicaRoche	human
@LaraaSaunders	unknown
@GazingIn	human
@celebagent1909	human
@tyleralexandra	human
@NorieOne	human
@EnchantmentLL	human
@hennatahirnawaz	human
@loveurneighbor	human
@BreaAnnWeiss	human
@eMazingDownersG	human
@chadominic	human
@Nivod	human
@YoungThunderHBR	human
@alterinfogr	human
@Valehousekitch	org
@MissSofit	human
@MellisaRaj	unknown
@Hayleyloufield	human
@jwlmichelle	human
@cckqueen	human
@lydiabakes	org
@MirchiLaddoo	human
@RookieChef_	human
@kitkatprof	human
@IDsiamoises	human
@redundanthoch2	human
@im_kazukita	unknown
@RE_followers	human
@CSkipton	human
@FoodsLove	human
@YourFace250	human
@justinelugayao	human
@YowItsAaron	unknown
@SaeriSherly	human
@GayeTakn1	unknown
@ji_cco	unknown
@SegryVI	human
@CandiceGuardin0	org
@HaroldsBistro	org
@EastBayGrilleMA	org
@RockaBellyAZ	org
@ProjectEvents	human
@NikiaStar	org
@JustAPinchCooks	org
@CoachJaniceD	human
@sabskaur	human
@RachelUnleashed	human
@randynomad	human
@ByTheHudson	human
@dinokengreserve	human
@SebaMarin	human
@LisaMercurio88	human
@hotjacks	org
@ParkHyattTokyo	human
@YourAquapark	human
@msneakerpimp	human
@MissBB_Mok	human
@deedeethatsmee	unknown
@wriwra	human
@jomargelera	human
@Joanna_Renteria	human
@PippinHillFarm	org
@MissPond	human
@NQ_nailqueen	unknown
@girlinflorence	human
@lashygirlpv	unknown
@Capture_TO	human
@jjak2003	human
@Ollaanty	human
@TheReal_JUNE	human
@EiraSyiraz	unknown
@MizzDimeCita	org
@RobynKurt	human
@petar_stipanovi	human
@TheClerkAndWell	org
@HelenaBandeiras	human
@Newfangled_Wife	org
@pockycnd	human
@ilkerkacan	human
@SFTEBakery	org
@NonstopFitSav	org
@IsaacsDeli	org
@jeerzgirl72	unknown
@dizishernie	human
@MarketingEyeUS	human
@imaima0909	human
@HelenHsuPsyD	human
@qwksilvr21	human
@AnaRodiahMubin	unknown
@TastyBrand	human
@jaydee1204	human
@LupeDominguezf	human
@jonathan10joes	unknown
@MohdRamzi	human
@TappinTammie26	human
@LynBennett68	org
@jcnerio	org
@ameeeex	human
@grippado	human
@MagnusEngvall	human
@kanomz	human
@celinesaludes	human
@DanaLeaB1	human
@PerthLovers	human
@mellyybell	human
@efiza	human
@Lluliana1981	human
@Stawojo5481	human
@alejandro_mlndz	human
@Banisai	human
@Umerlathiya	human
@SheretteW11	human
@Little_Jessie92	human
@VasiFtw	human
@azteeg02	human
@suppingood	human
@gregfinck	org
@czarong	org
@thaifoodmuseum	unknown
@chefshowdown613	org
@HITMANIAOG	human
@EStilossas	human
@XalonKnorr	human
@LJB_Photography	human
@bruceybld	human
@ItsAutumnsLife	human
@Snross23	human
@marceloalmaviva	human
@Phelps10Lou	org
@KimRipleyHartt	human
@vichupedia	human
@Marcelaprezchef	org
@UnrulyShebrew	human
@rmfaris	human
@SheSoStyles	human
@rgiub84	human
@Reesiebabygirl	human
@heybudflowers	human
@EmilyK3997	human
@EdiblePotential	unknown
@NNaily	human
@MadoxOfficial	org
@HannahRyder21	human
@ViBE_ub_apple9	human
@shee_rine	org
@davidmead	human
@MoreJuve	human
@shanz_enuhh	human
@BeautyNDFeast	human
@oldcauseway	human
@ShaneSosMundy	org
@GraceSyiariel	human
@unruhe	org
@monadsamadhi	human
@SerchMartinez	unknown
@Dridgway	human
@rhui1112	human
@ValueTravelerOz	human
@Hodgkinsonhotel	org
@Ardi_Pradana	human
@LungoDog	human
@PearlzPearl	unknown
@josecno1	human
@ShoSoFooly	human
@BettyLounge	human
@BonitaAfrelia	human
@mikaelainfinite	human
@RaggaRagga	human
@AnotherRoot	org
@SugarfireWingH	org
@janettwokay	human
@PolishedStars	human
@DJAlberthmoreno	human
@pdxatxwherenext	human
@EllieWhittam	human
@timothybui	human
@yayesm1	human
@shinkeleila	human
@looknarm	human
@AmyAgustin	human
@cappuccinoaddic	human
@Kizzy2809	human
@djlenski	human
@rutiler	org
@Tring3	human
@KerwinRegis	human
@palavermaven	human
@nystephiee	human
@rod_evant_nyc	human
@LauraKidman	human
@themerryness	human
@guja40	human
@ayako113	human
@fuldendeen	unknown
@Luci_Cam	human
@ikhwanrustam	human
@fajy	human
@MelindaDunne	human
@faizal777	org
@AShaq264	unknown
@venuepeterboro	org
@SurLeFil81	human
@easyeatsbykai	unknown
@mindyl308	human
@BrownSuga_35	unknown
@christina_ooi	human
@PlayaVintageBB	org
@gastronomiayfit	human
@munawarahazmi	human
@MissZindzi	org
@ChrisPancake	org
@NemoAmelia	human
@FredKABIENA	human
@AhhTongzxc	unknown
@ArielNan	org
@JnLee5	human
@ciaramccutcheon	human
@taismarchioro	human
@NikkieEdmonds	human
@Skyentology	human
@DuranAlejandro_	human
@DJ_Kookie	human
@famyabuhassan	human
@Jasmynflowers	human
@SweetVivvie	human
@yellowbunss	human
@J_In_finity	human
@Meriime	human
@marz_riska	unknown
@CamdensCorner7	human
@JCWardPhoto	unknown
@254mochacharlie	human
@rattlinbone	org
@Ariane_Wilson	human
@JesE35	human
@Charbroil	human
@gofeltyourself	human
@TaraTeaspoon1	unknown
@elijahjoy	human
@femininemuscle	human
@STKLondon	org
@Caravelle210	human
@Bebalancemx	human
@kandimandi	human
@Ki_Zi_2	unknown
@mpcido	human
@MissyMaki	org
@AdorableArianne	unknown
@teamsupporttre	human
@RelaxIntuit	org
@JollyMom	human
@SStrode	human
@AncerStylez	human
@CHEWonthisNOW	unknown
@nicolauotavio	human
@JanineHarry_	unknown
@Ola143Cody	human
@m_tksh	human
@jakm0210	human
@GibbyBoy_410	human
@IWillAKTF05	human
@MSofiaPaparo	human
@BegorKeraton	human
@unaavic	human
@ShiyiLeong	unknown
@MonicaIdrus	human
@eatbourbonst	org
@NoorAmirah92	unknown
@JaynieMarie	human
@amottakeout	org
@businessbrand	org
@LewisTappin	org
@illydasilly	org
@Just_Cravings	org
@ByNoonie	human
@YL_Pang	human
@cniep	human
@iamcious	human
@soostoronto	org
@Marie_et_Cie	org
@Zoyche_devoyche	org
@TheLodgeAshford	org
@gulcelezzetler	human
@JRemix1990	human
@DietAnalytics	human
@KMillheim609	human
@Valeriejean15	human
@cantinalasvegas	org
@LakshmivdWart	unknown
@Nimade_Ema	org
@MarissaMamiE	human
@likeidreamof28	unknown
@Poet2	human
@zackhardie	human
@DinaCheney	human
@BJL60	human
@steve1922smith	unknown
@CaTurfPros	human
@itsbiancamillef	human
@TheAsianPear	human
@loureilacap	human
@KevinQUINTANS	human
@TOWIWoolwich	org
@riotbookshelf	human
@kneadfood	org
@Bel_Cafe	org
@matthew_hebert	human
@sherevillosa	human
@macastro98	unknown
@lookitsthinthin	human
@streetkingz	human
@jlichty30	human
@cheerfulchan	human
@meganj1109	human
@bladenomics	org
@yO_Onis	human
@Stornblom	human
@evelynnkess	human
@mkjoosub	unknown
@danieldfinney	human
@jecsanjuan	human
@rosapelsblog	human
@liut24	human
@uthmonster	org
@NehaYadav_Nia	human
@rachelkennedy96	human
@robertothecomic	human
@LillyE1655842	human
@EponinL	human
@vanillarose24	human
@jessjewlry	human
@akocyheng	human
@popolosydney	org
@Mssauceda	human
@siltazz	org
@TynishaHolscher	unknown
@michellehail	human
@_lnm_	unknown
@EatInNJ	org
@LissaCrane2	org
@niphy_baggins	human
@LailaFoods	org
@hernanverano	org
@TurkishMommy	human
@GhantaBabaJiKa	human
@Noflik	human
@Acme_kitty	human
@Fun1NTX	human
@Gathalasonia	human
@grace_leah_n	human
@yinchiro	human
@FatChoyLV	org
@fork_knife	org
@eddmalteser	org
@ivanalst	human
@kelciejojo	human
@Jana_027	unknown
@deaddollsclub	unknown
@Segovia_Eve	unknown
@FadilaZainudin	org
@mmango65	unknown
@plenry_company	human
@vipmartingroup	human
@shirleyhowell30	human
@CalmaChichaRTE	human
@jdbarbagli	human
@alonacolona	human
@Cinema_Epoch	org
@sara_paetz	human
@arturogomezrrp	human
@atsumina48ryo	human
@Minus18Degrees	org
@whatevsItsJing	unknown
@ajcelebtrainer	human
@deglutenous	org
@bosfoodanddrink	human
@doodles_dee	human
@hootz	human
@lady_green1785	org
@zy008	human
@MrSmooveLee	human
@BoneSuckinSauce	org
@TheQueenOfChaos	human
@bighunkaluv	human
@setchin	human
@b2st_wy	unknown
@AmaliaTrocea	org
@barbibegarie	human
@chico_malo04	unknown
@Lolofthedead	human
@jedmond_1818	human
@UpRiZ3N	human
@IstriaKempinski	human
@boriser_R	human
@_ToastedBun	org
@SophieH0use	org
@LucaLavelle	org
@mithilajariwala	human
@AceDavidbd	unknown
@ggaabbyy10	org
@MyFunHealthy	unknown
@grafdenusialove	human
@lm5280	org
@EHdragonfly	human
@JJ_WALL	unknown
@Stonezdesigns	human
@SoundwavesAV	human
@BillchensBeauty	human
@ToddGraysMuse	org
@yukirun	human
@Bulaf_sosis	human
@Imguud89	human
@IcemoonPromo_GR	human
@sherrimaQ	human
@XFeDeSignX	human
@ChriisFournier	unknown
@iamrush_	human
@noofardeva	human
@AmberPiirainen	unknown
@LadyPhoenix5	human
@superGpZc	human
@CBWorx	org
@Ruthdragonpan	human
@DanCottom	human
@TheOrganicLife1	human
@jessemc_13	human
@amandavergi	human
@TisferTara	org
@LincsConnect	human
@VanFoodieTours	org
@pure_wings	unknown
@VanNguyenMai	human
@mooosyy	human
@rica7yummy	human
@_Charm3d_	human
@gabswirkosz	human
@Kristen_Elise86	human
@dbrmarkiemark	human
@birdonawirenz	human
@LoveYourBread	org
@layenlim	org
@SOOSITREATZ	org
@Determined_91	human
@axduniverse	human
@3wafie_	human
@CookinGrannie	human
@mamet_fazli	human
@JiawenShi	human
@Get0ffMyCl0ud	org
@naturalmkt	unknown
@Iffatara12	human
@DowntownSpirits	org
@MO_BARCELONA	org
@RansomBaby	human
@leonardopivadj	human
@LSGPurchasing	org
@Christoff_Carr	human
@beibhinnisargel	unknown
@mr2fancy	org
@meekorouse	human
@WITSinSchools	human
@trubrabbit	unknown
@RandyBrutout	human
@Erick_Irwanto	human
@beaucoupbougee	human
@Isas_Bistro	org
@musing365	org
@EmmaParrish	human
@gevone	human
@missHDowns	human
@spider_72	org
@HiImflorcis	unknown
@COSpringsEvnts	human
@beguetwitimages	human
@MYXFusions	org
@HeidiNagaitis	human
@Lizwangari13	human
@nurulainaaqila2	human
@shantiisonline	human
@nuguerrilla	human
@TweetStella_	human
@SchoolyardMkt	human
@ChristinN0512	human
@nilsenfrias	human
@mimilcemil	unknown
@MrInIt2WinIt	human
@Foodieinlagos	human
@SleepValley	human
@DAgostinosMI	org
@MahaJoma	human
@yojieshabushabu	human
@ArborpointSL	org
@therummer	org
@diabetesfacts	human
@Pelhydrol	human
@maisontofani	human
@TheMatN	human
@coreybrunton	human
@jendrakefeltner	human
@Pyronn	human
@BradandVictorH	human
@TrainerTrina	human
@MKettt	human
@aimeehliwag	human
@jerryfuzion	unknown
@ToniaNardi	unknown
@JackFrancoBXL	human
@delishop	human
@Hollie_Betty	human
@jasaratoga	human
@makeshiftalisha	org
@Blackmores	org
@HisguardianisQr	human
@mackyduavs	unknown
@carolsdevonne	human
@its_Shae	human
@LadyRyleeKat	human
@MarinaMallAD	org
@ZachSwagsby	unknown
@0Unofficial0	unknown
@RockboyDonovanC	unknown
@hileher	org
@karenmiyabi	human
@teamsirizaa	human
@tookriss	org
@theOakwoodKits	human
@ShannonAnneJame	human
@zendelife	human
@youmesushi	org
@zoumrouda	human
@RogersDiner	org
@TirnaSi	org
@KarlaMoz	unknown
@lindaleedonahue	human
@curioushow	org
@DevaFey3	human
@AnnaueleSmith	human
@JustPerfectC	org
@JammyMee	human
@Norul_Edlidza	human
@OTMEWORLD	human
@davidedegio	org
@LizAlejandro	human
@MarchabeLTabeL	human
@Victoriamdq	human
@Lullynieto	org
@dwvdc	org
@AyeshBroCricket	human
@shynanegans	unknown
@realwholesome46	human
@AkosiIskoGarcia	human
@NapaOnProvCLT	org
@beatriizfb00	human
@AminKhalip	human
@anggism	human
@sheng456	human
@darylseahzh	org
@FOODIESIGN	org
@timothywpawiro	human
@pamelaaryan	human
@aledol4t	human
@yoririn31	unknown
@Ms_ValiantLee	human
@Righteousbabe01	human
@ChocoBlacktea	human
@iamnissey	unknown
@AnOrdinary_life	human
@goodeatsbeats	org
@EAC_Foodie	org
@billsindewald	unknown
@amusebouchebg	org
@TulviaLane	human
@FeliciaTrotje	human
@jeansfashiony	unknown
@Mymarthas	org
@LVStratosphere	org
@Big_Fat_Dan	human
@IndulgentFuel	human
@IrinaLV143	human
@yosiytublog	human
@wondergrain	org
@FamousToastery	org
@January98xo	unknown
@JAYLONDONHAIR	unknown
@LookAtLocation	unknown
@GR8FoodStories	human
@Cassiesearle234	human
@MJdaTRUTH813	human
@newtonandpott	human
@manzsuemeyye	human
@MutiaraVeelicia	human
@cocaine_cabaret	org
@sammylovesslash	unknown
@jamessc4scoot	human
@Poliedipede	human
@tina_bina12	human
@DavidBouley	human
@Shuuuuuyaaaaa	human
@OB_Events	org
@mccormacktiger1	human
@wins4me	org
@TheTanninLevel	org
@f0nzy	human
@CafeUnwind	org
@lidyaflorencia	human
@VANiTY8605	human
@Astronomic_Ebay	unknown
@inloveccsy	unknown
@TaylorPaigeB	human
@_SalsadiNuvole_	human
@dani3lvaz	human
@WrapSkinnyTeam	human
@jemofthesouth	human
@SofiaMounia	human
@ShakesBody2_MJ	human
@foodable_jeff	human
@sg_andrea	human
@darrypars	human
@laila_pt	org
@Tyrant_Virus	human
@HipsAndHangers	unknown
@lundister	human
@Andresnavarrotw	human
@PriceyDick	human
@TheLivingRoom19	human
@CMLobsterSD	org
@dollpoupee	unknown
@FoodFlaunt	human
@BreakingBadClub	human
@RoominaSalas	human
@FoodSpecials_CT	org
@JuanitaDowden	human
@muu3n	human
@nicholascfuller	org
@benjaminchef7	human
@PubandKitchen	human
@Happybluesky05	human
@Dblethefitness	human
@LetsFeedMe	org
@azota	human
@aDp87	human
@Lbarriales	human
@FabiPoonoosawmy	human
@DarthWadera	human
@TheBoldHotel	org
@scrabbleking	human
@lily_tarigan	human
@chubrinochub	unknown
@yakoching	human
@CBHouston	org
@somcity	human
@AnXiOuSINDIGO	unknown
@foodandstyle	human
@Megawatiyenny	unknown
@BrandiPizzeria	org
@0804Sison	human
@vendee_web	human
@avomine	org
@Anab3lla	human
@M_Hsna	unknown
@josh_mani	human
@yenheartlove	human
@jennyshun	human
@EleonoraVattiat	human
@FairviewWine	org
@hendytong	human
@boydontbadboy1	unknown
@meowtiff	human
@AndreaMi27	human
@Zahyk6	human
@mystery_merci	human
@fashion_arch	human
@hh_haizal	unknown
@signedbyesme	human
@jOhN_fRaNcIs_jf	human
@JulietaMellia	human
@bsperkins25	human
@qoOMaShiOop	human
@QueenStRescue	org
@Ohm_maria	human
@realgiealbano	human
@DaileyBeauty	human
@malinh1988	unknown
@DsrR1235	unknown
@Denise_Austin	unknown
@bongvideos	human
@hollakei	unknown
@tonlidumpling	human
@PlenishCleanse	human
@mappingmayhem	human
@cutehealthyhap	human
@henrygohz	human
@FirstHomeNews	org
@andreaaquije	human
@cockROSH	human
@CarmenSCantos	human
@kachuacobilla	unknown
@amandabeech	human
@brandimoore92	unknown
@HainDaniels	human
@eyespoke26	org
@The_H	human
@eina_fets	human
@AyassHereIAm	human
@DreadedUp_Merc	human
@nikki1573	unknown
@lilmay26	unknown
@BarkingDogPako	org
@santosoemanuel	unknown
@RAKSaeed	org
@glez_vane	org
@Vucko24Fit	human
@bnlfan70	human
@NYCFoodJudge	org
@indre_et_loire	org
@ufphotography	human
@DeBoomBoomRoom	human
@AlonSimplemente	human
@YviMosura	org
@Artikamayasari	human
@AlexWrethman	org
@Drama_Alert_Fam	unknown
@SillySri	human
@SoundMyYAWP	human
@bodiesbyheff	human
@HotelVerde	org
@MorningGerald	human
@ScotchKitchen	org
@DieeYean	unknown
@HabanerosHRM	org
@Gian7Andrade	unknown
@choosen_hayata	unknown
@ChrystallJane	human
@glamourosasexy	unknown
@marljust_	human
@LJ709	human
@atizelinda	unknown
@beenAnomad	human
@gade_z	human
@ChefSantaella	human
@JamMeurielle	human
@JUSDOINLEM	org
@TheLauraLeeB	human
@LaSeafoodBoard	org
@AdamMcGrath89	human
@HappyFactoryID	human
@noki_k	human
@Liz_11111	human
@romatias13	human
@lifewithmycats	org
@ihateharlem	unknown
@suffolkchamber	human
@Manchester_SEL	unknown
@AnastasiyaLavr	human
@StarTruckNY	human
@linne_pin	human
@__Money_News__	human
@mannjain1992	human
@TheCoalShed1	org
@essijohanna	human
@MeShoumily	human
@Alirezasho	org
@AnnettaDarandri	human
@CRagsdale	unknown
@walkwithafoodie	human
@BesitoMexican	org
@pixleah	human
@theTeresaNicole	human
@SmilingMoose	human
@etagurl89	human
@yemyovloli	unknown
@NellaMirante	human
@CidStoll	human
@mingmartillan	unknown
@OrbeFive0	human
@enylove2	org
@queenmiserable	human
@CornerCafe	org
@dginhac	human
@krishnanugraha	human
@coouge	human
@WanderLustGirls	human
@jwtbeng	human
@723YEEEEUUUP	unknown
@NoSylviaPlath	human
@aishious	human
@maxemiser	human
@FSChicago	org
@candice_mcnish	human
@ObviousNinja2	human
@FSPaloAlto	org
@JMBrown2012	human
@vivichan08	human
@CarlyGenic	unknown
@Vapinghippie	human
@dhioyulestian	human
@JEstherlita	human
@ApplebeesRD	org
@Inktd	human
@maaaaachan0420	human
@thomazellineto	human
@KitKats_Mom	human
@ElaineWong85	human
@MrsRenfros	org
@Irina_Fit	human
@SabaiBrighton	org
@maisima_ojisan	human
@bibijamoo	human
@breakfast_bad	org
@JellyfishOne11	org
@lozandollys	org
@CynDwn	human
@iamsuppaduppa	human
@ScrubIsland	human
@GEAUXRYAN	human
@furu3m	human
@tjejmorsan	unknown
@OurPaintedWorld	human
@AnticChef	human
@DJTESONYC	org
@YoureInShane	human
@koopersnorth	org
@Ne2n	human
@joann926	human
@15_ivann	human
@DouglasHowes	human
@JoyceMiranda	human
@dinerporn	org
@zonlibrat	human
@vofnabuja	human
@DreamChaser_56	human
@KIMALYNs	human
@aloveuxxx_7	human
@Lets_Deli	org
@iriafabeiro	org
@Romashkina_N	unknown
@jackyhackett	human
@7Lucu1	human
@Deanpants	human
@sho_heiji	human
@sarahsonions	human
@ytkuts	human
@je7672	human
@StefanieChua	org
@Melvinbackpack	human
@RalphC92	human
@Sparkle_Core	human
@stacietinney	human
@girlswearblack	unknown
@Just2Fluffy	human
@ArabHunk	human
@The_Well_Nest	human
@sugacrushllc	org
@flstrawberrysue	human
@kristynhall	human
@SarahGoldstein_	human
@saienvantomme	human
@Xuan1115	unknown
@AaliyahGangxM	human
@healthfull18	org
@MarianneL2010	human
@greg_antonio	human
@AliWinch	human
@moneekwe	human
@naoewoda	org
@JolieMatthews	human
@7MissMichelle	human
@mrsmoneymillz	org
@BRIANNAHAINES	human
@AdmirableAthens	human
@dohertyseastave	org
@Ushijiman	human
@ShapetothePlus	human
@angelcano	human
@alimaalbari	human
@dangerous_krock	org
@recuweb	org
@veganchiq	human
@sirentravels	org
@Joyceon4th_yyc	human
@SgtPepperine	human
@SonoranBrewCo	human
@KarmaKafeDxb	human
@Hospitality_Dir	org
@JennMelby	human
@Shop_LuckyB	org
@Agnesegullotta	human
@CRVTravel	org
@PenralltWales	org
@LO_ice_creamery	org
@it_s_you_	human
@HarlemHCL	org
@aie001	human
@BrewLabCoffee	org
@Pauline_1964	org
@susielfa	unknown
@AvalonRhodes	human
@0921Lili	org
@ZeanaRomanovna	human
@DonerGyrosdubai	org
@anaretabieber	human
@SunnyPatchBlog	human
@TheHeavenJones	human
@TheFarmBelly	org
@Iciecute	human
@Nasri_rey	human
@speedygo	org
@cocoabierto	human
@tonypoohbear	human
@DinneratAshleys	unknown
@allison_day	human
@acs1991	human
@giveforgranted	human
@eziamodafferi	human
@Yee_Jess	human
@WO_MAG	org
@PurdysChocolate	org
@Go_Away_Baby	human
@DanielleHeree	human
@Al3xisBrAndy	human
@BelovedBre	human
@oishi_in_canada	human
@EkoMunartyo	human
@super_jex	unknown
@shah_arshad	human
@SoulAfrodisiac	human
@daynacw	human
@2UFarm	human
@araiza_lourdes	human
@famies	human
@guguluver	human
@wantlistcreator	human
@balqishbasir	human
@otherydta	human
@PancakeHouseSF	org
@monikabalyan	unknown
@lenluvdea	human
@RosalynCarthy	human
@sweetmaarina	unknown
@eakm0106	unknown
@suziswadling	human
@SpiritedBK	unknown
@MNFarmersFeedUS	org
@Dancehealthy	unknown
@akuz94	unknown
@t_s88	org
@GreatrixRobFoto	org
@Dvdavisdesigns	human
@culantrocookery	org
@Kiddie_Yang	human
@CaWalnuts	org
@FlirtifyUK	org
@Kickin_Chicken	human
@BossiNclassy	unknown
@rachelleruby	human
@goodappetite	human
@Donnasilvadelao	human
@PortlandNicole	human
@NoaGreenspan	org
@ItsJacquiG	org
@FHHA21230	org
@Primal_Jean	unknown
@mijnbreintv	human
@fayelyf	unknown
@emmashinta	human
@Naima_Chaudhary	human
@breadandmilkuk	human
@DogLimo	human
@carmensayz	human
@alessibrugada	human
@Skuyla	human
@emmahxc	human
@Jimik88	human
@N19Archway	org
@sunnieisww	human
@herescharlie	human
@AubreyLoveSiwon	human
@SadlySweetJenny	human
@femalehustla86	unknown
@KababjiJo	unknown
@SallysDietRite	human
@dr_dedy	human
@BATA_P	org
@fitfoodiele	human
@IloveCityWest	unknown
@justmartame	human
@commaforlife	human
@LeylaaSmiles	unknown
@AmyRogersTV	unknown
@Nikki_00	human
@boos_ya	human
@GCWestgate	org
@Y3ANL3NG	human
@robvelasquez18	human
@LiaHalsall	unknown
@MerrylPetersen	unknown
@layerphase	human
@hey_brittanyxx	human
@baileymichelle	human
@postalakecomo	org
@MADOUAE	human
@foodtrucksTO	org
@Cyborge01	human
@SunnyOfficial	human
@jesuscaff	org
@hellotiffy66	human
@MontpelierNevis	org
@SWilliamson87	unknown
@WhittyPaleo	human
@Act_Fan	unknown
@39line	human
@kingscrossN1C	human
@fergy0216	human
@KushalMJJ	human
@BelfordsSav	org
@tamygb	org
@never_sleep	human
@RinaSalinas	human
@sullivanojules	human
@everfreddy	human
@Erikazelayao	human
@FazeleySocial	org
@minniepuno	human
@EverydayRevelry	unknown
@eds_easy_diner	org
@OlgaNM7	human
@dariofattore	human
@lizschneider_	human
@LaciJane212	unknown
@fly2wales	human
@itslynnykansas	human
@Rhydonal	human
@choupi_healthy	human
@rachel_doell	human
@fara_auliana	human
@DulcineaCocina	human
@racquibaby	org
@sheilaarlando	human
@fsmooth9	human
@burlinigiovanna	human
@andi_delfino	org
@HugOfPeace	human
@plateandsimple	unknown
@hairyfrankfurt	human
@FoodSnobDFW	org
@ProvisionsMrkts	org
@shopathome	org
@JulietteDudley	human
@srta_Persephone	org
@ElfeezaUlHaq	human
@Casper300zx	human
@shion_miyawaki	human
@Nicole_2000	human
@StephienaRahel	org
@guadajoejonas	human
@PTIISIMRANKHAN	unknown
@melo_cortez	human
@scarylalla	human
@DavithaRinner	unknown
@jasminehabart	human
@TheDessertDeli	human
@isabel52888	human
@iCosmo_King	human
@SissiluvsReggae	human
@Mousesteps	org
@Idreamgourmet	human
@krazyphatgurl	human
@keyasirena	org
@haleysue580	human
@RoggenartSerbia	human
@ICC_SPORTS	human
@MarionMeinhardt	org
@RandomArchivist	human
@JeiHan16xx	unknown
@AlManzil_Hotel	unknown
@iCook_co	org
@Hkrystine	human
@BajaCantinaMDR	org
@Philthy_Clean	human
@klund13	human
@OikonomouAt	human
@paloaltomedical	org
@ankie01	human
@laspicesisters	org
@CourtneyAbrams	human
@msamysteele	human
@ECbotOfficial	human
@shadito30	human
@DialloKreed	human
@JenicaZimmerman	human
@JacoGallarde	human
@urbanpear	human
@Kaytee_Johnson	human
@mimily_me	org
@leafygreenscafe	org
@inamiguel	human
@KTo_17	human
@JocelynFFreeman	human
@JIC15	org
@Roaxtan	human
@AngieBandolini	human
@ionelia_le	human
@lesleycchange1	human
@Anthony_Lee_97	human
@toetjeaddicted	org
@RachelBustin	human
@facciolifelipe	human
@so_wingtung	human
@Jelani_Nkozi	human
@iLiaaV	human
@Darly30	human
@HareezIzwan	human
@BeZaperfect	human
@MRLICEANGEL	human
@HHDesserts	human
@superkimpoyyy	human
@jana_banana_16	human
@MyDietitian	human
@GreenParkUK	org
@aa_ndrea92	human
@saraxelizabeth	human
@EastofEdenCook	human
@sylviepx	human
@swervontime	human
@YuHsuan212	human
@scottiewun	org
@AmyFreyaNeilson	human
@nukiraa	human
@Calvin_Leonardo	human
@Mah_Mui	human
@MissJinadda	human
@SaffronBootcamp	org
@bit_rude	human
@Katherinehsuan	human
@fmeldi	human
@setiawan_masuki	human
@mollyjwalter	human
@vasneverov	human
@hydro2oxii1	human
@funkychickparty	human
@EddieZamora	human
@mump86	human
@StreetFoodUK	org
@ChefChurchill	human
@rahrahdeee	human
@schooldinners	human
@silwou	unknown
@asarogiulia1	human
@mintnmimosas	org
@ACadasaca	human
@NurmalaEka	human
@rissa35	human
@CarolionD	human
@adeeyasrah	org
@Sionnun	human
@AMANINALANI	human
@pungumu	human
@timothy_jayson	org
@monicaolvia	human
@AddelynSilva	unknown
@nurulizatuleffa	human
@natasha_chef	human
@dickins0n	human
@HertsCatering	human
@KristiLCorrigan	human
@sugardose	human
@ChefBettyFraser	human
@mickymeikei92	human
@adamfidler	human
@bookvoices	human
@nickclassick	human
@Msjackmusic	human
@GaryWorden1	unknown
@varakom	human
@khanShiro	human
@chefsgateway	org
@Lodema1	unknown
@PastaFits	org
@TorchResto	org
@AZgrilly	human
@yoshikoting	human
@AZTommyTaylor	human
@Jihane_MD	human
@gabyhatusupy	human
@chuyunjudy	human
@sashashantelvip	human
@rocknbreadrolls	unknown
@Aldrin_DK	human
@anotherisms	unknown
@GrumbleDude	human
@Kazwei	human
@musketeerfox	org
@_baseline_	human
@itsg333	human
@Speak_SirEarl	human
@anukiciqaxob28	unknown
@MsKattyArante	human
@SBen_	human
@YouMemiyu0627	human
@Deyb_dieSinger	human
@Gedak527	human
@MookieWilson7	human
@nattanealz	human
@MyPlaceBarGrill	org
@Lara_Leito	org
@iloveyouweirdo	human
@Cahas	human
@RhaposdyPhoenix	human
@jonnaethompson	human
@LeavenKirstie	org
@KatyanaAzman	human
@sophb92	unknown
@marce_ortizc	human
@klikz2013	human
@SpiceRoutePaarl	org
@HoroscopeOfUSA	org
@muhammadhazren	human
@BellinisCounter	human
@valerieoon	unknown
@basilmomma	org
@WhitbyCrabCo	org
@ManManPemba	org
@ImagesbyBrian	human
@DFrittsy	human
@Stiinis89	org
@Anita119091	human
@xclairebaer	human
@JULIE1031	human
@BellysimasCris	human
@rvalperez	human
@trendy_healthy	org
@Sophiembartha	human
@itsmelanierodz	human
@Roos_09	human
@jieying154	unknown
@Griffintowncafe	human
@bangalibabe	human
@2wildfriends	human
@2LiveAndDine	org
@PhylLondon	org
@cinziabagni	human
@MegaMenus	org
@sasha_love26	human
@bebopsplace	human
@ChanellyK23	unknown
@Nikkolai_J	human
@MissVranHalen	human
@ColeGatsby	unknown
@House_AliceRose	org
@nfp2015	human
@smaemaryu	human
@columbusmama	human
@p0larmilk	human
@otbnpboathouse	org
@TheresaFowler	human
@delfigaffner	human
@WelshMotorsport	org
@espeverr	human
@lucy_grace88	human
@ramenbots	human
@MaundaLand	human
@Goodpiecompany	org
@lifewithdawna	human
@selgrasmontreal	unknown
@beyndnutrition	human
@alexnbeltran	human
@londoneating	org
@Passievrouwen	org
@CherrieRon	human
@MariannaZuliani	human
@CamBhakt	human
@MCMMargherita	human
@TristanVenable1	unknown
@Antolinezcata	human
@wheretopartyNYC	human
@julie1918smith	unknown
@IonaKirby	human
@AmstelHotel	human
@mmhgrty	human
@BrookvilleRest	org
@abeerii12	human
@iloveannedg	org
@JudeLegendre	human
@CMortu	org
@barbsalem	human
@Clean4YouKS	unknown
@PamelaFlood41	human
@loVeeHyunable	human
@boxtreat	human
@hafizchan	human
@missamytran	human
@VedaPowerYoga	unknown
@mikesmith8026	human
@Wintersyve	human
@ButterBreadGirl	human
@tamimarieb	human
@round_barrel	human
@yuan_rocks	human
@kendawgz	human
@TriKx	human
@vitaminDrocks	org
@Damaira_Herry	human
@lwk940402	unknown
@ChenGiada	human
@jennyCupcakes69	human
@800419	human
@FLY_Charlotte	human
@MartitaVolo	human
@NerotecaKL	human
@IdleHandsBar	org
@Fr3sh_SnapBack	human
@hitopitopitomi	human
@misstoni_w	human
@Kln_ShangriLa	org
@mingfoods	org
@Zahnfee12L	human
@etsyan04	human
@cita_pasaribu	human
@lubys	org
@rayofglitter	human
@DiDi023	human
@nomadicdrummer	unknown
@mschwanzer	human
@smithmeister89	human
@TAWHotel	org
@erwinindrawan77	human
@sherwoodzino	human
@LeeJoon_Oppa	unknown
@TeeJay_SQ	human
@Admired_By_Many	unknown
@g_nperkins	human
@WhitneyBCooks	human
@LMarseillaises	human
@nisha_ksg	human
@thegaytraveler	human
@AndreChirinos	human
@Manbach12	human
@jowieduya	human
@yankegal2013	unknown
@TRENDrevista	human
@thelarksb	org
@joannmramos	unknown
@iamalluringjen	human
@majestic_cannes	org
@JILL_Dot	human
@KristyBee	human
@KolkataFoodBlog	human
@friendsofham	org
@tdhdubai	human
@ceibarestaurant	human
@Eboni305	org
@scotthallsworth	org
@BunBrunetti	unknown
@beinginspiredby	org
@health_e_snacks	unknown
@agarciasays	human
@popsiclerain	unknown
@PurplePplEatery	org
@KatieScanlon	human
@pookie77	org
@CholuBalan	human
@Evilfromparadiz	human
@chapikuropi	human
@chayferrerebina	unknown
@GreyhoundSaug	human
@Alligrosjean	unknown
@laura_luna	human
@Matt_Aspden	human
@kevinthepimp	human
@PuertoAlegreSF	org
@Mary_Bulkley	human
@AshwiniDodani	human
@Madrid_Bike	org
@TheStraunt	org
@JoycelineFoxy	human
@victoirethiesse	human
@KellenJones	human
@stranealchimie	org
@allsangsmamma	human
@hotliquidicepop	human
@LuqmaanEl	human
@homedecorpin	org
@Mrs_LadyLove	org
@afinamahira	human
@mrsbeccahanlon	unknown
@PanxoSmart	human
@ParrisBeasley	human
@sucresalecravin	human
@ChurchStEnoteca	human
@TheLiquidMuse	human
@therealneeks	human
@shawnchou710	human
@TaimMobile	org
@saint_ds	unknown
@HeinekenLe	human
@Scampers49	org
@tserimai	human
@StangsMagasin	org
@Rezasalazar	unknown
@iamlitamarie	human
@Oldboy_Nikku	human
@qtchris_10	unknown
@Mon_____Amour	unknown
@ROTRDelivers	human
@Palenleen	unknown
@Shacolat	human
@AMBreath88	human
@hacking1t	unknown
@Knightlover11	org
@ChaseKojima	org
@xiaopingguo1	unknown
@two_woon	unknown
@Priscias	human
@cutepinknpurple	human
@RestLagoCisnes	human
@AgentBaz	human
@ethnicbynahid	human
@KholifMamuunun	org
@_derpqueen	human
@gzdkrpc	human
@MalaKipli	unknown
@julesrlavin	human
@FlourishNutri	org
@IamMissIrie	human
@Melerealw8kauai	unknown
@zeemasita	org
@CuriousGrape	human
@DineOutBali	org
@ChefAmberShea	human
@pearltalato	human
@calaiskie	human
@gohhannah	human
@HoneySugars	human
@kuraokakinatsu	human
@nanciiix3_s	human
@Matemarsi24	org
@MrNotthing	human
@GabriellaMeghan	human
@eyesanon	org
@KinderCare_SA	human
@DietitianGen	org
@zakiansulhi	human
@_TressaLynn_	human
@sonyajeon	human
@HealthyAuthor	org
@po2huang	human
@MacarenaDy	human
@iam_johntan	human
@NurHeidi	human
@TheIanIlagan	human
@taratarayuriyu3	human
@cuckoofoods	org
@narcisapheres	human
@SFChino	unknown
@TheLloydsChorl	org
@bobbyciletti	human
@tinglouie	human
@Bitsofcarey	human
@ivankwanchoong	human
@yhen_lee22	human
@BlancoyCaramelo	human
@Greenbelt_hb	org
@Ivonne_perez19	org
@LOVETATUM	human
@grillatwestlake	human
@stylistnicoline	human
@lucy_apriyanti	human
@valdezgirl	human
@lovepurplestar	human
@JayOhSheFine	human
@YouKissMty	human
@xiaoswai	org
@69ideas	human
@celestialground	unknown
@GreenOmBe	org
@HashHouseChi	org
@joidevivreblog	human
@akosilelets	human
@HolicArtmk	human
@EW_Essentials	org
@ashvon	org
@ey3zonly	human
@shinaliit	unknown
@_H0m3s_	unknown
@CafeJulieta	human
@SkyGan01	org
@yunaysMP	human
@alanmcvey	unknown
@artlovermia	human
@CharlatanVan	org
@EverFree_JHCS	human
@adrianacarcelen	human
@Ju_Oliveira24	human
@tiboobligado	human
@_DreamingYou	human
@AnimatorsPal	human
@EfiraNasha	human
@ModaAmoreMakeUp	unknown
@coolcancer83	human
@limwengmarc	human
@ElenaThoe	human
@ticko_ahmad	human
@sheconfident82	human
@diycraftshome	org
@redzep812	human
@VisitXTVFan	human
@chibiharuca	human
@PialaCitra	human
@RealATK	human
@HannahStrattons	human
@mmdortiz	human
@anungadhy	org
@dj_serhan	human
@Jizel_D	human
@LianeHung	org
@HELLBOY2318	human
@ll_Cece_ll	unknown
@ayveecruz	human
@StyleofTwo	human
@chrislyyy	human
@COOKieNJI	human
@ARISA_212	unknown
@chrisfelton35	unknown
@Maurystinycove	org
@_CityLoverzz	human
@KidsCookMonday	org
@dearrcaityy21	human
@sandyv1955	human
@CorickHotelSpa	human
@TheMichaelLeedy	human
@ArifAzizi91	human
@eqavrilyani	human
@JeremyGerth	human
@MJ4235	human
@BestOfIndustry	org
@XDRMOON	human
@heathercannell	human
@FONZY1381	human
@CaraFoshizzle	human
@SaptaniaCP	human
@AntnioSarabando	human
@marice_angcao	human
@Ardhi	human
@BeefandLambTeam	org
@SinghLaurie	org
@Jewelyanna	human
@dobaekki	human
@RobbyBridges	human
@snapshotfashion	human
@Katew17	human
@zZROOZz	unknown
@emzbenz	human
@NurAmirah_Ishak	human
@munchandbrunch	org
@AkashSam	unknown
@MyPitangas	human
@PrahranMarket	human
@Rizalastrod	human
@breadbromwell	org
@sammyt7three	human
@tom2mind	human
@Lees_BiggestFan	human
@AAOsAwesomeFans	org
@LGatHP	human
@EmpanadaFork	human
@kiska_29	unknown
@mrapd662	human
@MasalaLibrary	human
@__Renesmee	human
@pcruzsays	unknown
@RealScottWeller	human
@chinitadesserts	org
@Miss_Rootless	human
@dineshoplocal	human
@SORA_alien483	human
@susan1215	human
@Thubthimkrob	human
@FirstKingTre	human
@SchubertEquip	org
@MrIzReal	human
@FinancierNYC	human
@CaraS1986	org
@serafu1072	unknown
@LouieVentura	human
@UStandardBris	org
@VibeOnGoodVibes	human
@ShaniDelamor	human
@FilipaCSemedo	human
@snarkfetish	human
@Trippa_Mc	human
@AnytimeDallas	human
@oysamore	human
@HiltonAberdeen	org
@OxFood1	org
@zubafitmom	org
@slavikphoto	human
@DXB_SButterfly	org
@KiKriSta1758	human
@richcrem	human
@Hirofumitweet	unknown
@shefahsue	org
@Arcespejo	human
@SaltTraders	org
@HollisBennett	human
@Thejadelord	human
@SeberHealthyLiv	unknown
@SpringHill_MedC	human
@Jadacool	unknown
@m_crx	human
@me_73	unknown
@DeogratiasX	human
@don_cuac	human
@kasbahboracay	human
@jeff_diggity	human
@bookmarkfal	org
@MarleneJaded	human
@hotvideoau	human
@BigMikeKoulchar	human
@fitkid81	human
@elythiahosana	human
@lobsterfromaine	human
@SzaiiLey	human
@notjustfashion	human
@gpws2k	human
@Fammiez	unknown
@NeuvooAdmMis	org
@sheenbadass	unknown
@jbus13	human
@dextercjr	human
@SteamyBunTruck	human
@msssreyesss	human
@noorputri	human
@voyA25piece	unknown
@AleSiliezar	human
@AustinJockrockr	org
@airbuspilav	unknown
@stevie_ly	human
@Brays_Cottage	org
@Feather1999	human
@situren__kotoba	unknown
@tbowman88	human
@slc84	human
@astridandmiyu	human
@NeshanTV	human
@AnthonyBatow	human
@GSIbethesdacafe	unknown
@SavseSmoothies	org
@vh2collection	org
@BenjiManTV	human
@azce_j23	unknown
@Sami070911	human
@Melltoo4Sale	unknown
@773Toya	human
@anriiii0216	human
@LocaSunset	human
@STRADA_BIANCA	human
@VivienneChow	human
@trulyonlysora	human
@puterinuratika	human
@PendahGlossy	human
@CSNNOttawa	org
@yuu731ichika	human
@lickmydip	org
@theChicBarbie	human
@lbnassar	human
@KailaPfeifer	human
@sheppard_sheryl	human
@sknybox	org
@BerettaSF	org
@MochidukiKoyori	human
@AlifHuazim	human
@BPFrontandJohn	human
@Foreverfit4u	human
@HollywoodFLCRA	org
@zaida710	unknown
@CicelyTripoli	human
@grannybz	human
@che_vamp	human
@lottieyates88	human
@DeLLuXLounge	org
@GaetanoCartone	human
@babap79	human
@TheVeganRoadie	human
@Tatin39	human
@PearlsnSequence	human
@Nisenough	human
@CoreyWys	org
@cjmorrisjr	human
@AmyBrettPT	human
@sdusman83	human
@AnnitaKatee	human
@ollyatbolly	org
@ciEn__ciEn	human
@carliux1984	human
@taraboyde281	human
@themacrowizard	human
@keawy	human
@LanChisOnMain	org
@ty_tyskitchen	org
@KelKang	human
@EzzanHaqis	human
@_NayShawnta	human
@SheSimmers	unknown
@not_moby	org
@mayuishikawa415	human
@UnicornSorbet	human
@davepperlmutter	human
@ZuppaTalk	org
@Neonclassique	human
@mtvh09	human
@shyoom1998	unknown
@CarlosOFuente	unknown
@sulirmaos	human
@chefmaureendath	human
@SoloChills	org
@ArcherHotel	org
@MaauVR	human
@kalynnydong	org
@_IAmBrigitte_	human
@BenBikoG	unknown
@Trouble2356	unknown
@Darlene61726	unknown
@GiuliaCarladami	human
@truff007	human
@NightfallBeauty	human
@abbyjillian	human
@mollyandstacie	human
@inaaku	human
@IntanDaningrum	unknown
@thaboholic1	human
@JUJUXII	human
@veritasawards	human
@BarEstiloCamber	org
@allarayofficial	human
@pauline4515	human
@dave83x	human
@Grezzci0	org
@147Deli	org
@Jenniefish84	org
@ShayraFG	unknown
@DJFrankieee	human
@Irwandegalendyr	human
@taka5825	org
@CocoBing69	unknown
@valleerose24	human
@desiekaavilia	human
@ToastOfDetroit	human
@joysauva	human
@PSllKhem	human
@TheRealCHANRY	human
@soltantochiara	human
@theBRElife_	human
@synzmemoir	human
@nexadmedia	human
@mychoiceofwine	human
@Halley	human
@RacielCastillo	org
@mrscardillo	org
@madeiraholiday	human
@asmallvillage8	human
@TheCCCboston	org
@RyoheiBC	human
@ematigian	unknown
@PachinoPizza	org
@iestrada	human
@Ana_C_D	human
@hortipernia	human
@milsomhotels	org
@Teisha__K	human
@lovingindie	org
@fritesandfries	org
@maribelpedrozo	org
@indtwt	org
@anaireparis	human
@hatsumi0907	human
@FaBuLoUSDarLiN	human
@LemorW	human
@HB_Belle	human
@HolberNu	human
@MariannyMateo	human
@LarisManiesShop	org
@Volutology	unknown
@gogoglutenfree1	human
@eldridge4	human
@prettycuteninja	human
@loveandanarchy1	human
@jqnotjq	human
@terrysmall	human
@happygirlaya26	human
@RSgarra	org
@akaSPARKLEZ	org
@ershadahmad	human
@bembemlensa	human
@iENtrEprENEUri	human
@busdriverjoey	human
@Clevelanta	human
@LisaButller	human
@stefanogallon	human
@FountainsatRsvl	org
@NewAgeSoulFood	org
@HerlindaZM	human
@GUERREROphotoLA	human
@ChuzRoman	unknown
@HotelZetta	human
@ExtravaganzaE	org
@BUCHEERY89	human
@youarethebest70	human
@MzIllest1	human
@Karinvonz	human
@HeelsandGrills	human
@CastleDreamsT	org
@AfamosaResort	org
@BelleDodosmom	human
@vanilime	human
@seeksnewtreats	org
@BiggieColdcutz	org
@Manateebooks	human
@ilvoloftl	human
@LittleMisJonesa	human
@pseudo_ish	unknown
@ScratchMommy	human
@CrabbysBarGrill	org
@HyeinPain	human
@tsingwala	human
@AngelHiro2	human
@m_mangour	human
@susanagmz90	human
@Trini_Millz	human
@jeffersonj515	unknown
@maryer8405	human
@thatsTelugu	human
@B_Grimaldi	org
@jasonthompsonco	human
@cakequeen11	human
@PTNAfrica	human
@BRUboulder	org
@kuluwaz	human
@Mills1608	human
@blaqsheepcoffee	org
@CatsOfIran	org
@MoniP10	org
@Miss_Livx	unknown
@BrideOfChucky15	human
@thesantamonica1	unknown
@QuiteChefy	org
@LordDinkus	org
@dishleeds	org
@mombeachblog	human
@MhyDrex17	human
@CassinaDunston	human
@iam_JIFU	human
@comm4project	human
@alainrotana	org
@Domje	human
@rosannacooking	human
@independtnews	org
@syamellnasir	human
@Shhon3y	human
@JonnNubian	human
@JurGool	human
@AlEmadiMA	human
@TheJayvux	unknown
@the_real_avh	human
@ShezRespected	human
@MichelleMencias	unknown
@SassySasin	human
@halimyusof15	human
@transpacifique	human
@TorresChess	human
@LisaSheppard456	human
@ilcudega	human
@PizzaPreacher	human
@emoukun	unknown
@Vilmarys13	unknown
@angcat30	human
@SylviaDuh	human
@pappaececi	human
@aeporteous	org
@HappyMeBermuda	unknown
@ivan_i19	human
@MaiAdobas	human
@Unalatinaymas	human
@angelinaella	human
@DrunkOnShoes	human
@Feechaman_MMI	human
@Lv4263	org
@pyaartrick	unknown
@PatrasGreece	human
@Shayneejay	human
@SteamedBunMunch	org
@UFullOfBritt	human
@TidyMom	human
@mariaotero4	human
@foodforlifetv	org
@measured_life	human
@shichan0324	unknown
@Amazing_Cafe	org
@De_Dear	unknown
@GwenMetalfly	human
@Gonza_Tacos	org
@Flaviant_Thomas	human
@morningberries	human
@cookalexv	org
@OccupyMars_	unknown
@Lili_mckay	human
@TheFlamingVegan	org
@Panicmanic4	unknown
@nealbrooker	human
@Dilip_kumar1988	unknown
@gulcinozkan	human
@thisgirlabroad	human
@AnnaPosp	human
@DineOutwithMike	org
@olcay89	human
@artapril	human
@DaniWagner10	human
@abarracosoivy	human
@ConnorBarr95	human
@BYUSportsCave	human
@TheMFWIC	org
@JetsMaryville	org
@Jnappygirl	human
@hustlin4me	org
@YESYOUCANdiet	human
@Momentro009	org
@Octa_Fenny	human
@j0y_wr	org
@DannyDoronio	human
@MissPhilly10	human
@rahma_prisdiana	human
@C12Hood	human
@AlbertShrews	human
@NZ_Globetrotter	human
@DishingwMedia	org
@joemzsalazar	human
@nhavhee	human
@MIKAKAMI0403	human
@jontybradley	human
@poppyrobinson6	human
@TASTISTRAWBERII	human
@suzettetweet	human
@Jabinpostal	human
@crossoakland	human
@ciaobella71	unknown
@trevj1	human
@JAPANisDriVn	human
@varsity_kale	unknown
@HomemadeForElle	human
@Kaigra	human
@jameyp11	unknown
@ItsSBenali	unknown
@NanerADay	human
@popsweetgirl27	human
@HotelSurya2	human
@AverobertsonAve	human
@Ajengwatii	unknown
@GlitterBlueSta	unknown
@CALLIELIM	human
@GVolpintesta	unknown
@SissaLage	human
@LikeLuvWantNeed	org
@iMaart	human
@Amanda_Rubini	human
@alexwturnbull	org
@ziruspizza	human
@akozibina	org
@orysia_a	human
@LifeOfKingDi	human
@GemGem_20	human
@ZahrMezze	org
@J_Marie384	unknown
@littlelulu81	unknown
@saf1wan	human
@GongHello	org
@CarnavalDuDesir	org
@TrueAimEdu	human
@erni_05	org
@EastSideKingATX	org
@BeatriceTrodden	human
@NJ2dbz	human
@yanochang	org
@franniigee	human
@nays_place	human
@dannibabes89	human
@PublicistGroup	human
@nadiacooks	human
@AuthorTonyaJ	org
@KISSkitchenblog	org
@babcnitaboo	unknown
@prosydelacruz	human
@McDonaghsNJ	org
@NerdyNerak	human
@ronron_diet	unknown
@HomeandFamilyTV	org
@biginjapan8	org
@amWoWie	human
@diamondsare4ev2	org
@AngelSSJ4Fallen	org
@LBLAZE_916	human
@ChefPelley	human
@modernotexmex	org
@NATURALNUBIAN	human
@george43218	unknown
@Bwitchedbyme9	org
@jackie_xj	human
@EmsHealthStyle	human
@nessieontherun	human
@Fuxinka	human
@FarringtonMonic	unknown
@ThePortlandBlog	human
@lindaayinyin	human
@ayumi_agung	human
@Serina_	human
@levidelacruz22	unknown
@theprivatecook	org
@sehmer	human
@XtianRenhard	human
@MagazineNiche	human
@TropicalFruit4	org
@daneestar05	human
@misshullatalula	human
@JkomDabomb	human
@shuhlawm	human
@lustfulpalate	human
@enyaherrera	human
@gagelewis	unknown
@ramawidi	human
@sarahj2m	human
@RedyShikina	human
@Jericutz	human
@ZonDEShop	human
@YeyaJA	human
@mylbsonlbsoff	human
@RavenousREL	org
@AbbyC_Marshall	human
@fashionfood	human
@Moe2theJoe	human
@yingluvchu2	human
@jennn2369	unknown
@mr_weed_22	human
@AwjaywosePhoto	org
@AllanSipajlo	human
@AbujaBuzzer	org
@__Nn06	human
@jordanrosetes	human
@steve_falla	org
@StevenGani91	human
@tomomi0105sama	unknown
@MoMoLeeKwon13	unknown
@Irene_bheiibhy	human
@andrablue	human
@Pier6Boston	org
@AtticusDenver	org
@siska611	unknown
@uHaveGreenLight	unknown
@iam_jonathan	human
@holajalapeno	human
@TheSmugglersTav	org
@ihdinadini	unknown
@minakoboi	human
@feverapp	human
@CJeonkwan	org
@Marina007s	unknown
@KeriOuye	human
@krstnimbao	org
@PlusHealth2014	unknown
@dellicson	human
@Emma_Spez	unknown
@simplywebsterly	human
@zuhiboy	human
@chamz_alyk	human
@zuriboi	human
@peah_hashim	org
@Hoppymen	human
@Will_Be_Thin	human
@creator_nene	org
@MammaHomemaker	human
@TiffRod4321	human
@SaviAssStr33tz	human
@fndinglessjess	human
@MarquessAB	unknown
@RaemilTatis	human
@fmomof4boys	human
@kpplasterer	human
@RossAugusta	human
@beemellie	human
@naughtynatmum	human
@mikkaila	human
@HostessAtHeart	human
@Chevsandstripes	org
@LoopMagazineBuf	human
@Mymr1222	org
@hey_jelo	unknown
@VincentMpls	unknown
@PercysAeroplane	org
@Khalidmelmi	human
@nzgirlemd	human
@bagel1955	human
@opalandopal	human
@Dee_Mehta	human
@andizmeriamsr	unknown
@hrdkbhatia	human
@Leentje2405	human
@KathySWM	human
@CamMayoMellow	unknown
@CromwellVegas	org
@F1k1pho3n1x161	human
@IndianSpiceCoUK	org
@OCDungeonMaster	human
@Bambinoness	human
@2607babayega	org
@OLIVERVASQUEZ	human
@janecosejo	human
@b_lenoa	human
@steph_tones	human
@Am_and_In	human
@EugeneLock	human
@FadzOnAir	human
@Ashley_dotcom	human
@MissHayleyDenby	human
@nikki412	human
@ARCDM	human
@PhotoLMarie	human
@CowabungaKids	human
@luisa_fisher	org
@DemanTan	human
@MJFortune	human
@natures_table	human
@ranjitpharande	human
@clairejustineo	human
@divorcedoula604	human
@kellz81	human
@2northshore	org
@staerox	human
@GemmeryA	human
@Temperpastry	org
@SahatDr	org
@CarltonJoel	human
@finest_clubs	human
@HabbyTravels	org
@23Hrf	human
@FoodWineStyle	human
@Lahapps	org
@ysmary72	human
@judezhuo	human
@Sammi_Collins	unknown
@Samuel___Smith	human
@Scottferd88	human
@kawtaralshikh	unknown
@JC_Hernandez_	human
@lifefabstyle	human
@IstanbulRTweet	org
@WillWong1289	human
@Mn_Marta	human
@LosTorero	org
@RoleNDaHay	human
@ReinaDePolanco	human
@DymondO	human
@1ove1dj	org
@ParisJeTaime	org
@BricolageBk	org
@Tapzilog	human
@StoneMtnGrill	org
@JulietLemar	human
@juniorbreak	human
@BlondeBiPolar	unknown
@GetCityDealz	org
@pumphousewv	org
@powerpuff_fairy	human
@YoSoyVegano23	human
@cowgirlcreamery	org
@Sartori_Cheese	org
@SumitomoMasatom	human
@JaYiZmEe	human
@SuperStarEst78	unknown
@diadorisa	human
@Jacque_Studio	human
@loverocka	human
@hoppo_78	unknown
@theresa_beh	human
@ViralBJJ	human
@BlueMonkBflo	org
@srw4ever	human
@ellebannay	unknown
@j37892008	human
@CrabshackLI	org
@Pearl	human
@ShareMiiTruck	org
@ramendra4	unknown
@the_lazybones	human
@meals_hamsmith	org
@enazuero	org
@krONik	org
@JurateDudley	unknown
@hrtbrkgrlf125	human
@spiceychoc71	org
@OLIVERKAY_	human
@__fmagic	human
@JanetMarilyn	human
@Manoucheparis	human
@paris429	human
@Pogorausch	human
@ElliMolin	human
@akgirlinco	org
@jmark123	human
@Manolo718	human
@NevinK18	unknown
@TotallyAmnesia	human
@EskiciCemre	unknown
@ukhti_k3cil	human
@GreenhillKitch	human
@LunaRed_SLO	org
@Dodo0975	human
@fletcher33040	human
@daffagradien	unknown
@CikMinahSayang	unknown
@antonio_jiga	unknown
@NashWynter	human
@giltcity	human
@woter15	unknown
@ErikLmusic	human
@E4LDeals	org
@FreshBabyBiz	human
@HighDynamite_	human
@SimplyMeKaty	human
@xs_xs_inspirit	human
@RareLondon	human
@ur_cooldude7	human
@AfterTheHB	human
@severus_adhi	org
@MarycruzRamire8	human
@DeanyWulan	human
@a_kickbush	human
@TheStarBug	org
@lalatking	human
@FarmersTableFL	org
@SEXYFOREVER0513	human
@jirayuojo	human
@cohnhead65	human
@oricher	human
@wifemomgeek	unknown
@GirlfriendsOB	org
@ItsYAmM	human
@LifeEnthusiast_	human
@aldhy406	org
@LanghamPasadena	org
@OldCalNick	human
@midlife_mummy	human
@bblythe_biang	human
@ChocoChibi6754	unknown
@Someday_Shabby	human
@jvictoria05	human
@reviewsbypony	human
@NANDAtie	human
@LeanEats	unknown
@samuelwongso	human
@maRiaRistidou	human
@deaniekaa87	unknown
@REZOLUTION05	human
@CIAOBABYCUCINA	org
@giftoflifenc	human
@annaelerihart	human
@scottlarsonclc	human
@beatschlumpf	human
@cheap_highside	unknown
@Deli2345	human
@cozy_and_cuddly	human
@shmoosie24	human
@TheRealPeterLin	human
@ThoryaTravelUK	org
@nickbchambers	human
@Emlofthouse	human
@TheHarbourHouse	org
@SitaraIndiaUT	org
@LillyTheBrownie	human
@Lady_Lucifer69	unknown
@hashanfox	human
@IxchelSays	human
@pataypedal	org
@brandonw1120	human
@RawSammy	human
@kirancooks	human
@Brassangel	org
@fitsoulandspice	human
@kimmietran	human
@GossipGurL_XOXO	human
@ECO_ROCKS	human
@Emy_Cooks	human
@NKamikawa	human
@GreenWhoreXXX	human
@nitin_hawks	org
@flavoursofspain	human
@EditionLifeUK	unknown
@Liftsarah	human
@carloshugueney	human
@sanjeetkumarit	human
@pacomakesvideos	human
@CakesandAmy	unknown
@Cindae	human
@theywontchange	unknown
@GiancarlaPB	human
@Mother_Nourish	org
@Thebestinparis	human
@Eyag	human
@rhonda_greene	human
@yasminahmad7	human
@britmarinucci	unknown
@Natural2017	org
@TwittoSpiaSPORT	human
@TheMainonMain	human
@CilantrosCA	org
@B_modaeestilo	human
@HesterPool	human
@PrimpSiam	human
@yayee_jatiya	org
@neeeeewtreeeee	human
@Natura1beautii_	org
@takoyaki_imbot	human
@JanineANSmall	human
@KsenyaLamonova	human
@oicaBli	human
@EpochRift	human
@buckscountyhog	human
@JoshuaJHager	human
@TassyaYusoff	human
@hollymoore1	human
@LeoPosadas	human
@RaqEspi	human
@MartinaCorte	unknown
@Am_I_Nicole	human
@_oliviashaw	human
@RussellReno	human
@2014winter	unknown
@hoopsta71	human
@MannMannnnn	human
@RMeiklejohn	human
@PixieDustDiary	unknown
@stefixerri	org
@DDubsGeordieGrl	unknown
@Andjela988	human
@roxburghed	human
@PaulsWife1995	human
@floresCmaureen	human
@gcheeseawards	org
@Spiinza	human
@CulinariaEvents	org
@shaeganvishal	human
@BenFrankApoth	human
@chefruzgar	org
@Trains_Rock	human
@HorseThiefBBQ	org
@Versvandeteler	org
@BetoXool	unknown
@Johnny_V33	human
@GalaxyFoodsInc	org
@ketueki_tannzyo	unknown
@jonbretton	human
@denizshares	human
@dewlaps	human
@nozomi_11risa	org
@johndime	human
@BiboDG	org
@tapicnic	org
@alohasavani	human
@HerAimiy	human
@NomadTherapy	human
@NunoCorreia5	human
@EveliinaGS	unknown
@RockliffeHall	human
@SerafiniFrancy	human
@Orca901	human
@seetony77	human
@FoodNavigatorUS	org
@Mknk_712	human
@ChefPaulCollins	org
@martalopez137	human
@TomsUrbanLV	org
@eonepeace93	human
@Dezz973	human
@agatazasada	human
@wfd180	human
@yasminebanez	human
@crowther_hbl	human
@MonifaRenee	unknown
@2FlyY4DiSsHyT	unknown
@MissConcool	human
@mynameisnizzam	unknown
@sagegio	human
@Agus2308	human
@cathyy_carvalho	human
@lovemindanao	org
@Jenvier	human
@ELBeamish	human
@Myatzee	human
@dimondonyc	human
@Lord_Bk	human
@missanna_bella	human
@suisisisam	human
@tffunedited	unknown
@chinwan0111	human
@itssophiayuen	human
@RegnierLauren	human
@southbayfoodies	human
@craig12283	human
@playpraypaint	org
@WinslowLeandre	human
@AnwarAAKA	human
@Qamra	human
@Jacc_Bnimble	human
@bearrivercasino	org
@Muller1Michael	human
@Josh_Frazetta	unknown
@fashbeautylife	org
@SognoImmortale	human
@LJS4247	org
@Matt_McPhee	unknown
@TijuanaFlats	org
@pecameals	org
@frances_wcs	unknown
@fitbodyrocks	human
@amsaj85	human
@OFDelivered	org
@bertsanity	human
@lilirunning	human
@AnnaOfficiial	unknown
@KotuMustafaa	human
@ma_mi1203	human
@Angel_G_Makri	human
@RNgoodfish	human
@KnoxvilleShadab	human
@VTpeanutbutter	org
@slhim100	org
@ohnok1	human
@VictorHMendez	unknown
@Janet_congge	human
@UrbanOveralls	org
@marthineeezzz	human
@yoginilulu	human
@ShonaMackin	human
@n1cky1001	human
@pinkbratz08	human
@mspearma	org
@shenelle27	human
@STARRSET	human
@CatalinaQuerida	human
@shotlovesfood	human
@tiffyvasquez	human
@nezbieberdrew	unknown
@mariepsanchez	human
@missxbrit	human
@livingroomdeco	human
@sindrisan	human
@beapereirab	unknown
@RantRaveRandom	human
@matea345	human
@Matteofalcone	human
@dapiorecords	human
@larazafoods	human
@NorthsideBar	org
@Khodjaeff	human
@Angiewhity	human
@KelEMartin	human
@hakkachick	org
@kathy_luv4U	human
@JoanneNP	human
@nycgov	org
@ahyu94_fishy	human
@Dayang_Noryza	unknown
@ebrusiyah	human
@Can2i90	human
@BelizareBK	human
@cattilovebugg	org
@1MichaelJamal	human
@bellarinna__Y	human
@TheDoniJones	human
@BarrettBailey	human
@LauraLoon	human
@MagdaSimply	human
@mosoulfood	org
@MistaSham	human
@crowbros	org
@Hildah_M	human
@vesseysam	org
@putriviana99	human
@PinkkBalloons	human
@dFoodArt	human
@NOREZLEENA	unknown
@Kayleigh_Pym	human
@twopurplefigs	org
@mi2ulxi	org
@covebeachdubai	org
@TrendsPHcity	org
@kira619	human
@SaraGalipeauRHN	org
@ElleRoseParsons	human
@edwinabacan	human
@stevenlamphotog	human
@kramphiliplahom	human
@_DjChurch	human
@The_Grill_No5	unknown
@ASOS_LTalulah	unknown
@jovinang	unknown
@FSHotelHouston	org
@hanrowlands	human
@NikkiGunz83	human
@_ConsciousCafe_	org
@a01072487344	human
@DiscoverMKE	org
@Sarsoura_84	human
@AcheleBenoist	org
@gizemozsaylik	human
@furkansamed	human
@cintaenak	org
@HeardInHove	unknown
@bobbied100	human
@vegasylvania	org
@jillianguyette	human
@elexasecrets	org
@DDlebanon	org
@jimmyboult	human
@luxurybeasts	unknown
@Y_Ryuichi23	human
@KingMallMurda	org
@Aikyrie	human
@hirocha0_0	human
@peachpiku	unknown
@GoldieGinaGin	human
@Arte_e_Moda	human
@SairaRasheed1	human
@ReveriesdeParis	unknown
@FatPandora	human
@gypsyleonie	human
@BigtimeTeez	human
@NourhanMuhammad	human
@chua_louie	unknown
@terreitory	human
@HealthIzSocial	unknown
@sekizawa_h	unknown
@wifemamalife	human
@runningonpinot	org
@asliceyda	human
@melheyward	human
@johannorrgard	human
@lizzie_loy	human
@PrettyPieLady	unknown
@lauracloughley	human
@rizmaristya	human
@andrewjamescpt	human
@CCmdpena	human
@LICgifts	org
@youka_na	human
@artiecpm	unknown
@hellenjoss	unknown
@DroneCorner	org
@cnmivestidoazul	unknown
@CannsCloset	human
@Katasticx	human
@mjtibayan	human
@raissatabone	human
@oppning	org
@acetildaylight	human
@Liquor	human
@thejayse	human
@MogulsCoffee	org
@skoutorganic	org
@jaediva	human
@YamilaHenderson	unknown
@TheAlphaNail	human
@LK2CHAT	org
@CacheBistro	org
@Light238	human
@teh_izza	human
@empirebiscuit	org
@startsateight	human
@MisBrittney	human
@anime_rbhZj	unknown
@Soniamay66	unknown
@mia_est2013	human
@f_lia0	unknown
@thedirty_floor	human
@BajanPrinceJR	human
@neeneestorm	human
@UnLeeshd	human
@homegrowncafe	human
@livinginsteil	human
@DayNightApp	org
@peminumkopi	human
@carlodehuts	human
@hugissimo	human
@kcejeckz	human
@BloggerBible	org
@slim_pickings	org
@zShockProofz	unknown
@MissNScordellis	org
@ItsMeErina	human
@ShiruMumbi	human
@TyraSurihani	org
@missjosiiie	human
@WhatZsaZsaAte	org
@belinda_jansen	human
@LveByrd	human
@Filipinogal2pt0	human
@jasonyng	human
@hanyelkhorazaty	org
@terrikap	human
@CafeDupont	org
@denachtegaal83	human
@catclaudio	human
@CANDY_DBSK_SJ	org
@0716maeda_	unknown
@matthewjennings	human
@justScotti108	unknown
@MartinaMelluso	human
@Elsa766hi	human
@DanielSyazwan	human
@friendsrelec	org
@jessesgirl214	human
@ShreyaTweetsYou	human
@CarlosMarvalR	human
@interfacevisual	human
@dr_Phaidon	org
@savoringftc	human
@dbestbandung	org
@ZetsuEleven	unknown
@omoshiro_KPwJ0	unknown
@EvoOrganics	human
@ExplosiveBabe	human
@aarongosee	human
@kubikinspace	human
@DoncasterRoofer	org
@darla_hogan	human
@klikoliko	org
@MisTrBrown302	human
@MadameOsi	human
@Gemini1214	unknown
@diladia	unknown
@EnjoySouthside	org
@ThisIsMe_Bob	human
@RicardoPardoS	human
@chutmonsecret	human
@taatiiaanna	human
@Veggiecation	org
@testbotpad	human
@BlueNileBoat	org
@matthewcmt	human
@sparkfix	human
@EricUshiroda	human
@moopuiiz	unknown
@esther_nyc	human
@gethealth_	human
@independentmami	human
@blackqueen92	human
@Jennifer_carr88	human
@RoamingHarvest	org
@LeicesterHouse	org
@229robot	human
@sdlove951016	org
@TheJungleMuscat	human
@NYR_Canada	org
@LivinLikeaLocal	human
@RENZ_JACKLYN	human
@SEMitrofanov	human
@EmPerez	human
@JessicaBore	human
@Jessie_HongYann	human
@servedbystadium	org
@gochandni	org
@kereboke	human
@peritinkerbell	human
@chefzubin	human
@zebramouse	human
@besoslatinos	org
@BagelShakeChef	human
@OiAsianFusion	org
@marinoivano	human
@IgnacioFrrer	unknown
@elamthegreat	human
@Besleybean	human
@the_mercantile	org
@DIYBinge	org
@jaimegonzalezc	human
@1kmitsu	human
@MONTY1JLM	human
@FloydBurney	unknown
@eleanork8kin	human
@MisterUncommon	human
@BlogBeth	human
@PetitoWines	unknown
@995themountain	org
@stefanpinto	human
@Eatclean3	unknown
@yakitorikintori	unknown
@feelbodystrong	human
@Veganetcetera	human
@massimo_zamboni	human
@Elliots26	human
@DanishAoi	human
@SebAberer	human
@worldfamouswrap	unknown
@aranzazu11b	human
@La2GiG	human
@Nhlamulo_BoZzA	human
@XXXJazzy_Laveau	unknown
@DanielSoon94	human
@diamondtkpub	human
@Rebellious_Fish	human
@NirmalModi1989	human
@dilsweezy	human
@JessWildes	human
@DaiChantique	human
@Meshari__G	human
@bethteoh	human
@KiaSuban	human
@BaconNationCA	org
@KillerThrifters	org
@TWISTNFILLSIPS	org
@christine__liu	human
@OTularuk	human
@leecoc	human
@airgis	human
@PLUMPUFF	unknown
@PeponneBakery	org
@leeannehayden	human
@AfrikaFoodPorn	human
@bitebymichelle	human
@DanielaTomas9	human
@mep_1231	human
@melonmilkshakes	human
@filippowshura	human
@LIFT4women	org
@JohnJGentry	human
@adipolo	human
@AriPutrii	unknown
@MackoyCeleste	org
@miiico129	unknown
@desibakerboy	human
@hoorrayofficial	human
@Elli3GM3	human
@POKOYUKKU	human
@ebrownsugar	human
@Sammyk_17	unknown
@ann1rt	human
@TSilberstorf	unknown
@UCanCallMeSammm	human
@sbyhurtes	human
@stevelord	human
@KathiSR	human
@DonWEAZALITO	human
@lacuisinedizza	human
@NeverGoOutside	human
@DAHAMM3R_914	human
@iheartjane	unknown
@Azest4life	human
@julsleilani	human
@Mr_ChrisAnthony	unknown
@Hello_jars	org
@suzystronglynch	org
@angelamalik	human
@ch33huei	human
@sherylsunico	human
@gvcostarica	human
@MircoSelmin	human
@CurvesColor	org
@nathashajoseph	unknown
@Adgoggle_global	org
@RecipeSocial	org
@LorenzoMalin	org
@fionaoko	human
@itzbblac	human
@MatkivskayaDian	human
@waihao_timothy	human
@alba_pampin	org
@BenBenWinks	unknown
@gamerbabe419	human
@RadiantReads_	human
@six67seven	human
@JenniferBachdim	human
@meSayanti	human
@barbbs8	human
@YiM_YiiM	human
@JOE__11	human
@GrupoLounge1	org
@amanduhcampbell	human
@delicaciesfood	human
@sakae0225	human
@kevvyrowley	human
@Jif	org
@JessVanD_	unknown
@lahuellacali	human
@appetitemaguk	org
@meMHR1	human
@bowieSPY	human
@mssxnimmy	human
@septsawangrak	org
@scanky_chops	human
@unedanslafoule	human
@medserendipity	human
@ly0ns	human
@TockTack	human
@ElynMa	human
@sleepyblonde86	human
@DjuninSilva	unknown
@sapdxgifts	human
@Senalovesray	org
@MadameMariposa6	human
@andrea_busatto	human
@JuJuuJune	human
@clumsybunii	human
@Yunisimpel	human
@Yacarli	human
@clocktart	human
@sonnurduzgun	human
@HdaEncantada	human
@ICEEBEAR19	human
@BUNKIN_VIPTEE	unknown
@ARahmanMagdy	org
@melovebeach	human
@Zaferalpat	human
@BoyAbdullah5	human
@Cheererry	human
@dadongskie	human
@988DJ	human
@Mazeratie	human
@ZoeBakerPT	human
@SchnuckMarkets	org
@Jules8777	human
@AvenueStory	org
@girlietrash	human
@YukoFitLife	human
@MikaelaTralala	org
@jihye1805	org
@NeuvooPlantati	org
@COCKSUCKRECORDS	human
@fy0n3fi	unknown
@ModernTableMeal	org
@MoKenDoe	human
@AliciaCSingh	human
@Kitchen_Gossip	human
@JCazals	org
@SJE1981	org
@Xgaba_EmotiveX	human
@Lynsey_Lous	human
@thewinesoul	human
@NeuvooBuffalo	org
@MartaMCG	unknown
@PeckishPendred	human
@MissVictoriaLee	human
@kasmir81	human
@AomHeart	human
@TheFieldsPDX	org
@HeyyyAddin	human
@pip4fun	human
@tanyao5210	human
@reddawn	human
@BritGirlAliCat	human
@regla19	org
@kristi_kiti	human
@Pr3zKiD	human
@Amayzine_int	org
@yummymommygr	human
@dennistuanphan	human
@NadzreenHaziq	human
@ProsecoPrincess	human
@DestiPriyantini	human
@spinpizza	org
@Powline_L	human
@Pocivasek	human
@ovolacticagirl	human
@Lot1cafe	org
@AlexBevard	human
@Kaocha23	human
@nina_swirlzie	human
@sweetrosie12	human
@SirGarnetPub	org
@MonicaBeatrice	human
@Schuabb	human
@DashofSnP	human
@gabs_gollino	unknown
@jennylynda1	human
@papadellapastaa	unknown
@iamLadyK	human
@HudaALSo	human
@AppleHatsune	human
@mmm_mayumi	unknown
@HadyFerzie	unknown
@CardozoHotel	org
@JanKokLodges	org
@sonicahedgbot	unknown
@fleurdorange3	human
@MUAinParis	human
@TrendDeityGMATO	human
@timenty	human
@smolderlovato	human
@MTMDenToz	human
@griffberry	human
@LaskarinaKatia	human
@JDavison415	human
@AnniemationFloe	human
@intherainbowz	human
@Mitsuo_Ishihara	human
@HungryBuff	org
@BelBelony	human
@EsJay87	human
@BesterNJ	human
@komoriyuna72	human
@OpenTable_miami	org
@Hiphospitality	org
@xiaojie_shena	human
@ktbuchs87	org
@C_Pear	human
@Lex_Ploit	human
@WANN1996	unknown
@EosBuddy	human
@AlexBurchnell	human
@butterfly_muse	human
@jbgbuenosaires	human
@Tandoorbistro	org
@whesley22	org
@KorolPoli	human
@MsJ_Alexandra	human
@jeenaCheesy	human
@wagnerleitee	human
@secretshopperTO	human
@cityjoyce	human
@Healthybymleee	human
@macelmaki	human
@zarajaja	unknown
@JuiceBugjuice	human
@meatballonline	org
@omkitti	human
@NadineAmanDUH	human
@MelissaJBond	human
@iammikeegee	human
@Krisiku	human
@Miss__Peel	human
@DestinyBlaine	human
@andriluu	unknown
@vic_vinegar7	human
@KnittedHugsUK	org
@0129Ayrui	human
@_chenhee	human
@lattecosmico	org
@SakzoS	human
@meikandmauri	org
@CrystalSuicide	human
@Greg_Pomes	human
@jonassaul	human
@chriswong13	human
@RosewoodLondon	org
@phcjam	org
@WhiteMulberries	org
@kitoooy	human
@arpeeusa	human
@VBbbboh	human
@That_Whiteboy	human
@GilleanMSRD	human
@JaredTheJator	human
@_Time_Control_	unknown
@FleurdeB	human
@bomberlover	human
@dakki_16	human
@pluckingducky	human
@MrRainyCity81	org
@HelloDanielSan	unknown
@chokmanalo	org
@herbert0282	human
@CompagnoKoba	unknown
@kirstyboag	human
@MBHotelCT	org
@TonyNMai	human
@chefmodelactor	human
@RoosterHarlem	org
@moversnorthvan	org
@iamriza_27	human
@TheBluesKitchen	human
@FoodieDreamer	human
@Audilicious007	human
@Tish_Anna	human
@igging	human
@LRyker	human
@alessiamant9	human
@marguuh	unknown
@MrianRivraa	human
@ezzbez	unknown
@lewisnikki33	human
@EWetterwald	human
@DaRealMichiKING	human
@AndreaFCecchin	human
@gymrafitness	org
@I_AM_ELLA	human
@TheHeights101	org
@alxmondragon	human
@bland_rus	human
@firsterlaster	human
@FSMaui	org
@soraya1983	human
@ObstacleMaster	org
@zeroseven22	human
@cHalfyard	org
@tacovolution	org
@pippolimpionico	human
@RevistaMustique	human
@MLEMESHER	human
@guitar_nanasi	human
@bloom_ale	human
@MaxidaMarak	human
@PoisonInk_NM	human
@LobsterFromME	org
@annaebri	unknown
@PSluvLS	human
@jesseybautista	human
@DJTRAW718	human
@vcreekhealth	human
@ARossoGroup	human
@WildDuckRoad	org
@TheSpreadBagels	org
@yunoyswr	unknown
@JazmineSpirit	human
@DriaGrey	human
@KiiTTyy02	human
@romanticshannon	human
@subeezyaletown	org
@WeightStyle	human
@FysalMohamed	human
@caemzo	org
@MindfulChefUK	org
@fittie_nic	human
@CrimeSceneCandy	org
@KwoonMinji	human
@Beaaristiya	unknown
@DJCrucena	human
@juliashapiee	human
@A22DNAL	human
@pRincEssLyRa17	human
@slythachu	human
@CormoraniLoano	human
@GYMHEADZ	org
@ShakeItUpCorona	org
@axeanazmi	org
@june0623	human
@Jules_apps	unknown
@WeiYee_94	human
@ireemi_	human
@RenBcnFira	org
@MyTinyPickyeate	unknown
@marimoooon22	human
@M_Carroll1	human
@jame9627	unknown
@DIA2ILL	human
@YACHTINDUBAI	human
@lovely_bunny65	human
@Gigglesaway84	human
@DEMETTOPA	human
@Demul_	human
@dasbss	human
@johnphudson	human
@jessicacemms	human
@04FY10	human
@jessmeldrum	human
@debbie5784	human
@NutneeStyles	human
@PriMinki	unknown
@DonEmilioRD	human
@LaLaScoop	org
@alaraaslan	human
@haggerstonian	human
@yantiely	unknown
@aliengin	human
@MachMike	unknown
@jackwhk	human
@follabella	human
@jimmysegg	org
@Ion_John	human
@swimswithbricks	unknown
@DrinkSeva	human
@zzzeynepay	human
@TheSexyScorpian	human
@joymooiweer	human
@jeannehappuck	human
@Healthylunchv	org
@a3_xoxo	human
@altrinchamhq	org
@FortLeonardGAH	human
@fiolopez10	human
@NormaEscandon	human
@Pann_PJ	unknown
@hennydwibhakti	org
@seika_0901	org
@cfdc_nyc	unknown
@SBN_Croydon	org
@Paloma_PT1	human
@MarieLouiseBist	human
@awayfield	human
@sprattysgirl	human
@gbasalla	human
@Abi021101	unknown
@salaamlaw	human
@olasis	human
@YummiBanhMi	org
@72Wanda72	human
@AnotherHollyDay	human
@Eric_Kelley	human
@yasmofficial	human
@unicornshemo	unknown
@ariezistableSAM	human
@angelacakaapp	unknown
@DanDanTheArtMan	human
@mukul_07	human
@bibamaman	org
@ruchika83	human
@HelloGymFlow	unknown
@TravelMush	org
@8mitsurun	human
@hirochan_pon	human
@CAN_Serve	unknown
@Arianny_Eugenia	human
@queenbluxuries	human
@abyss_corpus	org
@reagan_samuel	human
@hairyhomo	org
@AgaFantastique	human
@ConsuCrea	human
@agnes_sim	human
@ZambiaRetweet	org
@CLCulinary	org
@ellaandanniemag	human
@ronaldflorido	human
@AnthonyMBurnett	human
@Katie_O_Connor	human
@SweetMolcajete	human
@stratism	human
@brettthebaker	human
@aldiwanbeirut	unknown
@MrRandyDutch	human
@Liddle_Middle	human
@tlopes260	human
@singlescookin	unknown
@nutrizionistas	human
@_hrhsunshine	human
@WVMountainShine	org
@NettyP	unknown
@wickedlychic	org
@amandaJohare87	human
@Flora_lfe	org
@Thelansdownepub	org
@reentiz	human
@masa_324	human
@ent_302	org
@AlexisB2007	human
@LUREIzakayaPub	org
@SOCOCollection	org
@whiteoakny	org
@YennyYM	human
@DevinJamesGroup	unknown
@azrinamar	unknown
@stealhless	human
@AlissaForte	org
@FedericaRasa	human
@Naty_Halou	human
@RothschildCLE	unknown
@fdoassad	human
@Southern1Living	human
@Lettyy013	human
@TakiaMcClendon	human
@purposefulrunnr	human
@kleiree	human
@anri_sz	human
@_KAREN_MACK	human
@TRUEGENTS1	human
@GCarcabelos	human
@CharliexLai98	human
@chadha_a	human
@kristifuoco	human
@Jemy_Martin	human
@reresuperstar	human
@nicholaseffendi	human
@CeeCeeCollins	human
@WEN8306	human
@armstrongpaul64	human
@yurichan2507	human
@NicoleHFjk	human
@ngantrung	human
@JASgivMeAReason	org
@Robshermusic	org
@Amy_Sue_Bro	human
@kurniawanariadi	human
@beautyshoutbox	human
@simonjames91	human
@RivahJordan	human
@HealthyHubs	unknown
@lolimiggi	human
@juliesexface	unknown
@BlackySandra	human
@Fontanilla30	human
@mj56499	human
@youanew	human
@bharatrawail	human
@Edzlande	unknown
@RedazioneSoste	human
@kenwoodoficial	human
@grabgabgrabgab	unknown
@JOGFav	human
@GIMICKS247	human
@natenlee	unknown
@LaiaSango	human
@SweetK4ti	human
@mackenzyquinn	human
@MummaFly	org
@foodboozeshoes	human
@RyanScyler	human
@panmitu	human
@LuxxeNailSpaLLC	human
@JDOLLA417	human
@SoldeuFocus	human
@DeMendozaAR	human
@andiCiCipurple	human
@RetrouvBiz	org
@wgdNY	human
@SuwimonK	human
@jenniefurry	human
@BBFelice	human
@CarlyThomson25	human
@janejustiiine	unknown
@patriciaamarboo	human
@FlorenceGazelle	human
@sya_ehoza	human
@itsdabitchnme	human
@Gastropark	org
@PeterGeorgene	human
@Carlos_D_Davis	org
@CharlottetownPE	org
@andzzsandzz	human
@ricleal71	human
@Melanieoscarson	human
@hellomara95	human
@handa_chua	human
@HummusHouseDXB	org
@Linkbiscuit	human
@SmithMaryanne	human
@BeyondCertainty	org
@irishraeeeee	human
@SasaSazaliM	human
@AlsAdventures	org
@miyuryuharu	unknown
@MINOTLEY	human
@TheNotedPieShop	org
@TheBiltongManUK	org
@tie_hukuro	unknown
@HealthCastleGlo	org
@eulbynnub18	human
@nisshan09	human
@TiyanAlile	human
@PabloUruena	human
@ChefBellec	org
@1_Proud_Dad	org
@Ocy_b	human
@miesharoshawn	human
@Vedazzling	human
@iamarcopaolo	human
@pawidpao	human
@CASanctuary	human
@tobertomenlu	human
@JustDwana	human
@shop_grrl	human
@ChrisCallow_	human
@AndreaKoid	org
@aerikvon	human
@sunshinecafe_co	org
@mangoabouttown	unknown
@GraySavgray	human
@RestiiiRULES	human
@hamzahalhabsyi	human
@JeanetteThorn2	human
@fyna5600	human
@femkedeschepper	human
@MrsBerry03	human
@ChennaiFoodGuid	org
@PapagayoMexican	org
@rorytothemax	human
@n64_mina	human
@D1Goa	human
@Waffles_M	unknown
@GiuliaPastorel1	org
@tikaphein	human
@walkerdoug	human
@ChaaarlUKBFF	unknown
@FDDailySport	org
@JihanKrisvianti	human
@LisaRojasSQC	human
@inouenaho1207	human
@BrandyClark09	org
@QueTaco1	human
@mari_piknik	human
@Moh_Ashi	unknown
@chriswatkins_	human
@Puddy_Nickz	human
@Jo_RDPT16	human
@JepSpotted	unknown
@kclugtu	human
@moutons_nuages	unknown
@semikoshereater	human
@ophdenver	org
@ExBiTioN	human
@SonnyAnnesley	human
@tragantate	human
@HermaCherrette	org
@LeonMckenzie1	human
@cookiesfms	org
@NickyAnderson5	human
@dailyRx_News	org
@JeannineOnTheGo	human
@Alcadimahotel	human
@oldelpaso	org
@Najnuj1	human
@tapasytintos_	org
@aurelieguerin	human
@Dana60339031	human
@CherryBombGirls	org
@xxniqx	unknown
@gooseandberry	human
@threewinks	org
@MagicSouthYorks	human
@DewiSubrata	human
@JeanALias	human
@ArticulateLit	unknown
@KeilaPonce	human
@Sk88queen	human
@Jade_Woody	human
@milprado	human
@rokstaarl0ver	unknown
@bouchra23994978	human
@Asterchik	human
@aunaja	human
@waynehulas	human
@Lakotaihl	human
@AnamaKiesha	human
@PracticalMommy2	human
@GrindGastropub	org
@NoelSolrac	org
@melanmendoza	human
@ullisw	human
@OMPCServices	human
@leaveamarktoday	human
@TravelCostaMesa	org
@Wilvel	human
@YTLovers	human
@GokhanKOSARR	human
@CityBlueHotels	human
@2Beautyfull	human
@kyaryuna	human
@SarahScaparone	human
@amberkblog	human
@FearlessSF	human
@NYDesignGuy	human
@srphrtm	human
@juancarmartin	human
@gabrielchen	human
@ActiviTEAshop	human
@Idea_Apps_Inc	org
@Ccitric	human
@7a_0604	unknown
@BethGrangerSays	human
@Paris_the_Great	human
@SisterBluez	human
@Annvies	org
@dbouchardet	human
@Ms_KnoitAll	human
@GillinghamTalk	human
@RetroGamingROM	unknown
@sibylrozella	unknown
@OnceUponASkirt_	human
@FashionCalgary	org
@danielle_fuchs	human
@sarah_emmett	unknown
@mcrippa48	human
@VanessaBueno82	unknown
@TiagoLimaBeta1	human
@LynnhavenOyster	human
@LeBlancSmg	human
@marianampolima	unknown
@DonatoAngeles	human
@TolunaQuick	human
@MeQuedoKidsMx	org
@drtazmd	human
@dbBistroNY	org
@goldiealoysius	human
@GeorgeJohnson33	human
@NTN24_espana	human
@brighteyedjaymi	human
@CokeHogan	org
@LauraCarbu	human
@DriveThruVegan	human
@ThePantryMumbai	org
@Jazzsaxaphone	human
@SweetGabyChef	human
@wiedtwied	unknown
@anaisabelopes	unknown
@Marylou1895	human
@JennySchulzz	org
@JudiCrowner	org
@_gogolondon	human
@Alisss_93	org
@lrjsmith79	human
@eat_tabla	human
@Jengpotski	human
@neckbreakinLYNN	unknown
@savvyqueen_com	human
@mistereatgalway	org
@realean	human
@meryemaslam	human
@JudyCcakes	org
@salebell	human
@LiaJadeRoberto	human
@bronsonchu95	human
@AkronChildrens	org
@_5qhh	human
@_881210	unknown
@Justicetavern	org
@AddisonWodder	human
@quakersteak	human
@FudgeeKaypee	unknown
@MavyEntCo	human
@ice_aka_matt	org
@bhur00	human
@__min_chan__	human
@ittybittyfiitty	human
@ajengkolopaking	unknown
@Eugee007	human
@MarriottBKK	human
@GinaPotter1	human
@eniarolaihsek09	human
@minimalgray	human
@syashaLOVE	human
@mihiro_109	unknown
@swirjomartani	human
@para_sita	human
@theporchwp	human
@sbr4evr	unknown
@Videcipe	org
@NoelleMandell	human
@TellDramaUK	human
@ChuckKerber	human
@Elle_Blink	human
@WayneOnTheTrack	human
@pizzapuffs	org
@cool_rascal	human
@BrainBalanceID	human
@Ariok69mord	human
@VirgineLKM	human
@FORelementsBlog	human
@cookiesscream	org
@supershakti	human
@kyuqqq	human
@ReginaMel	human
@LuViEELuVsFaME	human
@RichvanNair	human
@foreverkiko99	human
@passthetable	org
@MaryToldera	human
@manilaswagger	unknown
@HennaJosele	human
@giuseppepodesta	human
@NeuvooLubbock	org
@MonPokorna	human
@DjXavierRiley	human
@BallaroNY	org
@VeryVintagious	org
@silverbirchst	human
@Nathanielfriis	human
@LakenyaGraffeo	human
@HistoryandWine	human
@jolee_dee	org
@Bhujon_Dining	org
@PenguinHeidi	unknown
@JMCVAULT	human
@LouClarke99	human
@mammabigne	unknown
@dansvogue	human
@Story2Penquin	org
@carlitosparedes	human
@cicisylvie	human
@naomi1302_febby	unknown
@Berasmati	unknown
@ArtDesignPopUp	org
@MZuppetta	org
@SanDiegoPlaces	human
@iMegReyes	human
@AndreyVG	human
@Jolenemaree90	human
@gleni77	human
@glamorosa88	human
@inspiredEric	human
@Babo2Baka	human
@itstwentiifive	human
@buffybestcat	org
@tezza147	human
@cakeitupstands	unknown
@AlohaCafe	org
@letti093	human
@coloavidgolfer	org
@767AD	human
@GabCasagrande	org
@Jessy_Mars_87	unknown
@yovitayap	unknown
@DJ_Knappster	human
@alucyta94	human
@StevensAvila	human
@CoachMarieT	human
@DISCIPLINE543	human
@tetsu7jp	human
@trabauss	human
@paulafurd	human
@aretakis	org
@1st_In_Command	unknown
@eatinglondon	org
@anggaffandika	human
@ChrisMasses	unknown
@MarylouDeMello	human
@TheCyberMax	org
@ENailMe710	org
@Bigfoot_Bakes	unknown
@KissTheGirlz	org
@wyrdup	human
@LadyLovesBlog	org
@clubhotsauce	org
@doughraymee	human
@Dheoglorianti	human
@sydcampos415	org
@taylorsayworddd	human
@Auilda	human
@qchustle	human
@saffron_group	human
@camille_318	human
@AmazingPRltd	org
@bettyvandy	human
@MrsBruchie	human
@jamesalbertbata	human
@janadalecruz	unknown
@kingcafechicago	org
@jessez2080	human
@djshino507	human
@littlecarr9	human
@iluvfrijoles	human
@OliviaKEYS_aten	human
@utekkare	human
@vc_1202	human
@roselonger	human
@BullritosATX	org
@timelymoments	human
@maitakee119	human
@sranatsu	human
@__kntan	unknown
@Blakes3Beauty	unknown
@bere27	human
@UGURONEL	org
@Frabootylicious	human
@CosmeAurea	human
@AuThingy	human
@StyleNInk	human
@NhlaksZondi	human
@gigi_bax	human
@IHOPGdl	org
@churvalu	human
@azam_sra	human
@shhyvonne	human
@TheMatchMan	human
@indulgethemag	org
@beta_lopes	human
@Tina1807	org
@beatricegillego	human
@radiojosie	human
@elysiasegal	human
@tonysamia	human
@DemarleatHome	human
@theebritgirl	human
@lisianthushana	unknown
@brunettipizza	unknown
@nehas_1984	human
@brsodaa	unknown
@MavSayz	human
@nyami703	human
@VQ24hours	org
@TheHumbliess	unknown
@nnjastyle	human
@AndreaFDrumond	human
@nasrul2409	human
@FadiJano	human
@mike_m_50	human
@RudyFDF	org
@balaji_seo	human
@GreatSpaceUK	human
@MartynWilliams6	human
@sunflower1114	human
@HotelsDigest	human
@selinahnunez	human
@elvangoknel	org
@jacquemontia	human
@ohquietdear	human
@marymoraislima	human
@JaimeTheIsland	human
@Casketers	human
@jodibrownceo	human
@SohoSquareSharm	org
@GraceVirginieJ	human
@katvonwonder	human
@ArielKoalina	human
@Wooderice215	human
@megjunkyy	unknown
@1wellnesswithin	human
@AkashGrewal6	human
@sampinotti	human
@TinaErotica	org
@luca_lombardi	human
@emilyofnyc	human
@lilibaby82	human
@vidaorre_	human
@mcontrol	human
@agnilin	human
@TheFitMumma	human
@FriskyFengers	org
@Baines_xxx	unknown
@MsLadyMommy	human
@FolkloreLlc	unknown
@Ayliiinaydiner	human
@masayan1dayonnn	human
@Arighi_Bianchi	human
@Lilyspad58	human
@ShopNopal	human
@ichaMArisa85	human
@thestax	human
@cassuleSN	human
@Alfalfamlambo	human
@Healthy_inHeels	human
@_Mearmaid_	human
@dulcepart	human
@Sapphire1074	human
@sakura_mochiko	unknown
@KrunkTina	human
@AnotherEartZ	human
@AllShipsRise	org
@FriskaChicca	org
@iammikechacon	org
@QuakerIndia	human
@_MiXEDBEAUTy_	human
@SIMCOSABERHACER	org
@fowl2	human
@ChildRuby	unknown
@okjohngo	human
@LucyLafloure	human
@WingyPie	human
@missdiuai	human
@ValryLand	unknown
@laylabrisbois7	org
@EatingAsia	human
@jaybeeriv	org
@Nattalyee	human
@saltandpaper_	org
@zanoobaw	human
@andreeasoleriu	org
@Tk2Loner	human
@m_uonuma	human
@BBPRO_AmyConway	human
@cupid_kc	human
@idestroyrunways	human
@kenraras_	unknown
@SamAdamsBrewhse	org
@EatSweatSleep	unknown
@uneprisedeluxe	human
@imzakd	org
@BairesGrill	human
@SmokyMtnPizza	org
@TappyNovio	org
@dimitrisgk	org
@DianaBecerra68	human
@ZombieBarMadrid	human
@TradingVoyageur	human
@GOGOKOKU	human
@mathews_lara	human
@PecanCreekHou	org
@KiraMBates	human
@mojojojolx03	human
@TraceeRDN	human
@GotJodo	human
@Co_CoPelli	human
@MyMBautista	human
@WineStainedLife	human
@AnnikaRG	unknown
@BoldskyTe	org
@thecornerplace	human
@footnotesnfinds	human
@kiddiematters	human
@niclaselving	human
@nicafeole	human
@xaviguvi	org
@jessicacuff1	human
@LusiPangestu	human
@kevymac	human
@MassyPower	human
@JMEJROBINSON	human
@Ambitious__One1	unknown
@barmorris	unknown
@unprestigious	human
@starburstt	human
@juelael	unknown
@Candida_Tsasie	unknown
@MsFluffz	human
@boostbyslinky	human
@Fanggyts	human
@shitmybfsays89	human
@SnowbirdsF	org
@Marylandfanatic	human
@sobropizzaco	org
@MinFude	human
@summerbuis	human
@Romeo_N_Trainin	human
@cailin_slainte	human
@Nectar_Ambrosia	org
@valentidut	human
@papayaminions	human
@chimneycoffee	org
@beautynerd93	human
@MiliBaldoni	unknown
@remilai	human
@ovolo_hotels	human
@RoslinaOu	human
@MoniqueMay	human
@emilyalexmorgan	human
@MasquedFoodie	org
@davidkbaker	human
@thewebceleb	human
@colorsnewyork	org
@randiaditya	human
@Lay93_ka	unknown
@andremagda13	human
@kelvinkenneth	human
@Limoneira	human
@promixxmixer	human
@UpperParkChico	org
@ChacraLana	unknown
@5HorsesTavern	org
@charisegarcia	human
@Anqel_r	human
@chlorastrolites	org
@FreshiiColombia	human
@SSCYoong	human
@MOutlawrun	human
@EvyGonzales	human
@Sam5o5o	unknown
@ColeMarieMcKinn	human
@IntDesWellness	unknown
@gonchimontero	human
@PrincessRunners	org
@nansie	human
@ryan_skieh	human
@inakartika	human
@Cully445	org
@KevSoFlyy	human
@sherilynreedus	human
@syafinazm	human
@lima_janalima	human
@KoMoDoZide	human
@intansuehaini	human
@QiqiyoNyan	human
@ewabbott	human
@kathrynleanne	human
@goldenbustours	human
@JesusMnzOficial	human
@ElizabethSwaney	human
@angelgraceband	human
@tinacos	human
@LediniaGomez	unknown
@ooyamamaioo	human
@blog_mellelilly	human
@ChefMedinaNYC	org
@Yap_Kat	human
@SjokandShizi	org
@DJVirusLive	human
@wirandootz	human
@DollyJules	org
@Poetik_Lunat1c	unknown
@BowelOfChiley	org
@performing_zoo	human
@mkydmnky	human
@junhorpaul	human
@ChingCaro	unknown
@BigEasyLondon	human
@PauLin_DR	human
@tiffanysoper	human
@perez8484	human
@esquiredreamer	human
@StefanoSalt	unknown
@KristenJakobitz	human
@TammieHolland	human
@GinevraGibson	human
@Ameli4kinVladis	unknown
@ted_nghiem	human
@akikooo1	human
@jimhamilton22	human
@EmilyRecipes	org
@VeganPramana	human
@SarangeEka90	human
@lyricist_singer	unknown
@shookfoot	unknown
@yana_leena	human
@asos22	human
@freshistastiest	org
@sefilomeo	org
@AlisonP__	unknown
@rustictablenyc	org
@valenzuela_mrs	human
@DisneyWorldPost	human
@Dpetites	human
@iamAnnFaithful	human
@Roscoedash	human
@LoveAmalfiCoast	org
@Imashin_NYC	human
@Madinaa_Cisse	human
@ayaka0119v	human
@RedCatMitchell	human
@Airport_Food	unknown
@gaygigga	human
@ZuwarRest	human
@ako_turtleholic	unknown
@CentroBarsha	org
@AnaPaulaRabula1	human
@IanIvanCsy	human
@_stephmatthews_	human
@pacoibarrapi	human
@namasvishah	human
@MrPico65	unknown
@La_Gige93	human
@lovingly_beth	human
@MoiContreLaVie	human
@HVillaPadierna	org
@sensationalviv	human
@emmylou1290	human
@maczarr	org
@jc_macs	human
@Travelscultures	human
@katias	human
@carpcrusader188	human
@chefsethraynor	human
@drldsza	unknown
@Phinestro	human
@missklayre	unknown
@KDCLasVegas	org
@InnontheTwenty	human
@ErinMurphy04	human
@SaywordStaz	human
@Lollinski	human
@GoBuffsio	unknown
@Lashays_way	org
@_liveloveshop_	unknown
@LozEmery	human
@Cubanica	human
@suzieo1	human
@RoseNobs	human
@jillianskitchen	human
@Arkhangael	human
@abusm2	human
@wan_nam	human
@rai3117_ana	human
@supperclubbing	org
@ima_assiak	human
@sunissa87	human
@IdoiaCasanova	human
@angiecring	human
@IKettell	human
@SignalGunWines	org
@DeadFrogBrewery	org
@90Yayan	human
@taniamercer	org
@GantzShop	human
@ZesteezLLC	human
@AdrianaBraje	human
@EmJ_LaDouceur	unknown
@hayleythrifts	human
@KeiAmber09	human
@OhSoTY	human
@MadeByWater	human
@johnjamieadopt	unknown
@bird_stp	human
@y_u55	human
@LegendaryGaza	unknown
@TachiraGourmet	unknown
@pennyjira	org
@sarab_en	human
@WasabiSushiCen	human
@yaniyosephine	human
@xiiaonee	unknown
@DownRoyalMaze	org
@Color_itRed	human
@Booshette	org
@solised	human
@jaygrantno1	human
@ship2volk	human
@nightlifelink	human
@edlittleman	human
@AnnaKatrina_	human
@FoodyMoodie	org
@hbndavid	unknown
@Beauty_FuLL_bEE	human
@SilvyFratini	human
@youzeff47	human
@tywynn	org
@VectisPhoto	human
@theparticular	org
@josephalvindj	human
@AidanNg	human
@Cyclingpeople	human
@FJ_KRUSH	human
@RaginAzian	human
@Cafe_Tesoros	org
@LivLunatics	human
@BecciV	human
@jose_lara88	human
@EthosMezeNY	org
@Seftonhour	org
@JulienWatterlot	human
@twisper_travel	human
@jonpollavalle	org
@WPlannerMexico	human
@gleekswift09	human
@Slimming_World	human
@WFM_Woburn	org
@spiceksa	human
@nicoleperr	human
@jamjiro	human
@Joely_kau	human
@takanalove	human
@Reyes_Tomas	unknown
@Dj_Absolute876	org
@TangoNuevoTapas	org
@gumballz81	org
@geecolovesu	human
@ShopBottles	human
@oshoneezy	human
@Anas_tanlim	org
@StramelPR	human
@TimRodriguezPH	human
@emmacoleman64	human
@VOLumeCANOn	unknown
@all_giggles	human
@ds_ojan	org
@AmericanSardine	org
@grandted212	human
@ADRENOX	org
@Parts_labouruk	unknown
@salascarl	human
@AllstarDemian	human
@LovliestOfWomen	human
@WebbJaneen	human
@ObbiOlan	unknown
@AzariaCouture	org
@MrsJahari	org
@cookingweekends	org
@svcnbjk	org
@charljackson17	human
@EmreDicle	human
@seeto92	human
@KatHeartsJJ	human
@_jackbatera	org
@JessicaPerigny	human
@StephFHoskins	unknown
@Shipleys_Donuts	unknown
@OlleLofgren	human
@teenfitlife_	human
@DPavelich	human
@MZdbBABii	human
@MarikaSemprini	human
@niketaben	human
@NatalieBellBaco	human
@DimaSharif	human
@imranrobles	org
@LocalMel	human
@NovSuryani	human
@robertogentile7	human
@chalala_name	human
@primarilypaleo	human
@SimonSidhu	human
@czerwony04	human
@gofasterfood	org
@glorybeful	human
@dacydowiwup	unknown
@NelwasGelato	human
@j_peeh	human
@akticubby	org
@kendra_xox	human
@ChefReuben	human
@BangOnWestern	human
@berlinveganlove	org
@TukimDhew	human
@briannacolette	human
@snickles_x	unknown
@iamcaaarl	human
@Basak76	human
@YoshiokaSachiko	human
@modakolik	human
@YoungNative1491	human
@fioangulo	human
@RobsMusica	unknown
@Katie____Taylor	human
@maya104x	org
@SpiceGirlPR	human
@KimMichels	human
@HAnNAo16	human
@NourZibdeh	org
@SalmanAlfaridzi	org
@geraldwafu	human
@StievenAndreas	human
@TocksTick	human
@Alyhanhaa	unknown
@beej_cee	org
@vintage06	human
@Iceziz	human
@CharlesGiaimo	human
@MarylandLover	human
@scoobydoo33198	human
@kotarosaito1211	human
@Hanelyncamay	human
@KaizenIzakaya	unknown
@chrissylenguyen	human
@TWCNewsAlbany	org
@JGloverArtist	human
@Bowdon76	human
@suffolkfoodhall	human
@thefabrack	org
@GotVegan	human
@MeekMillos	unknown
@deborahcraft	human
@GrubaskawMM	unknown
@djmissnine	human
@cindi1601	human
@CakeFlour	org
@DncbbX	human
@Vivi00720	human
@MIU0914	human
@girl_organized	human
@Leli_V	human
@LA_Hutchinson	org
@TrenchBabeFFI	org
@tranchedepain	org
@kikij4y	human
@Stephyd07G	unknown
@mortimer96634	human
@ReixaCamacho	human
@AinaJongman	unknown
@AErikson13	human
@SoPRnl	human
@Chez_Margaux	org
@littlebean28	unknown
@AmbarElie	human
@petroordeep	human
@KendallCovitz	human
@god4bandme	org
@suzannah_lucia	human
@EatandMeetRest	org
@lyi95168	human
@Amy_Vicki_White	unknown
@Realmarkmallari	human
@frozendurian	human
@Fitbritsc	human
@carolinemayling	human
@No1Jarlsberg	org
@tammy888	human
@CherylsGlobal	org
@ayeshaken	human
@themadeleineg	human
@visitourtown	unknown
@alex_koh123	org
@alidabdul	human
@May_Ramirez18	unknown
@J_AlHammadi	org
@TobySchneidauPT	unknown
@jtcf_1981	human
@viasantiago	org
@Tonnello	human
@OlivarezOshea	unknown
@jabusfield	unknown
@furkidzdad	human
@GastroTwins	human
@LauraLuz5	human
@fionasimpeijun	unknown
@crayyzee	human
@thewriterMonet	human
@priyam_c	human
@borly	human
@learningtofloat	human
@TeruJugo	human
@BlendaCoull	org
@KittyBradshaw	human
@TajPalaceNewDel	org
@BriaaRoot	human
@GratefulGut	human
@NEzwe	human
@jjamesontime	human
@RobPengson	org
@ZandyleMabika	human
@jefftothefuture	human
@aylLopez	human
@msflyty	human
@em_lovelifejoy	unknown
@queenamorb619	human
@Hero2dom	unknown
@msraywilson86	human
@anneyasamsitesi	human
@smsoulfood	org
@emilk517	org
@penguin_big	unknown
@shvasaa	human
@KarieEngels	human
@jeyarsi	human
@jen_ingui	human
@shoeboxstuff	human
@birdsparty	human
@AnnaNayyar	human
@vbaltsanova	human
@TLAlanaHerrera	human
@Hellococoakitty	human
@MONOCHROMEinc	unknown
@esucuadrine	human
@Ricsonkoo	human
@ShinyHappyClub	human
@AntoCartOneKir	unknown
@LexiGelo	unknown
@Chima_Charlotte	org
@WeLuvMoms	org
@beardedbern	human
@Haribhoomicom	human
@sarahkostusiak	human
@adityohartono	human
@DariesDish	unknown
@AshleeSade7	unknown
@FABYORKCITY	human
@hollylpclark	human
@maarianaup	human
@Dancing_Moose	human
@myFidhaa	unknown
@Slim704	human
@Joslovesfood	org
@charlesmopoli	human
@RabekahDamarah	human
@Xazurim	human
@ShiningWs1	human
@HeiressRomance	org
@MarinaGistau	org
@simonotstreets	org
@vikyvictoriavic	unknown
@_AlyCasagrande	unknown
@savorysweetnyc	org
@CookieBeib13	unknown
@cuochivolanti	org
@thecyprea	human
@gfillonramos	human
@AlonsoLioneth	human
@C88cCHIARA	human
@mg_perez	human
@MikeTemloo	unknown
@HomeSweetYum	human
@EmmiJonatic	unknown
@LoverEchelon	unknown
@Milespope92	human
@eatpraylovePHL	human
@vermilionuk	org
@GabrielGorgan	unknown
@drenthotels	human
@94_pit	org
@maherscoffee	org
@tieu_mario	human
@iamKenylyn	human
@merveeyurt	human
@hilraiser	human
@susanfkeefe	human
@SMILEY_AC	human
@memocirco	human
@AmyEBarrow	human
@PurplexRocks	human
@asiamodels	human
@AnnaBanana_x3	human
@TheCoronette	org
@allisonjules	unknown
@JoelYeung	human
@Klangbox	unknown
@lovefromlisa_	human
@yuikoro514	human
@EmilyCanBake	human
@aum_portlygirl	org
@Aboutzz_J	human
@1MediaStudio	org
@GiftGorilla	org
@rztia	human
@queen_bex87	unknown
@KezziesCorner	human
@Coco4spiration	org
@farelle273	human
@ReneeKellys	unknown
@minnieeve	human
@Esmeralda_Med	human
@Ishaaa17	unknown
@EDGARDOGARCIASA	human
@jennmetcalfe_	unknown
@Mar_MarFlores	human
@Tiffanikarinda	human
@unicornbeauty	human
@milarosinta	org
@jhennyhabibi	unknown
@SamanthaMajka	human
@DOCisChief	human
@xica1946	unknown
@SarovarInd	org
@BigE1783593	human
@dracoharufoy	human
@DartsFarm	human
@allealexander	human
@RockettStGeorge	human
@__s0127	human
@Torialou78	human
@jtpang	human
@TourAscension	human
@AnjaniLadki	human
@dreaxog	human
@moejamal91	human
@MoooRestaurant	org
@Mica_Mihaela	human
@RosalieWilson99	human
@carlacecilie	human
@rapo4	human
@ActualHotGenii	unknown
@GoWestGal	human
@ViBE_ub_orang8	human
@Put3Aleena	human
@ziafmihar	human
@keikbarcelona	human
@MatreshkaCats	human
@RABUTA_	human
@a23357989	human
@spencebakery	org
@KapowEvents	human
@FabisVieEnRose	human
@_wholefoods101_	unknown
@chemese	human
@phmns51	org
@FitFluential	org
@alex_uziel	human
@DrBullyCom	unknown
@chocochocowan	human
@shero4hire	human
@PAWmckenzie	human
@CoreNetChicago	org
@Angelinat77	human
@iNdepthPhoto	human
@Sweeetlady_89	org
@KiNGOSiRiSFAM	unknown
@LoganHeightz12	human
@BetoCarcagno	human
@Arohchan	org
@KassabCarla	human
@EchelonFoods	org
@YevP	human
@ThereBrookhaven	org
@shaynaelika	human
@kissyfurpillow	human
@daliavicente	org
@yoshihikoa	human
@TWF_Ewer	org
@Muhd_Huzaifah	human
@Joekimson91	human
@TukTukTapRoom	human
@OakBrookHills	org
@itsmejhayD	human
@DestDelicious	human
@lelaniblack	human
@martijnkolkman	human
@welliamCHLG	org
@CharmanderRoar	unknown
@paddypower9000	human
@NicolePugson	unknown
@candicesullivan	human
@themapetshow	human
@deer_haven	human
@bosco_sara	org
@picassospizza	human
@KadenCore	org
@Sarahdrofn	human
@mmuadzam	human
@andreadecas	human
@MehreenSultan	unknown
@nunnanicke	human
@marquez_wil	human
@Auchan88	human
@ZayconFoods	human
@OuRiFox	human
@RK2299	unknown
@CherryLover_23	org
@oliviagumienny	human
@SeverinStone	human
@AlbertJrCordero	human
@Ali_Markt	unknown
@Brothers2Rest	org
@managementexper	org
@stridvega	unknown
@kencurte	human
@sandeepbahl	human
@Katiebbloggerx	unknown
@SuzyPelta	human
@IRun4Wine	human
@AmyGreeny	unknown
@luvcarlton	unknown
@lala0581	human
@SitiNurSuhadah	human
@Meng_Hsuan	unknown
@Glos365	human
@7GI75	human
@apennyfortea	human
@Tbones1982	human
@OfficialSPAMUK	org
@jessicasays__	human
@MariaFrangieh	human
@Parnellisthat	human
@foodaddaindia	human
@doeeyes67	human
@TheLawrenceATL	org
@SamanthaClow	human
@amileeyvonne	human
@PakiTangorra	human
@FutureDrCin	human
@isinsusavas	human
@Love1430M	human
@GreatAmFoodLV	org
@neatlife	unknown
@misZviOna	human
@Deej02	org
@maricel0319	unknown
@southwestdayspa	org
@LucyintheLarder	human
@ElCoyoterest	human
@HeNhYY	human
@samuelkirana	unknown
@RepeatPo	org
@bigmikesbbqnc	org
@OsamaKarawi	human
@roshiokkz	human
@lench40	human
@georgiashire	human
@KidsSafeEmail	human
@carleycoe	human
@syrious89	org
@HomeCookMemory	org
@Golaniii	human
@Salmanhmrd	human
@dsaleist	unknown
@EsmanianWarrior	unknown
@actualitymarket	human
@mariJADE1989	human
@jacobsinn	org
@TuffyPoo	unknown
@cutiericancuban	human
@The_ItAlien	human
@Urfavbob	human
@Tepharodriguez	org
@Taikaa01	unknown
@AHUIDOR	human
@ChrisKirouac	human
@harleyquinn103	human
@RomanO_0	human
@lookatfood	org
@FLOliving	org
@golinaveena	human
@johnlgrossman	human
@Deepika_Garg28	human
@daphchiodi	unknown
@WinnerDelta	human
@PelicanCafeBar	org
@annepredictable	unknown
@nantkb	org
@kathilicious88	unknown
@92shivi	org
@HvaalStreet	human
@LazyWholeEats	org
@sitayulistiani	unknown
@SolarSignSupply	human
@kozy2000	human
@karaullo	human
@ReanaMK	org
@TheRealEnzooooo	human
@KSchlossDiaz	human
@SoyConnection	org
@NAEPRETTY_1	org
@RsNadhir	human
@JelfVhon30	unknown
@ainunZN	human
@BocconcinoUK	org
@ItsMrzBieber_Yo	unknown
@PaulCBrunson	human
@RizzyBizzy	human
@KingBlaze138	human
@sihzuo	unknown
@GabrielMurgas	human
@dilanipieris	human
@carnalita01	human
@SilverspotFilms	org
@BostonJMartin	human
@tejas91083	org
@PtownDotCom	human
@rapheydhillo	human
@bajanqueen02	human
@Pierre_Nijhout	unknown
@rs8703	org
@magic828	human
@AskMsAutism	unknown
@creamhubbar	human
@rizkypranedya_	human
@nuralyaamirah	unknown
@rainbowcrush	human
@trisnoOo	org
@ilovexx15	unknown
@DeeGeeMusik	unknown
@allmunch	org
@zeppy_baby	human
@leslierouach	human
@tyansasha	human
@ChrisCastelonia	human
@BunnyNPorkBelly	unknown
@CharlotteLSM95	human
@Oscar_Ivann	human
@Junk_talker	human
@souvlakigr	org
@LorenzRuiz	human
@Kristy__78	unknown
@Berry_Boy	unknown
@mfcarbajal	human
@NPCCSMITH	human
@Summergirl_Yui	unknown
@ningzz2014	unknown
@judithsbooks	human
@DJJustNoize	human
@marinastanley	human
@JustHiHeels	human
@stthomasbcs	org
@goodasfr3shboi	human
@123chelbell	org
@EHSausages	human
@MichaelDABtree	human
@wistfulprincess	human
@healthylifekids	org
@danishcanadian	human
@Nikkipuenttes	unknown
@Verycocoa	human
@beckjanewest	human
@LovingKels	human
@barton_david	human
@JustKeyana	unknown
@waitressdotcom	human
@dabipalma	human
@MyrtieStarke	org
@Ericka087545	human
@DreamDelights00	human
@Ch_andtheCity	org
@RanoomG	human
@JoshinDubai	human
@Evelynyap11	human
@Stephanie300674	org
@delafuente1440	human
@laurenpwillmot	human
@Annasully17	human
@IsafoldBistro	unknown
@SkiniminEnt	org
@realsabrinacat	human
@SHOPLOEIL	unknown
@AlecLobrano	org
@accidental_tt	human
@IFitUFit	org
@herberttunac	human
@LIVERPOOLjakie	unknown
@innov8tivmag	human
@TonyaGolightly	unknown
@AmyHCross	human
@Denouncement	unknown
@WRGatherGather	org
@AimeeRosewell	human
@dyaNRuKKa	human
@SexBinge	human
@Bru_Mog	human
@8863Shyma	human
@angelaxPIERCE	human
@delhibhukkad	human
@AldrichHouse	human
@ivan_temelkov	human
@shukriabdullah	org
@jennifer_dawn15	human
@birdslikecake	human
@PastaeBastaLndn	org
@IlCieloSanibel	org
@alisoncrocker	human
@bradleyjohn91	human
@tplugge	human
@D7events	human
@victoriamfailla	unknown
@ScrappyMamas	human
@xmollymaex_90	unknown
@Safari365	human
@TumblegumBake	org
@DaRealPatrickP	org
@eLy_sheen	human
@EpicMedClinic	org
@Susan_Serenity	human
@fundagirgin	human
@TravelGumbo	org
@Areston19	org
@Royal_Shopper	org
@primmz	human
@SophC_17	human
@4thWall_Belfast	org
@nealberk	human
@todoinhalifax	human
@PinkHeart623	human
@Arnaud90210	human
@UltimateDining1	org
@makenawlt	human
@Hungrymoomoocow	human
@712Chisato	human
@imstarim	unknown
@nuituptim	unknown
@MeeToYouFitness	human
@EveHitchener	human
@kookidee_nl	human
@NutritionLives	human
@Destawafdaa	human
@madeli_ne_d	human
@Stavis_Seafoods	org
@shoegirlinDE	unknown
@Hakura	human
@IndigoHerbs	org
@thepeach115	human
@HeritageLifeFit	human
@Greg_Barth	human
@JMD365	org
@ivorytable	org
@oferernar	human
@SocialMinaD	unknown
@ElyBelli	org
@Adesso_Bistro	org
@TheTroyReport1	unknown
@momsnightoffdel	unknown
@DG0205	human
@K_Almahmeed	human
@goldentruffle	org
@LarryLagman	human
@AbbeLew	org
@sebsalnic	human
@kittylover1313	human
@Aaaalem	human
@JC4ItWorks	human
@tjianx	human
@torontoalumni	human
@ludwin_love	unknown
@Phoenixpowerp	org
@jeremydelaroche	human
@Miss_C_Marks	human
@DevonRoseMeats	human
@princess_shellp	org
@Wika_Kusmira	human
@TheQuecheeClub	org
@Titi1211	human
@arclarambla	org
@joshyymoon	human
@goodiefrappe	human
@we_Eatmore	org
@Blynnsav	human
@Phoebedenise	human
@IvonneSuncin	human
@johnygleeker	unknown
@ZakirHakim	human
@hernanes85	human
@Aurora_333	human
@DairyLane	org
@syuhadafais	unknown
@NantaiseAParis	human
@dabida	human
@CMLobsterATL	org
@WillReyna89	unknown
@TimeWithThea	human
@HomeDecoration_	org
@dinapauladuarte	human
@BlazerBC	human
@OnixJihane	human
@CRUSTRestaurant	org
@wichoivan	human
@didsburygav	human
@Hot991albany	human
@ferginthe_sky	human
@GezelligeDDate	unknown
@bobbinoodle	human
@msrbookkeeping	org
@evseats	org
@MrGreyWeathers	human
@Indulgence_Cafe	org
@LucasRey_	unknown
@Novan_Tristan	human
@piyasarkar11	human
@winetimesCG	unknown
@kookiHS	unknown
@prettylilworld	human
@winetimesNG	unknown
@primetimeparent	human
@itsjust_fika	unknown
@fransischaca	human
@LOCALSoCo	org
@marktebbutt1	human
@ThingsinReview	human
@jayceeluv	human
@TheMintMag	unknown
@ElaineHardyFit	human
@YoursTruly_Rose	human
@danieIa_cbr	human
@paiedles	human
@FifteenCornwall	org
@neeymondares	human
@delvichiq	human
@romainbets	human
@DoTheBurgh	org
@FlavourHunting	human
@ineminnemutte	human
@edgarestevez	human
@klausing_alyson	human
@VeganBohemian	unknown
@XocoChicago	human
@Tee1404	human
@xkrisnovak	unknown
@kiahthediva	human
@KaceeandCeecee	human
@Youngmi950122	unknown
@CamiiWinchester	human
@ThaReal_AMJ	human
@alerseixas	org
@jennykarpenko	human
@ShielSf	human
@ContiBeatrice	human
@fannie_widjaja	human
@RaiiMichelle	org
@ShaiUnfiltered	human
@winetimesAO	unknown
@IAteMtl	org
@MrTotoQ	human
@umerfaruqansari	unknown
@peithius	human
@Diversetfb1	human
@pseei	org
@LesBatignolles	org
@sutluukahve	human
@lyngdong	human
@bala021172	human
@mayaharun	unknown
@saraidylla	human
@BreadChefMark	org
@foundinparis	human
@artoaky	human
@Kerrie_Leigh	human
@DoraDistributor	human
@Samueld_999	human
@7October	human
@GenOlivier	org
@shiphrahgalz	unknown
@carlcuare	human
@SoniaPunjawani	human
@Spotlight921	human
@primalsoupcafe	org
@gastroladelizia	org
@Kenialissette	human
@Grace_h11	human
@itslyndell	human
@Gabrielle_Paris	human
@BaarahK	org
@KharissaForte	unknown
@BexSaunders7	human
@pafpotamia	unknown
@TasteSenseSA	human
@ofertasbarna	human
@TheBrookeMullen	human
@Shhh_cret1LOVE	human
@jhwphay	human
@Narelle_NZ	human
@phuongchicks16	org
@icklebristol	org
@MogulnaireBlog	human
@BUMpkinJody	human
@f13084	human
@miratorres	human
@humihosokawa	human
@Deniseyland_	human
@Pears_India	human
@kesohekifahaw	unknown
@aboutcomhealth	human
@ShannahCarr	human
@Andiplse	human
@arin00	org
@mspengu	human
@avecdessiblog	org
@massa_cui	human
@DontBeefWitNeef	human
@Mabululoluis	human
@runningandrew	human
@prisci_tweets	org
@mlofenfeld	human
@MissAnnaBannana	human
@eddesandsgroup	org
@RTrollblad	human
@aliasgrrl86	human
@rltor_prn	org
@1FaceByGrace	human
@magical2727	human
@714media	org
@JanuaryDC	human
@dUniverseOfDee	human
@nyta_mylove	human
@designerbodies	human
@naninuneNOVI	human
@HiltonFLLBeach	org
@hickorykitchen	org
@gorkemdemirdag	human
@BigHubeMusic	human
@lovmann7	unknown
@cicikha	org
@RossanadeMata	org
@senangmemuji	human
@Pee_Emdgreatguy	human
@VidhyaNair5	human
@JoytheJRPG_Geek	unknown
@_coreywhite	human
@Uniqu3ByRebecca	human
@JayDeeHoneyBee	human
@lastnora	human
@schnydi	human
@munch_bites	human
@hannah031891	unknown
@Bishopsgatemkt	org
@a1515i	human
@FrancescaFoxy	human
@EarlUyDX	human
@jaxsaid	human
@LandingResort	org
@chequersorwell	org
@DesParisienne	human
@bagatyou	human
@RobynKuhn	org
@CoziFamily	org
@Joynture	org
@shainasandoval	human
@nikkiw76	org
@Pooh_0426	unknown
@CeresPR	org
@die127bpm	human
@japzrocha	human
@just_me_ida	human
@SepulvedaMorse	unknown
@goaliefan1973	human
@HerbalistBarbie	unknown
@Kellyluxe	human
@AlbaniaNewYork	org
@zohefelici	human
@tenorbuds	human
@Taz_vi	human
@anomiseditrix	human
@ashleemariecake	human
@KayRM	unknown
@ManjaTiqa	unknown
@unclejuliosatx	human
@lharmeish	unknown
@SyamsulR_Waters	org
@Omnamashivaya12	human
@Rei19911110	human
@pria0412	human
@durgashrea	human
@Valley_Cali	unknown
@RushinaMG	org
@Oatz4Real	human
@debbiemc18	human
@rbellz	human
@ivivek_nambiar	human
@iowafiregirl13	human
@raletachanel	human
@AlonShaya	human
@BridgeStWrittle	org
@KamranGerami	human
@B7SSN	human
@SavonaScarsdale	org
@AlexLlana_	human
@tarcsafalvi	human
@FMeatball	human
@Hottesome	human
@gedcarpizo	human
@kkKatiiee	human
@spicy_shop	unknown
@wyldwomanmedia	unknown
@xiichamitalubsu	unknown
@pakdramafans	human
@SelfCareNLove	unknown
@StefTheTICKET	human
@TheRealMDares	org
@GuinaelleMatar	human
@YUUMI_ISHIDA	human
@amyhoards	unknown
@AMcLeodPhoto	human
@noughtefood	human
@carolina_bin	human
@MashUpplusEn	org
@MaryOOxendine	human
@Sarahemilysays	human
@GossipCelebNew1	unknown
@cjshiho	org
@FrenchGirlGuide	org
@joshwilliams802	human
@1RochesterGroup	human
@KitchCrusader	org
@Avie_N	human
@myweeklytips	org
@Sweetness_12	human
@aangie26p	human
@Austieb7	human
@kate17_kate	unknown
@JessiaMorland	human
@miles706	unknown
@MariannaChalk	human
@ChefMikeDeganis	human
@BeCoconut	org
@tastymontreal	org
@DAC_Detroit	human
@allthingsmayo	org
@Carol_Raval	human
@ChristinaLala	org
@TracyKHilbun	human
@ayu3088	human
@jussenie	human
@ChateauViand	human
@CapeDiningGuide	org
@BakersRibs	human
@JelainePJ	human
@IamleevanGalace	human
@Sanjay_Praja	unknown
@PJRasmussenJazz	human
@Hawaiiexpat	unknown
@Essenblogger1	org
@UshudntDunTht	unknown
@StylishIqueenah	human
@debora_cheregi	human
@NinaSever	human
@tgfablog	human
@belleetamour	human
@iEpsom	human
@kelly_yeager	org
@m_mksk	unknown
@pilar_ruizR	human
@joeylny	human
@Quandoo_tr	human
@alexlhunt93	human
@thegastrogrill	org
@CASSIEowoc	human
@iam_epfi	human
@sami_tweethart	human
@dogdap1	human
@brit_g_thomas	human
@Amanziliverpool	unknown
@FanyPonytail	unknown
@LesterChung	human
@FaithEinhorn	org
@fan4photos	human
@SpideyAndrew	unknown
@PKBABY247	human
@ficallan	human
@KayPort11	human
@WalMQ	human
@lullaby_of_dark	human
@ShortyC94	org
@jalormee	human
@whatjanesays	human
@ParkerRvrGirl	org
@hello_tinge	human
@LouisaBrownSoap	human
@comotion4u	unknown
@slparkel	human
@SheizAStar	human
@blondemoma415	human
@nats_cr	unknown
@Le_Jen	human
@CholitaDessert	unknown
@crueltyfreemt	human
@ottoottowa	human
@Isabell81305181	human
@KillerBSharp	unknown
@maaaaaanaaaaa	human
@Gourmet_Gab	human
@jrrchilders	human
@Faizal678	unknown
@justynkoh	org
@PioneerPartyGif	human
@AlDiarHotels	org
@commonsenseands	human
@IstvanEnyedi	human
@PadgettOphelia	unknown
@Mariang19	human
@Giaz2000	human
@FreshDineLLC	human
@BMoore734	human
@DFCafeBar	human
@hoopstar37	org
@JulieDuffy4	human
@ICSafety	human
@jnery	org
@spacesuithelmet	unknown
@Rucion	human
@JustJoanBags	human
@feliciachian	human
@pyrosamcox	human
@alergic2vanilla	human
@leptoo	human
@recetasadelgaza	human
@thirstmerchants	human
@WTFDudesh	human
@BloggerBees	org
@NikiBThatsMe	human
@popsugarau	human
@IPreferLemonPie	human
@clare_sparkle	human
@LePetitFour	human
@hayderalzuhairi	human
@jennacarlson	unknown
@ESColSprings	unknown
@karleeov	human
@SFL_Fitness	human
@ABREGAN0	unknown
@NomadPizza	human
@TFCcatering	human
@mikemfifty	org
@LiveLikeTomCom	human
@BeckyatGUNIHCC	unknown
@jasmoxie	unknown
@foodobyte	human
@BigPetesBurgers	unknown
@TavisLau123	unknown
@jaynefoo	human
@joveeyang	human
@BoulderEatBeeps	org
@lesliedaniels	human
@hakimkeemo	org
@PetesNS	org
@ONLY_EDITION1	human
@Muller21	human
@b_goodbread	unknown
@_LisaLeonard	unknown
@Aventrous	unknown
@keyme94	human
@DenverBiscuitCo	org
@AnthonyRktm	human
@tokipepsl	human
@Nongskhaomangai	org
@Mohd_Ali84	unknown
@jordanmaria2186	human
@nickOramirez	unknown
@SvelteLiving	unknown
@VanNSTourism	org
@NLMKART	human
@staceypluke	human
@SweetVanLoan	human
@sharnizashafie	human
@marielevine	unknown
@63johnJ	human
@fitness__barbi3	unknown
@casey_awesome	unknown
@lawflores	human
@JohnKhenChuan	human
@_GeeWhizz	human
@Samantha_Riepl	human
@MissTorrriBaby	human
@tastykitchens	human
@dioadamara	human
@smoothrider14	org
@MaroushBakery	org
@TheBrambleBar	human
@yhai	human
@2fahadalmutairi	human
@Chebadass	human
@GiraffesCanBake	human
@BSpielwiese	human
@nanacom_xx	unknown
@trixilla	unknown
@vCenterNerd	human
@theskinylife	unknown
@REIDSRestaurant	org
@HateMe11378663	human
@ThatCherryYeshi	human
@VisitSLOC	human
@pjayadipura	human
@mjuligalli	unknown
@TheSoccer_Mom	human
@tarabitesblog	human
@TryCaviar	org
@fishladsgr	human
@bobble84	org
@FunnyCutAnimals	org
@cat_faith90	human
@trevorpaxton	human
@H_Abracadabra	human
@Still_Flowing	human
@AdeleYuboco	org
@JB30_52	org
@ChefMattHarker	human
@VIBE_ub_berry8	human
@makotofalcon	human
@Sp0rts_junkie	unknown
@BrendaPerrott	human
@AllieCrimilde	human
@gabbieteixeira	human
@NicelyNeurotic	human
@Bikingcrew	human
@edibleAllegheny	human
@GlensWorkshop	human
@AmixStore	human
@MzSuZee	human
@JamaMannick	human
@caseyliew	human
@rickyrob	human
@custard_art	org
@OmiCaramellas	human
@glampaula1	human
@EuropaFloridaRd	human
@HealthWithBecky	human
@sofiamentakis	human
@KatakanaSushi	org
@Pizzafiocco	human
@melrosefam	org
@RareEarthGF	org
@ninatimm	human
@liammbriggs	org
@TheSlimGoddess	org
@aritarded	human
@Kara_M_Smith	human
@sunofirwin_	unknown
@HoayY	human
@jennelyn21	human
@Caplansky	human
@ladypuai	human
@maddymakescakes	human
@LivedinItaly	unknown
@PrincessCarlaS	human
@_MagicHolidays	human
@LisaYeng9	human
@BWiekeraad	human
@beautfld1zastr	human
@CanKemaloglu	human
@Cyntp24	human
@Sahena_	org
@Andy_Alis	human
@cacheng	human
@jamirxp	human
@shijiaooi96	human
@kankanrambz1	human
@HeadologyGuy	human
@jocey215	human
@TheIndo	human
@sitichumlee	human
@arnd_thecorner	org
@filizceyemekler	human
@itsKidray	human
@Gabrieaus	human
@akicchi2609	human
@sloppyshertford	org
@Kingpin285	human
@DecozyFreeMag	unknown
@DarianMurray	human
@Roksnutbutter	org
@SpankyZane	human
@NinaLove_93	human
@Tisnancypub02	org
@ShinYi_goodgirl	human
@tybully3211	org
@IQRTG	human
@EmiratesTaste	org
@maaaaxoxomi	unknown
@its_parodi13	human
@ArdenD88	human
@JessicaBrookeDC	human
@LeongHanz	human
@BetsyDiJulio	human
@tableteaspoon	human
@TheConvenience	org
@SylinaLangham	human
@wearemadnet	human
@TopgolfDC	org
@Yogimagination	human
@Piyopiyousa	org
@magsthemaven	org
@AshleyD422	human
@ppmmak	human
@Djjohnluna	human
@TheLifeOfNadia	human
@lolo_6969	org
@p8tlv	org
@jmiguelpr	human
@cocohatesyou	human
@sharsnow	human
@shan_neuman	human
@Evgrafov_Ilya	org
@BourbonRealty	human
@TeishaLyons	human
@pkus	human
@terry_huey	human
