@_thevasmood	human
@HaneyPub	human
@nadiaazahid	human
@France_Platon	human
@EmChanNorris	human
@DTAYDAHUSTLA	human
@lajka_dog	human
@BurtMaxs	org
@patysatiko	unknown
@JuicyLizzz	human
@RachyBabes7	org
@davefmrocks	unknown
@kaworu86	human
@ArmandinaFrend	human
@shalemeshale	human
@TheChichPub	human
@8BitGamerbot	org
@PatriciaRosa4u	human
@mrchemistryjr	human
@eleonas	org
@theFoodylicious	human
@alvish_2001	human
@_ChienTing_	human
@sh0517ko	human
@Patricia_Bau	human
@spongeo_o	human
@FitlerDiningRM	org
@Hawaiishark71	org
@hanz_kariz	unknown
@suzelmoursi	human
@Mimistar_05	unknown
@TigerJohnDinh	human
@andrewsaputraa_	human
@nobelsuhatmoi	human
@howyurderighn	human
@ayettelee	human
@asayuki_mariane	unknown
@Specmonkey	human
@GeorgiouFitness	human
@YJoejit	human
@elmalin89	human
@faten823	human
@TammyFacey	human
@ChampagneLPUK	org
@Sherly_LJ	human
@ddelich	human
@toddklinck	human
@SarahMarlo	unknown
@SusanJennings7	human
@phanunuch	human
@daringgourmet	human
@B_Photolicious	human
@Hellooo_Mini	human
@raff_albano	human
@MzValerie_	human
@ashleighfenwick	human
@TomyOrtuzar	human
@FitriyonoBayu	org
@MrMarkDPotter	human
@MusRoew	human
@beannhere	human
@emmilyym	unknown
@merucoffee	org
@herenaofficial	unknown
@CathyLSG	human
@essentialblonde	human
@ktloveminami	human
@amzdj	org
@RomaMadrueno	human
@makeupkiss14	human
@anthodevera	unknown
@wonderisse	human
@mattebmx	human
@LeForetNOLA	unknown
@kevinkline14	human
@UgneBendikaite	human
@serena727	human
@Chase_N_Chedda	human
@hwnael	human
@zingermans	org
@GBALLIN20	human
@zydmontecillo	human
@NathanElias	human
@themanofdann	human
@Maelloushka	human
@SerenaMurillo	human
@BentinckNotts	org
@fabhailgail	unknown
@juanoossag	human
@crimsonroses7	human
@asheta5	human
@ClaraHooper	human
@amor_artificial	human
@GIZI_1B	human
@MarissaOtz	human
@camilinhasmoura	human
@Zephyrinia	human
@arethabbb	human
@x_Leanne_1988_x	human
@fuzzybunn3e	human
@jubelpasuruan	human
@worldofavirgo	human
@gfbrampton	org
@stacymarietb	human
@carlooftheworld	org
@PrideRadioNE	org
@The_BreezeVA	human
@dinnie	org
@Joanne_Tse_	human
@hayleypople	human
@shadschahine	human
@lalla__by	human
@MennyBey	human
@rubiamala_	human
@LovelyLadyL19	human
@brooke_alexa	unknown
@EjohnsonChelsea	human
@PreppyPanache	unknown
@DianaDJ7	human
@LAGhirl	unknown
@univofmiss	human
@Edupues	unknown
@LeBoutiqueHotel	org
@yvesfernando	human
@ShaqillaGhazali	human
@pamrhiz	human
@nattybotty24	human
@manojnayak	human
@sswandewii	human
@FATISTHENEWSEXY	human
@cdshand	human
@mistersoul216	human
@ARTFRENCH	human
@osr337altonio	human
@shzrynMUFC	unknown
@ElfaraFM	org
@HomesMalone	human
@sulis8712	human
@fatmasouidi	human
@lacucinadiqb	human
@spadeforkspoon	org
@airi_0302	org
@dian_0803	human
@sueann202	human
@andreagzzj	human
@quocthongvo94	human
@Kammee25	unknown
@abalaseialina	human
@wreckitwack	human
@bensloan83	human
@MarcheRobinson	human
@cahayaeza	unknown
@indianshringar	human
@safiahzainudin	human
@michellegandres	human
@danielleadelb	unknown
@deppoximate	human
@PaoloRaymundo	org
@MetsDanny	human
@SnobbryBoutique	human
@hermiedelacerna	human
@TheDriskill	org
@kopraonu1	human
@KoreyKlein	human
@kaseybroyles	human
@spiritedbliss	human
@csisk1	human
@matthewhalsall	human
@dadatoselli	unknown
@Socials_Friends	human
@styleandsociety	org
@BunnieHopps	human
@DeluxeDuck	org
@calgarygooners	human
@SwaggaReg	org
@913sportfm	org
@chronicfemme	org
@natashainozblog	human
@CourtneyNSW	human
@graygirlstudios	human
@HiltonBeirut	org
@RussosNYRest	org
@hlthnwelness	human
@HContinentalPTY	human
@carl_loco	human
@CRASHRadioNOW	unknown
@DZalumni	org
@RepublicReign	org
@itsAntoineCurt	human
@ilvstrated	human
@criscarandinoOK	org
@JoelCaffery	human
@ThePaulRProject	human
@FindRestoWeeks	org
@TTinywaist	org
@blazeprteam	org
@FlixationApp	org
@yamastapas	org
@screamHZT	unknown
@AbdullaAbdul	human
@Doc_Durham	human
@FitLifeGuruu	human
@Firetrench	org
@Stoli	org
@KristinPColeman	unknown
@baglovin	human
@adrianr88796695	human
@dairystoreMSU	org
@beefitpilates	org
@SharpestJim	human
@Nutrition_HandW	org
@ConteEleonora	human
@marroquindiego	human
@SicaPelle	org
@SchulerBooks	org
@BrancheBistro	human
@oakhurstinn	org
@FieldHouseOrl	org
@Ny2EXwish3	human
@ferry_fung	org
@StarStruckMinaj	human
@mblopezchamba	org
@savemysunshine	human
@CantinaHntsvle	human
@pyonworld	human
@chodingminji	org
@angelocanzurlo	human
@nikitree	human
@kylegalbraith	human
@aVanessaSantos	human
@erwinlaiz	human
@DrumMachineHero	unknown
@tiagoocandeias	human
@MaisonetDemeure	org
@GabySosaB	human
@MistyDMyers	human
@Egerton_Hotel	human
@IamALcedric	human
@MesutOzil1015	unknown
@priitypari	unknown
@bloop1694	org
@DenisaH94	human
@sneider_chaves	org
@CantinaLtleRock	human
@TrishLomax	human
@hrm_herno	human
@DelochoDioses	org
@GJevstachi	org
@narrysdancer	unknown
@McManalu	human
@EspeeJordanRico	human
@AnabelEnriquez_	human
@winsonsihar	human
@atastymess	org
@_dreamer12	unknown
@makitea1	unknown
@feezfey	human
@agreene14	org
@DianeKochilas	human
@TijgertjeRawr	org
@mrjoebell	org
@RunsOnEspresso	human
@calz_qiu	human
@agaveissaquah	human
@SH_Fitness	human
@reshmi_ganguly	human
@CheCheh	human
@RENRAYRAY	unknown
@_Fadra	human
@GatesWifi	org
@LaBrindle	unknown
@TheWestinSohna	org
@micmicscorner	human
@InkletPapery	human
@Ndries_	human
@Annanightingale	human
@RomySmeets	human
@yumdeliciousnes	human
@LpoolChamberSW	human
@TASTYSKINTIPS	human
@dingz9	human
@nda_pandaa	human
@iamalphonso	human
@LisHsu	human
@lamandorlawp	unknown
@Faz46	human
@DjHapaBoy	human
@Mr_Fernandes	human
@mandy__sr	human
@NoMeek_JustMilz	human
@Pizzazillamiami	org
@Sketchingblonde	human
@KerryDungate	unknown
@larrywaight	human
@annemccoy	human
@maurimaradona	human
@bcookie33	human
@teenytinyspice	org
@ericavagl	human
@baddlilchick	human
@scout510	human
@HappyFoodsTube	org
@natasha_cribbie	human
@Puppyprotector1	human
@BDub7473	human
@kkumarchef	human
@nicoleosinga_rd	human
@a0422u	unknown
@CNeculcea	org
@MichiganMilk	org
@_MrsMode	org
@RedVelvetLDN	unknown
@OxfordStPaddo	org
@BrookstreetBBQ	human
@rinarosita_	human
@ijugadiqao	unknown
@bindermichi	org
@UKGlamLifestyle	org
@psychofan1	human
@mon1que_p	human
@abevsaka	human
@LE1Market	org
@Ulmavi	human
@fearlezz13	human
@SJCORTEZPR	human
@iZwanCarlos	human
@YahyaGarjees	human
@naja1218	human
@HerbalifeDream	org
@PaulaBoluda	human
@benirawan	org
@Aleksblind	human
@rafanador	unknown
@yerui228	unknown
@BattnieMyTummy	unknown
@karolmiekina	human
@clickaback	human
@SouhaybEter	unknown
@FrouLoves	human
@thekrazyeight	human
@Oscarlazalat	unknown
@CherylsArt	org
@Immac_Laptops	org
@AnacbPereira	human
@KimCoLim	human
@MoisesGR1985	human
@_rubstr_	human
@BEazyOne	org
@seekhappyville	unknown
@aylaabrasso	human
@Ines_CFerreira	human
@playordisplay	human
@waifro	human
@Chrisgenge	human
@_MusicWardrobe	org
@TiagoFAleixo	human
@MzTatiBell	unknown
@ErewhonNatural	org
@swaggerlecious	human
@ChicMuslimahLtd	human
@thompsonhotels	org
@TimJetMartin	human
@EmmaFarthingMUA	human
@RachaelNovello	human
@BBCCornwallJC	unknown
@Snorgtees	org
@BWelsalvador	org
@Wavewhore	org
@jnjkendrick	human
@Sara_Awamleh	human
@Drm2life	human
@idjitminion	human
@Miss_Bonnie	human
@AmyLillianAllum	human
@davidkiang	human
@TPHFBHooah	org
@kenboggle	human
@Zaku__u	human
@GoodnessCakesny	human
@attyhailey	human
@catysan76	human
@iLoveTorontoCom	org
@CowboyNewsBot	org
@Giusva82	human
@41801inside	unknown
@cindyhsy	human
@07_MARLENE_07	human
@levieux_chateau	human
@clnormand	human
@minxonamac	human
@moorekat	human
@ranatamrin	human
@superbessential	human
@treehouse_stl	org
@BrendaGott	human
@mattIttam	human
@EatDTSA	org
@Cboudewyns	human
@maii0316	human
@wwwdesignr	unknown
@TheTINKitchen	human
@Alexe_EsCa	human
@MontesHector2	unknown
@Ales_Pellegrini	human
@abdgencal	human
@mrandrewcho	human
@Joha_Anniie	human
@MrsCatHenry	human
@TattooedSpirit	human
@barbarajchin	human
@TheWagPack	org
@bodywrapreduce	unknown
@OWKids	org
@jokichi_inc	human
@TimiFeher	human
@SproutJapan	human
@CJShannon1	human
@iamelviswong	human
@IoIchrisIoI	human
@MYP_MathTeacher	human
@BradleyVine	human
@shenoyify	unknown
@kennainafrica	human
@madrynha2012	human
@snipz08mich	human
@SouthernFoods	org
@miparevastrano	human
@calfonzobas	human
@vallisac	unknown
@barbi_lyn	human
@debstarpr	human
@Crystal_Oceanie	org
@OfficialCesca	human
@MonterreySmyrna	org
@Joze_Mndz	human
@alexander_KW	human
@RyhanaVarlesque	unknown
@cati_21	human
@styledbynatasha	human
@skullzomb	human
@magalidalix	human
@linaearrrahmrr1	human
@Shannon_Clare	human
@kafeinbpn	human
@jfoguet61	human
@petite_fabeli	human
@GeflingDollFace	human
@motsdemode	human
@Charissa_A	human
@VeFebrina	org
@mikeygatal	human
@theejamieson	org
@j_schultzz95	unknown
@SirVancelot22	human
@Angelic_Lily	human
@Cybergabi	human
@throwwedoff	org
@SarahLouieKegan	human
@ryancliffy	human
@BaronesPizzaGE	org
@bomi51	human
@Samanthropy	human
@Clam_jowder	human
@dircasacalora	org
@omenfrezia	human
@CookingDolls	org
@jaunlaubscher	human
@evite	org
@the_roadhouse	org
@keiratai	human
@Fitraaaaaah	human
@alricthompson	human
@serdargoknur	human
@printrestaurant	org
@LilJoyNannies	human
@Lilivazquez7	org
@InstaNakhodka	human
@risyakanahaya	human
@JacquiChilds	human
@athiskemon	human
@LexRaymond	human
@monsieurene	org
@mrsflyingeagle	human
@shgnyc	human
@iamlird	human
@JohnboysBBQ	org
@hellochi0304	human
@greyshya	unknown
@chriscampanioni	human
@VignaMichela	human
@lila_mara	human
@hanalaz	human
@Brynn_Paur	unknown
@Turborunners	unknown
@monicamarge	human
@MissoulaC	human
@BodyByFadi	unknown
@TwinklStarsz	human
@Flavioblc	human
@SabrinaSobe	human
@kuishinbousagi	human
@chef2thestars	human
@JanainavonMoos	human
@johan_brandlove	human
@aciremei	org
@TexasLips	human
@iampamenriquez	human
@saikanachiyama1	human
@TenderGreens	org
@DallasTidbits	org
@loren_kmp	org
@ReonaNozaki	human
@UnoChicagoGrill	human
@I__LOVE__NYC	human
@BrockSandwich	org
@BaranyBettina	human
@1ChewStreet	human
@rachieb	unknown
@KishanU14	human
@AVLmaps	human
@aristidesgil	human
@RJBRAD	human
@maguiremusic	human
@KoKoChanel_85	human
@xxJJG	human
@imcharissamae	human
@FigTreePenarth	org
@lovejuneann	human
@DaisyatHome	human
@JiXingO	human
@KYOGOKU_DINING	human
@JhazyWodi	human
@ThatDudeLy	unknown
@l_combs	org
@BritbabeE	human
@michashinesfit	human
@TiitaPerez2010	org
@Noel_Elie	human
@tipramas	org
@Eveline_MVP14	human
@deee646	unknown
@Nadine__Wa	human
@neveedah	unknown
@paloomartinezz	human
@debbiedian	human
@LuxuryUkHotels	human
@MeggoWaffle	human
@chicyael	human
@RichtreeMarket	human
@ayami_setron	human
@bryle_cyril	human
@cookitraw	org
@FlicksFancies	org
@food4u_pk	org
@aubeve	human
@SteMid	human
@TheNickZajac	human
@MIKK055	human
@PicaTapas	human
@cruz_control15	human
@takasago92	unknown
@rycbaryana	human
@co72396	human
@KarlinLangley	human
@farmerbrownsf	org
@bigchetti	human
@erincoates	human
@AnnSeeYEOH	human
@Pauliki_5	human
@Giulia_Tiffy	human
@SA_rahfrog	human
@MyBigFatMouth	human
@ItalianSC	org
@markeyzz	human
@shellnicole511	human
@GiorgiosAgency	human
@ladysweetchip	human
@ovhatherainbow	human
@ChelseaLynR	org
@iheartShaney	human
@hamhamgirl	human
@anaescalante24	human
@MariaNutrition	human
@Elvajamaica	human
@davidwhitestudi	human
@vicnes7	org
@andyvirrey	human
@AllanBergqvist	human
@MizBrown523	human
@Melissaa_Crouch	human
@jaimecooking1	human
@tse_samantha	human
@CorePower	org
@tweet2eatbeat	human
@rhellias	org
@Nidhish_Kumar5	unknown
@acesosicwitit	unknown
@trixiealmazar	human
@jdiddymac	human
@BloodyMaryTour	human
@neilgasms	org
@dwmah	human
@DebbieAtdZenith	human
@Keisha1323	unknown
@Azar4Durham	org
@GlutenFreeCutie	human
@poshmoma	human
@CUFood_BrandLab	org
@Baralto	org
@LAGUSTAVOADOLFO	org
@RL2BLAND	org
@SPOrganics	org
@marketcafeLDN	human
@spottybottyyork	unknown
@SenorMalcolm	unknown
@Countrysideksa	human
@wendiesluv	human
@Deedeethatsmee	unknown
@Asu81kA	org
@jlhuspek	human
@miliestories	human
@CoreBarLondon	org
@iamPilyongStan	human
@DriftwoodBB	human
@btownblog	human
@goodnightt_moon	org
@mismaris896	unknown
@sarahBijouClub	human
@Marcquelle	human
@Thomashuynh86	human
@oli_amoroso	unknown
@CozysWestbury	human
@MizzDT	human
@bubzsemblante	org
@TCreativeBlogs	org
@orkneybreaks	human
@chickkinOZ	unknown
@Forgans	org
@anindhiputry	unknown
@elseElanor	unknown
@PamelaOntanon	unknown
@JoraineFC	human
@GGheral	human
@KCBreaka	human
@haruka_princess	human
@homemadebeerguy	human
@XxHannaaX	human
@mnsachs	human
@FlipSideEaston	human
@TriciaMorilla24	human
@twistyoats	human
@LADY_SALT68	org
@alberto_bdn09	unknown
@joesvegas	human
@lattesnleather	human
@GOTEXAN	org
@BelieveTriumph	human
@akemiMKurdi	org
@chefvan_dyk	human
@timmy_nator	human
@JeremyySoe	human
@Dulimeyyy	human
@Chympui	human
@sweetoothdesign	human
@AnnaEllegaard	human
@princesshabibee	human
@ha3careeredge	human
@M_IMagazine	human
@RujQmr	human
@SebBDx	human
@carotrelles	human
@4bny	org
@eliothong	human
@ruthilicious	human
@DJ_MrMeeH	human
@sundazeweigh	org
@jasonvermilya	human
@SingaporeBong	org
@Algerocaine____	unknown
@nxbeautii	org
@DevyStylish	human
@TCsayyys	human
@saeyk	human
@LiftCoffee_Whis	org
@mikechalut	human
@MarkIanHarrop	human
@KhernCrystal	human
@pharr2	human
@FATFREEALMOST	org
@BWPHaiti	human
@MarianaVivas	human
@rizka_ikajun	unknown
@DaphnieCaliboso	human
@FoxyLoxyCafe	human
@ShellyChanel	human
@ShawnReven	human
@OlivierMorosini	human
@Kerrimcguinness	human
@soffhte	human
@dgmm0925	unknown
@Nereida647	unknown
@chokeoutcancer	human
@DreadShamus	unknown
@Fronswizzle	unknown
@phil_dfc	human
@TheDura01	human
@dianaastanley	human
@BenteOH	human
@healthyhomo	human
@EdwardianSteve	human
@chukkee09	human
@ItsEzpz	org
@07_matsu	unknown
@MMARing1	human
@zasshaziq	org
@monahagulan	human
@gunalexgun	human
@NeuvooFranklin	unknown
@SpeedETab	org
@Beastmodeonum	human
@MatiasSecchi	human
@joy_hopwood	human
@WallauRoberto	human
@anegodinez	human
@UlissesWorld	org
@DivaMNI	human
@nickywickywacky	unknown
@floydban	human
@blakiz_bootiful	unknown
@DestinationWxm	human
@lloydcordero99	human
@agusss_ferreyro	human
@iSaleSingles	human
@AdamDanial16	unknown
@NicciGlade	human
@VinAmbassadoren	human
@rmz_akdag	human
@DebFuruichi	human
@joebasurto	human
@aainfz	human
@mrsfaz16	human
@SarrahDiab	human
@itskadirozel	human
@BridgfordFoods	org
@Daaniiaquino	unknown
@Aditya_Ramesh5	unknown
@Sophistaprice	human
@xkirstyanne	human
@chef_erickz	human
@rs65	org
@SummerGirl2994	human
@takagi1964	human
@Sassy_Kattt	human
@kath624	human
@kattiakattu	human
@criscabbab	unknown
@The_White_Swan	org
@schirato	human
@ourGFfamily	org
@PromptPayer	org
@krystaldiaries	org
@SheerazBilly	human
@kertawidjaja	human
@Jaeyoonc	human
@_THESIGN_	human
@WisdomNZ	human
@JonathonKemp419	unknown
@a_consciouslife	human
@leskova_natali	human
@jfhealthcoach	unknown
@hennessy_vicki	human
@iamdrfitness	org
@PasionTentaciou	human
@Tiffanyartiste	org
@cotyyyy21	human
@38saecha	human
@nixen93	human
@meggieC97	unknown
@JanWebber200	org
@luwarrior	org
@chie6002_	org
@Athleta_Newbury	org
@AnimeSharer	org
@abdulfaiz14	human
@RikySantoso	human
@sugarlovespices	org
@DailyForage	org
@BeanStyled	human
@Abou_El_Leil	human
@AlbertsonsNM	unknown
@PepeCisneross	human
@ld_club	org
@fredfougerat	human
@TheNorthEndBBQ	org
@crashettez	human
@keeleyd40	human
@k8lae	human
@frankthetank523	unknown
@AnnaIntnational	human
@tryliawati	human
@gorjus_Chinita	human
@StefanIrina4	human
@pantel81	human
@christyyongjm	unknown
@MariannGierhart	human
@staffsrt	org
@geetanjalidhar	human
@Fitness4Louisa	human
@LatifahNingrumK	human
@SED1990	human
@mohuberapodile	human
@achab_ali	org
@Julez0127	human
@helpdesksocial	human
@akabuhi	human
@danadais	unknown
@bettyboopfit	unknown
@ReNika_blog	human
@ALLIN1PRO	org
@UtterlyRuins	unknown
@AndrewFarmerUK	human
@measureless2man	human
@budget_momma	human
@stacey_nicole_	human
@tully_412	human
@2spbrewing	human
@bigdefaz	unknown
@StellaaaHo	unknown
@AndyLim27373881	human
@WFMCoSprings	org
@QuattroHouston	org
@shiesvallen	human
@MineralDoc	human
@victor_boxguate	human
@BarakatME	human
@AigoresA	human
@Celebrate_Mag	org
@ShockMunch	org
@Houston_Barrie	org
@happyBerger	human
@chefmarcocuervo	human
@chiribizzle	human
@OPPriceChopper	org
@Dat1Guy_Punchy	human
@AdelizCruz	unknown
@Kakyokuhime	org
@ES360World	org
@sagezumaya	human
@Salutmavieille_	human
@taeFeed	human
@marleneconccha	human
@IvanIngram	human
@wevegan	human
@LN11	org
@Redreamclothing	org
@romina026	human
@TheFatFinn	human
@213Zoey	human
@hanasakura777	human
@lisakim_p	unknown
@heatherhillsuk	human
@maryherrington4	human
@BobbiJoKitchen	human
@Futbolhaber16	unknown
@apertur4	human
@BroncoBobsSauce	human
@BuhawiKIM	human
@klivelovelife	human
@MomDot	human
@coastblackpool	org
@mememoont	org
@sburoni	human
@enjoytruro	human
@shakira_dc	human
@carlamuchogusto	human
@famoussparkle	human
@ribkalistia	org
@stefanielarue	human
@hawaiimomtravel	human
@imnotMeek	org
@kimtonyssi	unknown
@RivingtonChoco1	org
@elisaserroyen	human
@RHidiosyncrasy	human
@CVocci	human
@GBrigithaS	human
@SoundBodyLife	human
@calli_boi21	unknown
@KerriStefanidis	human
@chiozp	human
@danielblancogt	human
@LoversWisconsin	human
@tripsFLORENCE	org
@EBistline	human
@Accordin2Angela	unknown
@henilim	human
@LJsBraceletB	org
@Tonia_Salling	human
@skdp7	human
@RebecaMedina26	org
@jeffSARRIS	human
@chii_212	human
@Meganowens20	org
@mami3104lovea	unknown
@KiranPriety	human
@veronicaguerrad	human
@ThingsMorecambe	human
@AiStudioOnline	human
@1Georden	human
@bertchai89	human
@LifebyCynthia	human
@Shakeel__PK	human
@Maicols	human
@CharimaXxx	human
@IvanMcKinnon	human
@mrmyspaceguy	human
@ChiveOnLasVegas	unknown
@nachi_mxc	human
@VanessaRoseV	human
@Vive_Nutrition	org
@lyysen	human
@NeuvooCarlsbad	org
@suitan174	human
@makigigs	human
@Dawgelene	human
@mega_ern	org
@nutritionistsam	human
@EwaPiotrowska	org
@ScottSj84	human
@vonty83	human
@YeahAniall	human
@sassyKhaye	unknown
@jimigo_wong	human
@VinceClaravall	human
@H_David_G	human
@Cielgha	human
@JoshDSaleh	org
@Accrdng2Gigi	human
@fotomauer	human
@AyanaTomeka	human
@BillyKhairi	human
@SteelAndOak	human
@ChloeSzpyt	human
@RooMZiC	org
@ErnestKoh	human
@NathalieSehgal	human
@MistyGatlin	human
@yullsaid	human
@MaaNey	human
@NitaLiu96_	human
@nanacocolili	human
@umvox	org
@Create_BetterMe	human
@ammbizzal	human
@CamilaMC46	human
@healthyhappystr	human
@LizzieB253	human
@ediblegarden	org
@truth2beingfit	human
@andSQUAT	human
@miss_cheko	human
@Aa_Nattha	human
@tkmsn_chitchai	human
@ArisMenu	human
@mskimgiambrone	human
@cathyde	human
@meets_com	human
@junctionTO	human
@RaquelPardines	org
@YaYasKansasCity	org
@bakabakasempai	human
@Lopshire_Photo	human
@bermantravel	org
@75terebede	unknown
@myvivopizza	org
@AydaJp	human
@JackyKantarach	human
@Blenditout	human
@YuiOkmxxx	unknown
@ChambersDonna1	human
@hiro_ass	human
@PolishChiro	human
@Nunna_Ika	human
@ClevelandCookie	human
@MariaPensi	human
@sajithneyo	human
@Makatu_Lugisane	human
@shari_lynne	human
@HwoodBibi	human
@kreesaid	human
@horvath_renato	human
@_BleeckerStreet	org
@cookingkt	org
@ChristieRochaa	human
@CantinaSandestn	human
@EX9M___	unknown
@diakaye	human
@singrunlove	human
@KimxShorty25	unknown
@Terrywhitejr88	human
@ChemaliMarc	human
@boywitch	org
@Aaronical	human
@mustangjayyyme	human
@LinkeKatharina	org
@Devin_Stclair	human
@williamdowning1	human
@sofakingawhsome	human
@ceyms63	human
@niel_jums	human
@bruninhalemesx	human
@herawatisyam_04	human
@kshorty	human
@ErinMasha	human
@MCollignon	human
@HQ_Chicago	org
@SoniaCosta	human
@ANDREAMURA6	human
@junvebbei	unknown
@alexkpotter	human
@KoreRat	human
@Miss_MariaS	unknown
@tania_francisca	human
@farizahanami	unknown
@yen1603	human
@multifacetedacg	human
@wearerawliving	org
@Eatopian	unknown
@anderswoundhier	org
@ruthiulia	human
@isuth1127	human
@HottieColomBn	human
@elhousehead	org
@mshollywoodnyc	human
@meerarais	org
@LilPryer210	org
@OpenSesameYYC	org
@FortWorthFWF	org
@taekwondo_fer	human
@vieelicious	human
@needt0be130	unknown
@cokeaddict	human
@Rudy_Chase	human
@donsbarraquias	human
@NoshDC	org
@KusieMcaba	human
@higashiyuko	human
@bufflove072	human
@Agusper3z	unknown
@ballyhurtin	unknown
@sissybeck	human
@gazzerooni	org
@CartoonClubCC	human
@Farrah_Chanda	org
@iamchingdee	human
@00Banks	human
@judosaya	human
@RihsG4Life	human
@Sif85	org
@YaYaYoo_Eu	human
@Devonlydelights	unknown
@CubanRuben42	human
@JohnGermaine	human
@TitaniaTeeta	human
@SLVDR_GEO	unknown
@lovely_nyitzz	human
@BrownBoogz	human
@misssushi	org
@tabita_amy	human
@GravitterBo	human
@mrs_katethomas	unknown
@FlacaJewelry	human
@Nicole70340991	human
@BurtonKeenan	org
@MariangelAC3	human
@ericallera	unknown
@Fiiaaah99	org
@jef713	human
@yaquie93	human
@karenkfau	human
@ShowTheWWW	unknown
@chrisighnat	org
@samoale_shokudo	org
@JaiKadence	human
@Zackisan	human
@naturalhealthbl	human
@Vera_Wibawa	human
@kgluxlife	unknown
@niyaxzx	human
@NUFarmersMarket	human
@raEdenRockZ	human
@myUganda256_	human
@verityseattle	org
@Nikou_DQ	unknown
@qsabenadie	human
@denbypottery	human
@obebeorganic	unknown
@natdavis5	human
@TheEmpireProd	human
@Sabrina_Wise	human
@jnpvintagejewel	human
@mmmmmikaaaa	unknown
@Candypenelope	human
@Jamiej_fit	human
@LeamingtonGuide	human
@mlb_bobblehead	human
@BigMoPTs	unknown
@barandclubstats	human
@sensespeak	human
@LesleyB86	human
@About_Pixels	org
@theeJmB	human
@Ahoahoman009	human
@anujmahadik	human
@DreyerStefanie	unknown
@rockabyeguinnie	human
@mackie_erma	human
@licq26	human
@mantobuil	org
@FBVchicca	human
@CafeCeramique_	unknown
@iTongueFuckGood	unknown
@CoachV_HLF	human
@wildwesttweets	org
@HaithamKhaiyat	human
@tender_grill	org
@sugarhut	org
@Feedback2you	org
@kijo17	human
@jeepand4x4	human
@FlavourHunter	human
@Wai425	human
@wanwijaya	human
@paperrdoll	human
@AJPlowright	human
@marchmean	human
@UYN_TTCC	human
@ahenzxc	unknown
@gracillia	org
@luk_92	human
@ladydukes100	unknown
@mustardseedcook	human
@rodcute	human
@bqsl	human
@tomo_rin	human
@GarrettReynold9	human
@aimara31	unknown
@agentgreenglass	human
@WEEJUNHO	human
@DaRealCashCow	unknown
@KadeyrLoveto	human
@moeka1121	human
@FortJacksonGAH	human
@FitnessFuelLA	human
@Ricettilla	human
@olliecouillaud	human
@idblovinmeg	human
@Dusti770	unknown
@capitaltravel	human
@ThefactoryPEI	org
@Kurarizu	human
@nova_diana	human
@Nanink_Widyas	org
@grammy_dila	org
@FishLemonTree	org
@TheGracinator	unknown
@kait_2908	human
@SPhoutavong	human
@samsoon123	org
@botkier	human
@GreenVenus10	org
@Purple2vin	org
@saintlavie	human
@angelicahtex	human
@fuurinosuzu	unknown
@HejHygge	human
@NatalieSifuma	unknown
@diegocook79	org
@weasteman	human
@XTRAORDNRY_CHIC	human
@MiddletonLodge	org
@yukiko_terazaki	human
@Amanduhh31	human
@lexiloo33	human
@Nadeem104	human
@lilyinthelight	human
@SGDelivr	human
@akirasek	human
@srbeard11	human
@nickylie2	unknown
@hannafahed	human
@ziggyfoodlust	org
@catrina11011	human
@OhHowCivilized	org
@maguscivismundi	human
@MerrilyVerilyVi	human
@AlexaOliva	human
@knighty4u	unknown
@BabyDollie20	human
@rigatonis_Pasta	org
@kawena13	human
@dean_deane	human
@RD_Global	human
@BrockleyMarket	org
@MandyMaeR	human
@RodsSteakGrille	human
@jrad87	human
@feedpetpurveyor	human
@IvanBega	human
@StamfordJandB	human
@Karebear2567	human
@StrawberrieL0v3	human
@LoreneMichelle4	human
@Skinnyoats	human
@stine1_online	human
@HarvestOrganic	org
@GatskeVan	human
@madlenb75	human
@phoebekon	human
@AmericanSuppsUS	human
@Traneving	human
@luisbellocchio	human
@dukenorfolk1	human
@SheardShe	unknown
@shelloG	org
@rosaliaocha29	human
@lydia_eznie	human
@melincalt	unknown
@xxFynaTixx	human
@Dayton_Local	org
@reyhanyaz	human
@Lisa2Kaulitz	human
@manaiakalani	human
@TheEastPole	org
@mr_ThomasLiang	unknown
@Directmeats	human
@Patio_Life	org
@Korey_Carter	human
@melmck2	human
@MentionKempot	human
@LozoyaL	unknown
@jessteasdale90	human
@jessicaw1981	human
@amigodehashibe	human
@KunnKwang	human
@MuGeN22PoWeR	human
@Patrickp5770	human
@akane86	human
@tomasowen93	human
@adswedz	human
@Iluvinspireu	human
@PCH888	human
@PittsboroCVB	org
@vanwinklesmedia	org
@TenerifE_mishap	unknown
@MelodieCohn	unknown
@vegetarianyogi	unknown
@kouyokkuma	unknown
@Winkonthings	human
@thekeypieces	unknown
@SazonDeCaracas	unknown
@jaquar123	human
@ge_morand	human
@Toyo_Majid	org
@Yana910	human
@Shang_Nemi	human
@moabelofarm	human
@TrenthamEstate	org
@shootshareeat	org
@docNikita	human
@___RxF___	human
@OzoneCoffee	unknown
@crookedcooking	human
@OliverSpecks	unknown
@KaikuRestorante	org
@Jeri70064	unknown
@ayuma0913	human
@BoBoStyleMag	human
@dalerun003	human
@PeTeBhAtMaN	unknown
@Damountje	human
@omso92	human
@VicFeVillanueva	human
@AmirahJailani	org
@AprenderGameDev	human
@ShelbysBistro	org
@DJCFOOT	human
@sticksnswirls	human
@TheTrippM	human
@michelececchin1	human
@SteveLeonardo	human
@JWMarriottHKT	org
@LibbyxSmith	unknown
@thefinebalance	human
@iamSKYDC	unknown
@UCLA_Alumni	org
@conniebarrass	human
@MoneyBagE	human
@chihi625	human
@markbiana	human
@HelbraunLevey	org
@Muddinity	human
@amyhill1606	human
@leohosang	human
@Stachlkatz	human
@kimmikye	human
@j_kanj	human
@MyFarmerMarkets	org
@Sawtheclaw	unknown
@SusanAprilia	human
@frescosfishchip	org
@BahamaBreeze	human
@renatinharoche	human
@Leosallyphotos	human
@battaIlalgoos	unknown
@buckeyebecs	human
@Nothings4Dinner	org
@VeeVee_Bloom	human
@Red_Blaster	unknown
@girovagate	org
@AnnitaLazzaro	unknown
@gaetano_1412	org
@TigerNutsUSA	org
@ynachiquita	human
@nativeangelaz	human
@Echoscape	org
@JohnMcCormick	human
@willowclay	human
@S_DIMOPULOS	human
@ahen205	human
@nakberlin	org
@sealedinflavour	org
@juli_rott	unknown
@PetesPaleo	org
@creativeness	org
@Inlifecare	org
@squareonefishco	org
@msdanaboop20	org
@purenchic	org
@jazsimplymoi	unknown
@DMCeeOfficial	unknown
@LibertineBris	org
@bcserrano	org
@kristinquintas	human
@ChefJus	org
@NickySplinta24	org
@insertgeek	human
@ChristyParkHS	human
@Sexcessful1	unknown
@faltnation	human
@SlimAnomaly	human
@lilfa_Karaba	human
@fristhya	human
@julianarw	human
@3NG3L	human
@northsideBEN	human
@LULATORONJA	human
@CacarisMC	org
@gamraes	human
@NomuraSushiLA	org
@RayWook9	human
@IamYabba	org
@Seanslongtrip	human
@JaysUptown	org
@Riska_novita	human
@Vegicano	human
@Daniedex	human
@che_rry_co	human
@SixpacksDaily_	human
@RuksanaWrites	human
@PTFood	human
@astridsantos10	human
@JulianaZarate	human
@AhraniLogan	human
@Dana_Hamdan	human
@markie1022	human
@MillPersonnel	org
@TCL_TCL	human
@Tobiberta	human
@SadiaAzzad	unknown
@ShawnHong	human
@tathatubby	human
@madebymargie	org
@yuuko10170807	human
@tokiohanai	human
@BeautyBlvd	human
@samantha_rjsdr	human
@EvaScolaro	human
@flobeck	human
@OfficialEdan	human
@qthoney_twit	human
@Kaitownnz	org
@jozenkuah	human
@greinho91	unknown
@AlexBramley	human
@CricketsSnacks	human
@Bristol52	org
@willms13	unknown
@zaziemon	human
@AdrenalinAdd	unknown
@iyaroo	human
@hollie_k	human
@Azahar_Rest	org
@ireneardiani	human
@kaypmumof3	unknown
@JessickahM	human
@miyusoopi	human
@Ambitious_Shub	human
@PuriumWellness	org
@BoldCaddy	human
@yuritan_1225	unknown
@farhanaFSY	human
@supernerdplus	human
@All4Seas	org
@RomoChiro	org
@DarwinNoble	unknown
@SanciBaby	org
@Birsinsivar	human
@lemoneddahlia	human
@HersheyPA	org
@KerryPower2	human
@valentinaf3	human
@SiscaCya	human
@justwieka	human
@NoltonCorner	org
@hiiroomixx	unknown
@skiy7	human
@vikingunicorn	human
@Kjax555	human
@ld_da_don	human
@nyad9218	human
@BiancaH80	human
@akolkar_kalyani	unknown
@lagringapatagon	human
@rosaly_acosta	unknown
@ishouldread	human
@Ainur_abdul	org
@absltlyobsessed	human
@craigyunlee	human
@bearnika	human
@yildirimmali	human
@Honeysblood	human
@breathagain_	human
@thecurriednut	unknown
@rnovedo	org
@PicsFromVenice	human
@wanderingshane	human
@SanremoHarrow	org
@audreygirl89	unknown
@IsabelleEmard	human
@romy_bee	human
@AngelEnHogwarts	unknown
@VeronicaLeeAnne	human
@PublicPervert84	human
@chin_liee	human
@PiedmontDurham	org
@THEFLYLADY	org
@princeofhaitian	org
@harperdimmerman	unknown
@Chris_Cachuela	human
@lahlouf	human
@TheVegg	human
@ioanachisiu	human
@XaviPortales	human
@rhymay10z	human
@hassanqureshi2	human
@Cali_Grown_619	org
@MariaFydia	human
@dappidappi	human
@WallisJollins	unknown
@eethetbeter	human
@healthybutcher	org
@Cafe_fuWAri	human
@PJaquezz	human
@FoodandChic	human
@AidaMayoral	human
@ellyziawati	unknown
@MylyCrtz	human
@SimYvonne	human
@HelloTny	unknown
@Tyezeer27	human
@brancaantonio	human
@t_rexgfernando	human
@tomomi_arc	unknown
@RGVMetroGuide	org
@OMGyantzen	human
@Ranae490	human
@realboozebuddy	human
@tonhla	human
@BeingSoInspired	human
@TikTokOclock	unknown
@En_lovedan	unknown
@Reme86	human
@JacMcSantos	human
@KamiSushiJbeil	human
@nicola_marie	human
@ShopNorthBridge	org
@SantistaSantos0	human
@christine_cruz	human
@mykenkens	human
@___abbyrose	human
@Vernz13	human
@Ufa_2life	unknown
@KilliansKitchen	human
@misterlorcan	human
@PringleHawkins_	human
@GeoffFox46	unknown
@LivLean1	org
@Megalastraips	org
@Deeviantheart	human
@SocialQuiche	human
@BlakeEzraPhoto	org
@agzzza	human
@SerenityCEO	org
@ESoftie	human
@toddtfuller	human
@ChicaAbstracta	org
@VerlaPetrello	unknown
@themuliabali	human
@The_Steve_Adams	human
@resto_kayumanis	human
@dietlist2014	human
@alegorosito	human
@silasilala	human
@Dawn_News	human
@SeptyaWiwi	org
@azaruddin94	human
@Jet_smell	human
@damommatimez3	org
@EatOutDevon	org
@PatrickMunst	human
@djlalo_1	human
@TheJasonProject	human
@KandyKissesUK	org
@AnthonyBratts	human
@GusEcheverryT	human
@antoonyaaa	human
@TammieEmily	human
@jhenpot06	human
@janinameixi	human
@RibelleBKline	human
@GrantHardenUp	human
@brandsWpurpose	human
@JonathanChristo	human
@aksrpai	human
@RossyRusso	human
@ComedyKidsMagic	human
@baytreecafe	org
@StellaaLee	human
@manuelveraortiz	human
@TubsterTubby	human
@chihiro_chiba	human
@annalmn	human
@Anyluziitha	human
@anSur74	org
@anjbisyosa	human
@obesiverse	human
@Fashfoods	human
@Meyy_Hq	unknown
@ian_snake	human
@jasonneroni	human
@Teresa_Mtz65	unknown
@CopeyjoeBlogs	unknown
@dhe_syanaBff	unknown
@KingFeeva	human
@gothed	human
@Seungmy_b2uty	org
@DentonPearce	human
@FergieBee1	human
@maryjarrett2008	human
@ManorBrampton	org
@HappyDayResto	human
@ponpare_officia	unknown
@berettafarms	human
@miaowgetshyde	human
@SelinSerefoglu	unknown
@Titu_Bear	human
@clynnspriggs	unknown
@Gayane1982	org
@ccodyharrison	human
@The_RealDanny	human
@TeamMoneyBlue	human
@foudeparis	human
@bikersdietclub	org
@rowind	human
@DEDY_NATALEGAWA	human
@imkawebb	org
@meals_hurlinham	org
@HusnaaDhiyaa	human
@FloTheFrench	human
@LousCityBar	org
@CassArchut	unknown
@labelleaurorect	human
@Exitodelosbares	org
@simpledrinks	human
@wickes40	human
@Beksville	human
@LoveTayee1010	human
@ArmandNel1	human
@amyappletree	human
@SimonaMua	human
@kay_maerin	human
@MeDaSuperman	human
@tontenn	human
@pounecha	human
@AmuseVMFA	org
@blogbyrosalia	human
@citychicgal	org
@D12Renabun	org
@grohsARTig	unknown
@fashiontravelll	unknown
@nurain_faizal	human
@mariepalbom	human
@_Katie_Mcc	human
@ibakekris	org
@nTiiiee	human
@Viki_Vampi	human
@AishaAisiha	human
@danifearon11	human
@disquisitions	unknown
@RickyNEscobedo	human
@_InsKsm_	human
@Giuliane13	human
@VirginiaKVJ	human
@CConiglioModel	human
@Emric	human
@WhitneyBW_	human
@sekkidesphoto	human
@Juliedeshaies	human
@LaurenTrainor21	human
@Louibearnaisen	human
@dclisby2011chef	human
@blkkoko	human
@jomounty	human
@imnot_Alex	human
@LimAgnes0918	unknown
@jax92__pink	org
@rubidinorah	unknown
@SwaddSomething	human
@lena_alghamri	org
@Codojedzenia	human
@AviusL	human
@MatteoPrato	org
@frank_ellul	human
@Miitaaaaan119	human
@dj_b0nez	org
@ZZantika	unknown
@banila__	unknown
@nfafeh	human
@mohantychikoo	unknown
@pics_your	org
@deemalchow	org
@karljavellana	human
@loabenz	human
@RQLMeneses	human
@TheBangerzman	unknown
@euromaidantwit	human
@_xo_Shakila_xo_	unknown
@Pavilion_KL	org
@Eugenia832	human
@Womensrunninguk	org
@MimiBBlazin	org
@maancapuli	org
@WondermomWannab	human
@KaylinaC	human
@ScootADoot	org
@DQuincyJones	human
@MissAmarone	human
@caferacermn	human
@ChrissyAC1	human
@mex32571	human
@AsiClaypool	human
@LoveHackney	org
@BramdeSmit	human
@frlweiss	human
@DJCEMYILDIZ	human
@Number1Native	org
@jay_jay_808	unknown
@StevenLittle89	unknown
@Hirotyson	human
@jopcabrera	human
@DelenaKim	human
@tryinglish	human
@goRMVR	human
@feebysworld	org
@toxicbassism	human
@CRAZEA730	human
@definitelytwins	human
@petergohtt	human
@LynnWebb7	human
@baby_plannr	unknown
@ConsolWeedhouse	human
@BurtonMedia	human
@CandieGirl5	human
@TexasTit	human
@Abby00703	human
@hopestreet_LPL	human
@youbettergetitB	human
@valencia_priska	unknown
@K_isforkatie	human
@sfcheesecake	human
@Ale_BeernaL	org
@hakusanarakkaus	human
@yungrizzo	human
@HisGirlFriday14	human
@TheDolceDiet	org
@mgkitty22	human
@Jmt590	human
@VicDelCampo	org
@MsLizGutierrez	human
@jpnegreros	human
@mbjr2008	human
@anandjoshua	human
@ebbhead666	human
@LukeTyburski	human
@FrantoioOlio	org
@DailyMatcha	human
@YogawithAnne	human
@Getfitbodywraps	org
@pricelessPKU1	human
@Mowglischmowgli	unknown
@noruby	human
@reyosmot	human
@BourgeeUK	human
@ellerz420	human
@attiladobai94	human
@monic_lee	human
@FrankieG421	human
@ElaineARoche	human
@TheAshleyFields	unknown
@Kaile_Brumbaugh	human
@Snadias777	human
@LConinham	human
@AVILESHAZE	human
@MistressJuliya	unknown
@dewheem	org
@beck979	human
@acelimmanalang	human
@lauren_bowen	unknown
@Kosachenko_93	human
@giouin_abnormal	unknown
@PurePharmaUK	org
@ChabrotSmith	org
@thehopandvine1	org
@EstherMaenions	org
@beautyblunders_	human
@CweyRousseau	human
@Guadalupee_08	unknown
@LegacySurvGear	human
@TheBanksCincy	org
@FishChickshop	human
@LindsaySilb	human
@molto_molto	human
@naomixiaoxiao	human
@xiaostef	human
@verrraaap	human
@CaityCC	human
@selzay	human
@BlakeneseOne	unknown
@HaLauYaMa	human
@CavtatCroatia	human
@ElenaVidaal	human
@shandiegoo	human
@estiwandari	human
@DIAMONDAPPIAH	human
@ohtomo_natsuki	human
@haniffchicken	human
@jaymwilliams	unknown
@RavanELFButtler	human
@kononyuko	human
@BearBrass	human
@AlbertsonsCA	unknown
@AlixFleuret	human
@Griffin_Tavern	human
@jonbonjovious	org
@ConnectNigeria	human
@VenusAntares	human
@Amtafida	human
@erdemdilcin	human
@JackWebb96	unknown
@TDHAUGEN	human
@Aseprizzal	human
@MACKabiVIPer42	human
@HLNTMNT	human
@_PixieLixie	human
@jmsturgess	human
@Chamou233	human
@__giggleland	human
@docmh2	human
@Shastina_Eloff	human
@keidieXXX	unknown
@tifay27	org
@FloppyHatPhotos	human
@MichinNomad	human
@RealGraceShines	human
@ManuelinaDrops	human
@wa_no_kokoro	human
@george_band	human
@juakua	human
@Music24sevenTV1	human
@Cupcakes_Ninjas	org
@AlanDBanks	human
@TheRosaceaCure	human
@olguitapumita	human
@TheDateDish	unknown
@avnishn	human
@socialcityent	human
@dancing_chan	human
@shahiaarohi3	human
@LamarHeights	org
@Zoanee	org
@Running_Kia	human
@mayasariAnggi	human
@alofton	human
@Alexa_R90	human
@elisabet4ever	unknown
@mmanu2205	human
@NatsukiFSeiei	human
@onevanessajones	human
@ama_sia	human
@AsiaGlam	human
@AbbyiCaNdi	human
@bostonpizza	org
@earlsbridgepark	org
@NotQuiteSusie	human
@WearMarrow	org
@KirstieMaximus	unknown
@CantinaHouston	org
@impaugaza	human
@LaurentiaSandra	human
@VulgarDaClown	human
@KristineMicua	unknown
@PopdUp	org
@kdfowler1970	human
@SinghAshleyxoxo	human
@mfalconsilva	human
@MaddieMagpie	human
@svenja2410	human
@awkwardlyNYC	human
@pitcombe	human
@JoannaUchiha	human
@butadon_dayo	human
@bellechammy	human
@Addict3d_x	human
@YumiBehYY	human
@ADashofCinema	human
@3heather24	human
@Sophihi	human
@Cmex2003	unknown
@miss_inuesta	org
@passion8cook	org
@cameronberko	human
@SaveChildren1st	unknown
@ChrisCardan	human
@beabaka	human
@Mr_Moti	org
@egcigarguy	human
@marcgcairns	human
@mickaelweiss	org
@PondJaa	human
@yenyenz	human
@joker5974	unknown
@AsanaCulinary	org
@k_akomot	human
@ChrisWibot	human
@ClintTheLegend	human
@LaParisaine	human
@PaauErdosio	human
@HamiltonBeach	org
@MarinersIpswich	org
@Smil3Zz18	human
@Louise_DaCosta	human
@KelseyLynnF	human
@SouthamptonLove	org
@PicsOfLilyBlog	org
@SlimXSymmetry1	unknown
@styleandpepper	human
@anasjamaluddin	human
@BoozeEpoque	org
@FitChicProblems	human
@theGAPrules	human
@bakerandchef	org
@ruthtupe	human
@anitafrndz	unknown
@DJLTH	human
@jeffpetrovitch	human
@viraldharod	human
@shaykthomas	org
@MercedesGPC	human
@OfficialLyndiJo	org
@rese0314	human
@PieetaDJ	human
@ferbasar	human
@fancykitty229	human
@DHDrunkieGaGa	unknown
@MiiDealsChicago	org
@jessicadeebee	human
@Daydreamerdiary	human
@runjennnnarun	human
@AshwinJDias	unknown
@CJJerrik	human
@abhawan	human
@HeartfeltCater	human
@ManjaresMylen	human
@LorlaShimples	org
@khyatiskitchen	human
@niatrana	human
@johnlundin	human
@patrick_actis	human
@anambosorio	human
@Babsi_Sunshine	human
@sandflames	org
@WeiYi_13	human
@thisoneisbroken	human
@PurpleBrina17	human
@oykununbiri	human
@MiyaDidrichsons	human
@TLTeddington	org
@taraleighlove	human
@Jaeniene	human
@tricky_hudson	human
@OILNGASNETWORK	human
@Sandiebeach	human
@anesiae	human
@M4rionD	human
@candyhernandez	human
@Haymalatha	unknown
@zzachattachh	human
@AnnetteKilburn	org
@barcelona_cat	human
@CzechLevandulka	human
@Raymizz_89	unknown
@mohdmikail79	human
@SMichelet	org
@AriannaStarr	human
@matteogola	human
@Devi_NYC	unknown
@missgeschicke	human
@cookiesnmore	org
@HumphrieDenzill	human
@KaiserBrenda	human
@oneplymouth	human
@EdwardFYL	unknown
@beyondthemusic	human
@Hopeyger	human
@smmhatre	org
@LSASIEMENS	human
@NookieKawaii	human
@whelansgateTO	human
@recruitingchefs	org
@melmoiselle	human
@GamesRetweeter	org
@AmbiorixRG	human
@tweetsthatsing	human
@mrprettiieyez	human
@newfiemandy	human
@AzuMozzi	human
@MasterMike93	human
@GCacabelos	human
@aizagm	human
@Eyes_Like_Asian	human
@farizayacob	human
@kkttliang	human
@paspork	org
@runningRDblog	human
@KBodyStudio	unknown
@Its_Mya_W	org
@bigbossdollbaby	human
@gogogid	human
@PTrainerRXavier	org
@anekonymous	human
@TheeSexxiRelle	human
@DrTepi	human
@_tinelegaspi	org
@jonisht	org
@ruda_kita	unknown
@MerJaime	human
@Reuseit_store	org
@fernandazapata	human
@misswillis218	human
@OhMeGonza	human
@AngieFeret	unknown
@barbpanther	human
@ANDi_iSM	human
@paulagail	human
@mmonroe2nd	human
@kaoleycyrus	org
@Jake_Wilton	unknown
@fitlifefoods	org
@cafeleromarin	org
@china_nurse	human
@Irving_Gil	human
@100dayslove	org
@zenigeba9364	org
@adelynnlwkay	human
@elcafeatomico	org
@fufukun	human
@joffieanabelle	human
@evenstar84	human
@laiiineleen	unknown
@veganonthegonet	human
@BBQPictures	org
@FerventLoveMedi	org
@WildgStyle	human
@arkiroms	human
@obligacionicole	human
@markieeLop	unknown
@konpei_7_to	human
@JC_Webstar	human
@RomanHotel	human
@JessiaConaghan	human
@linositalian	human
@ganeshshevale	human
@AlexVato	org
@ChefShauna	human
@Xatx86	human
@PowerplantLA	org
@PRP89	human
@KremaPB	org
@warfeparilla	human
@Platform_1ldn	org
@_byKiki	human
@AnEmptyStage	unknown
@shutterlily	human
@MzccbearMz	human
@MarcoMandola	human
@noworrrries	human
@JINGWENMyWord	human
@MaijaPreddy	org
@TayLORDnTatted	human
@TownePlace	org
@thelockedwonder	human
@Raggalyman	org
@bakemag	human
@imbron135	unknown
@monarchisme	unknown
@PijaJajaja	human
@stevencooperdj	org
@CantinaAddison	org
@acousticz22	unknown
@erlineputri	human
@RTFridge_Magnet	org
@nonachristina	unknown
@Natty_Dew	human
@buntcake	human
@EatingTheWorld	org
@Publicitylover	human
@HalalGems	org
@fourthwusu	human
@IlCovoTrattoria	org
@Sstmec	unknown
@msFaLLen_AngeL	human
@rachidtaxi944	human
@sabbargny	human
@captainjames_md	org
@nenkzfortune	human
@tamumike	human
@freshsenses	org
@megumi50storm	human
@ACraynest	human
@tunkuerina	human
@TheDragonHotel	org
@BlossomDailyVA	org
@sophieeelliott	human
@ecyucrit	human
@amigo831	human
@bashGee05	human
@HeatherS09	human
@LUCIANAGONCA	human
@marklui029	human
@ErmaLeeSimmons	unknown
@andrewmurrman	human
@irenexplores	human
@InfosPoutine	unknown
@rjsburlington	org
@Lena_Chiu1988	human
@soovangarrett	unknown
@JennyMorrisChef	human
@Soraiapc	human
@jakokotybyt	unknown
@Nefees	human
@zekizekoi	human
@MyBratislava	org
@SheHulk87	human
@quemasspain	human
@Ridm_RessaStyle	unknown
@anchossouthwest	org
@SMRoballos	human
@doctorakil	org
@Miss_Meganxo	unknown
@catapmo	human
@movimentolabel	human
@Franzika94	human
@peopleJapanese5	human
@doreenh1989	org
@audi21	human
@vvn1114	human
@LULU90404	unknown
@Voler_Gars	human
@flyinspoon	human
@EsteffPQ	human
@JanAboutTown	human
@AnExpatWife	human
@927events	human
@avdotiaPL	org
@LilithHu	human
@ThatsAshley4	human
@saraquiroga	human
@idoitforthebay	unknown
@VinaQuinn	human
@ItsMeShillyB	human
@QQuelly	human
@TheJosACast	human
@Restaunique	org
@Jenwyx	human
@CoMoSmoothies	org
@monikapev	human
@mariamoquitos	unknown
@galvisdani	human
@mehmetberkayc	human
@Rifuaru	human
@gonzalouva69	unknown
@fishdjo	human
@suzyweibel	org
@LaCamera1	org
@mattiaclemente	human
@LeannaGarbett	unknown
@scarpettalondon	org
@lostwithlucy	human
@jenljenkins	human
@FoodieWarehouse	unknown
@Spongy1758	org
@PritsGosal	human
@neale_belinda	human
@carmendeberas	human
@Chrispuesan	human
@_hiyori_rdf	human
@Mi_Donghaeza	human
@milukokko	human
@TweetCardiff	org
@SaraRoderickLA	human
@D_Meehan	org
@SEANBOSS5020	human
@getfit4life4you	human
@dekleinezebra	human
@arigendz	org
@ManzoLiverpool	human
@Kat_M22	human
@ethnahunt	human
@ColinMoreshead	human
@scoobster621	human
@FshaaL	human
@NickiRaffa	human
@burntgate	org
@Dat_Gal_BabyLee	human
@yes_dealon	org
@jackelineperche	human
@autumnnguyen93	unknown
@wanderlustayne	human
@DebbiiePowell	human
@davidcastillo01	human
@TheRichAntArt	human
@reenamandora	human
@iAmDaBestEmone	human
@realFlanneryL	human
@I_Love_Manny	unknown
@oystersrest	human
@amyyhiltonn	human
@MarySue_McL	human
@mel_chivers	human
@mariairen13	unknown
@vicostreet2	human
@extrims	human
@debbycools	human
@sisipinho	human
@Hopeisaduty	human
@Mom2Es4ever	human
@QueenQuaySocial	human
@BATTLEOATS	org
@inkdgirl55	human
@thegeneralmuir	org
@treats_travels	unknown
@Aly_Jean	human
@phillov3	human
@KENT_0831	human
@kvnvni	human
@HiPpi3_LoV3r	human
@marsela2902	human
@itsfelixyall	human
@TasteIrelandMag	org
@MarcusShepard	human
@NicolePoirierSF	human
@BetterAfter50	org
@lucky_placer	human
@dani_testa91	human
@soratane_	human
@Jazmyluck	unknown
@MrAnthonyYoung	human
@ACMusu	unknown
@LifeElemental	human
@misschristaav	human
@kentosakura319	unknown
@GiOLee08	human
@NurNajwa_YS	human
@terraceinla	org
@coachJayLopez	human
@gourmandelle	human
@kymom13	org
@MatejMajer	human
@glyna18	org
@LiveFit_BeHappy	human
@GiseleSLemos	human
@kittycamz	human
@clphillips20	human
@hi1oaki	human
@MinKimColorist	human
@MarkPhoto54	human
@TekMNK3	human
@blueneptunehair	human
@monicakerstin	human
@mimsylicious	human
@LOStnachos921	human
@sydnie_purcell	human
@bialbj	org
@Kiss_MiiClass	human
@jasonk27	human
@fabriziotarallo	human
@AnnieSieht	org
@ThinkPlateO	org
@FantinelWinery	human
@MainStreetHRVA	human
@116theCITYnews	human
@Flakiz_Flirty	unknown
@DianeScuderi	human
@HarshulBohra	human
@zeeiwashita	org
@MymieYazid	human
@Oasis_Cancun	org
@sam_fisk	org
@djyaknak	human
@Vegan_jax	human
@thefelicialicia	human
@pamsLILkitchen	human
@ImTheRealMckoy	human
@haziqsyazwan	human
@Hey_Craig	human
@Caypay	human
@SkinFitBitch	unknown
@shirleyamancio	human
@anna0471	human
@Lady_Bug87_9	human
@aprilsobsession	human
@ItsBlackTyBitch	human
@HomeSweetHomeNQ	org
@Patafunk	human
@barclavs	unknown
@w2wministries	human
@najwa_halmi	human
@IamDashingDiva	human
@periopasadena1	org
@Heesun716	org
@imroatulmufitda	human
@Anthonygudkov	human
@KnitYeah	human
@alicemilehaam	human
@MrARVIN_	unknown
@lcescalona	human
@becentison	human
@bekkbekk	human
@chocopainbakery	org
@francesmakil	human
@Erisan805	unknown
@lwalsh	org
@el_makhloufi	human
@aldocand	human
@c7e2081575664b3	human
@reynaldojeh	human
@MyteacupStyle	human
@UtsukushiiOni	unknown
@JohanDaDo	org
@mrsfishie15	human
@cykelcafeet	human
@ning_indri	human
@juicylucy_27	human
@marie_haddock	human
@sandrasannovi	human
@MrsEdwards_xo	human
@SavvyVeganLivin	human
@ma_y0425	unknown
@HannahViney2	unknown
@agnesbennington	unknown
@AbsoluteCooking	unknown
@the_sheepfold	human
@innerfrenchgirl	human
@BeautyandEssex	org
@SexyDidi_69	human
@roreetaz	human
@lefrenchdude	org
@alexsjaya	human
@She_Dares	human
@CityBakeryAVL	org
@ccs_rshb	org
@bedsbizwomen	org
@Erelkrnfl	human
@FleurBarrett	human
@work_online2	unknown
@notesfrmthecity	unknown
@CinnamonRedC	human
@MissValGrace	human
@RiscaKusuma_N	unknown
@PublicAustin	org
@Crumble_uae	human
@seanmichaelhsu	unknown
@sweetlorrainesb	unknown
@StephSwartz824	human
@yuka_keanu	human
@DemetraBeauche	human
@C_mett	org
@JasonIanXIII	human
@chinittajen	human
@WhitCoLib	org
@bigshotmkt	human
@ArumsFoodFotos	org
@muamuav	human
@toddcoerver	human
@SheaDiamond	human
@WilPossible21st	unknown
@NewOxfordVan	org
@schong1016	human
@jessicadisini	human
@natlamlam	human
@StormySooner	human
@na0922subr	unknown
@jessicamch	human
@acrobatjr	human
@itsmephixie	human
@lalaburn125	human
@NoshandNurture	human
@MySweetMission	org
@mixedupsoul	human
@SarongJohnnie	human
@Kuaid	human
@PizzaMetroMan	org
@mitierraorganic	human
@PointandFeather	org
@william211188	human
@noodaii	human
@xxbebxx	org
@HitchinUK	org
@meteor6523	human
@CLR74	human
@CafezzitoAgs	human
@aprendy90	unknown
@MVPGrill	org
@ViXPHermanny	human
@OpenTable_PHL	org
@BikanervalaIN	org
@GabeSantiago1	human
@Cofuto	org
@VerierCo	human
@6erson82	unknown
@KathleenHessman	human
@socialmediafr51	human
@happygrillmore	human
@stephgas	org
@CoralHoeren	human
@zeegalvin	human
@siscawidyas	unknown
@dianmatsu	human
@gragrababy	human
@MarquetaSmith	unknown
@ElisaBPasino	human
@Grkqtmustanglvr	org
@PotluckCornwall	human
@phatbolouslyniq	human
@SOEFK1	human
@postscriptress	human
@Equitrekking	human
@maya_aoki	human
@2dineordash	org
@TheDepanneur	human
@imEdna_G	human
@yukiamei	human
@LCoyotemusic	human
@vigitam	human
@etsyoriginals	unknown
@feleesh_22	human
@Karenski3	human
@utopiagoodfood	org
@muuzix	human
@MaidenAustin	human
@wright4UFitness	unknown
@adikcpedro	org
@vitzky	human
@saskiaelvira_	human
@shilohbarkley	org
@anita_luy	human
@beatsbyallday	human
@DrRichSmith	human
@Migueeelon	human
@menassimascara	human
@kaytay4311	human
@Deez_Nails	unknown
@AorPhatthawut	human
@Rockforever01	human
@KarimShalon	human
@StuckInthewebs	unknown
@Lookof_Lyme	org
@tomokofu728	human
@daauuz	org
@consueeyore	human
@coachkay_	human
@DJJAKOBE	human
@amirulomar	human
@KandyDisenos	human
@CarmenONeill	human
@LeoToKoko	human
@ken2_dear	human
@YURINA_M601	human
@hmvWorcester	org
@MiraShafiQahR	org
@skene	human
@thebendomachine	org
@spookcooking	org
@JackdawE5	human
@HyattCincinnati	human
@AgroHort	human
@poetie_poetie	unknown
@ILuvDionne	unknown
@foodtruckhoe	human
@dillingerkid	human
@MariaHodge	human
@jerrytejada	human
@EleonoraBranca	human
@eadleeneazzaty	unknown
@KimFeiLix	human
@J666MMY	human
@PolNimal	human
@Mister_JB_Sir	human
@trashychiq	human
@CoAnalisisSV	unknown
@BBCLeopold	human
@Vero_Robayo	human
@shiaojair	human
@LMen	human
@kyten	human
@lamicheli	human
@RexTrulove	human
@Foodfactscom	org
@PalmerJoye	unknown
@FiqriThePrince	human
@krloshomefree	human
@OddfellowsOC	org
@MissyGotGame	human
@ery344	org
@artianza	human
@inLAMPUNGcity	org
@Hendry_hens	human
@FlorrKim	human
@cherrybushell	human
@MikyAliy	human
@BarbieXeng	human
@sanjayrsinghal	human
@iameljhaystrong	human
@driscoll_kay	unknown
@LiliRocKS	org
@zenacouture	human
@sofieimoet1	human
@iowagirleats	org
@Snehatyrewala	human
@Luca_Gaia	human
@paul_swinson	human
@AndeanAlliance	human
@MeroMeroTamales	org
@jubileemarket75	human
@YuliettNavarro	human
@NaotoKyuu	unknown
@pOrZy1981	org
@zoki1510	org
@Jonathan_Tavera	human
@JillCalhoon1	unknown
@ashwanimantoo	human
@sn_cabrera	human
@bmcgeorge	human
@Pharaohtography	human
@cook4beginners	human
@VelvetHotel	org
@OrangePretzel	human
@NYC93	human
@inallhonestynyc	human
@aihvee_03	human
@ImDopeObeyMe	human
@BountyfromBox	human
@mayemaye_11	human
@fslovexxx	unknown
@anixx24	org
@Greenescork	human
@gymmemes1	human
@IrixGuy	human
@KnowStyle	org
@AstuteLibrarian	human
@piiiiiiiiihyara	human
@johnnybeane	human
@PotentialMr	human
@lexivarsity	org
@LastCallWan	human
@BEAUTYCALYPSE	human
@arielramdeen	human
@steven_bow	human
@caribee71	human
@MattinikAko	human
@dancingnancyla	human
@izzywizzy01	human
@satomin55	human
@cooklynNYC	human
@wolverine951	human
@ShiengMe	human
@JessDorado	human
@modahr	human
@mizzashlee8	human
@deepakkumar_me	human
@abletotype	human
@NurHelmirul	human
@al2getherFit	human
@GQBarDubai	human
@second_startt	human
@Impalas_Lover	human
@RESIDUEYUNGIN	org
@LindseyMeansFit	human
@melissatheo24	unknown
@carmenbracho28	human
@VeroveroP	unknown
@walshmsw	human
@just_joan	human
@wilotochristov	org
@SofiaRirin	human
@vegfitblog	unknown
@DenRosen	human
@TheBabyBible	org
@TheTownDish	org
@side0fdahill	org
@yolevski	human
@MelissaFalzon	unknown
@ScarlettScotlan	human
@streamlinefilm	human
@Fadzmeera	unknown
@alainfrancis1	human
@msnat226	human
@IamTheJessieD	unknown
@FunFitWell	human
@podolyasha	human
@stylepeacock	org
@kristhepotatoe	unknown
@Cas_Ladalco	human
@wannab1994	human
@IsaZaihasram	org
@khanyizama	human
@TheWingCounter	org
@airyen89	human
@JFAnderson2012	human
@AkoShrwin	unknown
@vigim4789	human
@Alexmoyamusic	human
@ToyaBanks	human
@EnrimharAnne	unknown
@cookwithsmile	human
@NothinButFoods	org
@mizukin76	unknown
@sKEPticalruLER	unknown
@ULFriedChicken	org
@AllStarFM	human
@Tapeoemp	human
@DeliJefferson	org
@IrinaaAtanasova	unknown
@recipesresto	human
@reduca	human
@evaporsshow	human
@insatiabledr	human
@Janice_wai	human
@prachi_sen	human
@stasiaac	human
@BWWTorrance	human
@jas2jar	human
@yumsogoodto	human
@kathmapanao	human
@ThingsToDoLakes	human
@Charlie__Dee	human
@Xtinasaurus	human
@Naturally__Love	human
@friendmoscow	human
@vivianallman	human
@fatfreemelissa	human
@TheAmeStory	human
@ItsTheKavaShow	unknown
@moonbites	org
@McrPromotions	org
@sanjapantelic91	org
@janeesdunn	unknown
@tysgliveoutloud	human
@chokomille	human
@Target	org
@AVONHMO	org
@JR53703795	unknown
@ermanmuslim	human
@Mrcs_01_J	human
@GourmetGirlND	human
@Insane_Report	human
@DonWacky	human
@SAMMAYE	human
@VaaleGuzman	human
@Guselkumab	human
@pokemonpride	human
@samanthaaries	human
@trim_down_club	org
@GoodEatinChi	human
@wasikengwee	human
@Uadenwalla	human
@unachicacomotub	human
@kcmama8	human
@AliciaCalfee	human
@NubiInteriors	human
@junniekahying	human
@Tene_F_BaeBee	human
@JoseMontell	human
@Corrinne_9569	human
@PochoVE	human
@themattbates	human
@whytas	human
@MissNiomiNYC	unknown
@YFWhoElse	human
@MadRimawi	org
@TheREALMASONMAN	human
@fashionsackerl	human
@ganzi_0524	org
@TerryTyler4	human
@MissMarcha1	human
@faithlessbb	human
@chellecoolit	human
@ChoHic	human
@NicoleCoolAss	human
@ShackSpeaks	human
@barryprotrainer	human
@APT_AnnaReich	human
@TheWineSisters	org
@NordicCoffeeBtn	human
@kosugingingin	unknown
@lovingpho	org
@SaviProvisions	org
@yeoudatan	unknown
@imglopetdellet	human
@pofarvo	human
@BrogenKillate	human
@SonyKris_GH14	org
@mihospark	human
@KInstagramers	human
@heartfelthamper	org
@mrsrietdyk	org
@desii_sagita	human
@mitaldubal	human
@cat928	human
@gwilkerson19	org
@im_n_blue	human
@nielow	human
@InnaRias	human
@YumieSushi	org
@Alex81sdh	human
@KidsStoriesGuru	org
@LittleZu	human
@zaiirahhub	org
@GeekGawk	org
@CandraHermwan	human
@theAmanda_L	human
@akom_1148	human
@El_Caminos	org
@Lau0603	human
@ThatGirlLaken	human
@Timouh	human
@rinasrainbow	org
@liiique	human
@AlindraVilla	org
@GustiGusty_M	org
@kabaretero	org
@janahgandawali	human
@JRoberth_	human
@ChicagoGrillCre	unknown
@ElectricDiner	human
@Debi_Boop	human
@MizzZaty	human
@PIPhotographyUK	unknown
@RachelleLee_23	human
@YeReMinYssa	unknown
@josieeme	human
@foodcrawlblog	human
@viviruchy	human
@veeyah17	human
@GodsPrincess30	human
@kiaaaak	human
@Chifette	unknown
@ziquyou	human
@babyjea	human
@miwa_in_oz	human
@MirellesWestbur	org
@emily_fearnley	human
@MisterFinchFreo	org
@Bree8734	unknown
@Morgan18Hannah	human
@moderatemum	human
@ameeta3	human
@nadinekam	human
@SayyaR	human
@foodie_ben	human
@NickysCoffee	human
@thecheshirewife	human
@iDSohn	human
@MarcMullins1	human
@BlaqMystique	human
@my2diaryblog	human
@LiloChanel	org
@hinterlandwine	org
@katarinaofdnile	human
@alexgastronomi	human
@etvonweb	org
@PerezW15	human
@klbabyy	human
@aprilgirl_mk	human
@chamzie07	human
@maanloloves	org
@SurfGirlBrit	human
@fromthetabletop	human
@iAmDatShae	human
@FETRON	human
@healthilinguist	human
@cevizbiz	human
@DeirdreLorenz	human
@OhMieG	human
@EmoneyCrazy	unknown
@manosgavras	org
@Meadowoodnews	org
@sweetverona	human
@ZaradiahAB	human
@greggers_dj	human
@Haedeline_Here	unknown
@AlaynaWiry	unknown
@DeenHanafi	human
@feegadisnugraha	human
@SarciaRuby	human
@iSaliena	org
@AtlantisCoffee	org
@Pekahbooo	human
@MsPrincessHayes	human
@mero4649	human
@njstylesinc	unknown
@Vegalawless1226	human
@pepsigolda	human
@AdellaNYC	org
@yoshimus013	human
@MarLiinCR	human
@guitardjulien	human
@Isen6933	unknown
@GourmetGame	org
@shell_shoez27	org
@ipenhealthstuff	human
@emmajfitzgerald	human
@mealate	org
@MOLLLTEASER	human
@Brasserie1010	org
@CurtisStanding	human
@EATENBYM0NSTERS	org
@RogersHotel_TX	org
@watershedcafe	org
@tobil_lampard8	org
@supershamela	unknown
@AliceRDempsey	human
@CuteBright	human
@LouiseDraper	human
@gossipgrltalks	human
@CDXX_sf	org
@SashaVarenko	human
@muitoquerida	human
@marcelravin	org
@TotalExotics	human
@irmadevanty	unknown
@fairbornehomes	org
@kharriau	human
@Marlme	human
@Mlle_Jules	org
@ayaping__	human
@urbanquarterco	human
@PerfectPervis	human
@sosomustafa2	unknown
@jennieoousieo1	human
@mashdirect	org
@bluebuzzybug	human
@motoencontrors	human
@NathyGalarreta	human
@Dim2425	human
@xijikazyruzy	unknown
@chungz	human
@ennySugih	human
@WigOutBeauty	human
@OneEyedFlurry	human
@manatwun17	human
@isapo100	human
@zRicoB	human
@HIGH_LiNDSEY	human
@Jaonu_gf	human
@domingotrejo1	human
@robyndaviephoto	human
@sss_820	unknown
@r1k1garcia	human
@AndyF	human
@Kandy_467	human
@alice_nazarethj	human
@NutriFormance	human
@cubscatcher_2	unknown
@SchampLiselotte	unknown
@eatandysummers	human
@bnandita	human
@andychuRD	human
@fabiansbistro	org
@CrazyIrishDolly	human
@30PlusAccounts	unknown
@nutriloving	human
@darrengantt	human
@twohealthykitch	org
@mktyshotee12345	unknown
@emmjull	human
@tammyvon	human
@AleMarte19	unknown
@honeygirlk	human
@Flycity101	human
@AntonyWelfare	org
@bitchelle18	human
@ForstersVintage	unknown
@SaintAnejo	org
@Julia_Al_Arab	human
@steph686	human
@ynasanpedro	human
@loveforlacquer	human
@britt_brownsuga	human
@LadyWifeyGage	org
@BornAndRaisedLV	human
@RobELeeIII	human
@thalliadodd	human
@wineandfoodblog	org
@GoodGuy_Chuckz	human
@RebeccaCartier	human
@Bich211	human
@nerdBaLa	human
@lucieray	human
@deverdepintonym	human
@UrbanPaleoChef	human
@LuneMagenta	human
@SushiUno	human
@johndonavonlive	human
@azu3zu	human
@DrinkLunaSueno	human
@GoodGrubCompany	org
@StevieT2588	human
@drop_x_x	unknown
@iliRivas	human
@Bitchtwittanomo	unknown
@SaintsRugby	org
@skate_classy	human
@znonki	human
@gruvmedia	human
@JDContripleR	human
@BoomtownNOLA	org
@VladyGomez	human
@TheKeyofKels	org
@ilvindurorez	human
@Cachaaibara	unknown
@hilaly40	human
@AriellesSweets	human
@sweetemprez18	unknown
@k3vz11	unknown
@allan_d	human
@sintoista	human
@UpperEastSidah	org
@Lovely_Seeya	human
@judyshriner	human
@carolineselia	human
@antoniuserwin	human
@Burtaii	human
@Mira1991	human
@heyherbivore	human
@lvlvlyy	human
@joelxaviermusic	human
@bobcat62688	human
@Gmc026Mclean	human
@ItsNowU	org
@plk_boedaw	human
@talha237	unknown
@nesloashley	human
@catoliveira29	human
@Jean8Grey	human
@eamajor	human
@lykajareno	human
@DreamChaseHer	human
@RaffyINTER1908	human
@CosmicVoyager	human
@lmuvdi	org
@escoteshare	human
@AmyusB	human
@bamfactory	human
@loubawden	org
@mayanksarisr	human
@annieebum	human
@BellyMonsters	org
@fitequipmentuk	human
@alexandratity	human
@Chitchitchit	human
@Heromaan	human
@justenstryker	org
@FilipaRSantos	human
@M7Gadget	unknown
@CYanarella	human
@uMOLLIEw	human
@GeorgielouisaS	human
@_ShortyMcShort	org
@dayjonno	human
@hlmcraft	human
@Cicely473022	unknown
@shikinismail	human
@definitelydora	human
@sonykpk	human
@GameOnMom	human
@dreamsin4d	human
@julianwki	human
@_thegirlthesea_	human
@Azteca_CR	human
@MetMsavourent	human
@blncntrs	human
@bexter_sim	org
@MischiefMunki	human
@RungsonSam	human
@UKFoodshow	human
@ScottMunro48	human
@AyeeFTW	human
@shoemarley	human
@xKingJx	human
@ChicReaction	human
@ijah_28	human
@Theo137	human
@RajQsar	human
@_PoeticRebel	unknown
@_pinkschmink	human
@CJphotos1	org
@MancoraBayArea	human
@ClauMejiaD	human
@SCV_Network	unknown
@Cyndi0317	unknown
@JordansTHC	human
@snavas_75	human
@ChaCha_Singuwan	human
@yuipurinn	unknown
@saramusfira	human
@kotokonov	unknown
@torogordo121	org
@veronique_yang	human
@SAIDdal1923	human
@JETLIFE__21	human
@sthgnprtsdwn	human
@chiang06191	human
@natalayxxx	human
@_wei_chung_	unknown
@WhiteHeartDane	human
@ParanVirdee	org
@todricsresto	org
@RamRajesh70	unknown
@iamgregchainsaw	org
@rfcassidy	human
@imsachan	human
@OMGYoungCooley	human
@BlairGalick	human
@olenatomilko	human
@SR_ALMz	human
@RhevinaMaulina	human
@TheSwanSalford	org
@OrientX_Lounge	human
@whinnie_minnie	human
@twhitby12	human
@The_Bot	human
@09Toona	org
@cesurdoruk	org
@T_Wynner	human
@kenzalbe	human
@EpicaterTO	human
@MamaGaliFood	org
@chanel_nel	human
@EricaLeMaster	human
@Shakespearedoha	org
@DanLaMartina	human
@cremenatsu	human
@MARK_MAN3000	human
@sammaes	org
@alice_siddons	human
@JessicaLimpert	human
@erica_qu	human
@joejacksmith	human
@myfolly	human
@Nursefancypants	human
@BlockheadsNYC	org
@j4m1eb	human
@ThatsSoRaeRae	human
@housemiami	human
@DonnaAnnJohnson	human
@TheDejaZu	unknown
@honeyremooon	human
@Agustina_usa	human
@oceanicresort	human
@introductions	org
@ericlewis91	human
@WestDidsRA	org
@chiaravilla2011	unknown
@Sam_Rondeau	human
@NicolaVega	human
@alvcramis	human
@ogawakazuhiro	human
@nerdblogpl	org
@GiuCiccarelli	unknown
@DawK_PSL	human
@tasteaway	unknown
@goodgranolaco	org
@SrCarterD3	org
@Mistuh_Brown_	human
@AmyDelaine	human
@colorguy57	human
@SonyKhuttan	org
@KaraDykert	human
@GemmaGwen	human
@SarahLou_M	human
@lanahirth	human
@FCJr	human
@jaris_official	human
@2shopqueens	human
@RosieRose817	human
@PSharding	org
@JebiOfficial	unknown
@panesdejamon	human
@SalcombeTIC	human
@IrishPubPhilly	org
@Sblm	org
@SanadElrishi	human
@TOASTSanDiego	org
@DarkNight_PS	human
@ChrystelLivolsi	human
@moniquemixx	org
@lowcostholsie	org
@sumiemon09	human
@Toob_Alers	human
@tonetotone	human
@Afteryourevent	unknown
@drummerboy9645	human
@glamchick23	human
@MeffMaker	unknown
@SportsDirectTV	human
@workoutapparel	human
@Sheryl_s26	human
@KyleSBaxter	human
@SeahawkValdez	org
@josmandrea	human
@Annida_Online	human
@tyuriika	human
@sara_varga	human
@cottoncandy_117	human
@simmjul	unknown
@jOOLZable	human
@achiachii	human
@hotelkinggeorge	human
@ElizabethAndie	human
@mikayichelle	human
@Mathildebistro	human
@tvtoni	org
@FoodSoGoodMall	org
@Lizsmithyorks	human
@CaraLatchford	unknown
@swirledsweeties	unknown
@manuelasardano	unknown
@emilywarawa	human
@HaiBanyuwangi	human
@Hellomynameis_b	human
@cafedejoel	org
@famiefauzi	human
@inamchul	human
@InspiredbyTLC	human
@EmsFood	org
@immaray	human
@keiren005	org
@ireneclemente16	human
@noelmorrisxo	unknown
@hASHbrownLEY	human
@FoodTruckManna	org
@shelbyzhang	unknown
@BronxBarbieDoll	human
@KaraEStout	human
@Sura_30	human
@gardenoconfetti	human
@ashley_bohall	human
@BocciaMilano	human
@peter_kehl	human
@anggarinidwitya	human
@Liliane_AZ	human
@matibascorner	org
@AliciaCasillas_	org
@neetanyj95	human
@pelaezleo	human
@Karoljin	human
@Cakehounds	org
@Eastwest_Hotel	human
@ThaihouseOKC	human
@jbuttins	org
@WardrobeFlair	human
@Sousadeassis	human
@Tanto_Chen	human
@HarrietMoss	human
@LePavoniere	org
@honeyanddenim	unknown
@qziedana	human
@dermutanderer	human
@DJKeelez	human
@AStepoFaith	human
@ElkhartTruth	human
@KeetaKenz	unknown
@alohaneener	human
@PROFESSORGT1	human
@leblogdenini	human
@andycheung2608	human
@scarlettgf84	unknown
@al9890	human
@andrea_gg9snsd	unknown
@KerryJDonovan	human
@ayu_alifa	human
@pmk101	human
@eveningtimeview	human
@atxisawesome	human
@17Caro3	human
@WellingWu	human
@PutriaHN_06	human
@ram_spikemeon	human
@GrilldBurgers	org
@caecilmoerti	human
@2ia85	unknown
@SedaKali	human
@RoccoPoint	org
@seanadair	human
@GregsterUK	human
@juliekristine	human
@elizabethycy	human
@MattSait	org
@maima_0808	human
@turbohendy	human
@RashadMaine	human
@TattooSharer	human
@whyalexx	human
@eric_portillo12	human
@mashandsoph	human
@Fashion360mag	org
@daleluarca	human
@AashsLittleTalk	human
@SamColes2	human
@KeystoneMkt	human
@Solo__Solongo	unknown
@GoodnessMeFood	org
@JohnAshTestToss	human
@chefrp	human
@looseladies	org
@iedamyza	unknown
@jose_delgado9	human
@melissapuente1	human
@SylvaVentus	human
@JingQuanSoh	unknown
@crazysylvana	human
@slapcityempire	human
@InterKhobar	org
@ilazainal	human
@DotLee1	human
@RachelCarterPR	human
@WhatBobbyCooks	org
@missn2ishn	unknown
@brandifickes	human
@derdrew	human
@guccigoogirl	human
@get2shredded	org
@arkinkohenn	human
@No_Names_Needed	org
@HejClaudio	human
@CraveMyDish	org
@CambridgeUSA	human
@sangster_nyc	human
@k3vtan	human
@Lilianna27	human
@uqbnooytwx2	unknown
@oyDeyb	human
@RAZ__ZACK	human
@Jacobaduh	human
@dennis_kumara	human
@illone2	human
@Me_Pia1	unknown
@annnekaz	human
@MarcelaKubova	human
@whynotorchard	unknown
@lakshabay	org
@zalyazid	human
@birdutterance	org
@marleyreyes	org
@highstreetdeli	human
@EversonJerome	unknown
@TriposoKyoto	human
@nobbygaga	org
@pammmyyy_	human
@hswm_nmb48	human
@manrajsembhi	human
@LiveBlissNow	unknown
@nfatwasari	human
@ukyogis	org
@iam_tonee	human
@creamycaramelo	org
@baragarayaua	human
@KellyHarney1	org
@Narrowboatpub	human
@Coachbudhurt	human
@_AlwaysMissD	human
@ChampacaB	unknown
@gleddii	human
@tomiyamachi_bot	human
@George_Stockton	org
@tinkbrew	org
@Mari8Garcia	human
@vyandraa	unknown
@andreabalt	human
@biggrutherford	unknown
@CathyCecere	org
@HeartDiseases	human
@amberxojessica	human
@PavillonArsenal	human
@HugsandHearts	org
@ehaugeli	human
@shellypuri	human
@bkonair1450	org
@8Kbys	human
@BubbyChulo	org
@10Acre	org
@Arnabisme	human
@Dzethinie	human
@chochocolate_yi	org
@integratedRx	human
@Rob_Gallegher	human
@Tinnyse	unknown
@alnbrookes	human
@drolifo	human
@KentCrisps	human
@nietoperek	human
@Leng_24	human
@lebolukewarm	human
@BuyWBL	human
@theiceboxcafe	org
@PureGraceFarms	human
@c8nhogarth	human
@VaniA_YoungS725	unknown
@Harvestonhudson	human
@theunsinkableKB	human
@HiroIshimura	human
@tweetbusselton	org
@shirin_shahin	human
@UltimateGav	human
@bb_b34r	human
@Jolie777	unknown
@_Audio_Police_	human
@samcanfitness	human
@nikkimccaherty	human
@jennifer_su	org
@annie_tassinari	human
@paulabendfeldt	human
@TheRoxburgh	org
@KamiKamiola123	human
@meadrienne	human
@MegBUnlimited	human
@Samminat0r	human
@Fairfield_SeaW	org
@b377ad0nna	unknown
@smilepiyochan	unknown
@MeloVlog	human
@iam_Exceptional	human
@busymommylist	human
@BasiliosJeraly	human
@kooooye4	unknown
@AmyEVilleneuve	human
@Deltalynn	human
@JPAuto	org
@therunningteach	unknown
@Smolinil	human
@0419_haruna	human
@montsinaromero	human
@ziyasarkfatih	human
@Slindo_M	human
@cuquita1982	human
@guyfarrow	human
@ThanyaFernTK	human
@57MCM	human
@A__Bin__Saad	unknown
@HelloAcekook	org
@FoxxyChef	human
@FuzzysBricktown	org
@jordannlampel	human
@NykiBell	human
@USN_UK	org
@JulCafetaoGB	human
@HyattScottsdale	org
@4everRAMON	human
@MrMangoKiller	human
@chuckd660	human
@GreenWeddingCA	org
@fidegudiel	human
@LaTGastrobar	human
@AlanaAldeaMusic	human
@MyAsianFoodTour	human
@UmiHartina	human
@Sally50702222	human
@cjblackwater	human
@TheMadameMoi	unknown
@BreenDinno	human
@redsoriano	human
@MarkDilnot	human
@BrightBeerJames	human
@WeddingsLomasT	org
@SharleenRamos	human
@bartone93	human
@nosnin	human
@arkinicole	human
@thelobby_hotelv	org
@Javy_Jaz	org
@Loes_Kotoun	unknown
@spotthedealusa	org
@mhaiormilla0424	org
@ColtonDfan96	human
@FrannyCrawford1	human
@thebeanstore	org
@wqwozdw	org
@sheispaloma	human
@brighthaus	human
@JeanineSteven1	unknown
@larseniy91	human
@TheOneRockLive	human
@AbarbieriB	human
@DoeJany	human
@Expchester	human
@yolanda0109_Z	human
@Elizabizabee07	human
@JSilva94	human
@LaurenGoodger	human
@StewartFraser91	human
@hridya_m	human
@JumeirahET	org
@Cousine10	human
@Janice_R34	human
@airportlounges	org
@asyrafmormecy	unknown
@apsyarafina	human
@funsiize89	human
@PhillyAsianFood	org
@SenSpa	org
@Inaaaa_88	human
@Reiniew	human
@i_am_hologram	human
@IfyAndy	unknown
@ahaha6541	human
@Carmen_Szeto	human
@ivansivoro	human
@traveling_SEA	human
@skullver1735	human
@_Whenpigsfly_	human
@WagamamaDubai	org
@_eych	human
@unicorn_em	human
@seanaceoconnor	human
@jucamar10	human
@TayNewLife	human
@KerisGallery	org
@Keebyatch	human
@orphean_warbler	org
@yuen_andy	human
@amvazquez	org
@_creperie	org
@EGreen_Blog	human
@360MOM	org
@Artem_com	human
@beauforthoteluk	org
@geishacatmama	org
@PatriciaStreete	human
@Piiccuee	unknown
@BESBoston	org
@Luke_Bosster	human
@palmbeachsxm	org
@casarojafaralya	human
@fpb1973	human
@vinnie_chin76	unknown
@babydolldatsii	org
@Laurakeebs	human
@eRRRahman	human
@TamesideRT	human
@riCHElle_itsme	human
@JoakoHandsome	human
@NarledyValerio	human
@5Hearts1Family	unknown
@ilovejoce	human
@Shanelqj	human
@splendourazilk	human
@iori_m_1223	org
@RGVBusiness	human
@_NikkiAsh_	human
@NouraBooks	human
@tkdpaleogirl	unknown
@IWannaWok	org
@JamieWillshaw	human
@a2food	org
@SweatyPrincess	human
@MTGYL	human
@xychad	human
@BadBoyHawaii	org
@prprau	org
@libyjeans	org
@kitchenmancooks	human
@Flaming_ice	unknown
@stgeorgehotel	human
@Dennis_SC	human
@k_motop	human
@sk_ex10	human
@itsmekaye18	unknown
@unutus	human
@travel2sanfran	human
@TanInSeattle	human
@MilagrosBridgma	human
@katelyn_thomas	human
@Uuurmi	unknown
@SashaBaRD	human
@ozgurozmavi	human
@angie_caro3	human
@EatDrinkAnna	human
@mcpolcruz	human
@AdiyantsMilena	human
@iamDonareen	human
@LivingAndTravel	human
@PinMeUpSuzie	unknown
@bkgblogerxvii	unknown
@815wrldtrvlr	human
@Sooztheartist	human
@babymoniQ	human
@MattDodd2	org
@pedrombafonso	human
@Kitty98LJ	human
@BiciGirl	human
@AXADDA	human
@MelissaMSmith	human
@juicemaster	human
@chefjustinnorth	human
@e_vern23	unknown
@DenicePaola	human
@zeewriter	human
@debwh142	human
@FabrizioBurro	human
@dianajiang	human
@riza_oey	unknown
@killzeroes	human
@keke_fashowitit	human
@roxombie	human
@BrizosPoetry	org
@TianyanOng	human
@shanghaisupper	org
@nycstephen3486	human
@Jschexxy	human
@AbigailGray1990	human
@inciDolgun	human
@Nozin	org
@Travis_Crow	human
@PARMESSANO1	org
@VengaCantina	org
@GreenArmyPest	org
@OMGheeButter	org
@kadirbingul	human
@ShandySykes_TWx	human
@shyamkonnur	human
@BrianMalarkey	human
@ROGUISHDOOBIES	human
@NachOrellana	human
@__TREEZ__	human
@glaswinebar	org
@jmalonecreative	human
@iamjhayt	human
@jventers923	human
@Julias_Seattle	org
@AlbanyBID	human
@RayspicksNYC	org
@TheFoodDealer	org
@PolinaBuzanova	human
@meces29	human
@ako_si_ish	human
@hann_roberts	human
@Casa_Sol_	human
@lilj0n	human
@City_Perch	org
@shropshireweb	org
@TheCelticHearth	org
@AdamCUnderhill	human
@shoesanddrama	org
@LielKoletMusic	human
@MelRomilien	human
@nalika_2010	human
@haw2400k	human
@oamzeeza	human
@Emma__Peel	unknown
@amyrmac	human
@DonDon_John	human
@ASRRoseville	org
@JustineForrest	human
@TheHolidayCots	org
@RuthIsabella_RI	human
@TaraaaJayyy	human
@fra_fraise	human
@sayitlikeitis10	unknown
@InFaMoUsNaNi	human
@paul_from_az	human
@CHRISSEpipataah	human
@trulyredbulls	unknown
@__emi__smile__	human
@kemalcantekin	human
@takuya410sv	unknown
@udiprg	human
@MoteSilje	human
@erhlew	human
@mii_7269	human
@MariquillaSt	human
@xaviieerudoo	human
@solochefff	human
@PatmosAktis	org
@OnurTuncalp	org
@mting	human
@AAlexiszxc	human
@DoughDough904	human
@brandikey	org
@Ashton_u_Lyne	org
@jasonsaura	human
@KleaAndron	unknown
@MollyErinW	human
@d_dorothyjane	human
@ElvisPP10	human
@Neyoharr	human
@gugap_star	unknown
@DenhamRamon	human
@MrsSMade	unknown
@makeitloud	human
@rie_janine	human
@SlickPhotograph	human
@MirandaSman	human
@SnackBarReviews	human
@DanielaGaldo23	human
@KendraDawning	human
@KendraSpencer90	human
@InnkeeperTFP	human
@ferraro_raffy	human
@mstar_88	human
@Gourmet_it_up	unknown
@tytada	human
@ApplebysMcr	org
@stevieGmusik	unknown
@oneDERREKtion	human
@I_am_Maria_Y	human
@rafffael_lima	human
@meoangel37	human
@cjansen1	org
@j_flordia	human
@Alsh3aibi	unknown
@ViBE_ub_cherry5	human
@Pantherstar22	human
@MisterStevenLee	human
@CBRLife	human
@cucinaparadiso	org
@mcarmenteo	human
@suns_and_stars	human
@iamwonderdonna	human
@damelia_livy	unknown
@Stailun	human
@EmilyLouiseRE88	human
@VYogaChi	human
@Jo_nicola_f	human
@DudaDraz	human
@ImarieLarios	human
@OregonNguyen	human
@shifablue21bsb	human
@DosFamiliasWine	org
@Silvia_Grassi	human
@kidaJB	unknown
@cecetasha	org
@fuyunt	human
@Titomixx	human
@sbmk701	human
@umargl0bal	human
@oinkoinkety	human
@L_Kerryn	human
@izumindina	human
@amothersmilk	org
@MariRomi11	org
@czechclaudia	org
@aRdHyaLwaySs	human
@RamadaSpokane	human
@earthboundfarm	human
@jenbrew85	human
@DumbAssVids	human
@LittleHippyChef	org
@shykaliguy	human
@for_kitchen	unknown
@M_Nikolaidis	human
@ElisaGreghi	human
@ChristianKinell	human
@WindmillClapham	human
@bigandfine2	org
@meggycrva	org
@SevenNineZero	unknown
@runapoppo	human
@JoslinDiabetes	human
@XitApp	org
@DewiRahma_Adi	org
@bionic_phitness	human
@soycarbonero	human
@SupremeEvlQueen	human
@REdward_	human
@ArmonNavy	org
@zoo89	unknown
@Nacho_Sandoval	human
@tonyahayne	human
@brenda2bjb	human
@DjWaterboi	human
@BeeGeeCZ	unknown
@Rotisol	human
@cagrownofficial	org
@corazontweet	org
@DECOLOVEatelier	human
@JohnSeymour_	unknown
@jessa_slzr	human
@rusfruit	human
@IHCINEK84	human
@territeddi1	human
@CaninesCouture	org
@BeautyDressing	human
@Perrybwoi	human
@iamleaanderson	human
@bar44cardiff	org
@beavieka	human
@Fanshuwen98	unknown
@SanneRaySoro	human
@valeriavlow	human
@daqsslove	human
@jaehne	unknown
@wyebrookfarm	org
@BecciRoper	human
@cynthianicoleg	human
@patchtastic28	unknown
@caesariade	human
@Lakersgirl83	human
@oscarjackiechar	human
@Caramel_girlz	org
@schavana	human
@cristinabazavan	human
@VeIvetRose	org
@BarBrewery	org
@chrizlum	human
@unicornskitchen	human
@mgoicoechea	human
@ChanmanStyle	unknown
@LPQDC	org
@shi__h	human
@91n93r	unknown
@LacyBernhardt	human
@MARHUngis	org
@teraswhey	org
@Love_mjjeje520	human
@ramenagerie	human
@FrankVasquezJ	human
@9ratna_9	human
@BakeWithJack	org
@MissJennyTran	human
@gr8wings	org
@iMaxLin	human
@R0bynNicole	human
@Soniabaez99	unknown
@Husam_Mahdi	human
@DagmaraWJS	unknown
@TheAppGarden	human
@Pahtriq	unknown
@JediPimmy	human
@kotar3	human
@beanHappening	human
@heinzsanchez	human
@sincerelypoop	unknown
@DavidMuhlstein	human
@LaVinaLiverpool	org
@MariaAgida	unknown
@nuzulullaily	org
@Madhusanka93	org
@TraneiceShane	human
@imrealmart	unknown
@Knourish	org
@asesoriasfit	org
@SamAJohnstone	human
@HouseOfCurryMe	org
@HillsideClubNJ	human
@caliito14	unknown
@Bubu_AlH	human
@QueenToner	unknown
@KrumpliBrian	human
@FidKitchen	human
@djjaleoofficial	human
@RaXieLChoi	org
@OnePennyRed	org
@GabeFDome	org
@Angienewlook	org
@simonsquibb	human
@TheBaking_Lab	human
@NickeyStaar	unknown
@jivewithdeepti	human
@verticalbistro	org
@weave_song	unknown
@nina_hemmo_5sos	org
@boundlessfash	human
@cherylwennee	human
@Imlouricka	human
@VisitMijasCosta	org
@HRoxby	human
@KLrenChuChu	human
@JujuColina	human
@reswolke	org
@Midnight_Rain52	human
@Shahirah_Saadon	human
@gerry_yudha	human
@WildSmokeSTL	unknown
@Frizzanteltd	human
@MBO10701	human
@TaraNicole83	human
@BeJustFree	human
@EatCU	human
@_SherifElMahdi	org
@ClaraZhang0203	human
@Aldrin_Muya	human
@AizatHazwani	human
@shareenaaaa_	human
@psychocrzy1328	human
@fionasmyth	human
@Abeer_999	human
@BlushOohLaLa	org
@amoxiemomsa	human
@amisanoworkout	human
@intanjuliet	human
@iamglor	human
@harbourtapgrill	org
@marionjane420	human
@whereisthenusra	human
@TinyLittleFreak	human
@carissawarner	unknown
@MileHighB	human
@WoSA_USA	human
@wedinamess	human
@Grace_Carstens	human
@ticapella	human
@KroghLisbeth	human
@POM_Victoria	org
@ChaoticLadybug	org
@CosyBournemouth	org
@flametail2518	human
@suheem	human
@LeonardMiron	human
@calistaawyong	org
@teexwee	org
@DeeJayKutz	human
@kerrimedders	human
@FaithInFitness1	human
@greenpackage	human
@RyuNo_K	human
@contecoppini	human
@fingerfastlab	human
@christine_yen2	human
@StyleMotivation	org
@MaryLoran	unknown
@malpin83	human
@hriscareerworld	org
@dreamlandpt	human
@joanna_sison	human
@lingeswaran	human
@bkstacey	human
@Fahsai27	human
@madsmonsen	org
@tmmBEAR10	org
@kweeangga	human
@MiMiBABY_5	unknown
@Sml10431	human
@RaffAndRidge	org
@OliWorlds	human
@nidheeshn	org
@The_JabezJestus	human
@littledhita	unknown
@irinalakicevic	org
@Po_Michael92	unknown
@EVMUA	unknown
@PureEateryIndy	org
@beyondumami	human
@magchow	org
@_Thedy	org
@themobimall	human
@nyoing	human
@DimeCity10	human
@worldvintage	org
@vangiegirl2	human
@vehyuntop	human
@LoveLaFem	human
@0r1_yu	human
@states90	human
@avidajerusalem	human
@tephen_94	human
@MuratKuyumcuogl	human
@SamuPellizzari	human
@zalistatic	org
@HealthyPronto	human
@kelleyharvest	human
@sunnyk8quist	human
@pdepalloret	human
@Crinova	human
@olrikpflaeging	human
@IMshai	human
@tweet_miez	unknown
@WFIOH	unknown
@aliceliddellblg	human
@KirBerri	org
@NoahCharney	org
@SubwayBoldSt	org
@PYP_News	org
@saqipanther	org
@jooehi93	human
@nikkii_g	human
@blogmodeparis	org
@BlackAntNYC	org
@pinkchyna	org
@BukanDatinFAZ	unknown
@grannyfierce	human
@MissEBossBitch	human
@BCallegaro	human
@JoannaTuppen	human
@ISAPRONUTRITION	org
@LyNeShOuRi	org
@MarkanaMinor	human
@beautydesign15	unknown
@Jeux_de_Cuisine	org
@Nastya_10	human
@BettyBoopLuv	unknown
@alicitote	org
@NataliaChupil	human
@UC_STAFF	org
@RatnaBiah	human
@melandriaromero	human
@dalidalisch	human
@Strictly_Chris	human
@DelfinaLatour3	human
@rationanddram	org
@MandyNgcece	human
@familyfrugal	human
@toophatz	human
@ShutDaFkUpMarie	org
@CaterCon2015	human
@ThisAhPek	unknown
@ninernabila	human
@wiminizer	human
@Koiichie	human
@LarryFernandoi	human
@frugalgirl1	human
@drdavidsamadi	human
@martens_pamela	human
@neechy	human
@ChiRunnerMomma	unknown
@guiaoleo	human
@looktan127	human
@Christybelle	human
@Jenna_loui	human
@twopmjunction	human
@BrianMcCannJr	unknown
@skakinbacon	human
@Chef_French	human
@MyGGOfficial	unknown
@e_starpower	human
@JenelleWitty	unknown
@milleniumgray	org
@cecilia_cambero	human
@KSmutok	human
@s2_0423	org
@keituangel	human
@Pingswifties	human
@neiddy_ruiz	human
@poochienette	human
@PapiChulo_Bihhh	org
@francescamusone	human
@SerpelloniF	human
@JanessaBandulin	unknown
@glsesli	human
@rakskitchen	human
@CuriousPretzel	human
@CremascoliMarco	human
@fayeleung318	human
@PerfectBite76	human
@BellaDallas	human
@elvinet	human
@MAKE_reMAKE_	unknown
@Yuic0707	human
@AdamSchouten	human
@fitwrapsbyjenny	org
@thesecretsupper	org
@det3563	human
@HKorcesme	human
@tomberg13	unknown
@_FAMED_	org
@JesMarie813	human
@abhi_indelhi15	human
@LoveFoodBK	org
@LudyBrandao	org
@farhanahizham	human
@naon_ao	human
@lizarraga_11	org
@mische_xv	org
@Adele99	human
@HeyJirko	human
@lovsson	org
@FrancescaPillai	human
@fanashafie	unknown
@JessicasDinner	human
@ProgressiveRev	human
@hanam_hamid	human
@PeakElm	human
@PearlB_NN	human
@ShortcakeScraps	human
@Ragged_Cot	org
@DestinationSJ	human
@a_csf	human
@BestofBritainES	org
@Bertoldis	org
@DJKNUCKLEZ	org
@keetz__	human
@spillthevince	org
@xoxoHILAMEE	human
@gurupaint	human
@angiela_kim	human
@QueenAdSW18	human
@fuller125	human
@danz_pianist	human
@Gulteritta	human
@honey_apple79	human
@mszNIKITA	human
@FBINewbie14	unknown
@AlansVillage	human
@ViPetrof	human
@AlabamaLoverUSA	human
@GovindasDubai	org
@KingJames7828	human
@AlaskaLoversUSA	human
@jenny85617	human
@storiedellarte	human
@Kazfanks	human
@sh3maii	org
@DreamDinnersOpp	org
@Dylan_Azl	human
@MrCHILD_JONG	unknown
@NevaLuvAgain	human
@skinnteagirl71	human
@lyndseyg5209	human
@amingzzu	human
@fransiskairawan	human
@alvarezymae	unknown
@JordanGPittman	human
@xeloitalavera	human
@ConciergeAUS	human
@RaydeneSalinas	human
@ZoeDeFantast	human
@syipoh	human
@marjajohanna	human
@ChristerHansson	org
@tHeiligboontje	human
@afiqaxe77	human
@HollandBrodie	human
@MarieOngAllegro	human
@SarahKiboi	human
@HollyWoozle	human
@BaliHaiSD	org
@noviadees	human
@Mr_954_Busa_BTW	human
@ksedu2005	human
@jaronnsex	human
@GregBurke85	org
@nyamiuw	human
@courtzmelv	human
@pink__pirate	human
@mihofighter	human
@GlitZeeGlam	human
@kana_funa	human
@xtinaxenos	human
@SpudShackca	org
@bb0915	unknown
@TiendaWallander	human
@charbiiee0803	human
@hotchiufoods	org
@thefattybaomum	human
@robin1966marat1	unknown
@Official_Niki	org
@CoolChileCo	org
@AudreyyRose_x	human
@rharripersad	human
@NubianChicca	unknown
@esakwan	human
@Isita_Lopez	human
@ibviben	unknown
@debPDG	org
@Becky_Wren	human
@BlockandLarder	human
@letsmakeSIMPLE	human
@allanjenkins21	human
@Sola_Prestige	unknown
@mrimaboutadolla	human
@wordbird_ie	org
@sonofasouthernc	org
@lilkrazykdub	org
@waruna89	human
@mshyaciiinth	human
@vatsalaax	unknown
@lady_lazarus_	org
@I_am_Memar	unknown
@adamyusof	human
@bunnysays	human
@JWDubaiMarquis	org
@bananainn_bdg	human
@ImportFoodMark	human
@nea1027	human
@HDL_JennaS	unknown
@CamillsBrewster	org
@KitchenStories1	human
@LiliLVN	human
@asideofsweet	org
@yonmasa_06	human
@peskyme	human
@atlbarslive	org
@LadybirdOnly	unknown
@wendyluwrites	human
@ChinLovesIowa	org
@ICeezy	human
@AdlieAyie	human
@auliia_shelvi	human
@gurumiru1	human
@fashionmagenet	human
@LaBeatentente	org
@Vangie_Events	human
@SarahTerrivel	human
@Aroma_Imperial	org
@Vvntang	human
@NikolasSezar	unknown
@VisitSaltLake	human
@FYS_Perth	human
@_jessison	human
@Lucelove	human
@Sara12492	human
@jr_zurita	human
@SashenMe	human
@GSBHamilton	org
@rosyhappy	human
@recipefordisas1	org
@YunKEVO	human
@chlobeth_	human
@JustinaLeeStolz	human
@RL_EstateBarbie	unknown
@Melly_Cakez	human
@OhMyHeyzie	human
@abue282	unknown
@DIYTanya	human
@Woody_AFC	human
@sweet_chacci	human
@JaimeHickey	human
@ginica8	human
@ElinWallgren83	human
@vilmajar	human
@ksiazkowo	human
@ZensesHolistics	human
@SockmonkeysKchn	human
@arsenofwck	org
@Gamzee_Arpaci	human
@Vespiria	org
@tlimmartin	human
@HollyBrimm	human
@kateisnot0nfire	human
@Edna9211	human
@LouiseHamiltonn	human
@Trainer_London	unknown
@Parksidepdx	org
@Vital_Design	human
@f4nDy_1701	human
@KoryOnTheRadio	human
@Seth_Moretti	human
@chinxsterr	human
@Senjauh	human
@HeavyGunner1	human
@DamienDerwin	human
@NajearyB	org
@Toofeepa	human
@danitydonnaly	human
@KerbibbleVlogs	human
@DaOneAndOnlyMow	human
@misfashionista	human
@PierrePolynice	org
@CristinMcGrath	org
@ChannelZigZag	human
@WestminsterWed	org
@lovecyncyn	human
@dustinh1126	human
@waveseller	human
@ladyalanaxo	unknown
@Susan_Abramson	human
@angelcai25	unknown
@_jhOwayynna_	human
@CUCINAenoteca	org
@ParoleinPentola	human
@SmarterTravel	human
@JessieHardegree	human
@livelifeboldly_	org
@krolls_korner	human
@nogoions	human
@diewardiecha	human
@Huynh_	human
@leoragazza	org
@275Up	human
@iamMVIM	human
@CatherineRStaat	unknown
@JDsalem	human
@MsASH_IDGAF	unknown
@elviscocho_	human
@tabithadeanyoga	human
@DumbletonHall	org
@NatyTrickyAngel	human
@MisterrKraziie	human
@grrgsworld	human
@Courtney_Marlo	human
@DiningOutLI	org
@Zaraindian	org
@Vicky_TMUK	org
@Asiahwitdavoice	human
@ChileHotel	human
@OrianaChica	human
@JasonsBeachsid3	org
@kowsy125tweyrth	human
@artactivist_ekh	human
@FelipeAvalos5	human
@Wonderbooy	human
@BiancaRivera954	human
@GoRuralScotland	org
@SoulTiedN_AKnot	unknown
@BayStBiergarten	org
@Fiveminutestyle	human
@ESTELLAONG	human
@christinakhar	human
@ingridcorbridge	human
@lauren101339	human
@Juice_Garden	org
@jennifervitalia	unknown
@blissfulcow	unknown
@mynameismoshi	unknown
@iM_JuST_B33	human
@freakymarnz	human
@BruceLeoni	human
@MostKnownUnknwn	human
@trigrl10	human
@kaycataylo	human
@kairofox	unknown
@marvin_dc	org
@Hikarillex	unknown
@newbornindie	human
@MendozaEljohn	human
@Noor_Cahaya88	human
@lala_cooks	unknown
@kayajenn	human
@biggurlwitkurlz	human
@walkermdavid	human
@_CalvinLim_	unknown
@AresaDivinaflor	org
@rekasyt	unknown
@DigitalCrates	human
@adam_1017b	human
@taufanindrah	human
@cMoneyBitz	human
@Ninawilliamsonj	human
@JosmarAzzopardi	human
@minijo1	human
@Racheljedwardxx	human
@robynceeex	human
@wunch	human
@mycupboardlove	human
@BreffniHugh	human
@JoseyDope	org
@Sportsdiet_USA	unknown
@JoyceLeeMusic	human
@missbusker	human
@riza_bartolome	human
@RobinHorvatin	human
@johnasbaty	human
@hiroking167	human
@JirryJames	human
@SliceoflifeSOL	human
@delices_danais	org
@aya702190	human
@the_fiery_lion	human
@FINESSERoyalty	human
@JohnMatthew_t	human
@SityDaze	org
@bitememad	org
@ee27d67666a4428	human
@DonHerme	human
@NefariousNay	human
@jquinnlee	human
@mariedelcioppo	unknown
@Tunde_Fam	org
@JasonSchwartz83	human
@kayladawnwrites	human
@brunchologists	org
@astonger	human
@ButItsMaddie	unknown
@Gloriahillching	human
@rrozhevel	human
@CakeDesignLab	unknown
@angeld415	human
@MannieZak	human
@angelica_927	human
@csarj	unknown
@xeshnon	human
@FreedaLiCious	human
@Fit_good	human
@veruska_sanchez	org
@ynahmaye	human
@kikybrahmana	unknown
@tsurara_cocoa	org
@SKYLounge_Bar	unknown
@Castle_Hall	human
@khanali_	org
@mrschahrli	unknown
@DisBeds	org
@TheGoodFoodRoom	unknown
@ddelgado121	human
@iKHADZ	org
@OtherAmyAdams	unknown
@JustJessLA	unknown
@PLW567	org
@FranJJR87	human
@juan_ruizgarcia	human
@inazaguirre	human
@fight_theed	human
@7Lamps	unknown
@_Dur4n_	human
@clarkfarm29	org
@FoxyRiffin	human
@touristtrade	human
@BallacgJ	human
@safetygirl72	human
@donyirwan	human
@homestyledream	human
@Kimbolikes2eat	human
@listentojoshua	human
@SuperKaara	human
@FionnMacCoolsRD	org
@michaela_kc	human
@maigossip	human
@PaganOhio	human
@TBrianPeel	unknown
@xiiinyiii	unknown
@JJacyntha	human
@alainhernan	human
@365Sara	human
@komami0109	human
@iamJFord	human
@lusciousCT	human
@lilfishfoodie	org
@MstKn0wnUnkn0wn	human
@proveiaprovei_	human
@stxxcy	human
@Becca_Lou_Lou	human
@UrbanSlyce	unknown
@mynameislee971	human
@sweetcherrymode	human
@whoheals	human
@pepeantich	human
@brighteyesblog	unknown
@mahshooktweets	unknown
@MsMelanieM_	human
@aleelavine	human
@coachsarahraw	human
@adams_hire	human
@MeLoveAPump	unknown
@spiceandtea	org
@TheLaundryMoms	org
@PremiumPete	human
@pa_ul2011	unknown
@mr___moore	human
@t_nishijima	human
@chefkennyUSA	human
@jezztan	human
@pipiet_ajah	human
@jenzenboi	human
@VanessaRocha16	human
@CaptZexx	human
@GamerRAGEArtist	human
@kwissybelle	unknown
@TallThiccNdBadd	unknown
@PoppyPryde	human
@Kisses4Kidrauhl	org
@ayiswift	human
@IOKEYYOUOK	human
@pascalandsabine	human
@chezangelina	unknown
@valiriaaiwne	human
@MissPriss_Tiff	unknown
@MayamangJepRN	human
@beckylau	human
@AlisonBarker4	human
@Vivie_Viphien	human
@bonegoneviral	human
@MinutoliOrazio	human
@Debbie_Bam_1980	human
@MarcusWorldwide	unknown
@luposaniberica	human
@food_diva	human
@TheSmokeryca	org
@SalemWellnessFd	org
@Gooolds	human
@amiroarrr	human
@antonialim	human
@iluvsmiling	human
@ErinAnley	human
@MarwanMoses	human
@ZydecoBluesSTL	org
@maryylee29	human
@BurgistaBros	human
@ekin_sophie	human
@NOWBath	org
@FamilyBetty	human
@LLDJR310	human
@ward_jr	human
@ThymeAtSouthrop	unknown
@melissadunmore	unknown
@bloojuice	human
@rowdywith4	unknown
@shawnqk	human
@FatinSyafikha	human
@simonangeline	human
@Talula_nCo	unknown
@lizette_velasco	human
@CircaJoyLynn	human
@Amaliniii	org
@yukaring81	human
@Amy06_	org
@cho_hb4g	human
@MissFashionPark	human
@augustoled	unknown
@PhotogFound	human
@vickieadriano	unknown
@PattyMarz	human
@LucasDn2	unknown
@BuyDirectUSA	org
@TheDuoDishes	org
@Katy24Beth	human
@JewelrybyStacie	human
@StoyanBugarin	unknown
@FlavourSmith	org
@KandyKris91	unknown
@ObikaMozzarella	unknown
@mauriziocampos	human
@PeteyMillz	org
@twLola	human
@mrbjdatdj254	unknown
@letsbeach	org
@AnitaMunguia1	human
@CantinaTampa	org
@hawaiibobb	human
@gruttepyr	human
@illannpower	human
@clarentia	human
@OrangeJulius7	human
@diebotak	human
@littleforkla	org
@Margareth_103	human
@staceyharper	org
@TheMiGmartinez	human
@_bleGong	org
@LoritaWiryo	human
@pdekruijff	human
@VoiceComms	org
@hamzabenyahya2	org
@discoverPHL	human
@davidpai	human
@NJFPR	human
@rachelbaysi	human
@Ms_Glittery	human
@sora_hua	human
@marielrosenblut	human
@Noshsense	human
@neko_chhhop	human
@thefashionbutte	human
@BBNOMR	human
@TAXtizzil	human
@Dokdokbing	human
@Temakake	human
@noellecruz	human
@KentAleHouse	human
@BeerGirlCooks	human
@Suresh0s	human
@anne45aziz	human
@ChadSprouse	human
@BombayFoodies	org
@ShraddhaSirohia	human
@DaRealSiruTarou	unknown
@JAzaelC	human
@Lady_LaTonya	human
@cal_v3	human
@penjy	org
@xjozox	unknown
@Eleven26Talent	human
@Mix927acarigua	human
@phuniee88	org
@seanvernon	org
@Mickey_skr	human
@SendaCow	org
@MiamiFoodAuth	org
@_xoxokiera	human
@nitameilani	unknown
@nathaliee22	human
@IreAndrs94	unknown
@salte14	human
@BrwnTXBomBShell	org
@FreehouseMpls	org
@pualiping	human
@SSPAsafoetida	org
@Eugene96_wong	human
@vlnplyr2	human
@LaPapaRossi	human
@senpai____	human
@LarryBrownJr	org
@mickeyqing	human
@lenchuzerectus	human
@Vanesa617	unknown
@PhillipsBarrie	human
@LadyKdesigns	human
@clichenegro	human
@KCPepperBar	human
@evadietitian	human
@bifnaked	org
@Becky_ITFC	human
@FresitaCarola	human
@BluePyros	org
@JuicyJRoc	human
@tunglokgroup	org
@PaulaSoliant	human
@tastetestfood	human
@onflgator	human
@MsTrinkaV	human
@i_am_jeje	unknown
@echoside13	human
@WipalaSnacks	human
@Bella_Tar	human
@EchoYini	human
@tomhams	org
@Crystal1212121	unknown
@RobynTBraley	human
@NampHuangz	human
@CCherice	human
@mondayflowers	human
@shockun_yukosan	human
@renoash	human
@TheGBswhatwhat	org
@Fudo69	human
@mystilettolife	human
@blondite	human
@popuptabl	org
@al_my_life	human
@eledellaguardia	human
@sashaaafierce_	human
@IngloriousDogs	human
@MirkoDelGiudice	org
@kariheikkila	org
@outofthewoodsuk	org
@OldSnooze1	org
@susipsicol	human
@VeronicaSophi	human
@Rajcurryculture	org
@wizhinstar	human
@LesMdeMarie	human
@MiriamOst	human
@fmrwillems	human
@NoahLayth	human
@saadimakhdoom	human
@bitekitekitchen	org
@ScallywagKev	human
@elissabinion	human
@r_o_c_i_	human
@AlbeColombani	human
@nikkigreen85	human
@Volkosh	human
@Laietafm	org
@Blkcoffeeblues9	org
@el_boVidor	human
@ravin4arvin	unknown
@Harper6Scott	human
@ChiaraTorri	human
@kiirosingoo	human
@CrazyFreshChina	human
@Anaheim_OC	unknown
@AlisonHeller7	human
@LodosBarGrillHR	org
@TaniiuxM	org
@VertigoPublish	org
@ChainezFeriel	unknown
@InNinRoom	human
@AllINeedIsFood_	org
@999dso	unknown
@kassandras6	human
@Meiluvchildren	human
@SuellenSchmidt	human
@Agos_Mocci	org
@danzsir	human
@RocheHB	human
@mikejchau	human
@nur_fawa	human
@alifiawisda	human
@summerhoward94	human
@bourbonomics	org
@asturias63	human
@mikeabsher	human
@PocketGaysian	org
@xfamilyaffairx	unknown
@antonellacapoc3	human
@Mohd317	unknown
@MedChiupdates	org
@liz_mancao	unknown
@MustSeeIran	org
@OxyInnes	org
@Martassantosg	human
@acbrenna	human
@Eat_Everywhere	human
@Life_Developers	human
@sapphirepinkUK	org
@ciotollina	human
@swood40	human
@GregJeffery888	human
@lourdes_rp	human
@5813Que	human
@fabishine	human
@candypereyra1	human
@RickysGuo	human
@MrJimboy	human
@Sarahattable	org
@angelelliesmum	human
@remartano	human
@jadima35	human
@MischkeFred	org
@FoodGoesNaughty	unknown
@mayu_momo	human
@Litefooted	human
@thatphotoguy3	unknown
@run_4_life	org
@DanielYeom	human
@TonyAcero411	human
@amandamkaren	unknown
@egansmind	human
@oztoka	human
@BonsaiMiami	human
@TheHayesDays	human
@Journey2Fitnes	human
@silverleica	human
@N_huda7	human
@namoradonacozin	human
@hellomyhongs	human
@imahautemess	org
@meals_stambrook	org
@NelleJl	unknown
@globalrunaways	human
@j_dub7246755	unknown
@Win100MarsBars	org
@INFINITELuluKIM	unknown
@Cafe1505	org
@shirleyoakman	human
@Murray_Nichol	human
@seedspace_co	org
@_Elle_Dott	org
@SweetTaleBooks	org
@Gr8st2everTweet	human
@vipjg	human
@FulhamTarts	human
@tjunib	human
@apetnunez	org
@ChefKenCarter	human
@levylieu	org
@GreenHouse_H	org
@_TheDeck	org
@_3zoozi	org
@MarinKelly1	unknown
@neksichka	org
@okinbolivar	human
@fazley_mapet	unknown
@Katie__Franklin	human
@TanaddaR	human
@amstramglam	human
@jivatrosidi	human
@vixen_of_asia	human
@juliahechtb	human
@RaedTaleb	human
@casaveneracion	org
@Tiny_Chef_829	human
@BabakBina	human
@Ellessephoto	human
@ChefBradleyO	org
@RaisaVerheijen	org
@kota7akio20kuni	human
@I_dream_alot	human
@ConnorDagon	human
@adasg85	human
@estatesalesboca	unknown
@tridigitalgroup	human
@MitchGorshin	org
@je_gil	org
@walkinthewoods1	human
@thefatalfemme	org
@contagioustory	human
@missbrezzey	org
@BlackRose2890	org
@LinaPolania	human
@MaoriStream	org
@EsraaTuncer	human
@ShakyraLaShae	human
@xthefactorx	human
@noorghoneim	human
@kojiyuuiine	human
@Chloe19980102	unknown
@CrucifiedMind	human
@MarksList	org
@ExodusHookah	org
@SaraFHawkins	human
@kiaramurillo2	human
@LydiaTanzil	org
@BumbleBeeBabe	human
@guathee	human
@FadeTHM	human
@benjya85	human
@AnnaLanfreschi	human
@iAMKipPaige	human
@shanethacreator	human
@an10_0721xx	unknown
@dolce_vzla	org
@RadissonbluNDPV	org
@RealtorNArizona	human
@RosemariiieG	human
@yohandimartono	human
@PlacarddeGreta	unknown
@LookBookOficial	human
@steffanymiranda	human
@KatPummill	unknown
@alidoronyc	human
@ut0piapocalypse	human
@markVanNature	human
@Activ8Athlete	human
@TeaCoffeeCoOBC	human
@ellenbernardino	human
@GuideLive	org
@mylilchickpea	org
@LeenFaiisal	human
@MrAdrianMaulana	human
@TradestoneCafe	org
@ninni70010388	human
@Cheftonks	human
@angielynn	human
@averageguyruns	human
@renejustiniani	human
@paghaakmal	human
@DuosLounge	human
@GDWRKZ	human
@MissMurder87	human
@lieyanakarim	org
@RazorBHome	org
@EggyMcLove	human
@Quewpeycat	human
@manda_len	human
@4212k	human
@FoodPorn	human
@90Krisus	org
@mokshabruno	human
@juli1016	human
@tomoko_utauta	unknown
@RachelsCatering	human
@AntonellaDolci	human
@ThymeVortex	human
@SleepingFrog_	human
@BellaSunLuci	human
@VeritaDea	unknown
@sallykawai	human
@nedbell	human
@pxxxx_c2	unknown
@JacobsonMissP	human
@JohnniesNYPizza	org
@LeilaLurova	human
@Aira_Deathstorm	human
@DiadeCampoHB	human
@YunaX2_1063	human
@erin_malaika	human
@Feporicchia	human
@fjbstl	human
@MyNutrition2	human
@nadhilahtahir	unknown
@NellyMuratova	human
@Necilynah	unknown
@RestaurantDad	human
@StaceyStarman	human
@heartbytin	human
@LombardosSTL	org
@WTEGboyPortland	unknown
@adzkainnayati	unknown
@M_Crescentini	human
@madeleynecortes	human
@BrownsKitchen	org
@glampig	org
@Kandice_ikao	unknown
@MarlaLondon	org
@AmbroseWB	human
@dopestar510	human
@babytorpedo22	org
@yui_yoshikawa	human
@pandadraftjuliy	human
@jessyjayne_xox	human
@crescentgrill	org
@paintedEnigma_	unknown
@nooganightlife	org
@SoleMixt	human
@ZueZoey	human
@diabetesevryday	org
@iKTKT	human
@_MARAM18	human
@studiomayer	org
@chrissyslifee	human
@Lauren_Hudd	unknown
@mark02imperial	human
@UgoGrant	human
@herworldIND	unknown
@effycoffee	human
@meals_swiscotge	org
@GarethVenga	human
@gpolosecki	human
@KeysClaudia	human
@jillgustilo	human
@nicasebastianC	human
@Appleback_Grill	org
@JoshtheZed	unknown
@caltraveler	human
@sevenlies	human
@FDP_Tweets	org
@VeAiani	human
@3tking	org
@CodysCafeSB	org
@Embers_J	human
@PoorShopaholic	human
@LarissaRodrim	human
@BetRen	human
@PatFloress	human
@Realtastypages	human
@millie1962	human
@poyoooooon16	unknown
@Cathy_DeV	human
@BisharadSharma	human
@chinoabad75	org
@miss_isajones	human
@CindyWest10	org
@mannykikstep02	human
@xmenrogue	org
@nsai_0903	unknown
@PattyTominaga	human
@Amnatopia	human
@Yatarou_Iwasaki	human
@Osteriaventi	unknown
@cheezkom	unknown
@vincent_lepage	human
@Apk_Collector	human
@JMeanless	human
@puppabellula	human
@Binny0b	human
@nrhshmhkml	human
@Ssyuuhei	human
@issag_Ace	org
@CNNMe_Music	human
@SiberianLL	human
@Barbieys11	human
@MyUniqueBoutiq1	human
@marcellovar	human
@ariannguiller	unknown
@thinksoul25	human
@ChikFood	human
@AhFeE	human
@thesavingqueen	human
@ThebrunettesFL	human
@MsMurderMonroe	human
@cristina0131	unknown
@earayala	unknown
@MaryLeeFoods	org
@chubyphiet	unknown
@ChiaraMondoloni	unknown
@WholesomeDinner	org
@JACKERIONK	human
@MissTt83	unknown
@ClaumamaLA	human
@BhimaniSn	human
@gabriellovas	human
@PosterGrafix	human
@jenesparza	unknown
@Bistro185	org
@aaairixoxo	human
@AlexMerisoiu	human
@realtonihammer	human
@HillfarmOils	org
@ShannaKWard	org
@NaturallyRad	org
@TheIndianSavage	human
@SYGwalterg	human
@Court91688	human
@jecevf	human
@gorommel	human
@Hessdogg83	human
@JuliaBlogt	human
@ise_like_ice_ho	unknown
@passionandpreen	org
@KevserKaragoz	unknown
@Miragarvin	org
@InsanelyGoodIRL	org
@pacificfoods	org
@drewian	human
@TenTenErzzZ	human
@jewelrioshin	human
@Envy479	human
@jademc21	human
@codacorta	org
@jonelleagbuis	unknown
@ZYN22_	human
@Strwbarie	human
@TiandaSnijder91	human
@SuiteTale	human
@941Suod	human
@Lmanzanaverde	human
@JAAREDBROWN	human
@gaurang_b	org
@EfectivNutri	org
@SuzyLJDoyle	human
@livinlikeLARZ	human
@3tt3nnA	human
@matmazzafera	org
@lunaresrubios	human
@tomasenlacocina	human
@noor000000	human
@modalo619	unknown
@katekulpa	human
@klynnhank	human
@CandyDegotte	human
@onikapointer	human
@clothpoppy	human
@PlayaDelCarmen	org
@CLOVEfoodco	org
@stefflesc	human
@theactdubai	org
@Esssie13	human
@cheldaa	human
@BeneCatalano	human
@Silvixx_P	human
@Kerr_Winn	human
@tequilero79	human
@sethcohennn	unknown
@CODSIndia01	human
@DawnAreenKaur	human
@HH_Magazine	human
@_FitistheNewBlk	unknown
@WoozlesMom	human
@MzDemiLa	human
@chii_318	human
@ireynewong	human
@EliteGourmet	org
@phatiee94	human
@NeuvooEduPit	unknown
@LindaHobden	human
@derbygirleats	human
@AlisaRedmayne	human
@Essiegue	human
@OreIdaPotatoes	human
@JordanYeow	unknown
@princessval1	unknown
@mane_vahanian	unknown
@FSeifried	human
@katejohnsonhq	unknown
@Honeyholeent	unknown
@CECEMATA	human
@wypajyneliso	unknown
@thewholemealsg	human
@halocindy	human
@shaniceyarde	org
@knightdaniji	human
@WorldPTJobs	human
@sanasanz	human
@NutrAddiction	human
@AllanBohor	human
@francars	org
@MsBayBay	human
@Gabiii1D	human
@aidelana	human
@dyfucytuqas	unknown
@SquidCam	human
@megwalds	human
@LeoLuyneSiry	human
@r2ph	human
@ATHEER_OCT	human
@NoToroTruck	org
@arianne_colene	unknown
@StLeo76	human
@AnneJoconnor	human
@ramz	human
@jOrViiaN	human
@Alpha_Rowdy	human
@RubyGilmore_	human
@Punqecaa	human
@incurablepicure	org
@Sobrietyisgood	unknown
@BethanRhiannonx	human
@PurpleOnionNC	org
@lmurley2000	human
@tacomakermiami	org
@halecoffeeTO	org
@HomeSweetieHome	org
@BrownSugarCzar	human
@RachelEtNicole	human
@Kergosz	human
@StyleBrighton	human
@crimsong19	human
@kirshhtyy	human
@Iamishmaell	human
@Eddie_and_Paul	org
@hazeecsulaiman	unknown
@chriz_zabaleta	human
@bridgetc	human
@182Chube	human
@LeanMari_B_pwc	human
@SaraPolice	human
@MCRFoodGal	human
@laughingmedusa	human
@tasteofgame	org
@Diabetes__Info	human
@Mad_Brenda	unknown
@briskameifaa	human
@SSY_OSK	unknown
@BearWaldorf	human
@AnAppealingPlan	human
@mgage12292	human
@MissAngeLina90	human
@dyjyxaxolp	human
@uchiet	human
@roxiebeane	human
@Drwilcouk	human
@_bobobobo_	org
@mmccormickcny	human
@NATmikrovio	human
@Tugsaaa	human
@Aditya69577	unknown
@HarvestGm	org
@CookinMattersPA	org
@Hypnotiq525	human
@MrsFisheee	human
@lifeillumistyle	unknown
@_bubbbby94	human
@MoniqueNesbitt	human
@missmusical1	human
@Emily0_oStrange	human
@Hikuma_	human
@cayo26	human
@TaborTavernPDX	org
@ammararsyad1	human
@z5000z	org
@us_promo	human
@JugglingFitness	human
@whipuntilfluffy	org
@Pauline_Korneto	unknown
@DidiFarhanah	human
@SteveCKirby	human
@MarisoldasilvaM	org
@eliafongaroreal	human
@YukaSPCrew	human
@ManayunkTomato	org
@rdpsteakhouse	human
@rhefitria	human
@cookies_mimosa	org
@LeeBrowski	human
@RobertoUrbina	human
@EllipsisDuluth	human
@BerlinKeyx	human
@iAndyThom	unknown
@vegasfoodtrucks	org
@hannamandora	human
@_ria84	unknown
@buddingeniuz	human
@paramoreftmcfly	human
@phil_barnes	human
@ndazahra	human
@HotMamaFitness1	human
@Streetfood_SGN	org
@birdsall970	org
@marcmillmanpix	human
@RayaRossi	human
@minetudun	human
@Jim__Birdman	human
@KONA_Kimu	human
@CarmelitaCho	human
@7119Smlovekh	unknown
@annemai	human
@SGJB1DNialler	org
@fsa_novy	human
@KanagawaMama	human
@patchworkpink	unknown
@Li_vely	org
@PastaStoryID	human
@Chasing_Joy	human
@carens_rosedale	human
@DaKrauss	human
@alickofsalt	human
@Joanna_Adams	human
@GlassSafe	org
@FendyPutra77	human
@VIP0R	human
@vivabus	unknown
@ilaromano	human
@an_manti	unknown
@Emil_Gold	human
@ClaudiaVlnt	human
@icheftim	org
@wb07272	org
@potcholooo	human
@MitchelRaphael	org
@AdrianXTristan	human
@rifkares	human
@ars3n1k	human
@tesschallis	human
@yegispnk	human
@Ladieszoneqatar	human
@GodivaGoddezz	unknown
@hecyimarsalazar	human
@issavels	human
@Wine2TheRescue	human
@dmwsmiley	human
@flavourcape	human
@Encsyyyke	human
@daveschneller24	human
@PiaEspinozaMeza	org
@sg1radio	human
@fabalduzzi	human
@Dentaa_show	org
@VanDarckPire	human
@StephanieRault	human
@churuuun	human
@AHBELONZA	human
@brick_and_spoon	human
@nyracat	human
@jmb1386	human
@Blue_petee	human
@JBAGOZZI	unknown
@meinjoe	human
@GrandpaWill4	human
@toatealondon	org
@BradleyEvsich	unknown
@dyu_md	human
@Shekansew2	human
@Hayakhan55	human
@mskonfa1990	human
@DubaiLOverEbi	unknown
@MattEdwards001	human
@SianLacey	human
@HollyCarran	human
@HardRockLondon	org
@AhmilPurnami	human
@SandraHamington	org
@JonHoakaHoly	human
@lacka703	human
@louisejianne	human
@Eleanor_Anders	human
@mistry_chintan	org
@viiickiii	human
@JonesIsThirsty	human
@tsteffes	human
@AmieLouisa23	human
@namikikun	human
@sunnysprinkle	human
@lttleoctopus	human
@gavinhignight	human
@mistyorman	human
@tamaractf	human
@metabor89	unknown
@ducieduce	human
@JoleneGoring	org
@chazzerellie	human
@Gin_FizzZ	human
@RexSpecs19	human
@BeelRocha14	human
@ArthurGMGoodman	human
@Rivaldo9999	human
@GoldstaubPerlen	human
@SwitchingLives	human
@AtlasB2B	org
@AJune_bug	human
@josephsoto21	human
@Xana_Zurdo	human
@Synderella45	human
@HayvanModus1337	unknown
@faithmonreal	human
@NargisCafe	org
@shoesredbottom	human
@wingandaprayerf	human
@saltandsandals	org
@FineLineBow	human
@SixReasons	human
@MissKatMercado	human
@JohnSaltN1	human
@hugoalexgomes	human
@g9_reipyooon	human
@RashellAbril	unknown
@Sarai72	human
@HeikeAccorsi	human
@Fajowo	human
@VakantieFamilie	human
@mamibefit	human
@HealthCoachRob	human
@kellypowell721	human
@hassapelis1	human
@aldisaniawan	human
@KapanganRHU	human
@dhanalakshmihm	unknown
@Lola_V_	unknown
@elise_doucette	human
@angieyauw	human
@IHOPMorelia	org
@VIRtuz	org
@nicolejensen83	human
@honulver	human
@VivienneGan	org
@GumstepMx	unknown
@xhaine_	unknown
@shaunlayton	org
@viyafaari	human
@brysonjye	org
@murat6476	org
@ThiPerin	human
@SixSensesConDao	org
@IriSoHappy	human
@jcgoh89	human
@ArmidaRiveroll	human
@Kryssieee_B	human
@chitownyia	human
@eedyaj	human
@canaliyah	human
@purplecloud510	human
@roselique	human
@soypoblanablog	human
@KenjiHachiro	human
@empresshannahg	human
@OzgeCanevi	human
@Bnkbt_Andrew	human
@Jackieandstuff	human
@bigmoeinc	human
@tomeu2	human
@sug4rpuffs	human
@YoungsNYC	org
@GrocrE	human
@dica_musculacao	human
@jveezy7	human
@jepFREEako	human
@GastroGlam	human
@JordaanVanessa	unknown
@MsLeeLee66	human
@PureDestination	org
@feast_on	org
@iamMarikit24	unknown
@DJCrystalEllis	org
@hellomartypants	human
@EdmarBravo	human
@iratanara	human
@Deliveroo_MCR	org
@Pipeline_Ltd	unknown
@ryalled_up	human
@rrr1419	human
@nin_nix	human
@misscelineeee	unknown
@lunchtravel	org
@tstevens312	human
@ChristinaBe22	unknown
@gloriaaahh	human
@jleexx	human
@lynnkriesten	human
@CourtyardChakan	org
@Francesbakes	human
@meadowruby	human
@terrencekeegan	human
@Frankie_Freedom	human
@molloysbakery	org
@nikky_ikky_dooo	human
@nestyvani	unknown
@Takieaa	human
@NottingHillHour	org
@SuperPiPiz	human
@Truffles_deli	org
@zubi89	human
@bykrystyna	org
@SylviaKuijsten	human
@carissaxlpy	human
@SNClark12	human
@bunnyzaurus	human
@patriciaamoroz	human
@LaurenBlackDog	unknown
@melanie_nisbett	unknown
@BilgenSrmn	human
@zeelele	human
@Flor_de_Canela1	human
@myWellBoxie	human
@alexsteyne	human
@FatimaRGuillen	human
@ShakiraRockks	human
@NippleTrix	unknown
@1pipewrench	human
@twilightian	human
@janelliemusic	human
@vanjanceleste	unknown
@omr909	human
@becausecakeblog	org
@daisyjanine	unknown
@JoslynSinger	human
@marcusb12345	human
@WavesCafeBar	human
@nailminx	org
@aakashkrocks	human
@EGHtown	human
@SilvioDeCesare	human
@VipSunset	org
@mr__Leon	human
@kristine0326	unknown
@wissys	human
@Anj_T	human
@JhOn_LzSrO	human
@lindahf1	unknown
@RealCayenne_MFC	unknown
@iamkris_chan	org
@brittany_munn21	human
@italianclubnews	human
@alyssagutten	human
@TheMarkYounger	human
@_overthemoons	human
@LeoraLH	human
@SalamanderVA	human
@Mao_sea	unknown
@Cikk_Azie	human
@TheReviewWire	org
@translatorbali	org
@Oz_Go	human
@LabTestSTL	org
@MarkVMayo	human
@DavidFelixM	human
@incubutch	org
@sakosh505	human
@agungpryo	human
@angeu123	human
@bolognarest	org
@haaaaarari	human
@brandi__nichole	human
@BertoliIlaria	human
@MetroParent	org
@ms_joys	human
@Chloe_Seattle	human
@ManitobaMarlene	human
@fulkiani	unknown
@nzw212	org
@AldanaLaurie	human
@mardhiahhayatii	human
@kayndaves	org
@ModCityMom	human
@terrylo_calgary	unknown
@catchcathy	human
@M1chellemabelle	human
@fogevamogiko	human
@ernestoadiaz	human
@Steph_Grondin	human
@sittja	human
@sam_plaza	org
@K9London	human
@almaactive	human
@_MsClassyy_	human
@Civickid96	human
@Cybizwife	human
@acornsnlemonade	human
@amatoudaiou	human
@MichaeIsPenis	human
@samsitalianmar1	org
@EmmerTolhurst	unknown
@JasperHotel	org
@ForeverneverwfU	human
@georgiacart	unknown
@alaaezze1	unknown
@HealthHappyYou	human
@salimemaa	human
@Knys_Guy	human
@padungwo	human
@AliSafaa97	human
@ccaswellstyle	human
@EmanELhowary	org
@BouMelhemRstrnt	org
@KitchenThymeUK	human
@KrystledeLefin	human
@AbhijatYadav	unknown
@TAHRA27	human
@RheayEbarita	human
@zzjazz55	human
@deb_lab	human
@Kaycie0versby	human
@MonalizB	human
@DRamful	human
@washsqtavern	org
@ChilliBananaLvp	org
@ueruraeberu	human
@VegCancerCoach	human
@njmyoz	human
@DlxChampagne	org
@JeanetteChedda	human
@help4businesses	org
@Hiexburnley1	org
@DealFitness	unknown
@mpiajoy	human
@KeniThacker	human
@Tameismoney	unknown
@ItsEmma_3	unknown
@HempenHillBBQ	org
@muratcizmeli	human
@BetoGomz12	unknown
@NXwa912uKKfuFcN	human
@HallieGenz	unknown
@styledawgLou	human
@Toge_Siboro	org
@RamorePortrush	org
@moi_cheree	human
@EmmyNatiella	human
@stadiumpotch	org
@yogawesome	unknown
@MamasGuide	human
@Major95Viki	human
@oscar804	unknown
@BraceletsHeels	human
@emonprincess	human
@ClydeBlaugrana	human
@THEMKROL	human
@twinkleintrendz	org
@_tinatelli	human
@sylvieoptician	human
@Deb2904	human
@VinoVenueAtl	human
@franzygog	human
@TheNameIsTREV	human
@Opposite_Endz	human
@nirmalatrik	unknown
@lbrown1618	human
@eventsbyfluent	org
@Winstonind	org
@EissaN	human
@marusoler3	human
@Diamond_Of_STR	unknown
@PhilBell	human
@GTMarcom	human
@tastic_rice	org
@HannahONeill9	human
@MekaDayz	human
@Liloriniq	human
@nuratikahnazrii	human
@Kendo	human
@harrismattalino	human
@anisfeirmakeup	human
@VerdugoBar	human
@cuddlylisa1	unknown
@caycelubrun	human
@SageGeneralSTR	org
@timdarbre	human
@MyVoyageWithMS	org
@malaluanchad	human
@GenMillsBellIns	unknown
@ersenturgut2000	human
@LS25Business	org
@WhitneyABeery	human
@Cinco_Hotel	human
@Kweemiyawati	unknown
@therealfatdoo	human
@La_Charlie_	human
@MyNewCupcake	human
@AbintraFitness	human
@OpeningzByAbi	org
@yakiso_ba	unknown
@stevestillalive	human
@gmaxed13	human
@alisonlublink	unknown
@JRavioli	human
@FredChua10	human
@SalvadorNop	human
@SpiceTHorror	human
@daniloemedina	human
@Mandy_Rosette	unknown
@klonblog	human
@GeoffFox26	human
@mrcotera	human
@itsbrenbitch	human
@amazinghousedes	human
@rcamille0618	human
@AladelFitness	org
@SuperSmartMama	human
@kayare7	human
@WholeHealthTeam	human
@funakameari	human
@jeangtrrz	human
@Caveman_Foods	org
@TheDitmarsStrip	org
@anavero80	human
@GarunRiot	human
@gpcheeseandmeat	org
@LilianGenny	human
@Happy8Duffy	human
@taaaaamura0719	human
@eric_maechler	human
@alzy25	human
@kaulitz__tom	human
@AbacaBakingCo	org
@Maxerainna	unknown
@HerNameM	human
@JowenaE	human
@nyaoko1104	human
@yvzkylp	human
@shuukaigaru	human
@Celestte14	org
@MeridianMagLDN	org
@DJoka90	human
@GabizLima	human
@angiewongnc	org
@KWCHKara	unknown
@Unky01	human
@SimplyStylzz	org
@tin_patz	human
@VenusDhorreur	org
@HealthGreatness	human
@rhiannonmarie32	human
@MissArve	org
@LikeFoodChef	human
@Hotel_Navarra	org
@meiloveako	human
@AliceRyotyan	human
@McandSchmicks	org
@KevinTumamac	human
@JustinBirchmore	human
@TaeYoung88	human
@GodsKid420	unknown
@MsCyann	human
@Fp04M	human
@JuliaDiSano	human
@GF_Insider	org
@bnphome	human
@AarthiRaju	human
@mortisia79	human
@KathrynWong1	human
@p_consuela	human
@Tony_Sacto	human
@RTWgirl_	human
@kiangreatness	unknown
@ColoniaVerde	org
@KIL0is1000GRAMS	org
@tortadella	unknown
@mainlyfood	human
@JoShCm1	unknown
@therightdoctors	org
@jejeconsulting	human
@ezmecash	unknown
@Wickedly_wow	unknown
@earlspm	human
@iamjennatee	human
@just_me_ascer	human
@sievegirl	human
@ruiparada	human
@dino_roque	human
@bblrestaurants	human
@zzxx00	org
@LambruscoWeek	human
@ve_ra88	human
@livetoexplore	human
@MyKWonline	org
@HakimAbdat1	human
@happycho	human
@2nrc	human
@AirInDanYell	human
@KapurMeenakshi	human
@MeaganIsANinja	human
@Viitanen81	human
@PreeyaKN	human
@MIbabygirl624	human
@SuperHoteles	human
@ZicciSloan	unknown
@contezero74	human
@andreigromek	human
@alfio_libero	human
@Boss_jason08	unknown
@AgnesiaMega	human
@ri_nuupi2	org
@LadyLogAKAl_MBA	unknown
@panenco	human
@Tamayo_Ancona	human
@annings	human
@Jennquaye	human
@Petedrotar	human
@Indfused	org
@CantinaSctsdle	human
@Andhea19	unknown
@pud_hndyn	human
@kwest1908	human
@Enjoy_Harrogate	human
@mariana_tomas	human
@NigelStanislaus	human
@darkskinpinky00	org
@plesiryukcom	human
@ronsambrano	org
@saracci2	human
@itzel_cruz_s	human
@GilMoralesg	human
@rudyjangel	org
@amazingrecipe4u	human
@ShirleysBagels	org
@Victorious_rule	human
@atapgrill	org
@Nadinezvous	human
@kojiharunyan	org
@ChrisElliott2	human
@VeKainama	human
@Rochelles_World	unknown
@24kmr_un	human
@jflehmann	human
@BakingSteel	org
@Saw_Ville35	human
@Kez	human
@artpop_daniel	unknown
@mariekoma0524	human
@AuroraImporting	org
@StaceyWitkowski	human
@evyzdreams	human
@rieestatokyo	human
@LauraJeliModel	unknown
@AliciiaHailey	org
@helen_em	human
@DJENAPOP	org
@yanuarwisaksono	human
@DieDie_VENUS	unknown
@3141_southyarra	human
@ribsnbibsuk	org
@OBonomi	human
@polky_007	human
@celitheactress	human
@WinyCoba	human
@RoyceLovett	human
@lili4ka18	human
@Istg_ryou	human
@theelisabarbie	human
@shiningfast	unknown
@ChicaTierna	human
@yeyduar	human
@lavipop94	human
@Pieces_of_Bliss	org
@Mr_KNWhite	human
@Kodan3n	human
@Coccinella2408	unknown
@Cookiesparatodo	human
@thenikhilvero	human
@louisemushet	human
@SilverWareStud	human
@GrazinTriBeCa	human
@noahonair	org
@marciadx	human
@soothemePR	org
@itsmecamz08	org
@sakshi7920	human
@marnard	human
@xty0608	human
@SoyEliazib	unknown
@PeakFusionUK	human
@MainandWest	org
@onesixtylondon	org
@RowdyRez69	human
@rawkavai	org
@Simla_Jasmine	human
@TheJCSuperstar	human
@glasgowweddings	org
@CSamurai	human
@Termo603	org
@makeandTCK	human
@bOObie_Monster	human
@yahvi88	human
@sackitartee	human
@SophieGrey_Ldn	org
@dynamiteteacher	human
@brunabrum_	human
@vogelmann	human
@CharlieParkerUK	org
@Jessisawanderer	org
@JamieMaeCheng	human
@Ego_Heswall4224	org
@EvanMRos	org
@MUSCLECHEFUK1	human
@_DruWorldOrder	org
@niaga_hijau	human
@Junya_Maruyama	human
@alitham	human
@Rest_AltaVista	org
@deonte88	human
@StPaulsLifestyl	human
@iamdannettalynn	human
@SwanseaMarriott	human
@VidaColona	human
@a_chung	human
@Mise_en_bean	human
@lilyggreenwood	human
@InstaWindeck	org
@Shatarninbars	human
@TOculinary	human
@LesleyBradley2	human
@Fitnesscoachen8	human
@MissKateFisher	human
@misscolosprings	human
@dazzy_0d	human
@MissYaaNyamekye	human
@hyukxi	human
@Msfitone	human
@WheresAspen	human
@Stpbearman	human
@LaClintonx	human
@homeboytruck	org
@SubhanSaajid	human
@DiODoherty	org
@FrewinTheatre	human
@foxman464	human
@therealesco730	unknown
@StrathconaBIA	org
@ireneandriani03	human
@FrenchTrotters	human
@TavolaForTwo	human
@BLObrian	unknown
@redeliciously	unknown
@_Verguenza_	org
@Pudduuttt91	human
@verzoenrima	human
@GothicFrog	human
@wellingimanius	org
@CHINchirinCHIN	unknown
@NemchenkoOo	human
@dee_murray05	human
@bloggoneit	human
@Ricobarbereno	org
@RibHutElPaso	org
@Tkerbyson	human
@MozzaMonaco	org
@cfenko216	human
@TKatrak	human
@reneenovisca	human
@BelmodoTiany	human
@ergrilluo	human
@maaribo	unknown
@spanishbardot	human
@Azsa2go	human
@iammarinelek	human
@GabiiPadiilla	human
@Juice2166	human
@gekleckert	human
@jake_foneseca	human
@cavekitchennyc	org
@MalibuPier	org
@BonAppetitYorks	human
@1accidentalchef	org
@EMOpunksBRUNO	human
@NatalyGray	human
@Elisakitty	human
@makkiato_	human
@Cucharahouston	human
@flusitania	human
@NDonko	human
@KnowMoreTV	human
@virgomaldives	human
@K5nonchi	human
@latadins	human
@gabdedios	human
@mrvelocipede	human
@NRGvision	org
@ellys_khouw	human
@nouvelle	org
@halu_11	human
@TamerGar	human
@BestSportsBarNY	human
@annessasazrin	human
@SeoulSausage	human
@JohanGila	org
@Yoorinah	human
@thamefoodfest	org
@dencyLoiciana	org
@bevybirdtown	org
@lyricaleze	org
@_elvaretta17	human
@LiranMoshe	human
@DinnerDeals_NL	org
@Hala_BinShaibah	human
@Hayaalissa	human
@Smoothesque1	human
@marilenchan	human
@Anniii100	human
@Chiara_Solfrini	unknown
@TNC_KAZ	human
@BiancaCut	unknown
@abmuab	unknown
@DanielaHarriso7	human
@blakebymistake	human
@LucyAC_ART	human
@KrustysIndia	org
@waldenstrom_	human
@_crowf	unknown
@kjeankileleman	human
@lottavirkkunen	org
@chefkrakow	human
@_YamilaBrown	human
@NickLuntDesign	human
@JoniMarieNewman	human
@4Sons_R_Us	human
@winjaya	human
@Denny_RH	unknown
@HarryS561981	human
@yukinan26	unknown
@Imjustghost	human
@MochaBearHead	unknown
@HoldOffOnYoHate	org
@VinaFarhana	human
@interrogativus	human
@SisterLawna	org
@collawitchcos	org
@Ayobeee	human
@RamblingRatz	org
@wevawojugoje	human
@JessBushby	human
@Tyler226	human
@veepitaloka	unknown
@First_Watch	human
@fitness_shirts	human
@keljack725	human
@ChlOeniff	human
@mirboop	human
@kertukoppel	unknown
@loca4voce	human
@biggiefrank	human
@TheSiQShow	org
@deadlick5	unknown
@Ridyma_Ridi	human
@damianos340v	human
@jadecardenas10	human
@AssemblyRoast	org
@Barbz_Oberrie	human
@itsmejoanp	human
@321Video	org
@FromBerlinTo	org
@_eatrunlove_	human
@TimHHeaton	human
@KYCSConsulting	org
@NYchennai	org
@EllaeWilliams	human
@Ohdxra	org
@desertdrop	human
@CatherineFulmer	human
@paoaayalac	human
@KYCatPhish	org
@ainzamal	human
@marcialbarquin	human
@FauziahR98	unknown
@LeeannStraughan	human
@theCatLynch	human
@momstownOak	unknown
@EatsBeat	human
@FishergateSC	human
@palladiumykonos	human
@TheSarahWorley	human
@Ilesabetta	human
@GeorgeXris	human
@StylezCreations	org
@MrsVillarreal1	org
@cristelisabelm	human
@mchlrncs	human
@_Janet_Lynn	human
@davomassa	org
@KBunn	human
@AdventuresNurse	human
@yusodakine	human
@valuob	human
@Ishanishaya	human
@TheMain	org
@Pdiddy730	human
@Gwyne10	human
@SKYYismylimit	human
@michedw	human
@lbosquejo	human
@Mirah113yasmin	human
@winkelenholland	org
@ChaCharmeyn	unknown
@BnBGatwick	org
@therealJ_Kash	org
@AcademyCN	human
@SenseYoga	org
@dinesh_0d	human
@cuteasapie	human
@ChefDHerrera	human
@Flawd2Prfection	human
@berrr_bueno	unknown
@TrsBrynt796	unknown
@hellomisstaylor	human
@J_Laurora	human
@burde	human
@onpointnjnet	human
@KingRichard76	human
@TheSinghasari	org
@Fernandezm	human
@M1randa	org
@lil_lam00	human
@SteveLoveFit	human
@FishMama	human
@KATbike	human
@PietroSav	org
@Shastopher	human
@theebeautykween	human
@paul_jobber23	human
@mawarrrrrr	human
@tinmags	unknown
@florencehds	human
@thedoctor16588	human
@MomsBlogger	unknown
@NEKTINA	human
@loverdemix	unknown
@ryankeely	human
@kkaizxxerr	human
@ktheddfan	human
@Hierendaarnu	human
@FantasticDork	human
@sharmaine_0904	org
@GigiR212	human
@vmlipio	human
@jcraknrol	human
@glennygrace	human
@ChaatCart	org
@appetite4van	unknown
@johnlightrider	unknown
@IbizaGran	org
@CharlesAArcher	human
@RunToTheFinish	human
@AssieA1	org
@solariz	org
@yayee_ts_bkk	human
@Cjanelle84	unknown
@anggie_erika	human
@lykonorebywu	unknown
@jessicacwang	human
@snacknation	human
@SlimMkaouar	human
@FwineI	human
@SHadjur	unknown
@iwanliman	human
@CrowdfundingTT	unknown
@becca_cobb	human
@DarioMerko	human
@ThondaOficial	human
@maldita_rcm10	org
@NOVA_535	human
@MariliG_P	human
@LaiyinSheng	unknown
@BuxUpCom	org
@BSDI_Wellness	human
@itscarlaley	human
@JusTaxicouk	org
@annatooon	human
@MarisonTito	human
@DiverSakura	human
@Fashionho1ic	org
@SilvanaDRavenna	human
@C_LIVEFITNESS	unknown
@DowntownRob	human
@TreyDM24	human
@angus_macnab	human
@EdrisBehzad	human
@Nalawldo	human
@alyal_20	human
@CristinaFugaru	human
@natnutritionist	org
@garvydog	human
@SerafinaMumbai	org
@iamFrappoloco	unknown
@ManischewitzCo	org
@DannsWords	org
@PoshlustArt	human
@Cozyconny	human
@BergeronAuto	human
@derrickriches	human
@mathias_caitlin	human
@isaacrthorne	human
@yahoo_lei	human
@IamAlwi	human
@RT3Lebanon	org
@FlipiSkate	human
@nemesisalvin	human
@mrbobherrera	human
@georgehoteliow	org
@th3girlnamedAmy	human
@Aida_EatWellDC	unknown
@g_gorges	human
@vidulaj	human
@GetItJHBWest	org
@KaniaSukma	human
@Mz_Keys914	unknown
@MasDwiii	human
@mauricejohnson	human
@GeorgiaTpm	human
@Discover_Garden	org
@ramiboncompagni	human
@AshikiNur	human
@rebSOswag	unknown
@CTNseda	human
@Longrain	human
@amychodroff	human
@Missvikha	human
@88Rockorsou	human
@JimmyBurney	human
@neyiRubio	human
@vespers1005	unknown
@Nicdott	human
@BronzedAussieUS	org
@heardaboutsa	human
@nampeungsweet	human
@AJQ83	org
@Fregmartins	human
@kitsunesan	human
@satriamambals	human
@FitThings2u	human
@EhLyazLove67	unknown
@Virva_	human
@CynthiaPontifes	unknown
@Danny_M3	org
@EnildaHidalgo	human
@Foxicakes	unknown
@stevedores	human
@Treczema	human
@thechelseaellis	human
@nijuuyonjikan	human
@XavierNavy	human
@deannadawn21	human
@nataliamiszczyk	human
@hellotohealthy	human
@CarolineofKenya	human
@BantingClubSA	org
@M_Vaana	human
@Dasrycht	human
@RobeusLove	human
@mz_shanak	unknown
@DiaryofaGG	human
@bernasmaltez	human
@CapitalAleHouse	org
@aiceyaice	human
@GingerTrent1992	org
@vivelamagia_	human
@HOSTlNG	human
@DuVin808	org
@imLeeJongHyun	unknown
@retti_syafriani	human
@CucinaRepubliqu	unknown
@nisantasibebek	human
@MFord81	human
@MsUnforgettabl3	org
@SinanColuk	unknown
@hoolaBahoola	human
@aubinerie	human
@AlenaXM	unknown
@jasmine_tjb	unknown
@chaichaistyle	unknown
@dolly88cats	human
@Youllenkaaa	human
@LizzbtMlin	unknown
@DanieelZapata	unknown
@pool2035_aki	human
@TheEgorka	human
@OldeEnglishPub	human
@In_wellness	human
@JAMN945	human
@msm_riho	human
@BioBecky	human
@UnofficialKelly	human
@nynn_nynn	human
@ManipalHealth	org
@jecanex	human
@BalticBake	org
@MynameisSergiQ	unknown
@josueadonias	human
@kayy3na	unknown
@megclairehands	org
@CaradiMiller	human
@magaligorre	human
@ChefMarkus90	org
@LeeWeiden	human
@MrzDiaz11	human
@agentpurple09	human
@Larybs	human
@k0yuuki	human
@AmyZodu	human
@StHelierJsy	org
@vazquezmariaj	human
@cuadernomiggs	human
@hamasaki_avex	unknown
@7ElevenCanada	human
@HiliRayhaan	org
@NewMoneyTshirts	human
@YasmineTunisian	human
@Mariahelde	human
@weBikepacking	human
@NapaCruiseDir	human
@Jai_Lay	human
@EdmondTC	unknown
@yomitas	human
@KingTraylon	human
@daltongcc	human
@RoxanneJY	human
@jfamilyofeight	human
@GhanimAlSulaiti	human
@CuEjAy06	human
@thejasper_ha	human
@nicoleviip	human
@CeLesteMontero_	unknown
@sercankrm	unknown
@SummerShayexxx	human
@TeAmoBreen	org
@fitgluecklich	human
@Wine5CafeLV	org
@carlawatt	human
@figueiralyglesi	human
@Thanachakorn	org
@GrazieVodka	unknown
@ferwiss_27	human
@jenamunategui	human
@RedDogSOMA	human
@dimaswibiyanto	human
@NaomasaUjiie	human
@zoe_bez	human
@howardwrites	human
@Phwrecious_Slim	human
@mmluvsu	human
@ayooshadxb	unknown
@HailThyGoddess	human
@SophieFairbank	human
@Str8OutaCmpton	human
@ozbax	human
@LeahWilliams_19	unknown
@molevalley	human
@looniePEREZ	human
@msklu	human
@goldenvrush27	org
@private_man	human
@HelloFood_MA	unknown
@WhiteHartH	org
@domesticcook	org
@sawangpinky	human
@trattoriaibleo	human
@Fritolay	human
@ChristBoustany	human
@kirstenjoe19	human
@AngieLopez08	human
@jh3mm	human
@ogusuke_S47	human
@tinabutt	human
@lovex358	unknown
@yewoniii	human
@wendiwendi	human
@ccsweet1_00	human
@rendyraffa	human
@SugarPinkFood	org
@NALAPRINCESS	org
@HRBakhtiari	human
@nirwamehta	human
@marker_39	org
@SandwicheeUSA	org
@MilletteSam12	human
@makoooru	human
@the_punctuator	unknown
@giovanny_viola	human
@CookHallATL	human
@Annew_Diaz	human
@alfie_dzone	human
@gavsnomnom	human
@ehodgdon	human
@lizaliu414	human
@XMysticLoveX	unknown
@TimH_East_Det	org
@IsobelCeline	human
@EngAssemblies	org
@SaKESaSA	human
@Sissi_Stella	org
@SomdeepIndore	human
@col89	unknown
@RPIMac	unknown
@CastheMess	human
@nataliegould17	human
@nuwerizonic	unknown
@ryoforma80	unknown
@subornobose	human
@theresiaecha	org
@EcruTuckshop	org
@swurdnation	human
@GraemeDowie	human
@RUBEN_MIRANDES	human
@ilovemime	org
@smc0414	human
@MC2Ken	human
@iamyangge	human
@_sh__5	human
@takanori1963	unknown
@Kymsouth	unknown
@SafeJourneyBCN	org
@emmanuellelatto	human
@vsummers61	human
@missdwikus	human
@ellyne02	unknown
@ILoveCrouchEnd	org
@Stickii_Nickii	human
@Annababylove612	unknown
@enjoyPampelonne	org
@wisethoughts1	human
@PRSAPDXMetro	unknown
@ReynaFgk	unknown
@c_g_merrett	unknown
@ValooBerry	human
@raythekitten	unknown
@YueAkatsuki	human
@floydfanatic872	human
@ShanieKhoo	human
@LEFTFOOTSG	org
@haryseus	unknown
@Mattmetal28	human
@cleanleandetox	human
@zulfaqarsuhaimi	unknown
@jhezfornoles	org
@pauieynez	human
@OyebodeOla	human
@PurdeyChabs	human
@andrealynnloves	human
@A_E_Ozturk	unknown
@widiatianugrah	human
@ImYOUniquee	human
@sneakers_travel	human
@RADNUT_	org
@Fly_Yog	human
@devipipie	human
@VerinAngeline	unknown
@DoctorMu	org
@thesubass	human
@NienkeHofkamp	human
@gopril_	human
@jlmcdonald21	unknown
@abolaqatinof	human
@QueenXamantha	human
@LaRetronet	human
@EoinMarkey	human
@the_lady_lifts	org
@DaRealBarryYoko	human
@Angelic_Wonders	human
@lakaren3	human
@ganiasv	human
@gemma_lily	human
@fromage_blanc_	unknown
@LilSMALLVILLE	human
@ScarlettR18	human
@HadFlora	human
@TheActualEllie	human
@gofitu	human
@viking305	human
@aagussfernandez	human
@mashaharun	human
@mjslazak	human
@h_maechan	human
@intellectatl	human
@alcroncz	org
@femi1211	org
@ReallyMelbourne	org
@CocoPazzo	org
@goonggung	human
@Biergartenfest	human
@1982_ayumi	unknown
@OmgWonderbread	human
@BlackLeopardPR	human
@GarlosAussiePie	human
@brunonchavez	human
@OrchardsCookery	org
@KhalfaniKing	human
@Aioli_Cantine	human
@kekesuzofeta	unknown
@CrazyTanker	human
@spikyedge94	human
@genamariebell	human
@Mister_Spikes	org
@MissGaga007	human
@SMDWilliston	org
@riceworkscrisps	org
@TheRawXperience	human
@CitiSpi	human
@I_Like_Journey	org
@SharonButterfly	human
@TheRecipeClub	human
@anjouxxxholic	human
@Teh_Priya	human
@HelenBhudson	human
@NajmaAlJaser	human
@sexyladiike	human
@Rastagirl7	human
@yuipanporn	unknown
@WhiskeyBizzness	human
@pinaychicky	unknown
@ImaTrickRTreat	unknown
@ValeRen8	human
@PrincessJaedaPW	human
@Cloudchaser921	human
@juicepressny	unknown
@MyFoodMyWay	org
@NATURESCYCLES	human
@acctostyle	human
@Foodandthefab	org
@ramimusic09	org
@20081126No3b	human
@Then_Tony	human
@1frit_a3on	org
@omasu0602	human
@TheBrookCafe	org
@Easy_Greasy	org
@walidchaya	human
@sivakkate	human
@biryanionwood	human
@Wessam_Ahmed	human
@SittiRestaurant	org
@Su_Hell_O	human
@leaforbean	org
@lola_bistro	human
@LaDiizMaya	human
@Alina_HimChan	unknown
@manuki16	human
@spweber54	human
@LesPetitsCheris	human
@wombattree	human
@KevinJRooney	human
@bling2suika	human
@Caleb_Barclay	unknown
@Redbox63941043	org
@alawine	human
@kazfitt	human
@liveacteatwell	human
@Highlifesmoke	human
@Ritzvava	human
@gagateczkaaa	human
@RawickaKarina	human
@piccolany	human
@noellechuaxx	human
@smallmoskito	human
@DiboyRed	unknown
@Emm_Terrestrial	human
@zacfotheringham	human
@samiam4500	human
@adapandabuled	human
@theempoweredmom	org
@MarthitaBle	human
@mjup9526	unknown
@Travelanimaldoc	human
@LittleChannels	org
@Heidi_Veeee	human
@anyelisse_abac	human
@farhahzulkaffli	human
@Healthy_Life100	human
@emilyklein17	human
@meals_cheltnham	org
@MinzKnows	human
@hendochen	human
@fgodoyord	human
@KisstheRain_11	human
@OneRichSong	human
@DjXmusic	unknown
@pechini	unknown
@AceMac007	human
@South_Side_PGH	human
@timlecointe	human
@lamodajkt	org
@carolmceldowney	human
@sisterciccian	org
@MostElectrifyn	org
@MarcoGttw	unknown
@MiaAdinaVida	human
@VeldeAutos	unknown
@heatherswan	human
@Deedums3	human
@CremaPG	org
@ApeiroDelray	org
@TheBendySlow	human
@Holycow_Radal	human
@yohannapooh	unknown
@Mone_Knows	org
@ElieeAbouAntoun	human
@hannahlouise193	human
@thejordanlikens	human
@Daiana_Carrizo	human
@trollball	human
@_victoriaingrid	unknown
@MTPG_Lincoln	org
@idiutuk	human
@LaCoupole	unknown
@DanSha25	org
@JohnySaade	human
@CanelaWC2	org
@annie_bell1	org
@rizuanrahman	org
@prettywsize1908	unknown
@himistermagpie	human
@JaninaOLeary	human
@ristorantimonza	human
@mizzlouie	human
@Heartless3789	unknown
@devi_yang	human
@Inkymann	human
@GASTROLOCURA	human
@zermonster	human
@TheWordyVegan	human
@missingjynesis	human
@1beverlycanters	human
@DelilaDesigns	unknown
@swatimalik	human
@PearlOysterBar	org
@ayannasmum	unknown
@nocturnalbab3	unknown
@PrincesaElien	org
@SarahLBrockner	human
@hektorwoodleys	human
@Tonkaslol	human
@Kim_Pedlar	human
@BR4DY	org
@OTPHGburg	org
@PeachesDreams77	human
@NewCoventGarden	org
@BreddieMercader	human
@trainertiff	human
@VanessaSchoettm	unknown
@EvertonKlaus	human
@gosaliisabella	human
@kay_ruel	human
@fudgeinoz	human
@mjlegalreal	human
@toddjhammond	human
@weirddRo	human
@NoFreeWheelin	human
@cata_ploom	human
@Bot_Nik	org
@kayteee83	human
@Pine_House_Chef	human
@dvnfarrell	human
@TRATA_ROC	org
@Stylehostess	unknown
@Izze_Izze	human
@omnomnomstudios	human
@byebyetumtum	human
@ANDYPMUSIC	human
@mary_speight	human
@AlbertLam282	human
@crab_nyc	org
@OceanaNYC	org
@LUISRAVILA	unknown
@UrbanFarmerPDX	human
@BistroDeLaGare	org
@miss_Nagaa	human
@Lonnie_Almighty	human
@concilia9	unknown
@donaljmccoy	org
@MarishaAccardi	org
@GompersGin	org
@TanBeril	human
@chariiiz	human
@SMoumblow	human
@SyscoCanada	org
@nmb48up	human
@reneesonmain	human
@FCEcIlVoloVnzla	unknown
@cloudvita	human
@11CJC11	org
@WEMFRadio	human
@ItsAmaliahBlack	org
@kana5415	human
@wellingtonjg	org
@ObicaLA	org
@frank_vomero	human
@buyungandika	human
@Jacques_NYC	human
@LATASTEBISTRO	human
@AlexaChill	human
@frockgarden	human
@Fantastica14_	org
@SugarCoatedBake	unknown
@ericdbell	org
@JAnthonyMarin	human
@NaokiNeviLion	human
@SergEscobar	human
@MarsielD	human
@entrepreneur562	human
@mame_jyuzu	human
@ktascone	org
@sushi_zushi	org
@goofyangeljonel	org
@GetChristened	org
@ja3bali	human
@vie_2701	human
@SandyChoiRadio	org
@zelenyoko	human
@LorieoftheWorld	org
@Claire_tweets_	human
@KomalMirza	human
@CHICOJULIONY	human
@HerSheM3	unknown
@lasafron	human
@iambisora	org
@mumsdays	human
@mabutzloveyou	human
@kattymelgar	human
@SalmonArmGC	human
@pcpeaches1	human
@BKKtoNC	human
@MisCalaisBeauty	human
@GoodFoodChannel	org
@Vervedubai	org
@momsmagazine_	human
@davidsung200	human
@_siangyung	human
@joncreed2	org
@mccheslea	human
@africanqueeens	unknown
@zephyrilia	human
@mrfoodographer	human
@im_priL	human
@CT211213	human
@EllaSnappy99	unknown
@realtravisd	human
@snappdaddydogg	human
@YourSouthPeach	human
@lizzietester	human
@kivotoshotel	human
@Gissel_g	human
@ayasoBoutique	human
@BankCafeBar	human
@vancitydives	human
@theNAMEisRJHAY	human
@TimeOutAbuDhabi	human
@GoatCoffeeCo	org
@Chienjames	human
@Chunchonn	human
@MeganAdiar	unknown
@JanelGirl	unknown
@pkaidoo_	human
@SpankysUR	org
@dakotalayers	org
@onlygel002	human
@ElenaAriaStival	human
@msfancyboots	human
@karlayamilet	human
@gusto_il	human
@kirara_manawari	human
@NutriSaludMxx	human
@TCSAUSAGE	org
@shuckbearden	org
@champagnethrsdy	human
@TheChrisCharlz	human
@jasher_m	human
@Cat_Goodman	human
@LimantourMX	org
@7preguntas	org
@JamesNguyenCLT	human
@CASHtrisha	unknown
@ChloeCoscarelli	human
@___spaceman_	human
@Nectar1269	org
@FirstKicks	org
@muziqality	human
@persian__king	human
@SweetestAngel	human
@Enjoysobe	unknown
@xixoncafe	org
@BamPhiriya	human
@Afaenia	human
@s_khanna	human
@LonieRock	human
@wooobie	human
@oliviaroxstar	human
@carlayaemi	human
@Kumaresh09	unknown
@HaveFaithInGod7	human
@Happiest_Hour	org
@CarrieHuang1001	human
@RedsSmokeHouse	org
@SkullCafe	human
@Judas_Palacio	human
@PeirsonMichelle	unknown
@JoshieWolf	human
@femi76	human
@Aaronmg1Gray	human
@SasmitaIka	org
@Malvez3	unknown
@leexuevern	human
@shrinesford	human
@AlysonReay	human
@FashionHouseCT	human
@lizzynorris	human
@ashliee21	human
@XNikkiX22	unknown
@SantaTeclaHotel	org
@NanadNaddy	unknown
@Wholypoop	human
@BethMcShane	human
@AdnanJakubovic	human
@TheQueensbury	org
@bladeyaoi	human
@ahphia	human
@HTT11	human
@widyacitra6	human
@EadaStockhart	human
@EbErjohn21	human
@arjhayalas	org
@steakprincess	human
@keithjustice28	human
@spiderswhite	human
@lilmiss_jordan	human
@comet5o4	human
@HyVeeFleur	org
@liamoran	human
@giovicesa	human
@tihhjk	human
@LadyGirlsTable	org
@NikkiTurtleBee	unknown
@SandraSandygold	human
@QueenT_86	human
@flashgangster	human
@Adriananoah	unknown
@njanyarak	human
@gebavyhacur	unknown
@TorbenDN	human
@albalovesyou	human
@LaVinaDeansgate	org
@heythereDaisyB	human
@AutographGaming	human
@rodales	org
@JanineTondu	human
@mira_attieh	human
@thekindofmary	human
@Chef_Haswell	human
@inettnott	human
@NamikoBattle	org
@alohabejic	unknown
@ohsojaQ	human
@jaexin94	unknown
@SAVE_R_Animals	org
@Ms_Whittington	org
@RyanHandt	human
@DavidTorres_Jr	human
@TWhiteMNDS11	human
@TerriLynnCritch	human
@KaraKimII	human
@zuluquic	human
@missfi86	human
@Fyl	human
@CeliaC17	unknown
@BEAUTIFULVETTA	unknown
@dcreationsevent	org
@PrimalCambridge	org
@DanaLGH	human
@kid4dance	human
@CambelMarionne	human
@DrSweetTeeth	human
@maskokoyoyo	human
@cyandhi	human
@acacopacabana	human
@purplexcloud	human
@flaglermarket	org
@WilliamJMoon	human
@rob422lv	human
@saashafierce1	human
@EsquiresDrog	org
@MszInsanity	human
@Estelkaaa	human
@BlossomJasmin	human
@daniharrison12	human
@alemeyehu	human
@MatMcIvor	human
@CHCuisineInc	human
@xprincess_tx	org
@verocmsm	human
@chantalthillart	org
@loz003	human
@kalangtooots	human
@peppaskull__	human
@coffeedogsUK	org
@AlvaroZaQ	human
@MyUrbanOven	org
@valeriesu4534	human
@CoryGrijal	org
@mocha_almond	human
@angelogutt	human
@unicornswagggg	human
@Opera_lover89	human
@JasonETorres	unknown
@CardiganFiend	unknown
@RokovaiaTigra	human
@melialondon	org
@sscollignon	human
@pumezamdangayi	human
@GabePopa	human
@ChananBeInIt	human
@MikeAshford94	org
@the_crzymofo	human
@charlesrondez	human
@itsmargafe	human
@thefollybar	org
@Kara_Madi	unknown
@WanderlustGnome	org
@MatubaSushi	org
@hatkinson_	human
@kayleigh_gay	unknown
@abdlooali	human
@jhengmiranda	human
@LolaPaola_	human
@traveljenn	org
@DarlingSpuds	org
@TinWanders	org
@Food_Queue	unknown
@zuzazak	org
@helenedelillo	human
@natalierose20	human
@JkeepItCUTE	unknown
@PaulLRDuBois	unknown
@WellnessMinds	org
@wonder_binnie	unknown
@fancyminiblack	unknown
@NYs_World_	human
@mulberryandvine	org
@brigadese1	org
@_lexiainsworth	human
@TimeForYello	org
@MemetDiaries	human
@fabulousssjade	human
@genki_1_ban	human
@Omar_Su	org
@helen_loveslift	unknown
@leopearlsays	human
@egosuperpl	unknown
@an17_u	human
@NightSea_ageha	human
@Ktin2x	org
@CreeksideYYC	org
@likwuid	org
@SephAllan	human
@Homemade_GF	unknown
@thefames	org
@TheMercantile	org
@JanetStahelin	human
@mamalotties	org
@brunch	human
@kkandykreations	human
@konofy78	unknown
@BissonShank	unknown
@beerscenes	human
@Mangkathleen	unknown
@Cyntra_city	org
@Darcy_Menagerie	human
@MARIAcpal	human
@Sarreenn89	human
@Nyssa1209	human
@LydiaMonson	human
@ogalito	org
@thefrancypode	org
@DavidGough18	human
@alicees95	human
@AnaTaylorGarcia	human
@ENFINITEPOETRY	org
@GE_Appliances	org
@no3dubai	human
@gian_3vi	human
@ayudibali	human
@nicolehill17	human
@GBCBenLynch	org
@LegendFM	org
@ClaireNsmith01	human
@CedJackson	human
@AnnGuidry	human
@kristajarolan	unknown
@soheilkeynejad	human
@staceypa	org
@najibilahic	human
@AnneDeppe	human
@TUBBYS_TAVERN	org
@Paul_Snowsell	human
@polytikus	human
@KangstaFosho	human
@dyengkh	human
@didine89964718	human
@carocavaliere	human
@BriMichel	human
@eatingexeter	org
@GhostBoody	org
@buenodad	org
@pHotoEdiTed	org
@clairelds	human
@akonn_	human
@ShiniMK	org
@ThatSugarCray	org
@izyanalzaim	human
@Beyondthepark1	human
@theeDOPE_estRED	human
@iamengrjen	human
@zeppy_chess	human
@Anithakripa05	org
@Jinjer25	org
@oriental8	human
@WahyuukZ	org
@Khaled_yilmaz	human
@taaamiii0524	human
@phookiemonster	human
@queensviewsteak	human
@ByJoBeach	human
@wahyu_nining	human
@nadirkalac	unknown
@Sachin_SMA	unknown
@BudiantoNasrun	human
@Moes_RN	org
@JelitaHj	unknown
@ManPolly	unknown
@karishmapais	human
@its_the_twins	human
@Vankad	human
@eleXeye	human
@food_boo	human
@rilexander	human
@VikaRaShi	human
@BeThePromo	unknown
@davidatkinson89	human
@BChrisOnline	human
@ICANDYSENSATION	org
@jclothinging	org
@LilMackAtak	human
@SpeakSurabaya	human
@LeRnintri	human
@taimani1	human
@BesoHollywood	org
@Robboooooob	human
@Kalenyc1	org
@thepierupnoraol	human
@funsavingmoney	human
@riemerallen	human
@soyc5arofficial	unknown
@YUMMII327	human
@futuristufuk	human
@Michael_Giese5	human
@LOAR_Dining	unknown
@thatgr8little	org
@ZennySalihuddin	human
@bistro_central	human
@Asiago	human
@EztrySejati	unknown
@metinokkali	unknown
@throughnitaeyes	org
@ElizObihFrank	human
@JPSLuxurySafari	org
@Famicorp	org
@EAT_WELL_TRAVEL	human
@Rosaura_03	human
@lemonitsaaa_	human
@FarahBernard	human
@smartcookiesam	human
@dumbreck_fan	org
@tjuneth	human
@theSMPanelEast	unknown
@TodayBirthDayTL	human
@____in_K	human
@khhrmm	unknown
@thejollypoacher	org
@syunannnon3	human
@monazkey	human
@charlie_oliv	human
@vandofashion	human
@meche2676	human
@ChristianGray76	human
@justgetcurious	org
@godshkim	human
@merizzdean	human
@XMaddalinaX	human
@mstark17	human
@AimeeRecipeSpot	org
@TheChicSpy	org
@definitlyfuck	human
@thevicmileend	human
@Ghanasupperclub	human
@Sarah_L_93	human
@LePetitDubai	human
@chew_baka28	human
@malloc007	org
@svahrt	human
@JGrassman	human
@DJ2511	org
@DoooDahh	human
@onikmiraj	unknown
@GLEAMBODY	org
@rky_jj	unknown
@RickyKrisnanto	unknown
@nishakohli4	human
@SarahBailey92	human
@leafyfbaby	human
@xlaOw3l	human
@Witney_UK	human
@ItsJasonBitchxo	unknown
@lacajahabitada	human
@BodyByHannah	human
@DavidsonPIzza	human
@ilovegarick	human
@oishiqMCR	org
@DanielQuach95	human
@MissBlackVIUSA	human
@GWAJAP	human
@Delacovia	human
@RPlayhouse	org
@danideschamp	human
@Cornishson73	human
@jessicalwhiting	human
@OHBLABLAA	org
@ParadigmEvents	org
@downeastdrifter	human
@oBo_Michelle	human
@akimassoka	human
@elliottsailors	human
@Sapna_Mattu	human
@Marquis_Qydell	unknown
@Bibbles_Bobbles	human
@dipaolamomma	human
@Yanti_Oce	unknown
@deliempire	human
@MONKEYKEN03	human
@56restaurant	human
@txemaaguado	human
@anairis_garcia	human
@Visual_Doll	human
@arzuozev	human
@miles4short	human
@dari_anton	unknown
@Mistress_Patty	human
@NettaniaErni_	human
@MethLelis	unknown
@Racpong	human
@novi_sone	unknown
@dorasylvyana	human
@fera0602	human
@thecarpentersw1	org
@mauxitun	human
@mechmendoza	human
@MAmontesclaros	unknown
@MootezTaz	human
@SucreSaleNB	org
@Fitridoyo	org
@nananecoko	unknown
@mynameisEUNICE	human
@big3bioBOS	human
@JulietaK2x3	human
@Dorian_White	human
@GaslightBoston	org
@juliet27av	human
@CRPFoodservice	unknown
@gvmlove	human
@Little_MaryRain	human
@DeluxBurger	org
@the8birdsblog	org
@tesabellab00	human
@DivaDoesMakeup	human
@iino0914	human
@Ametia	human
@LaurenG721	human
@whatLOOKlikes	human
@TheRealDeliDPCA	unknown
@ModelTatiana	human
@BeansMacca	org
@SeaviewVentanas	org
@Banditgangnate	org
@couchmoneySWEET	human
@FollowbackSound	unknown
@sgborne	human
@PaoS_Life	human
@AngeLamannaVera	human
@Gastro1	human
@kappaincucina	human
@HealthCoachTia	human
@jesso4o4	unknown
@HTBrestaurant	org
@ladyanap	human
@ja1son1ck	human
@Matveeva_Nast	unknown
@Amela_I	human
@IrenesStory	org
@zhelmick	human
@dwianantasari	human
@Alidoter	unknown
@KristopheBKNY	org
@julietaspada	human
@veghome	human
@Elligirl	human
@thepiazza	org
@DSmernes	human
@KevinGrayJr	human
@andrewzeelo	unknown
@ZaraEM93	human
@Freonut	human
@640WGST	org
@CarvaoBBQ	human
@WestVil	org
@ForstersRebel	org
@VaneVaneAres	human
@WarsawChic	human
@keikahayashi	org
@KerlyCaro	unknown
@Gisellaayu	human
@TasMahomedy	unknown
@linusinusitis	human
@LeavyRey	unknown
@EstasPrincesas	org
@soyoulearn	human
@Sauviz	human
@AlessioDeLuca72	org
@LEAHatGROUPON	human
@TheDeviousLee	human
@s0a3e15	human
@SevimLokantasi	human
@najisara01	unknown
@LaoMamba	human
@faithmarie_bomb	human
@shotbarjacquis_	org
@Jpetchey	human
@BISTROTHEQUE	human
@Twizzle1414	human
@DanyNathan88	human
@GeoRobbInn	org
@isokeurbi	human
@oneeventslondon	human
@ckpunnika	human
@littlesparrow	unknown
@JoyKidsUniverse	human
@therealjoylaj	human
@elfrass	unknown
@Kara_kovic787	human
@Fishhour	org
@justin_O_O	human
@RobzyJ	human
@martinuplate	unknown
@SamudraCrew	org
@MrNazD	human
@miahhniam	human
@EatLoLahore	human
@1hellokittygal	human
@duckie323	human
@cat_ong	human
@bbsea1	human
@cchow935	unknown
@MaltipooAlmond	unknown
@CrazyButLuvable	org
@NOSE1981	human
@SugarFreeFamily	human
@jhenineng	org
@HRDCoffeeShop	human
@JuliaGuila10	human
@ibleedcolours	human
@MelamudSashka	human
@talesoftara	human
@palmbeachcom	human
@SoonTanEng12	human
@jessa_293	human
@innaNiee	human
@Natachyy	human
@MaahiKaur01	human
@setarehraeisi	human
@bluegrassred	human
@xkarmit	human
@eiiinn	human
@Msy_Chrissy	org
@sdelectable2	org
@MessyDirtyHair	human
@I_DanKelly	human
@begum_saba	human
@CarlaSGarcia33	human
@april_more	human
@samandrich	human
@squashplanet	human
@Nellennium	human
@yatstapia25	unknown
@sido7593	org
@Leukeadresjes	human
@john_hazen	human
@ShopBridges	org
@PhillisBarnard	unknown
@jamesbwheeler	human
@Fash_ibnuKhalim	unknown
@svealew	unknown
@Workplaysoul	human
@LivLeh	human
@evipentertain	human
@rs2hm1	human
@MUAbyLMarie	human
@stansonb123	human
@Serife_Tektimur	unknown
@devtey0708	human
@JustinCDuff	human
@JeffreyTolhurst	unknown
@kikibless	org
@cattoui	human
@_missmcshane	org
@erikaquah	human
@Ashlea_91	human
@100crowsrising	unknown
@cowboysfansyes	human
@Rachel_Gay	human
@lidya_kriuk	human
@vonlipisfaves	org
@HaveToDiet	human
@GooseGanderNapa	org
@ht_bts_sj	unknown
@TeaGardensBondi	org
@APOSRecruitment	org
@digi_catalyst	human
@5Fishermen	org
@alejandrott	human
@HRCAmsterdam	org
@yakdon	human
@miki_taengu	human
@SEOBmallow	org
@carinacapp	human
@plovesu	human
@LesBeMums	org
@JackyKwanTaiHo	human
@tunayilmaz	human
@rosannaoficial	human
@sendainomikui	human
@MagnoliaBTweets	human
@caffesorrentino	org
@agustinkong	human
@grkcutie93	unknown
@gingersnapstogo	org
@Iamkyrlymers	human
@SherlySC	human
@brarestauranger	org
@TanaAmen	human
@There_Caca	human
@SSPitCrew	human
@hinmi_desu	human
@CyDavison	human
@msjordanalexis_	human
@chamberrichmond	human
@JanaJacobs2	human
@EliseGuerrillot	human
@VeganOlive1	human
@phini_phinot	human
@Ralph30309	human
@smearingblack	human
@Bar10weho	human
@Alejandro_haut	human
@bobarcher1	human
@chango_ok	unknown
@BluebirdPtchATL	org
@girlcalledgemma	human
@KittyRamon	human
@BlueveltAvenue	human
@FiveDishesNash	human
@RoseBrent1	unknown
@roxysparxx	human
@p_kun614	human
@mimwashere	human
@SapphireGuelph	human
@linoscjbis	human
@UrbanSpiritz	org
@hamdiesahal	human
@ToumNYC	org
@SAUSALITOS	human
@TheArtistGrimm	human
@BillBatemansHDG	org
@MerkyLuv	human
@RWeThereYetMom	human
@Coco_Paen	human
@JClovelyC	org
@FranMoberly	human
@homeheavenAus	unknown
@spicemadam	org
@Pearuae	unknown
@Rina13Tay	human
@hastenchik15	unknown
@Lluuuccii120	human
@VMSUAREZ	human
@elemntnutrition	org
@ryan_kulawiak	human
@mintycrystal	human
@haymakeraz	human
@GuchiInfo	human
@EmmaJane2147	human
@DesertWiThEagle	human
@themaamelie	human
@chungseungduk	org
@nutellaeaterr	unknown
@Chisa_1103	unknown
@Momo_Sweetrose	human
@ElifYitmen	human
@somayhew87	human
@TheButtaSide	human
@tommy0309	human
@AlbertsonsLV	unknown
@calhouns	org
@TheBiBo	org
@coolkym	human
@audster987	human
@theleelanter	human
@simonedgett	human
@OneFMKe	org
@misaki1111	human
@corinechalfoun	human
@denoryBleu	human
@VivaLAFashion	human
@MiaLopezHTC	human
@anacom89	human
@robbyprice55	human
@marin072ne1	human
@PocketSousChef	org
@jhoetzl	org
@widyastuti_ira	human
@BenjaminHFT	human
@db_ros	human
@MarieManuel17	human
@MomLuvsSPORTZ	human
@_migovip	human
@BroodEnTomaat	org
@TheLesleyShow	human
@snodkm	human
@PugsAndKisses03	human
@BubblyPsychGeek	human
@GEE_ICECOLDSLIM	human
@tildafingal	human
@FoodiePRPaula	human
@IngridArroyoM	human
@FrankDiLuzio	human
@KateFaithfullW	human
@EnriqueMantica	human
@Lipodrops	org
@anshu_sengupta	human
@LivinJENeration	human
@benjapieres	human
@jairo_arguello	org
@TomaszGas	human
@JordanRobert13	human
@ccclarice05	org
@ebbyweyime	human
@JustMelaigraphy	human
@Asyraaf_afzal	human
@DanforthSecord	org
@Paynie3	human
@Louskitchentabl	unknown
@MontyNicholas	human
@Jerfmikko	human
@mmm_newcastle	org
@ChiDacrackHead	human
@MAIJAMES	human
@annabeejewelry	human
@DigitalCyclops	org
@latiamh	human
@Tabitha_Land	human
@romirahadian	human
@ChelaBaby_	unknown
@healthy_liz86	org
@fabim06	human
@Duncan_Quinn	human
@RacerX383	human
@xoxo_arhnel	human
@ChurchwellSusan	human
@kimyk10	org
@Baravento	org
@squirrel8870	human
@asrelliott	human
@meggg_roseeee	unknown
@Anchorage_Bar	org
@frenchjumawan	human
@Its_Me_Dj_Pac	unknown
@bbratty	human
@Artist10023	human
@madammarj	human
@jayang15	unknown
@AmyWes	human
@chung_05	human
@MvMalela	human
@ritemaeroeder	human
@enkaisukidayone	human
@Eth94_lee	human
@TGHoustonNorth	unknown
@MistaHaze	human
@p_sapphire23	human
@IMMALBTW	human
@paigeworthy	org
@EuniRocking	human
@DG_Yagami	human
@AlmaBristol	org
@Mista_Bankss	human
@Joho76581580	human
@4Lunch4	org
@clean_college	human
@laruedepolaris	unknown
@RossellaPiro	human
@jhon_davis	human
@Grandt95	unknown
@TAHONGAN	human
@sujis_kitchen	human
@baristabom	unknown
@DANIEL_LEEDH	human
@CagedChef457	org
@HRPstax	human
@runninghats	human
@GoosipsPeople	unknown
@TLatece	unknown
@interbredmonkey	human
@THEJessAdams	human
@martesito	human
@TheGreatOnePk	org
@LeslieAlberto12	human
@KarlaCarolAnn	human
@FUK_yuka	human
@aimze124	human
@windamariska	unknown
@fasegov	human
@rdtg_ARQ	human
@joodyjoods	human
@therealparker_d	unknown
@sail88club	human
@RootCellarCH	human
@RonsarLo	human
@Sonia_HQ	org
@BellaElla_Mtl	unknown
@CrimsonBoutique	unknown
@TedwardBouillon	human
@TamartianPeach	human
@TheRealRobB	human
@PanchitosGrub	unknown
@o44social	org
@ochanti	human
@YaniBilski	human
@SuperStar_BBQ	human
@NosrednaDfw	unknown
@meryienda	org
@SaltJobs	org
@YP_music	human
@BYEnikkiCoast	human
@euniceolsen	human
@TawannaBSmith	human
@GardnerPC117	org
@LarryFeelings95	unknown
@CKDodgeville	org
@sdf332569	human
@Sasuke_Gerard	human
@southridgecfa	org
@duran_cd	human
@aModernMrs	human
@MattChristmas1	org
@ropu	human
@AdrianYanezG	human
@DillinghamSaimn	human
@JGameren	human
@Ya_Boi_NutZo	human
@Chefjuanpablog	human
@jagmacmusic	human
@thewomenseye	human
@KraveCafeGrill	org
@AngusWoodhead	human
@riotharuhi	human
@LeftBankVan	unknown
@BlakeStoner11	human
@AnnaSkanderLevy	human
@ShandleyIrisa	human
@ivanborgy	human
@fontanweb	human
@krismonico	human
@MarissaIc3D	human
@MaxiEsses	human
@ChooChooLi	human
@_LeifDanielle	human
@MarinaKuharica	human
@RCMAmarkets	org
@AKB_Freak48	human
@vl_foodie	human
@shameltz	human
@budgetyourtrip	human
@thefinickybitch	unknown
@pushingthemoon	human
@RSNSportRadio	human
@JJoules	human
@mirahalonzo	human
@TheFitSkool	human
@emilycardiff	human
@rebeccaoxox	org
@eTobbTweets	human
@DeptOfCoffee	human
@GoxoYogurt	human
@xMissxMetzgerx	human
@KatherineT2538	human
@FollowBSE	human
@RobElPesao	human
@paulnyc10019	human
@Gabcos72	human
@infolakoca	human
@serg407	human
@yuka1203yan	human
@kepo_tangerang	human
@ClauVanAvermaet	org
@IngeSpek_Adam	human
@DJ_LADRON415	human
@Yumorama	human
@PurplePRCulture	org
@Bushra45273426	human
@Piawesome	human
@Ralph_Leo	human
@briehemingway	human
@ReZlAn_MuShRoOM	human
@vvhhaannjj	unknown
@JeevOM	human
@DoctorcitaC	human
@Phoenixinity	unknown
@BestOfTorontoTV	org
@Lhexiiamora	human
@earzusevinc	human
@tomatoblues	org
@sycrs2	human
@tammy__k	human
@TheStickyFig	org
@jojijoan	human
@Love_anna98	human
@mrcraigworrall	human
@nata_moto	org
@NurtureBlanca	human
@KuJoshua	unknown
@rituvarne	human
@LiziDoolan	human
@YHAOfficial	org
@McFlurryLife	org
@JesusAdorno	human
@mimicindy	human
@neeyablue	org
@Dollfacee_Ro	unknown
@naissus1004	human
@YYamkey	human
@HideSlimane	human
@stefanAllardyce	human
@JoeyC_583	human
@Vino50Wines	org
@czarinaarielle	human
@stupid_thinker	human
@olivaselene	human
@tweetika_	human
@VixxBaker	human
@chef_lloyd	human
@KetaminePanda	human
@humaryb	human
@ShadiBawab	human
@VanneyLynn	human
@RomaCondesa	human
@ShaeDerringer	org
@Plasticsir	unknown
@paprika_chip	human
@goodtimebob	human
@AdvMedNY	org
@MichaelEsquive2	unknown
@ns_ldn	human
@Suite_104	unknown
@shoesandbasics	human
@moulinbistro	org
@HanaNakagawa_	unknown
@Chasedastar	human
@Cougel	human
@laura__neville	human
@HappyTomatoFood	org
@vivsarkis	org
@jeffvegas	human
@jaslynongg	human
@misoppy	human
@Chira0906	human
@michaelsgenuine	human
@cafeone77	org
@UrsuLaFiesta	unknown
@cabailey1291	human
@JadesAPineapple	human
@gorgeouslara	unknown
@ugurkuloglu	human
@nadiaelliot	human
@BlackMarketCafe	human
@CapricornJiaYu	human
@saEnacHoi1501	unknown
@yachecia	human
@DJETMusic	human
@EsmeSpurling	human
@andreharry	org
@LuminoToLumino	human
@gamercado	human
@maza_marty	human
@mattleiv	human
@lakbi28	unknown
@BGPdesign	human
@Yulius99	human
@MickMitch	human
@giographical	human
@PlNOYBigBrother	unknown
@irene_tortosa	human
@DonovanBroome	unknown
@FashionFoodHist	human
@SWinChilwell	human
@Ewatan711	human
@TsukiNoMegami	human
@DPHBRC	human
@Superunner44	human
@chloe_rush	human
@TauntonTIC	human
@ShawneePC249	org
@amichun0904	human
@Stinkerquinker	unknown
@fm66666666	human
@camilicepeda	human
@MySkypoint	human
@QueenofPerth	human
@emico913	human
@Neil_iskandaR	human
@Mahltiet	human
@WalkMagazine	org
@akbrena0503	human
@1901shada	human
@TheMourningStar	human
@dingodali	human
@ToscanoIndia	org
@AmeyOnline	org
@iluvmygrandsons	human
@akifumi_hiroko	unknown
@Allanyheter	human
@JenRosaLopez	human
@tweetnanaren	org
@mybowtieboy	human
@MiiKii10_xx	org
@dennis7w7	unknown
@LVAudioGroup	human
@LissyM	human
@MzDParker	org
@ZulhilmiMzm	human
@braelodge	org
@FrullatiCorp	org
@koikasd	human
@craigers8355	human
@_hsantiago_	org
@AmbraRomani	org
@nectx1992	human
@AlexGaleth	human
@huiyingo	human
@jamie_corso	human
@Zadig_13	human
@Napadowntown	org
@eugysblah	unknown
@No_Saj	human
@eatwitheva	human
@AshPandi	human
@annlim_2706	human
@aj_ballesteros	human
@Ms_Epicurean	human
@ianvoyager	human
@AshleyMyrmo	human
@fashionfusi0n	human
@sabby_bee	human
@LadyWjy	human
@LNegras	human
@Four25hours	human
@TimVoters	unknown
@AlohaStreetCom	human
@ms_anitathe	human
@MsMoxieMalloy	unknown
@io0i	human
@brunchescoffees	org
@msandjaja	human
@Lugadu75	human
@jasonryancheah	human
@Valeledebieber	human
@rcanty27896	human
@VintageandLife	org
@thereselorenze	org
@lcryan01	human
@bapxrie	human
@mengacosta	human
@AigulShakurova	org
@andoos23	human
@HallFoods	human
@ilse_dayzz	unknown
@Lungowe_Sims	human
@spiritodubai	org
@caz_marie	human
@laina_turner	human
@jrivera007	human
@jrtanjuatco	human
@SimonaMereuArt	human
@ConnoisseurLe	human
@aufgerouget	human
@elithe_loyalest	unknown
@jam_shaffer	human
@kitlovespaul	human
@ThatLawyerGuy	human
@calonyr11	human
@Dolcerita76	org
@Simona_Minutoli	human
@__ChelseaJane	human
@DropItWithDani	unknown
@AnjaPotze1	org
@GraceStyle	human
@victoriaalynnxo	human
@MagdalenaDuma	human
@valleclubroma	human
@beyoujc	unknown
@fidahalim	human
@costacucina	org
@MlleBCMC	unknown
@ByDavePidgeon	human
@DeeannaLim	human
@drebarrios	human
@delatorrefamx	human
@Chika_Asai	unknown
@AszDorkchi	unknown
@_NolaRo	human
@Oh__Ann	human
@Sapranothegr8	human
@amcgxo	unknown
@matherzo	human
@DaycationDC	human
@TFAtweets	human
@arya_destraya	human
@HopDevilGrill	org
@CafeDNoche	unknown
@MMoronese	human
@DePsalmeida	human
@ponycatnewfarm	org
@monivalderrama	org
@BrooklynSavvy	human
@WVUGuy29	human
@Get_Headspace	human
@thara182	human
@Camillitary	unknown
@TonioYuson	unknown
@StreetFoodDE	human
@shaysavory	unknown
@Neilationship	unknown
@Jingwei_Liew	human
@sherabbit	human
@NiezamMNS	org
@xcarol24	unknown
@DeMorris1	human
@Miss_Solstar	human
@YulasialovingR5	human
@thestonercritic	human
@lbolduc0	human
@ClemensZabel	human
@MariaThomaszx	unknown
@DraftPicks973	org
@JessicaBiancon	human
@nadiagenmasri	human
@monicaleggio	human
@cachothemacho	human
@cuppacoffeeMA	human
@unluckiestliam	human
@MisBeautifull91	human
@jacksonlee1988	unknown
@tohoku89	org
@shielaloves	human
@CherbourgBakery	human
@JBraay	human
@aztek732	human
@thuhuongtrannd	human
@MillwrightsCt	human
@Arbonne123A	human
@travelling2GR	human
@suislinsolente	org
@NOLASummerBunny	unknown
@jenniegee	human
@debonofoods	org
@LouiseGolbey	human
@blue_cocoonut	human
@Parenthoodhighs	org
@18_tuntun	human
@beawithcoffee	org
@genkina30	unknown
@BroadwayGirlNYC	org
@_Laura_Ellen	human
@thelegalchef	unknown
@TomomiNakag	org
@VarietyVillage	human
@mimayblue	human
@itsbeergin	human
@josiegrantphoto	human
@hngrymonkey	human
@madeleine_matar	human
@jinaamode	human
@hashtag_tricia	unknown
@Pariseuro	human
@LBDujour	human
@mickey69reece	human
@Melissa_Andreas	human
@kadikoy_34	human
@RychardMartinez	human
@AndreMisrole	human
@Vely_Tan	human
@porshajje82	human
@naaaank723	unknown
@Angeloswinebar	human
@JaleoOcho	human
@LalRivero	human
@EmiliaMtnezJ	unknown
@fajarniskala	org
@EuVirgula	human
@DizWhite	org
@alllifesbeautys	human
@hasanedirik	human
@kgfreene	human
@CoffeeSpain	human
@JuliaPlatia	human
@JasonWReid	human
@stlyrumuz	human
@clamtoken	human
@shadow_heart7	human
@ntdbfsc	org
@edaanadira	human
@LarderBurtonWay	human
@DavideMicciulla	human
@toisan_abc	human
@mynameisnaira	human
@prosechocolate	unknown
@RoseDeonarine	human
@urbecafebar	human
@christy050310	human
@Bryandilbeck	human
@Sweet_Taters	org
@Latina	human
@Char_DL	human
@3_h211	human
@LiyanaMdYatim	human
@badhiin	human
@shawnkoid	human
@Barrig	org
@rabihhindy	human
@syarafiq_helmi	human
@Eastwoods15	org
@PlaceForDress	human
@eviwinnubst	human
@DJ_YZ	human
@happyy3smile	human
@ecuamelao79	human
@BLFallon13	human
@afiftynine	human
@rialandjones	human
@comachocolatier	human
@_yukiabe	human
@rjkulotzkie	human
@qbirdie2000	org
@AzizBadro	human
@ashdesol	unknown
@jamjambree	unknown
@MissHeartofGold	human
@adrianchat	human
@Vikeejeah	human
@CJmoreorless	human
@Mjuarez808	human
@Prinitha_G	human
@Ticha1992	human
@mafaldacastro	human
@FourinHand	org
@marselinusca	human
@Tribeton	org
@victoriabologna	human
@bkai_	human
@Missbritneybee	human
@lucindalovell	human
@ichagoeslaw	human
@StephArizonaa	human
@RaquellePedraza	human
@yxnxchix	human
@Alice_Reeves	human
@YoKo_Yo	human
@pt_archer	human
@Always_JonasFan	unknown
@Jeany1701	human
@KijoEibon	human
@andrejtrcek	human
@BlueNo7	human
@kmmayernick1012	human
@RVConfections	org
@tonygreene113	org
@lolme9	human
@BirbaWine	org
@MarvinGrill	human
@whereslloyd	org
@niksnikkiniks	unknown
@SyilaRotten1	unknown
@WallaceCarranza	human
@ChesterFiesta	human
@PerksnQuirks	human
@Baikluays	human
@ramil23	human
@RealBlackThaDon	human
@brugudoysampang	human
@EmanQadeer	human
@searestaurant	human
@CoffeeLounge85	human
@Piggy_Harold	human
@saiKkancharla	human
@Capcitiesbest	human
@rex_ezra	human
@mchiarafagioli	human
@timekeepersng	org
@demicua	human
@MissDivaUntil	human
@aysago7	human
@MichelleNico	human
@JanelleTan15	human
@AngeloInCucina	human
@DavisGMAirdrie	org
@theLoveofBeth	human
@DaniBiffi	human
@AnkeHetIdee	human
@RCroucherMusic	human
@VidiciRep	unknown
@KareemaMusic	org
@GiadaMusumeci	human
@JiffStarr	human
@Lyndadelacruzhb	human
@atapas	org
@chocolate76	human
@Chassylynx	unknown
@tama0531mdk	unknown
@Knight_Sanjeev	human
@illaberty	human
@Bencotto	org
@d_sahra	human
@dd23ya	unknown
@Keron_Trak	human
@blknastydaddy	unknown
@zzcetin	human
@DSmithXIII	human
@Dee_Sik	human
@SabineRapa	human
@TamiDeMarco	human
@debora_fg	org
@MELDATOPIC	human
@jeliordan	unknown
@that90s_kid	unknown
@RenWindsor	human
@Verjanka	unknown
@YouPinspireMe	org
@BODYbyEm	org
@chiftf_aon	org
@MargaretPing	human
@yourlittleblog	unknown
@BeauxHarris	human
@mister_jinrai	human
@jhelsea_06	org
@godai1998ty	human
@alainasteiner	human
@mylitter	human
@Megan_Loader	unknown
@vhickys	human
@laurashmea	human
@Ill_Di3_Smiling	unknown
@asia19051	human
@PhoenixMCtyPune	human
@hasbibinharun	human
@euntaexing1106	human
@mztabassum	human
@cube63	human
@LEPAIN_HISASHI	human
@JoannDailyEye	human
@Vicocr	org
@trytrinoah	human
@Robin_Kendall1	human
@funky_wellies	human
@JCPhysioLtd	org
@delicias1001	human
@JAyusoMolina	human
@supperclub_la	org
@skyhi624	org
@timgrable	human
@CR_Parker	org
@lifestylestarlv	human
@Jane132Jane	human
@PReCiOuS_LaDii	unknown
@Juliimancini	human
@2ghyOCon	human
@Rob_Rooke	human
@Brewsters_Grill	org
@smpinthecity	human
@chryssiR	human
@Kerpiccafe	human
@BasementGalley	org
@fayemcgee1	human
@DomMexiCan	human
@ahbonbrasil	human
@IndraniPhillips	org
@ApolloniaHotel	human
@raras_halida	human
@EleAngerame	human
@RebeccaSeal	human
@Scuby88	human
@Sneaker_Hoe	org
@DesiWN	human
@Kalita87	human
@Istaysolid	unknown
@AmirrudinOng	human
@begm_trkmen	unknown
@7_ozaki	human
@VWSouthtowne	org
@sukimissy	human
@PimchanokSmk	human
@HabitsGastropub	unknown
@ParlErdem	org
@Robin_Matteri	human
@maaaaikka	human
@fuckthat_fuck	unknown
@TheGonzoInSA	human
@loustatoos	unknown
@grj219	human
@raige123	human
@LisaRaleighSA	human
@avrbbb	human
@LottoGman	human
@Papi_Gordito	unknown
@banana44882	human
@Life_by_Dani	org
@satsuki0203	human
@shivvy130393	unknown
@ChevellePhreak	human
@canadiangoddess	human
@KITTYSCAKESC	human
@skyler_1006	human
@BLouisHorne	human
@ianovaya	human
@MikaelMicky92	human
@BuaQueeny	human
@Veronika0895	human
@Koor777	human
@MissTinywinie	org
@_evenoe	human
@Memo_Duck	human
@aandaya_	human
@TheFriendlyFig	org
@MughalHassan53	human
@danielawk	org
@AmaxNutraSource	human
@Foodler	org
@DeleteTVonair	org
@AstriaTarihoran	human
@_Veronicah_	human
@Orn_e_lla	unknown
@thepinkocean	unknown
@drew4524	human
@marshydootzy	org
@MarionLaney	org
@CaFiiiiiiii	human
@LolaGettsActive	human
@D_Jonker	human
@fossilsnippets	human
@sergi0M_	unknown
@whell4short	human
@suivezfefe	human
@bianca_yew92	human
@Berraakk	human
@Booksenbrunch	org
@RAlviand	human
@GeorshOn	human
@UberLouiShA	unknown
@LifesLilSweets	human
@Lucky_1973	human
@BaskInStyle	human
@nurulfuadah02	human
@TastyNate	human
@elyon412	human
@michelleaudrey_	human
@rolandobrazon	human
@heymolly	human
@flexingtwon	human
@PineConeAcorns	human
@mr_nieq	human
@blonditudo	human
@DafneFelton	human
@qipeggy9464	unknown
@share_ride	human
@NagoyaCitywalk	human
@bcnTB	human
@sensdu	unknown
@Bne_B	human
@kenji_enharmoni	human
@333903271	org
@Debora_Seg	human
@KraemerAndreas	org
@emichakooo	unknown
@LeoTheosabrata	human
@ChristineHviid	human
@TheDeemeister	human
@irankoto24	human
@ZacCrompton	human
@Food_Pix	human
@geloculated	human
@elifprideuysal	human
@lennynilsson	human
@Natalia_Lidwina	human
@Nelmicrupe	org
@5DChocolates	org
@angelismi	human
@BerriBomb	human
@sultansandur	human
@Peggy_Patt	human
@KuTeKaRiTo	human
@adapi7	human
@Christina_Tsiri	unknown
@Thee_Lewinsky	org
@Mirage444	unknown
@jooooomar	human
@Healthie_diet	human
@BeyondThrilled	human
@wlaxa	human
@MacdoAyonon	unknown
@Jilla_da_Killa	human
@tricialovesrain	human
@blushshop	human
@Maioriz	human
@JChurchill101	human
@Eat_True	org
@inmyRedKitchen	org
@enterplayer	human
@SilvianaLucia	human
@dellaharris	human
@NotJustIcing	org
@Giovanni_Id	unknown
@kyucupcake	human
@irenepak	human
@byangbray	unknown
@chelseajrae10	human
@LauBarbie	human
@HmAnniee	unknown
@JoyyLmusic	unknown
@mojsan73	org
@TerrellYates	human
@CaaLiana	human
@vividsalim	human
@mesaskin1981	org
@Favstar250	org
@Mr_He_Me_Him	org
@musicandhippies	human
@corinyamasaki	human
@mrbarcelon	human
@dursh	human
@grangermdk	org
@nameejorolan	human
@IsabelLauVR	unknown
@cherol9209	unknown
@ksirnick	human
@cai_zhu	human
@eiliendoho	human
@BexTonna	human
@TeamColbyMartin	human
@PueblaGateway	human
@KrisHadiawan	unknown
@AlifIzmeer	human
@orlando_jsoto	human
@babycentreuk	org
@beeeeth	human
@kismetlola	human
@RunswithFaith	human
@Blizzetta1	human
@calibudkay	human
@MikeMercadal	human
@bryanbalatbat	human
@MyndSkape	org
@BeckyABernier	human
@WilliePlas	unknown
@timelessnotes	unknown
@David_iop	unknown
@SjostromHeather	human
@pandaunicon	human
@RezyAiu	human
@FancySherly	org
@danchiz	human
@pregcitygirl	org
@Cendrityss	human
@princessfabio	human
@cupcakes_etal	human
@betterchoicesco	org
@JuiceFmUg	org
@Katya_Rosca	unknown
@nabomita_smiles	human
@ViBE_ub_cherry3	human
@hot_tokenai	human
@ConnorLauch	unknown
@Tiffy_Rodge	human
@RebeccaCombsTV	human
@Joygeous_82000	human
@UtheWae	human
@HappyMama_SoFla	unknown
@KObrien001	human
@Fridmaaan	human
@RootToHealth	org
@clinton_g1	human
@GAB_AND_AB	human
@RossoNYC	human
@gen_y_mum	human
@apolonia_milan	org
@Rarezasprsonals	human
@AlinenaEp	org
@fabianzitta	human
@SammyTpr	human
@FoxwoodsCT	org
@MainStrGrill	org
@natalie_2312	human
@yogakitchen	human
@NickFlit	human
@stephparker93	human
@purpledonnelly	human
@DakotaKozyBrown	human
@rebows	unknown
@SignatureLiving	org
@6harmon	human
@shinta_sukoco	unknown
@0101masa36	human
@baddieju	human
@fiastiza	human
@ohimawag	human
@CutePigB	org
@mongabong	unknown
@houstonforyou	human
@AtLeeseItsOli	human
@koukitaalg	human
@KevinXovin	unknown
@joyeejo	human
@MissJTennant	unknown
@Piratemann	human
@ana_hicksrand	human
@gamelody_	human
@getfitwithed	human
@mollyjordan88	human
@passoaprincess	human
@Nazzybaby15	human
@LemsAvenue	human
@inowgb	human
@sayrilamar	human
@ScarletJAsh	human
@CaeliumKat	human
@Bargansalondon	org
@news5wcyb	human
@zaheent	human
@FitzGibbonSarah	human
@Straightpr	human
@vickylove06	org
@viaprade8cafe	org
@iruntheinternet	human
@MeganOdonnell13	human
@Jesonhermansyah	human
@MartinMassiah	human
@soniapanda	human
@PineappleAnni	unknown
@BrookeCameron7	human
@MustBakeCakes	human
@HaroGenki123	human
@Projeckt19	human
@icamohammad	org
@TBentleys	org
@KarloGP	human
@Yazblu	human
@TheRealToylady	human
@PVasquez21	unknown
@sinacharles	human
@LAMagFood	org
@CapRocat	human
@CarolinaDelRC	human
@yc_havik	unknown
@silvana_md	human
@Ponzie00	human
@twittypeach	human
@good_imager	human
@genigeniee	human
@lorene4too	human
@holybellycafe	org
@Leesa_Lulu	human
@TasteWickInnBC	org
@MazelTovBH	org
@rburns0102	human
@GreenwoodBrown	org
@KumquatMaeCafe	human
@lorelizrg	human
@NicoOsteria	human
@FUSIONpb	org
@aordehi	human
@cookingdanny	human
@jacobgao	human
@hungryeditor	human
@asanfeliciano	human
@Tito_Tampa	human
@Blkbeautyqueen	human
@12ozpoizon	human
@ElisabettaVac	unknown
@Rustam_WLV	human
@antjphotog	human
@NaTuReLoVeR1994	org
@TNMCleaning	org
@deliciousbydre	human
@Jane_Dizzy_	human
@JeanninesSoCal	org
@MissSherell	human
@peach238	human
@anabohorquez18	unknown
@KNOCKOUTD4D	human
@QueenKalynR	human
@TayTay_Fierce	human
@AMLMOfficial	unknown
@thesideplate	unknown
@grizie	human
@Banuozakinci	human
@yoshimiyashita	human
@TheSuperhero89	unknown
@kevinkwan1217	human
@divine_blues	org
@valenciadeli	org
@mparks3	human
@DJMikeMorgan	human
@unitedevo	human
@LstyleKitchen	human
@stevenmariah	human
@gitaguloz	unknown
@GrandchampsBK	org
@hallnesting	human
@jagonyabasreng	org
@LiftedDragon	human
@manicpurl	human
@PaiZuri_saretai	human
@DitiroRantloane	human
@aynmmk	org
@naturallysavvy	human
@SportsFuelNutri	human
@on1sony	human
@nadhrah_	unknown
@milan1899_italy	human
@clarkconquers	human
@MKhamilamirul	org
@maliux	human
@gingerandtrends	human
@BizzyID	org
@sianawestley	human
@beatrizlpy	human
@cuteNclassie	human
@aaniita14	unknown
@NotStevenChan	human
@RebatoRosemarie	human
@DobermanKennel	human
@Lucysdressings	human
@DiabetesINFL	human
@AttibassiChi	org
@Cia_14	org
@SoniaNumber9	human
@my_sharee_amor	unknown
@nolitoybihasa	unknown
@eatacity	org
@JaxxNJ	human
@CFiOkada	org
@angilinajolie	human
@khunshy_fa	human
@___rarefemale	unknown
@RudiGunawan	human
@Beachhutcook	org
@BeechersNY	org
@devthefoodie	org
@fotogeniksyl	human
@Scriptette_830	human
@Hairie_MHS	unknown
@RENEA_SINGER	unknown
@xnor84	human
@MizaMissak	unknown
@mantelcuadros	org
@toyoyuri1124	human
@lifecrustcutoff	human
@PinkPlusBarb226	unknown
@MrHotYogi	human
@nakayamaaimin	human
@newspkonline247	human
@tihchristmann	unknown
@Grei_Autumn	unknown
@GetFarmed	org
@LazySunnyGirl	human
@paulagarces1	human
@BSnellenburg	human
@EastcroftV	human
@IntenseLingerie	org
@YoNoSe_SKEEE	human
@youhannah0303	human
@BaltaireLA	human
@Marko_Miller	human
@bellablogger	human
@StirPRLondon	org
@AwkwardAnnie0	human
@aka_BabyG	human
@DuchyUSA	org
@PubSlattery	org
@ndtv	org
@UrbanWellnessUK	org
@AnaFinogenova	unknown
@Prezzcottie	org
@ShfrAnnisa	human
@kikegiron	human
@asercaleb	human
@YentlHome	human
@FashionFoodieLA	human
@thekatwithak	human
@BayTreeRetford	org
@HealingHotels	org
@anna_nichol	human
@Roosevelt1979	unknown
@MarvinHigueros	human
@Caressabebop	human
@Mr_Gwej	unknown
@LuuRabellino	human
@My_Old_Dutch	org
@AdamOceano	human
@inihairdesign	org
@ofKensington	human
@KPRSRetweet	org
@CorinaBarladean	human
@likeatidaalwave	human
@habibihood	human
@itsJayyWoww	human
@DanValeAle	human
@FarmtoTruck	org
@insanecriz	human
@TheBullSteakExp	org
@CynTcy	unknown
@mandeenicolet	human
@A_G_Lolli9305	human
@Butaquesisomnis	human
@claudiacansayso	human
@Spoke_Stringer	human
@tylerbmcintyre	human
@Huddlenet	org
@RonnysChicago	org
@equestrianhtt	human
@nyuunyiin	human
@PureNaturalDiva	org
@PureFlexSA	human
@salmontes	unknown
@MistysLincolnNE	org
@mygoosechase	human
@lia_rimaldi	human
@sarahontherunx	human
@Melvin226Melvin	human
@dcedmeyer	human
@GabrielChTatar	human
@WIPBangsar	org
@DennisPang	human
@leokodama	human
@justmestu	human
@sashimomo1014	unknown
@too_one_be	human
@AmericanQT_xxx	human
@cgexpanse	human
@i_am__riyo	unknown
@notjusnefemale	human
@Mrsamfloyd	human
@nicklessismore	org
@DVHoek	human
@manamiso23	unknown
@KitchenTwins	org
@ykesha2001	human
@iluvdomestica	org
@ChristieCiolli	human
@flaviaabu	human
@misssisca	human
@Vivianchocogurl	human
@marcodeita	human
@LuttrellArms	org
@FaithfullyMiie	human
@TimTalmey	human
@JasonDKahn	human
@LikeLifeCL	human
@SweetlySuccinct	human
@acapre86	org
@niceneasyAthens	unknown
@mikeeandrei	human
@bellininewyork	org
@missyuniarr	org
@MishieRedz	human
@swiiitch2010	human
@mai_mae16	unknown
@montanaramiami	org
@kipper_anne13	human
@proinnerstadt	human
@MaeJeenius	human
@vintrospective	human
@FRANKTH3TANK	human
@opagyros	human
@RyanSwizzden	human
@aprilfleur29	unknown
@cheval1e8r	human
@jean61x	human
@StephenieKunz	org
@MoverAVL	org
@KissMyAzzy	human
@PrairieFireCU	unknown
@MelloMelonJuice	org
@ConRalph	human
@HaleemahG	human
@FoodTruckAustin	org
@the_lost_sound	human
@mwmm_deals	human
@fluegelwesen	human
@MarjPhotography	org
@JanvierNoir	unknown
@HeelWillMahoney	human
@TJKelly10	human
@izmirkizii	human
@lornajaneduffy	human
@antspantscafe	org
@Paulinajosephin	human
@SleepyHarreh	human
@RElizCor	human
@SingingCoconut	human
@Daria_White	org
@ladydakki	human
@sauljohnjoseph1	human
@offtrax	org
@WhiteWhisker	org
@MissTinaSun	human
@tejaspadekar	human
@fritoburito	human
@kaguilera09	human
@MRKENNETHCROUCH	unknown
@MesoEats	org
@AmpBene	human
@elsontanchico	human
@magic_terra	unknown
@ColonialInn	human
@ohmyAdre	unknown
@imvbee	human
@estudiodrap	human
@foodbloggercon	human
@BlogdeLucinda	human
@Bobby_Jean	human
@Widkhaew	human
@chikajessica	human
@LJF917	unknown
@ren26gaku	unknown
@sparkymonster	human
@23michaaprilia	org
@pijatalks	org
@_NeilRoss	human
@A_Emigrante	unknown
@chef_milky	human
@LuKiABM	human
@SteadyRush	org
@AllanAnttonio	human
@iammichaelwatts	human
@OLDBAYSeasoning	human
@ObsessedWrestlr	human
@Beellouise	human
@missKansLondon	human
@leglisehove	org
@MissMichiB	unknown
@mifiestadeTe	human
@PaulPH69	human
@im_superdad	unknown
@charhang_ash	human
@liloyuiiz	human
@claire_m_graves	unknown
@Tizznoe_	human
@LisaLuvsAston	human
@SoupSimply	org
@askthehiphopdoc	org
@UeaToronto	org
@victoriainez	human
@billionaireuz	org
@ScottMorrison16	human
@NickiDavis_	human
@_chrissiy_	human
@GiRlBrItTn3y	human
@anafuckermexia	unknown
@sam24r24	human
@katiepm386	human
@vertdropnutr	unknown
@laalbaida	human
@HouseOfPhilana	org
@GABBZiSDAMiLf07	human
@cvfabmama	human
@vharrison1984	unknown
@ilovejozelleeee	unknown
@LanaLovesbeauty	human
@TsunamiWhit	unknown
@ejcatering	org
@NicolleMK	human
@allinvillas	human
@ScioltiChocs	human
@Kaoru_84	human
@brittney_houle	unknown
@Nurwandi_1D	unknown
@natOtAQ	human
@stevemyalleats	human
@FoodieHouserMD	human
@MintMag_ie	human
@rslapp	human
@xshelaex	human
@JMEDINA1969	human
@Heather_Faz	unknown
@brouster	unknown
@StirlingHome	unknown
@birdsksn	human
@emmycherryemmy	org
@abbagej	human
@lexiiikw	human
@ybrooDS	human
@QueenBSF	unknown
@alecoger	human
@WmEvents	org
@ImABrand_BITCH_	human
@iamLittleApril	human
@MarceBoglione	human
@mymarios	org
@ZoeyWitherspoon	human
@jchrdz88	human
@2eji5Ejieji225	human
@BHThisMonth	org
@MUSANIPHOTO	human
@ARJOGK	human
@cacaonhan99	unknown
@Khatrina_Nanhu	org
@_TheSlayer_	human
@sin___m	org
@NaOsf	human
@mrs_mansell	human
@genpira03	org
@IamAlexisP_	org
@AndiAMusic	human
@Niiinen	human
@PurpleBikerGirl	human
@Happy0309Lady	unknown
@Ddiddy_GaBannA	human
@BounsandBabz	human
@litwolfmd	human
@_shxnnon_	human
@Tanpopo_730	human
@thedrswolfson	org
@lestiyahanum	human
@steffoy	human
@ChloeMcAuley	unknown
@Yung5	human
@Mooyuii_inam	human
@iamALDZtitude	human
@FqrSyqi	human
@matthew_v	human
@DivyaSeetohul	human
@AliceKY7	unknown
@dadofdivas	human
@QHotels	org
@ravynalyxandra	human
@NorainnAziz	human
@DJMenaRD	human
@SheikhEamir	unknown
@CheriStories	human
@meaghanhannah	unknown
@songbird128	human
@DonutFreaks	human
@TrimTina	human
@margmargmargm	human
@NYC_PhysEd	human
@KiaramelPT242	unknown
@andiamoservices	human
@katlsorizo1130	unknown
@julianpikachu	human
@hardknoxpizza	human
@EmNodge	human
@Peter_Cazp	human
@babyloiysta	unknown
@Nang_Dang	human
@lexi_xoxoxo	human
@KalaSung	human
@BritanyClaus	human
@Casey2Cook	human
@NerdyKeith	human
@cve4mejournal	human
@FishersMexico	human
@Augamaskee	human
@Blockstock	human
@pacerglass123	human
@AdajulesYing	human
@woodlandnrose	human
@MakeMyMix	human
@OWOTG	org
@ichimitzy	human
@paulj85	human
@Jeslaurinha	human
@CompadresOhio	human
@himechan117xx	human
@k8_kell	human
@Druwy	human
@CecilyMates	unknown
@cafemaxonline	human
@Sterlingsinc	human
@NSRHarkore	human
@AllHailKayy	human
@Willradiorun	human
@HazmiDhamiri	human
@vidajocif	human
@thatsourtable	human
@AnnettaPickerel	human
@SilviaMenendezM	human
@EcoOrganicKat	org
@camerongaunt	human
@ahcit_	human
@chrissawoj	unknown
@babe_mei	org
@FashionableJen	unknown
@macyescobar	human
@Rapupselle	org
@gourmet_soiree	org
@Philly_Beer	human
@misterSha	human
@vitos17th	org
@nandoism	human
@650Cabbagetown	org
@GeierMonsta	org
@Zeyadyes	org
@larrytheceo	human
@Gothic_666	human
@LindaMariaMusic	human
@cecebarbie52	human
@lolievents	human
@lepetityume	unknown
@ThatChickYacey	human
@Derek21Tru	unknown
@joshdpem	human
@yumajin525	org
@JoJoC4Life	human
@cherryswong	human
@AlSanbokOsc	org
@KB24_ProBeatz	unknown
@lizz_hn	human
@TheGingerTiger	unknown
@endswithaW	human
@Trimurbody	human
@HananGolabi	unknown
@cyruspetigara	human
@KiyahDuffey	human
@mexyooh	org
@andreygladysh	human
@buckatone	human
@TinaLovesLights	human
@RonHarvie	human
@FiloTer1	human
@FofiTourou	org
@RolaDaher	human
@DeVillesDalkey	org
@saraottaviac	human
@celerymbeetroot	org
@TacoVelozATL	human
@Tanya2005Tanya	human
@CotHaki	unknown
@EmpressAlicia19	human
@tori3jensen	human
@HelpSheffield	org
@loloartistuk	human
@EnricoGismondi	human
@AsadorDublin	org
@mymr2020	human
@MamiYessi	human
@Donge94	unknown
@PSYkoiTIC	human
@megtravis96	human
@devereauchumrau	human
@VictoriaJP14	human
@ZANA_ROSE	org
@Only1_Sahn	human
@OrrangeKitchen	human
@CoachEnzoH24	human
@_yeseniaherrera	human
@utiversum13	human
@teqabite	org
@aasuaje	human
@ekin_tinkerbell	unknown
@peterjpro	human
@abigaile	human
@SlzMo	org
@irunguhoughton	human
@716SevenSixteen	org
@SweetTampaBay	unknown
@rachaelcampbel	human
@Fc_Fenesia	human
@Heyzdabrand	human
@Visit_St_Johns	unknown
@jacreador	human
@molotoz	human
@newsds1	human
@ClitorisRosa	human
@nadya_shima	human
@Clareybear	unknown
@mazahrestdubai	human
@selonizm	unknown
@ParmieP	human
@thelionunicorn	org
@RmRebecca	human
@madridselfie1	human
@NezukiGirl	human
@carljasper2001	human
@annicakreider	human
@eda_karakas19	human
@FeistyMomma	unknown
@siiiiiiing	human
@Ellaesfashion	unknown
@lordjesusray	human
@MamaInstincts	human
@_AnaCurly	human
@joshkmoss	human
@thefatbaker88	human
@SuvlaWines	org
@robinshomes	human
@gkzaza	unknown
@BahriaSeafood	org
@jenna_say_what	human
@illynana	human
@littlevoice92	human
@citraica	human
@Novskie79	human
@patriciapoyatos	human
@NJCris	human
@DJ_Lim93	org
@Rivas_Charlie	org
@sharktoothsteve	human
@ri_co_0411	human
@ophiiieee	human
@BlapBlapTheo	human
@Leizelle	human
@2foodiesnodiet	org
@Porkyland	org
@leamindanao	human
@DawnMarieBigger	human
@corillac29	human
@chicolat_chaud	human
@Gantarvelocity	human
@Vebinista	org
@Justformami	org
@jlewin	human
@planktone	human
@SocialGourmets	human
@ChunksBabyJunk	human
@juicejointcafe	org
@PrincessSandyB	human
@prgirl65	human
@timunyl	human
@Ikanos_MTL	org
@marvinshirley29	human
@javintarun	org
@mesam0620	human
@FBWUSA	human
@artizonechi	org
@mickobrien1	human
@braffaut	human
@teedomingo19	org
@teriannbrown	human
@marlenemarino	human
@Fannielewis	human
@jnlmda6	human
@GreatHealth4Lif	human
@TorontoCafeFood	org
@tomao_jomz	human
@RoomwithRoses	org
@Apero_Bot	human
@Silverclaim	human
@gbbaburnside	human
@wondercurl	human
@KVelez42	human
@HouseofLotus1	human
@VictorAspidov	human
@valerychekeres	human
@djjoeyboii	human
@anna18von	org
@Milu_Marcela	unknown
@kingdavid_04	human
@CulinaryInspo	human
@JuanDrake	human
@marose89	human
@woodruff82	human
@MJorgeLuis	human
@Dudley228	human
@adriiennexo	unknown
@jonathansc	human
@woodstcoffee	org
@sm_darshan	unknown
@Sizzler_USA	org
@ChiCityScreech	unknown
@jalalspages	human
@SeharayG	human
@Queer_Soul	unknown
@KeraCartrette	unknown
@SrgTlst	human
@kliisariistii	human
@ArochaCam	human
@londonmelissa1	human
@edys4996	human
@officialkalista	human
@OZenniieO	unknown
@hirofumiarai	human
@BreeliciousBite	human
@iknowrightpao	human
@Savilife	human
@MP_Dairy	org
@hilmi_la	human
@brachohevert	human
@Marta_Malinko	human
@AGouletas	human
@Btodan_	human
@TonyJCronin	human
@Simonsandall	org
@huemanlife	org
@pgaleota	org
@BywaysCafe	org
@MonikaBrandtova	human
@Zengaku1	human
@CAM_GLAM22	human
@emma_bostock	human
@luanne_238	human
@Teesinthetrap	org
@Organicffy	org
@ornaoren2010	human
@Ambronite	human
@king426g	human
@realJAYJAY	human
@arifianisemesta	human
@zaira28mae	unknown
@lauraelenavivas	human
@mahaFlorence	human
@mtoia12	unknown
@emiliekuznicki	human
@Ploypailin111	human
@meryl1991	human
@danielj50923097	human
@lin82248437	human
@Mala_Landa	human
@_Insta_Cook	human
@WonderMike	org
@DemiAliHelenius	human
@AssoulinePub	human
@cucinapergioco	human
@yannyb24	human
@thefoodjar	org
@JerryManzack	human
@SWEEPSTAKESILUV	org
@VisitStatesboro	org
@Pomaio	org
@XCEO57	human
@sunnkissskinn	human
@Hui_Linq	human
@PenroseBar	human
@OM0517	human
@traceylclark11	human
@retnowhe_92	human
@BrendaBusyBee	human
@hellomecha	human
@Mustard_Cafe	human
@merba_1	human
@MunkeeLady	human
@UmangKhullar	human
@_lucyappleyard	human
@TazzyWazzyFrazz	human
@joshyballard	human
@MiliRMarino	unknown
@Jakub_Samek	human
@craigless2	human
@YforYang	human
@gLow_Rhy	human
@ZacharyFalb	human
@Leeyong_Soo	human
@joonasluotonen	human
@saritee	human
@MalloryCourt	org
@lynsey_wight	unknown
@thedavidtnguyen	human
@tehreem_mahmood	human
@TopNotch2805	human
@csquaredme	human
@Pagoda71	org
@eat_about	org
@FranciscaLeony	human
@absolutelyChike	human
@FoodieFridays	human
@StGeorgesNE38	unknown
@fredakimi	human
@Noemiixe	human
@Bianco_43	human
@blackqueen6179	unknown
@ChelseaRaeAXO	human
@MloBen	human
@ChIe_DemEsa	human
@HailMerrySnacks	org
@nathaliahehe	unknown
@LuluFleg	human
@MrsGleason7211	human
@EBarks26	human
@SixInchHeel	human
@MissElitaOne	unknown
@KarimaGhozzi	human
@WickedDesire2	human
@Cancer_Org	unknown
@Vermegen	human
@miraC00L	human
@nncelebrityskin	unknown
@iam_poti	human
@BugzGene	human
@karlas_thing	unknown
@ichutRiang	human
@inaworldofbees	human
@Dameadelphia	human
@TheMaleDime	human
@tr3z_marie	human
@evandwitras	human
@sherinish	human
@erroll_spud	human
@K_Randhawa90	human
@LinsayTaylor	human
@Magdalena_Roze	human
@johnnytestcb	human
@ElenaRaouna	human
@3ammarnajjar	unknown
@StiritupMag	org
@thenokhx	human
@805Living	human
@TommyCamden087	unknown
@NkoxLeader	human
@AchielloUtdMKS	human
@governondowns	org
@TBurkesPub	org
@Kiirrraaaa	human
@Reistips	org
@Urban_Milan	human
@BobRafati	org
@weand_co	org
@JessandJims	org
@MrCarballo	human
@Bravmelo	human
@amneris987	human
@PrettyBoyWithMe	unknown
@Lefty_Uno	human
@missnaturalle	org
@ZeldaWasser	human
@KoreanKomfort	org
@whatsoninharrow	org
@ElvieGCanete	human
@kincaid	human
@E_llusionist	unknown
@lyslyslys	human
@dianariantika	human
@albmen117	human
@TheBetci15	org
@GleekMagical	human
@Eich_AJ	org
@VikingJared	human
@AliciaVeronicaP	human
@panyunhe	human
@m0onbLink	human
@ijamescolcol	human
@dhineyulo	human
@MissAnnCatalan	human
@alfie_19860210	human
@pani_lovett	human
@chinabosuke	unknown
@maumaodin	human
@Ge0Rge0us23	human
@jonesforjazz	unknown
@ChefJonMoulton	human
@Finchy1313	org
@mrsclark_x	human
@Amorgan471As	human
@DemonnPrincess	human
@mattat330	human
@nuria_beltran	human
@Shuwand	human
@mermaid0916	human
@MsLisaHerbert	human
@ClarabelKacee	human
@CameoCardiff	org
@ElaineWong114	human
@VanessaPeragine	org
@ButterLC	human
@HIXRestaurants	org
@knoll_sina	human
@boldqueen12	human
@KendelPowers	human
@keshia_bun	human
@xuan_hoaa	human
@diningonstyle	human
@LYPANIPAK	org
@NeuvooHosSA	org
@lampNsofa	unknown
@cookstomize	org
@MaddyBeckham1	human
@jeejennifer	human
@TheNPAFollower	org
@AlwaysFocussed	human
@marleneb75009	human
@LittleJoBlue	unknown
@ThatsVicki	human
@producer_uso	human
@LonJandis	human
@TWHToni	org
@SrtaZaidaCastro	human
@henson40	human
@yellowboi242	org
@BrendaBopeep	human
@munchemapp	org
@rinsuz	human
@LaDiiJaii420	human
@olyolliee	unknown
@DedyKurniuw	human
@silvy_morme	human
@broframestone	human
@BarTaste	human
@Joytodawerld	unknown
@allystar1827	human
@CareerCoachJen	human
@APStow	human
@StacieBottomley	human
@case_belle	human
@juancopadilla	human
@robertscottPT	human
@Katiohead	org
@TheJointOB	org
@poet_teresa	human
@De_Vos_Kelly	human
@crispyyalert	human
@OTBLounge	human
@Abstterr	human
@becomethebride	org
@MichaelHJordan	human
@ProntoGelateria	org
@brickiepedia	human
@gwetzepassion	org
@xxTruckYeahxx	human
@BonniePfiester	human
@iworkartwork	human
@beyondbookwall	human
@ribkalestari153	human
@VillarDishes	org
@bayan4030	human
@MrsBsCatering	org
@PtheAverageJo	human
@babychinamae	human
@Grandale	org
@velyvillamor	human
@lpgofdgfdg	human
@AXclusive	unknown
@kparadiso13	human
@Rose_Zanne	human
@theroxbaby1	org
@fenrose79	human
@mybeautyful12	unknown
@isozakikazuya	human
@claraalvelina	human
@ninyan31	human
@ILuvLumberjacks	human
@BrackettMusic	human
@gettinusfed	org
@HaidyC14	unknown
@PizzaOfVenice	human
@DebsLOFT101	human
@foodjems	human
@healthy_strides	human
@ulmerstar	human
@RoxyWatkinsAUS	human
@ashkalei	human
@stephanie_mr	human
@AliceBee1234	human
@GranbyRanch	org
@iamynahshna	human
@DeaAmilo	unknown
@Artlettakid	human
@MrtDiana	human
@LukasFotografie	org
@YantraCancun	human
@AlbertsonsLAX	unknown
@Igoarmanda	human
@KettlesKitchen	human
@MarkGreen88	human
@NeuvooOdessa	unknown
@chieken86	human
@Susie702	human
@EmmaCB_	human
@jonnysutcliffe	human
@TroyDowling	human
@michaelnai	unknown
@DonnySinsXXX	human
@NikkiVanekan	human
@VeeBear	human
@Failtube_nl	human
@SpeedyEdieTRI	org
@juampiMolina	human
@happymaple_	org
@TexasFitChicks	human
@ernasuryadani	human
@cafeusaquen	human
@Pat_Goen	human
@yvonnesuemay	unknown
@missviirgii	org
@1wolfpumping	org
@bonsplansgeneve	org
@Lyucia	human
@BlueNile1957	human
@StephenHelin	human
@NGrinblats	human
@Sw33t_n_Sour21	human
@maricrismedel	human
@pooh05bear	human
@BrunoMhaaaRs	human
@PINCinternship	human
@SpacePleasee	unknown
@reymondkix	human
@syakir92	human
@lazyveganbaker	human
@peichenzhang	human
@wellinho_	org
@UAEeverAFTER	human
@foodgressing	org
@BehnerMyrna	human
@arabellaa09	human
@GaryDacanay	human
@Cursed_WithLove	unknown
@JulieAnneR15	human
@UweOpocensky	org
@Cristii17_	human
@RoweLeslieville	human
@DimeAllentown	org
@yeontadl	human
@themartinidiary	human
@TERRYCASTER	human
@Lobo_Leyenda	human
@AaronLWittnebel	human
@PrincesaSEO	human
@Buddhas_Mommy65	unknown
@xxxAiWeiC	human
@rosieliem_	human
@BlackGold_Ent1	org
@JeronLamour	human
@Burp_Blog	org
@SweetSavoring	human
@Bidvest3663	unknown
@KMinarskyy	unknown
@MiguelAngel_6	human
@Hiiroo	human
@LollipopSlim	human
@KathleenElsie	human
@Youngisthan	org
@dajona26	org
@ScientistGay	human
@LUceeYap	org
@AmoreEGusto	org
@rawkinwwgirl	unknown
@nanAyunee	human
@doctoban	unknown
@PonoBurger	org
@OForuncle	human
@ichaaismyname	human
@0429_yn	human
@AmberWang1	human
@dominicsy	human
@samanthachan_	human
@fromagechick	unknown
@dashrath_here	unknown
@DanforthVillage	org
@stephmayhue	human
@Saylor2009	org
@HeartForCarter	human
@ChinoValleyEggs	org
@clarisa91	unknown
@ReserveTalence	human
@erikreubenmara	human
@Holistic_You	unknown
@annejuliaokay	human
@MMSAUMY	human
@NicoDaichi	org
@melisaforano	human
@paradisodelrey	human
@David_Crayford	human
@Ida_Mrs_Isa	human
@riamaria88	human
@c24758493	human
@AZHRHM	human
@darealkevfields	org
@DoubletreePune	org
@RiasIdeas	human
@RobyMaulizhaa	unknown
@djahzi	human
@DjP4bl0PR	human
@emma_davies29	unknown
@cafemadhouse	human
@Singerman2000	human
@FJMaris	unknown
@crazysammons	human
@BoooJr	org
@TM_92_	human
@realajp	human
@beatrizalencar	human
@CheshireFitness	human
@johnprudhont	human
@VisitWyre	org
@Hol_Klandar	human
@mijatrombley	human
@norrieswife	unknown
@AnkitKhandelwal	human
@hide_8_zealot	human
@awanhitampekat	human
@cirelo	human
@MrsEManning	human
@Dantes127	human
@SputnikMery	human
@NEQUA_fLowww	human
@tarynthatASS	human
@PignMixSweetCo	org
@jeniussocial	org
@bianca_kline	human
@bestueverate	human
@hikaruco_888	unknown
@amom4u	org
@TinaSonnn	unknown
@markajumandos	human
@markescobar	human
@vanessaperrin	human
@food_dreams	org
@chanmura0126	human
@VANESSASANQUIZ	human
@Anything_Mc	unknown
@xescaflownex	human
@LenkaOtahal	human
@Charo75	human
@1970_Jones	human
@ppaetputzha	human
@BerleyySuee	org
@SharaMcGlinn	human
@supermanfan78	human
@tomfrances	unknown
@johnbunag	human
@courtneyduggal	human
@ValentinaEnt	human
@arimaamin	unknown
@GourmetStarter	human
@chomchunnie	human
@Emilylenore55	human
@tiborxia	human
@comperelapin	org
@qlshow	org
@liliankeybets	unknown
@dirasi	human
@Cornish_Tiger	org
@cute_maple	org
@EyRichieWe	human
@i_Am_MeEh	human
@graceslick77	human
@AlyssiaTilli	human
@Karl601022	unknown
@BenMelchior	human
@AchievewithAli	human
@gialicious21	unknown
@hotelsantabarb	org
@patgabz	human
@Perj08	human
@BoulevardNG	human
@lydiahappy4life	unknown
@JayMambo86	human
@tere_marcellina	human
@akolozvary	human
@clozoya13	human
@bfastfriends	org
@andrulau7	human
@leeemaaan	human
@Shout_Out_Bot	unknown
@Customizando	human
@j0NIE	human
@famouslyfamous	human
@Alessia_160114	org
@rebreod	human
@Reeph	human
@hcistevehulsey	human
@HBG1969	org
@GraceRuijie	human
@kcchan999	human
@silviapalma97	human
@muffinmom96	unknown
@OonkoolFatz	org
@faustolozada	human
@LolitaDollHimex	unknown
@hendrisamuel	human
@ThalassaSeafood	human
@Abraham_ZavalaQ	human
@KCSocialManage	human
@AmithRahman	human
@ArtichokeRecipe	org
@chefdrewandrade	human
@weeeitsthmmy	human
@WildflowerB	org
@my_pers_shop	human
@ten01h	org
@NengChant	unknown
@JLP_24	human
@laura_stonier	unknown
@emilynachazel	human
@MrsMcPartlin	human
@McCreative83	human
@StanleyPEtienne	human
@moscashirt	org
@Mamzelle_Mia	org
@jahLOVESwhaw	unknown
@kemcofood	human
@SUPERMAN2500	human
@omoshiromovies_	unknown
@TheWigleyFamily	org
@wkartadinata	human
@hernanadolce	org
@AilinaFabiyana	human
@BFCEvents	unknown
@italydreamer15	human
@pnkhrzn	human
@kevinsondakh	human
@chicle1977	unknown
@ReverieWillBe	human
@shamilfirdauss	human
@ThehealthyFT	org
@HobsonsBar01	org
@TomoKo666_RT	org
@peitan1001	unknown
@CarlosLozaAlv	human
@NikkiMikellides	human
@okanahoda	human
@Notorious_NCB	human
@isidahorncastle	human
@blindylle	human
@jeanchia	human
@Pelon1	org
@rmontour10	human
@Gingeraffe2424	human
@Hevphoto	human
@FSThailand	human
@CarmelaSavioli	human
@kelly_cerrone	human
@SimplyRLG	human
@kev_inE11	human
@AWDanielsauthor	org
@fixprovencion	unknown
@iyliaaa	human
@SantiagoLpez15	human
@fabianig75	human
@TunaAndSleep	human
@GrlpantsGR	org
@kingdenson	human
@sugiedamayu0102	human
@marclouieyap	human
@stick2stickTv	org
@PrivyLiz	human
@TrendSetMag	org
@dindasubeno	human
@passionsista	human
@Ding_1015	human
@rokadavet	org
@_King_SERGIO_	human
@laurarovellini	human
@AEMHealth	org
@karlafernanda16	unknown
@CSArtsQuarter	human
@TrusRichard	human
@vladaferinscka1	human
@andreavigneri	human
@Ms_Awesumness12	human
@EbruAksuna	human
@zahida_rafik	human
@macacha_w	org
@ampleforthplus	human
@yolandayollie	human
@LegendaryGirlA	human
@_TamaraRM	unknown
@fiesty404	human
@2ScoopsOfScoopy	human
@nawaz57255752	human
@BankBourbonPHL	org
@VirtualSingh	human
@Chop_Street	unknown
@StopAgingUS	human
@KrixSeyLicious	human
@TSGroenendijk	human
@pikariooo	human
@Gloria1Cruz	human
@OutlanderKitchn	org
@Jet_Nasty88	org
@kabilanchelvam	human
@Pirrin43	human
@luceveilleux	human
@Nieshonline	human
@DannEatsCake	human
@angelocamaisa	human
@ovargas3	unknown
@paintoplenty	human
@oldshawneepizza	org
@paolo_naive	human
@Mingissiyeva19	human
@DenaMusic	human
@hazz_roeclke	org
@CreativeQDublin	org
@Eharlemfilm	human
@Sandeepsingh_k	human
@nursewanderer	human
@DanielDunlap	human
@secretmann01	human
@SOOfoodtruck	org
@Jicageni	org
@smjsinclair	human
@ItsBryceCarver	unknown
@Terence825	unknown
@vhend	human
@HELLOPROMETHEUS	human
@TanyaShopDiet	human
@TrustHim333	human
@AartiMadan	human
@taftsalehouse	human
@Mainsqueezemike	unknown
@Mirakcis	human
@imaeffendie	human
@hstreeterh	human
@Gastrocjomeus	human
@freddysfoodcrt	org
@Boblack98	org
@yayakmara	human
@OLHotSauce	human
@_Ziberia_	org
@laraaaemily	human
@DIntoxicologist	human
@Maddie_Fash	unknown
@ScopeLocation	org
@CantinaGilbert	human
@YellowDogBBQ	org
@mikkojerf	human
@AnneXthX	human
@Katieelynn91	human
@chiyomu	unknown
@serogers	human
@Elena_Baturyna	unknown
@astrijenik	unknown
@filledumidi	human
@krizia018	human
@LovingPurposely	human
@encircled_	human
@valeriebellaa	human
@MrsHColeman	human
@koukos	human
@JudytaPapp	human
@cajunjass	human
@JBieb_NB	human
@JeannettePawula	human
@nesaqueenn	human
@BrewersFork	org
@Cailleachmimi	unknown
@dani77Love	human
@Mysweetcormer	unknown
@IamAllyx	unknown
@shyrsatr	human
@This_is_fifty	human
@eLisabeTHeLiaaa	human
@pawabonga	human
@MajaNorina	human
@iVillage	human
@FoodForYouMx	org
@JennXO37	human
@stefancaliaro	org
@FerreiraSofs	org
@rawlivingfood	human
@linkOGUN	org
@stefanotarascio	human
@NathRavitej	human
@ashleyday	human
@fsyrvasaa0	org
@jesaminsalen	org
@LadyCBright	org
@BossyMatilda	human
@Neehaas	human
@bubstephana	human
@tori_mayxo	human
@soulsocietybuoy	human
@RobertMustafa	human
@BilliHenshaw	human
@FlyNeska	human
@CrunchPak	org
@wrystyle	human
@santosferreira	unknown
@VictoryLightnin	human
@Matthew_Pratt	human
@VisitSouthBank	human
@Gastro_LE	human
@baby_revathi	human
@Joe114025	unknown
@SofitelCasa	org
@indra9191	org
@iOfferRT	human
@iekasam	human
@driftyu	human
@tjramos11	human
@NanC628	unknown
@BarkerTeaHouse	org
@RiederNadine	human
@pochomking7	human
@belinda79104453	unknown
@NateTite	org
@maisondepawZ	org
@heonybear	unknown
@skyhawkmlt	human
@the__himanish	human
@tempopilates	human
@KidiRapGym	unknown
@cherylko50	org
@ChrisVenuss	human
@ATO_online	human
@jhai_yam	unknown
@EGMConsultant	human
@JessieQuezon	human
@OrganicMixology	org
@photojourney_tc	human
@ColdHollowCider	org
@Perfectcater	org
@NaomiGabPhoto	human
@DiniaVargas	org
@CamdenPaces	human
@Lara_Monkey	human
@firefely	human
@MrBuiltFit	human
@werdibali	unknown
@LowReedLuvR	human
@xxOlivia14xx	unknown
@Tiffanyjo80	human
@MYassin270	unknown
@Vonsilly	human
@ebonkyoi	human
@caitcork	human
@noshwell	human
@wahyuherma	human
@SocialHotTweets	unknown
@1917AmericanBis	human
@sushisavedme	human
@ardenrubens	human
@rhubilicious	human
@jennyologie	human
@itstyleblog	human
@MyYogaOnline	org
@Irmela_Horst	org
@KatieJBeales	human
@YouCanFixIt_	org
@nur_shyuhaida	human
@KamuMelcky	human
@ayieb85	human
@GPHealthNut	unknown
@ModaciousMo	human
@imraz	unknown
@Carlalluna_bags	human
@VidyasBeautyBox	human
@Harvestland	org
@Lorraine1984198	human
@djalvinc	human
@Jetvin13	human
@thovit	human
@summer_luu	human
@chappaquamkt	org
@payalminhas	human
@JenniferWoodFit	human
@krisanisus	human
@ZiadAssaad	human
@anumbatool	unknown
@Arthur_Chance	human
@Mc6Laura	human
@hafeez10	human
@libertyonair	human
@ginaway1	human
@rdmfashionlife	human
@somepinkflowers	human
@KACrombie	human
@jojolou69	human
@MiguelNazario4	human
@honliang94	human
@EricaRobinsonND	unknown
@aldrindatu	human
@roverade	human
@randomshenans	human
@ShootingCreek1	human
@HChoules_Events	human
@ShellaLutz	human
@3b0nk	human
@GigisMayfair	human
@Sw33t_kupcak3_	human
@tastoriaqueens	human
@kelwen_leo	human
@fontcuberta	human
@SteelersHashOff	org
@JoeAllenWC2	org
@STYLIGHT	org
@christykovel	human
@daydreamerstale	unknown
@105Tp	human
@Omathomeyoga	human
@mucifer_obama	human
@RRCoC	org
@IAM_Furlow	human
@nezca_	human
@sahinkayaysenur	human
@nategrey86	human
@michelle_beer	human
@Herlaann	human
@joshua_reed09	human
@zenfrogyeah	unknown
@fangfing	org
@denise_badass	human
@NekoJenW	human
@ma_khan_	human
@raihana_abas	unknown
@JohnPhotography	human
@coco__dee	human
@DjMDoT23	unknown
@MeaganMcBain	human
@PamNeedsCoffee	human
@AdcelOfficial	human
@amirulwax	human
@FaladeTolu_	human
@THoldich	human
@2universe	human
@aykowoaaa	human
@shiiiyamada	human
@olgarodz	human
@Hubi1857	human
@TyaaPricilya	unknown
@NurusSoffia	human
@FrankieNicole_	human
@lulubinty	unknown
@ibrahim_helmi	human
@JasmineKneale	human
@MissGelicated	human
@DhananiGautam	human
@BALLET_KANAMI	human
@farahpinklady	human
@jwatkinsonxxx	human
@PureWareUSA	org
@mrFoong	unknown
@JBervar	human
@HassanMaynard	human
@lucca_patrizia	human
@flyjenduf	human
@seeknsave	human
@reneebergeron14	human
@Easyfreshglobal	org
@GettinFitNHeels	human
@koigdgfdgds	human
@chillibananamac	org
@RyoheySmile	human
@foodiepara2	unknown
@TempoTemptress	human
@IKEDEES	unknown
@ATA_Fitness	human
@GungWahNanda	human
@SpoonMeBlog	org
@CandyCoatedTT	org
@Brayndamage	human
@enharmoni	human
@Kelsey_Wolfe7	human
@MatthewBanks3	human
@kitty_hy	unknown
@Cornerrest	unknown
@BestCrepe	org
@kashkhanesq	human
@acouplesdayout	unknown
@jibranmuis	human
@Kristen_M4	human
@Zakina_Kitchen	human
@dizzyparkermoo	org
@_E_LL_E_P	human
@bogotacity	human
@Yohachristi	human
@avrnir_16	human
@TwiterTooth	unknown
@katey93xx	human
@melvinavii	human
@JazminCorona4	human
@GingerFrecksXO	human
@Lux_for_health	human
@TheHesterClub	human
@xxlove_wolfsxx	human
@chavamendez	human
@dancin_Crystal	human
@PegGall	human
@Claire_Foster86	human
@georgielclarke	org
@i6m421k	human
@paliblood	human
@20ToesFitness	human
@sharilhss	human
@GNitro	human
@ripimpact	human
@byJennieTai	org
@Essexsteve78	org
@BurrsBerryFarm	org
@OOTD_RT	unknown
@SmileMeFood	human
@akosimarben	human
@aichang09	unknown
@TarekWoodie	human
@samertabban	unknown
@dvoti0n	human
@lancebreger	human
@Giddymos	human
@NoOtherNicky	human
@jalapena2007	org
@HongHongJean	human
@angieloves8807	human
@SadeFagbemi	human
@chandan_01c	human
@SofitelMunich	org
@crftfrycre8ionz	unknown
@VIBE_ub_peach5	human
@nycrealtyxstyle	human
@TryMyKitchen	org
@impossiblerainn	human
@itsmeadrian0306	human
@GuiguiDehiwa	human
@Ra_k_	human
@ItsmeJeannePaz	human
@Shinyotaku	human
@DanielaBrites5	unknown
@b08db6068cdf4ce	unknown
@SimoneDannii	unknown
@SerdaTweets	org
@ruffygwapo	human
@annitaoctavia	human
@TalkMinion	human
@DavidJChanning	human
@DanielKold	human
@SpencerLazara	human
@PullmanJLT	org
@efulo2001	unknown
@JUSTMIKE77	human
@lightchaser03	human
@NoNg__PT	human
@numxa	unknown
@lovecherry991	human
@A_C_L_A	human
@StripDistrict	human
@PetraLiuski	human
@meimei395	human
@DJHazzardMusic	human
@heiditan604	org
@TheTakenPulse	human
@GeoffDuncanLive	human
@kathyulia	human
@MaryGj1	unknown
@kenny07_	unknown
@Meg_BMusic	unknown
@gluxemuesli	org
@strayedtable	org
@AlmutairiSameer	human
@MusselburghGC	org
@dapurmamahanna	human
@RickPipito	org
@emmabung	human
@FabianSyph	human
@cvlinens	org
@reegak	human
@megss___	human
@paReng_gLen	human
@sammylou28	human
@cutiesicle	human
@rawanelhajj	human
@abukikpop94	human
@JennMcDermott	human
@Cindiswestcoast	human
@edie1st	human
@VeSunarjo	human
@JerichoDy	unknown
@DoraTrap	human
@AnyoliAbregoS	human
@eatmancakes	human
@CarmelleVillar	human
@Owen_Barnett	human
@Pafarhys_	unknown
@IncendioSignora	human
@GOTRNOVA	org
@HVaerendonck	human
@olivacla	human
@iamjudyg	human
@RaisingClovers	human
@lolamorarest	human
@tungaregenza	org
@GournetMX	org
@jpogsNdMove	human
@AnElegantFlower	unknown
@ktrnaaa27	unknown
@Vegan_4_Ever	human
@BroadlandRadio	org
@razzakova	unknown
@BestWayStone	human
@r192532	org
@dawnaacookk	unknown
@firmanimawan1	human
@iphann	human
@KnifeNerd	human
@Boardwalk_Place	org
@ARMMISSION	org
@ChristinaLarso1	human
@happy_samira	human
@gcwhite	human
@Ricochet6It	human
@artKidda_	human
@YrecaJane	human
@Leydeelicious	human
@seductivestew	unknown
@ScarfesBar	org
@a_yan0120	unknown
@urneum	human
@Ameurpina	org
@HKrammRealtor	human
@chanyc620	human
@titipatt	human
@iamkjmartinez	unknown
@chic_hangers	unknown
@mangotreethai	org
@Nanaaaaaaa__	unknown
@derikpoh	org
@JenfwedB	human
@nalkha	human
@nadmarnad	human
@NunoMilhinhos	human
@ekaprsti	human
@namallanka	human
@AysegulLaLaLand	unknown
@VancityBitty	human
@GreygooseKY	org
@febrianimulia	human
@gaynel_l	human
@klouis23	human
@orderofthemaya	unknown
@DevineDivaLoi	human
@Sangeetdevata	human
@DjGravityIntL	human
@MayAbdElAziz	human
@Esmaburcakgun	human
@iloveclacla	org
@LowCountryToday	org
@Spritmuseum	org
@Biggie_Nate420	org
@Is_Georgia_Rose	unknown
@evagruber	human
@kbuhr9	unknown
@TheNaughtyLady	human
@potagerrr	human
@Foxtongue	human
@081Magazine	org
@defiestacarlo	human
@LuizRaam	human
@JaNursing	human
@poteytorrific	human
@GymyG	human
@Thom_Crow	human
@j_uliom	human
@thewolfofbari	human
@VasiKing	human
@Letstestblog	org
@doubleA_WIR	human
@Keanovich	human
@PunisherRojas	unknown
@yabut5	human
@donnatallarida	human
@Gingersbubble	human
@Jdando13	human
@_kiia	human
@thatgirlchika	human
@claudiamkiss	human
@AdotRobles	human
@NabilAniss	human
@m8rihanna	unknown
@qSPOoKYp	human
@Jonbuckhouse	human
@cdipiazza	org
@marlyngiselle	human
@doubleservings	org
@_fennieer	human
@w_haylei	human
@rosariovice	human
@rachieannek	human
@katiefotis	org
@Quirie18	human
@fresh_atl	org
@irene_rke	human
@DrRichardTucker	org
@robmehta	human
@FitBusyB	human
@ninjaying	human
@allison_boyer	human
@pocarles	human
@funakitei	human
@GaiuzzFlames	human
@FennLim	unknown
@DancehallYogi	human
@melle_cat	human
@MeltemEsenkaya	unknown
@CottonBeachClub	org
@badgertopspin	human
@ChloeIQ	human
@TasteArkansas	org
@IbericaMCR	human
@hendhan	human
@cikLilis	human
@HLByatt	human
@Monica_Kidrauhl	unknown
@KGorlickCoach	unknown
@IamTheSexy0ne	human
@DeniseWEtzler	human
@D61N	human
@suzellecamou	human
@CathyChrysso	org
@rogarciaphoto	human
@PDoore	human
@hasnasaniy	human
@Bitstrean	human
@MeronK1	human
@ShrutieeDesign	unknown
@RickyAndrew90	human
@desdwipus	human
@cleee	human
@schottentor	human
@TamaraTamariski	human
@Jose_MannyLA	human
@Cam_Heyes	unknown
@Nok77	human
@amy__finch	human
@jerryredfern	human
@paulwelburn	human
@CARDIFFSPORTSNU	human
@marienclas	human
@ItsToni	org
@MissSheila1	human
@CrAiGnEggS	unknown
@rotrotgsp	human
@Beanies_Flavour	org
@celestinatanase	human
@SarahAnnMasse	human
@NashiliAnkhein	human
@CakeBakeFood	unknown
@mommyluqi	unknown
@HomeBrewerInSD	human
@davidpicado6	human
@Aguss_nb	human
@AnneSwenson1	human
@TasteInThePark	org
@BlockYYC	org
@atuldarne	human
@takashiyamamot9	human
@sharonaethel	human
@TheKavicLiving	human
@CoCo_Naturally	human
@ArtisinBakery	org
@NickiSlabbert	human
@JohanaMcnamara	human
@TrinaThomas48	human
@Chef_Pederson	human
@ashilafatima	human
@mneuhouser	human
@ItzDowns	human
@hujanpanaz	human
@FancyFour	human
@cookiecupcake7	human
@glossy_official	human
@Enoch_Derby	human
@Stepnice01	human
@Rosewellzz	human
@retiinyssa	human
@tailsbeth_	human
@xLooDee	unknown
@whatsernamebj	org
@GCraft313	org
@bruntorresp	unknown
@yungfrostt	unknown
@unionDining	org
@raphaelfrangi	human
@YasmineTrulley	human
@Open_Networking	unknown
@sarah__burge	human
@konankel	human
@FarishtAlawadhi	unknown
@joaqly	human
@MadameFromage1	org
@OmaruEdelka	human
@Vicki_McGrath	org
@WhyVonYvonne	human
@Orlandobanquets	org
@TigerCCN	human
@bboy_tomyamada	human
@STREETSTWEETS1	human
@NeuvooBothell	org
@christineputri	human
@jeffaugust	human
@PatialaDubai	org
@shewuyifan	human
@maxbfriedman	human
@TheHampshireHog	org
@princesslenerd	human
@Kom_Eten	org
@josephconrad_	unknown
@JMBFitness	human
@iruuanheeseo	human
@hhappynow	human
@ya_zzie	human
@hazelwho	human
@Lihunhoney	human
@jason_devil247	human
@Foxkitchen	human
@Kul2oMi	human
@SheilaDowningRN	human
@teh_shrimpo88	org
@FOBBrigi	human
@lentinealexis	human
@ying_jaaa	human
@johnofficial15	human
@OttavoHorcrux	human
@RozenoiR	unknown
@NicKool_14	unknown
@yanjbautista	unknown
@KerriesPMAFit	human
@Masa5Masa2	org
@theempireedit	human
@TheRealDprizzy	human
@AleksSvet	human
@MilestonesGuelp	org
@keeeee_sha	human
@ViBE_ub_orange1	human
@HealthyWayMag	human
@Kevinmartinelli	human
@GeM_KiXqueen	unknown
@mpmellott	unknown
@ileensaprincess	human
@ElisaToniutti	human
@KTNV	org
@DJkooni	human
@AnneseMe	human
@shoegirlinNola	unknown
@JasmineCirjanic	human
@FarahShalina	human
@gl0ryhunter	human
@The_1_AnOnly_JR	unknown
@LohanJordan	org
@GloriaSherinaLC	human
@yeaaah_yeng	unknown
@joshrapp	human
@Digital_Jackson	human
@PatryCompres	human
@so1001so	human
@widadxoxo	unknown
@walulaslap	human
@Aye5ha	human
@mana_ut	human
@choupie	human
@boujeeandbroke	human
@ElissavetVasala	human
@Hudson_Pacific	org
@Bbbls_oOo	human
@Marksdogfizz	human
@googleplay_app	org
@NatmanYamaguchi	human
@RajChaudhuri	human
@olaavia	unknown
@liberattostyle	org
@xoxostefany	human
@Tashatpc	human
@49erNumber37	unknown
@maru2marulee	human
@t0r14	human
@tamarama_ibiza	org
@kaori6085	human
@surabhihotels	org
@maria_andy2	org
@Sugaakki	human
@jiiachen	human
@rgilsolano	human
@Frau_Welle	human
@HelenaIronsChan	human
@hafifaumitis	human
@bmottphoto	unknown
@afissi	unknown
@yuribow1127	human
@grantloan	human
@DailyVacationer	org
@Juperius	human
@AnnieeP_	unknown
@AntonellaImpa	human
@Kurrrkuma	unknown
@IlPuntoH	human
@elw__1993	human
@peach_n_passion	unknown
@MAMILINDA543	human
@aaronsigau	human
@Erika1Lewis	human
@NohmadSnackCo	org
@GoEatDrink	org
@AnnaemarioL	human
@sweetrosem45	human
@BossLadyVicki	unknown
@tapyfun	human
@12VANCE	human
@IntanAgusti29	human
@MediusFidius	human
@PantryTeaRooms	human
@laurajswift	unknown
@splashcafe	org
@ErickaLAbrams	human
@smiley1791	unknown
@ZinaPopejoy	unknown
@byAshleyM	human
@thekconeil	human
@MilMomSteve	human
@AsianSweetieOrg	unknown
@Kyunisa13	human
@CulinaireVic	org
@stellavitany	human
@justinecedwards	human
@iamai1205	human
@hannahh_smithh	human
@ZataraDriftwood	human
@SOLODistrictOC	org
@lownote187	human
@Serpensss	human
@FlosBeauty	unknown
@StuftMilpitas	org
@Gemma_Kennedy	human
@letsTlkAboutMek	human
@PrinsesaHailie	human
@MathieuQuilliec	human
@BKKfatty	org
@FlowerJump	human
@countrynest411	human
@siwitrisiwi	human
@leonngsz	human
@peterepka	human
@CriminalSingh	human
@BurgersandBlues	human
@Giuseppina1599	unknown
@alejitha_s	human
@BeachGrassPoway	org
@AnnEscobia	human
@GlitterCheetahh	human
@ChefJordanD	org
@thomasyoutwit	unknown
@HRONOFAG	human
@KatKatCity	unknown
@RedbeanSerena	unknown
@NatasaDragnic	human
@Juriskupris	org
@AlHossnaAbdalla	human
@ikitamara	human
@FashionSandrina	human
@xaicabrera	org
@tomroelens	human
@mwesselphoto	human
@clrundle	human
@truckfollowers	org
@CantinaBHM	org
@rvelvetcreme	human
@missyoe	human
@ChimaFtLaud	org
@Matowix	human
@thahirpersija	org
@Duccyo	human
@giacinz	human
@Mica4Life	human
@Lipsticklunchbo	human
@MangoMag720	human
@MISSRED617	human
@cjjacobo	human
@HudgensFinland	human
@R0SH16	human
@larkandlinen	human
@Ovalice	org
@megyocum84	human
@MzBrownShugah	human
@LMAOitsMoose	human
@FastCasual	org
@LeeSaranglyn	human
@yeswedrinkTO	org
@LippeNutrition	human
