@Jeffronfeelwell	org
@ojenileda	human
@KuroKuro969696	human
@aeshalathyf	human
@thenapturalone	human
@maatiside	human
@zynpvelibeyoglu	human
@Elgordi_83	human
@dakitchenmaui	org
@Nyeemah_Monet	human
@YASanklebreaker	human
@vshaTHR	human
@Coolbuscafe89	human
@cinthya__	human
@School_Selfies	unknown
@lainey42	human
@CannonBallDance	human
@AntoniaEdwards	org
@sammabaybay	org
@misskrystleg	human
@sexyredbonesc69	org
@BLoungeGrp	org
@shalini_aro	human
@theLakeRoad	unknown
@shitsukn	human
@CatoNoiZe	unknown
@Sherlynkoe	human
@lemonchaii	unknown
@jt_squallo	unknown
@LuisaDDomingues	org
@NatDdLZ	human
@serensuna	human
@LJM2828	human
@PhatgirlsRN	human
@EventiZing	human
@MACemcee	org
@ViBE_ub_berry7	human
@funwebtoday	human
@MFLCard	human
@MissMarla	human
@IamLeticiaG	human
@beauty_POL	unknown
@gifzzcom	unknown
@jewelclicks	human
@NikkiStarSC	unknown
@kalewair67	human
@purpurapfel	human
@DeenieLou	human
@spurlinc79	unknown
@All_eyeson_BRI	unknown
@MikeTheButter	human
@kristysuki	unknown
@shanadwelsh	human
@ofdidagdfsd	human
@Yerisevina	unknown
@wanyaaart	human
@egopalace	human
@owarai_line	unknown
@Track2Table	org
@HaiccalHazim	human
@mutfaksirlari	human
@SweetTTreasures	unknown
@ritzajvr	human
@presh_ong	human
@1kcasserly	human
@Jessy_leo_claws	human
@aluiza__	human
@flowrx	human
@BeauTy_MiST	human
@2510_Restaurant	human
@EryneO	org
@Shizzymbabie	human
@GwendolynWrigh4	human
@micamotto	human
@vyivyivy	human
@steakwatford	unknown
@PVFranglais	human
@marvielous	human
@AllWhitesEggs	org
@vincedas7	human
@ali79shine	unknown
@susanmallia	human
@jordychen	org
@verosegurav	human
@EccentricEllis	human
@TTivasuradej	human
@ange_law	human
@smallfear	unknown
@ammbar69	org
@Uccank_tomochin	unknown
@alifahgandis	unknown
@AllyMellens	human
@thepigandpearl1	human
@xyratenyonyot	unknown
@mejonesmia	human
@joeuniverse	human
@CommunityMarket	org
@trovaweb	human
@roseannelampaz	human
@pepejeans23	human
@nalualohawaii	human
@thekitchendub	org
@PrinceAlbertEly	human
@CindysCmfrtFood	unknown
@mlcatering1	human
@G_theBrunette	org
@Absolutely_Lucy	human
@bigpoppiazul	human
@julioglf	human
@ziaokaide	human
@cristitoacosta1	org
@hellovynn	human
@MissCamry	unknown
@coloradisima	org
@SouthernKellOK	org
@andy_reyli	human
@JeremysFoodTour	human
@Michifu5	human
@thehawtness	unknown
@AamannsCPH	unknown
@tiffanyariki	human
@FrancescaMethod	human
@22NINA77	human
@parinitarb	human
@AirportFoodApp	human
@PanamaPuntoCom	human
@mmmaaaiiixxx	human
@trinaellen727	human
@craigmair1138	human
@lknecht150	human
@EngkuLiyana	org
@big_gal_no_more	org
@Lilkimi1321	human
@MarcellaLyno	human
@slowcookinggal	human
@natewhite1992	human
@arkiepot	human
@MamaAsh77	human
@popsiculture11	human
@AnnerzC	human
@clmvisuals	human
@CafeDADallas	unknown
@Travelzaz	human
@ChrisTheNewsGuy	human
@GooJayHee	unknown
@gobeaman	org
@vangorkum	human
@BulldogNE	org
@rebeccassunday	human
@FitTrophyWife	org
@ExpatsParisiens	human
@thedanah	human
@El_Tigra	human
@Everilddawn	human
@iqbalbustoni	org
@samsonitemusiq	human
@Sagrada_IG	human
@sfm_42	human
@DegonDegon	org
@Forsberg_issa	human
@MichaelMorrisEA	human
@chel_c19	org
@jeremypenniman	human
@leoniebanana	org
@TrinaCharlotte	org
@xtianteh87	human
@pinaapinot	human
@Jan_soong	org
@djmodkutfive	org
@kaho7373	org
@RaDragon	human
@AdamsAdventures	human
@FriedChickenLDN	human
@bryantfalconz	human
@MissKaseyK	human
@caglaguniz	unknown
@stefanico	human
@CarolineIlima	human
@HiltonAlAin1	org
@Daahling1	human
@abuturky2030	human
@Palmersfresh	org
@AngelYJ	unknown
@sirroro	human
@justchilin_24	human
@TeamSanJose	human
@chathealthy	human
@missoci	org
@MaasAnouk	human
@flaviagianini	human
@Sleepiec00kie	human
@UsmanAsifMusic	human
@AlmaCabaret	human
@itsYandyho	unknown
@vegachristie	human
@l10n3ss43v3r	human
@BellevueDaily	unknown
@madammoda	human
@SiyaTheBrand	human
@AviatorSports	human
@djoffriedegroot	org
@luridlily	unknown
@93marni	org
@shimoaririn	human
@duliad22	human
@aysenurdemrkan	org
@UtahFoodNet	org
@the_toussaint	human
@GeaLingeman	human
@jhenelorde	org
@Azarel2088	human
@DeterminedFiti	human
@barrywattbc	human
@GhahHamza	human
@laulo_82	human
@evannovv	human
@sedp23	org
@MounirToub	human
@PureStagioni	human
@IcebergQuest	org
@BeltDougal	unknown
@b1mb00	human
@xynwenn	human
@SacCIO	human
@TashyPStuurman	human
@Anu0123Sweet	human
@JudyLand	human
@maraxchua	org
@JimiWalsh	human
@TracyGehman	human
@nataliaroks	org
@LilyGonzlez4	human
@adrianacook	human
@Susan_zhuang	human
@babytoycapala	human
@Islandcheetah	unknown
@CakesandBakesPK	human
@chefjoseandres	human
@TamaraPogosian	human
@otiktoktik	human
@BonyAdam	human
@NinaPaulaM	human
@GraduateBarbie	unknown
@tortillacoast	org
@Diegoart	human
@Suncani_Hvar	org
@2feet1world	human
@carljay_07	human
@thestateofme	unknown
@JohaDeres	human
@Sar0oo0h	human
@fritztenebro	org
@yourfoodguide	human
@FARALIZASAFIE	human
@NourChuCk	human
@veganenthusiast	human
@arzmoha	human
@XOJNH_InDiGoXO	unknown
@IHOPLeon	org
@JYONGRI0830	human
@IWill_Travel	human
@tracywmc	human
@juanc_uribe	org
@ValentinaCid97	unknown
@Bill56251374	human
@msmir	human
@merry_nath	human
@DevlinHuxtable	human
@andy_bold97	unknown
@nindysings	human
@prpinny	org
@ping_mako	human
@nikkisixxfan93	unknown
@erinireland	human
@owen_minogue	human
@yodayuka_1121	human
@Jo_Montenegro	unknown
@Kcomekarolina	unknown
@ItsJerry_	human
@Radisson_Nantes	human
@CountryGablesCA	org
@MhyaNamie	human
@MangosTango	human
@brookanned	unknown
@paulimata_	human
@bevwilly69	human
@sjwcf92793	human
@LeColonialNYC	org
@littlejmano	org
@moonlight_30	human
@cupcakesdejujo	human
@FigTale	human
@tinnedsoup	human
@ucopafeben	unknown
@MediaStrikeTeam	human
@StreetsOfTdot	human
@wanykechik	human
@meematute	human
@myates09	human
@Tracy_Daugherty	unknown
@UMacLeod1	human
@jitka	org
@Lee_TheSensei	human
@KulHealthyYOU	unknown
@gsahidnoor	human
@ShannonCWhitten	human
@pikchurshuru	unknown
@partystarzent	human
@HomeBaking	org
@soniasruart	human
@StyledMama	human
@iamchelseacruz	unknown
@eleanorgraceful	human
@Bettesdiner	org
@VillageMoseley	org
@farahdiba_	human
@lin_andry	human
@AysenILGIN	human
@itsdelahoz	org
@Kath_Couturing	human
@muzesariefe	human
@Kokeshimeie	org
@VDZphotography	org
@lauraseregely	human
@OldDirtyBrandon	human
@clarasein	unknown
@Piero_Lover	human
@fitandfreetime	unknown
@ClosMaggioreWC2	org
@PIGGUYNYC	human
@nicholasteo_47	human
@_kimjuarez	human
@FannyLouvel	human
@michumiuch	human
@tnhuffhine	human
@Prof_Skitz	human
@gulfcoaststudio	human
@KolaBlueRose	human
@cheung_gordon	human
@TCanDaMan	human
@xo_little_J	human
@darcyanderson92	human
@SEX_Overlord	human
@AdamVale1	human
@lagabbyt28	unknown
@drzamalfy	human
@syaiidah	unknown
@flipper211	human
@meroper	human
@Yvonne_Ben	human
@sofreshsogirls	human
@angelica1205	human
@Marlowesf	org
@MaisondelGusto	human
@ExplorerMD	org
@CsorbaFanni5	human
@thegirlburgan	human
@onye_soediro	unknown
@growingnaturals	org
@CliveOwenLLP	human
@kirsty_else	human
@Nutralite	human
@ethan_hjlim	human
@vitriandhita	human
@Zaragoza_Mayra	org
@WarwickBarsey	org
@krystianmarlo	human
@fuadloebis	human
@DottieTan	human
@rtl_therapist	unknown
@TheKitchenWife	human
@ayambebeks	human
@chiarakean	human
@MissGLKelly	unknown
@Jollygardensw15	human
@ik4_neh	unknown
@BabyDimplez84	org
@Eve_Pijika	human
@lawraleal	human
@lbh_tt9395	human
@Maddeslang	human
@kelegirl6	human
@Dzigandara	human
@MarleneSrdic	human
@Jerome_Junior	human
@bythelakewithme	unknown
@ronaldtheshort	human
@TheFoodieExplr	human
@meltingmood	human
@shuttergenic	unknown
@JellybeanAgency	org
@Asami_Deyama	human
@prettyaizirk	human
@sorcerersfroggy	human
@CoachPCare	unknown
@BrittaniBoBaker	human
@ThyagoLeyte	human
@AlexTurnerUWhat	unknown
@SunsetPrl	human
@natalka523	human
@CakefieldAvenue	human
@YatesHereford	org
@raquelchoyce	human
@ThePeeetz	org
@foodie_tiffany	org
@MissNunnerley	unknown
@Latinafluential	human
@its_not_xmas	human
@sabera	human
@Alice_mad_kuro	human
@tanjha	org
@jill190	human
@MrDmCarter	human
@KakakBeruang	human
@siabdo	human
@benjin15	human
@Yubert681	human
@nadyaadynda	unknown
@ACGsrl	human
@jjangLIPE	human
@IAmChanges	human
@Isabell_Manns	human
@aslipapatya	org
@FriskaFood	org
@adelaidakm	human
@adheanne07	human
@ookvanjou	human
@ThirstyThursMan	human
@GrowUpMadison	human
@Nico_babyboy	human
@QuailLodgeCA	human
@MyFrenchTable	org
@tokitokopalu	human
@Mokuba90	human
@LianaLazarou	human
@Chelly9659	human
@vacquerie_zhel	human
@opendoornyc	org
@Rosalia_Cataldi	human
@AuPairHouston	human
@heyccarissa	human
@Angeliczns	unknown
@jaimie_beth	human
@Msliangabrielaa	human
@JetsetExtra	org
@Yamilina	human
@MrBayWearea	org
@bloodjetpoetry	human
@SocialWinesBOS	human
@WishGardenHerbs	human
@FirstCrusH21	unknown
@mr_ibat	human
@MiraMusank	human
@fbr0305	human
@pinkkirst34	human
@BernadetMartin	human
@PeppermillME	human
@BottomlessBook	org
@butterball	org
@DreamDoors_Ox	org
@Carol7Caballero	unknown
@DaybyDay_BB	org
@gregkauffmann	human
@alessandraZ	human
@kayochun_n	human
@1chrissyrose8	human
@MaesterKeej	unknown
@ActiveBryantSys	human
@Yyinghui	org
@Jacqx3	human
@TuscanPizzeria	unknown
@Snoopy_pictures	unknown
@utamiirawati	unknown
@bohemianstella	human
@Phoenix9018	human
@IlariaCancian	org
@PromoIcemoon_CH	human
@WellAlbatross	unknown
@Slickhotpants77	org
@fezile_nkosi	human
@WhiskArnosVale	org
@joeyruaro	human
@BunasKitchen	org
@MyFrontera	org
@_hello_dave_	org
@SappTheStoner	human
@VincGoodHour	human
@Docforkids	human
@ilvmntnbkng	human
@MissAvePDX	org
@zaharworld	human
@aru_urara	human
@ravenings	human
@oblatesimon	human
@Pasta_Roma	org
@Hollywood_wife	human
@cris33tina	human
@Salomaoguimara1	human
@spencerlot	human
@ElleNoirDebast	human
@intansyafinas28	unknown
@xinalia	human
@starrettlehigh	org
@three3bees	human
@MetroCircus	human
@jairomlopez	human
@Gerar468	human
@AlexandersonBL	human
@yiling654183lin	human
@kristurnbull1	human
@Ale_13t	human
@Paroladilaura	human
@hometurf	human
@fitdailydiary	unknown
@x3toshi	human
@nishant13india	human
@HotKitchenGadge	human
@gerard__89	human
@wearmarrowmedia	unknown
@thepippergirl	human
@MissPSW_	unknown
@GarbosHHK	human
@CatalUvaBar	org
@bellevilladiego	human
@thegreatmarkie	human
@rubyalabar	human
@SpinachTiger	org
@JewelDivasStyle	human
@genallyAllen	human
@KatianaUpton	human
@VanessaGrinszek	human
@bioitmilano	human
@weigna	org
@AlzateJulia	human
@mycitystylist	human
@landritoheidyc	org
@Tuinvrouwtje	human
@jodiesaunders	org
@McCoysElkRiver	org
@GlamRock____	human
@sarahclareTT	human
@KostinkovaT	unknown
@sabsoh	unknown
@xHannahWilsonxx	human
@Micka_Lawrence	org
@SoberLaneD4	human
@CarlosPollo2	human
@MattFratt	human
@mynameisdanram	unknown
@foxnomad	human
@beheardphoto	human
@f_1010	human
@ZondagbrunchZVT	unknown
@xavier_nixx	unknown
@jjjaniceee	unknown
@lukussimari	org
@mistikus_chenta	unknown
@wyzapplegal	org
@iamaby17	unknown
@acheemeuve	unknown
@TheHillTavern	org
@getfit_whywait	human
@howdoessshedoit	human
@bpotx	human
@kellyjcameron	org
@gocarefree	human
@bigDchiro	unknown
@Dimitia_	human
@Thymeandlove	human
@eboyer2000	human
@thestevemccurdy	unknown
@LizabethBohler	human
@KittyRaces	human
@Fuel2live	human
@craps38	org
@andylown	human
@greengateuk	org
@MWSHerbaStar	human
@Enigma008	human
@Scotlas1	human
@Asmrant	human
@venessabasaiaa1	human
@iamjjake	unknown
@jejeruben	unknown
@SelinaAlmodovar	human
@CollegeNTRN	org
@SugarSwings	human
@MartutiGC	org
@samissa_28	org
@ONOSCAFE	org
@ddeniseharrison	human
@carosandoval1	human
@Hakkakking	human
@fullupandeating	org
@TheMrsAdams	unknown
@yogadeals	human
@kittastickat	human
@AndreLesevic	human
@ZEONDAX	org
@YapJiaJian	unknown
@TIGGA_TAY49TH	human
@motivationspark	human
@WhoYouWanna	human
@ischaeff1	human
@MadzLo	human
@DevastoMC	human
@AGiulians	human
@JozisKitchen	human
@HotelArtsBcn	org
@xSimplyReikox	org
@leandro_moreira	org
@TessBelieber	org
@miamithepug	human
@christykramer	human
@wildnmild4u	human
@lemon1437	unknown
@annieform	human
@AxAsvcs	unknown
@MartyWieder	human
@pidginvancouver	org
@blaquedahlia82	human
@patriciavega101	human
@Coleweiser	human
@lexamantis	human
@wichaddiction	human
@WhiteOwlTweets	human
@NmsBauer	human
@knowthyself1111	human
@DJRiisc	unknown
@MichAgCouncil	org
@hollyckk	human
@Volutologist	unknown
@StefanoCavaleri	org
@IlVoloNJ_Qro	human
@Ingredient1	org
@jan_paolo	unknown
@AlEx__HoWaRd	human
@ReginaSosing	human
@Joanna_Embley	human
@Grilliantfood	org
@Sulekha_US	human
@moxby_SummitWeb	org
@LaceDresses	human
@VirginieBichet	human
@rachelvdolek	human
@LazyTulipCafe	org
@kitchenonmainst	org
@femalefitnesspt	human
@VelveteenLounge	org
@WolvesFitness	human
@LostinDoss	org
@mariaaq_	human
@Parl_	human
@citylivin58	org
@Nashgurl93	human
@chefjbob	unknown
@Katie90Louise	human
@kurtcouto	human
@EclecticEvelyn	human
@Niesaayu	org
@BeniCompGroup	unknown
@howardu09	human
@realestlamb	human
@SleeplessVeins	unknown
@sammnicole8	unknown
@LaurenceJones99	human
@julvyanno	human
@pnassan	human
@DanielGeisler87	human
@burnbernnieburn	human
@Disneyement	human
@RitaFan125	human
@HughTT	human
@RichardMHHardie	human
@NancyWish	human
@MaxDelivery	human
@see5588ooh	unknown
@BurganD	org
@TheRealKC297	unknown
@QNOLAuk	org
@JaniceCravens	human
@herryshi09	org
@Cassiaumi	human
@iamdana_babe	human
@Niiiiiiiiiiiin_	human
@eelinky	human
@abs_afizaiman	unknown
@nadjalg	human
@iksmario	human
@JetsPowell	org
@yusuf_dx	human
@marizgeuliz	human
@nourzea	unknown
@Viv_Salazar	unknown
@KristieFinnan	org
@Shar_ren	unknown
@iamMarialee	human
@MrJasonZaii	human
@Cris_Bernas	human
@NGwens	org
@Blackfade4L	org
@vvanto	human
@Raniti911	human
@chieminggg	human
@HollywdBubble	human
@S3CRET93	unknown
@Emmajanesoftice	human
@bayeramogulCOM	unknown
@charlesdeer28	unknown
@FranklinParkBK	org
@cmurray4175	human
@HungryDuckUK	org
@Mundaqwe	unknown
@janinepulmano	human
@KentLeonie	human
@PititeConnasse	org
@DonCarlosResort	org
@apikstory	unknown
@christhalim	human
@YennieSolheim	human
@RiceandDough	org
@CafeDripRegina	org
@MsRhondaW	human
@Catha_Brown	human
@MegsCanvas	human
@iloveatr	org
@Sadingbebe	unknown
@trini219	human
@MayerlinMirena	human
@AlekMestan	human
@AlexandreMaras	human
@piyokbokujou	human
@offthemarket	human
@American_Social	human
@kenco_al	human
@CarolineLi0121	human
@ReggieCordova	human
@Onelife_live	human
@EquusRestaurant	org
@SantoriniCLE	org
@vanillaandwhite	human
@iam_nanaalyahya	human
@PEnn6nyc	org
@Mellymarischa	human
@dafOfO	human
@hexes58	unknown
@DaviesCandice	human
@GrilleIsland	human
@ComHiiiii	human
@juudcosta	human
@BubblegumBasics	human
@cme_phx	human
@Tellee_Babee	human
@NiHa_Nurul93	human
@Twi843Rami	unknown
@AtlantaAmado	unknown
@SSOquiRIT	human
@AlloraMeico	human
@TubbytoonsArt	org
@selmiiina	human
@LadyleahJ	human
@KerryEdees	human
@Slimfitprogram	human
@PaulBacon30	human
@HYasuna	human
@BlondesRun	human
@ColeenBorgonia	unknown
@ReedPrescott	org
@lilfashionkids	human
@marcomboy	human
@ahmad_almango	human
@_ConnerJay	human
@GetFitWithKrisN	human
@NikaB84	human
@MSouthernbelle1	human
@physcochild_09	org
@cindyythenn10	human
@_jadeneth	human
@CorwinInVegas	human
@georgiablue82	human
@BeauGucci2cci	unknown
@PicnicMeats	org
@Amy____Jones	human
@CocoCh74	human
@yangpotts	unknown
@MrUkuleledorset	unknown
@Dareen_Kassab	human
@houseofmoseley	org
@y0ur_grace	human
@Mood_Ristorante	org
@VouchermaniaUK	org
@brand_miche	human
@Sharon_Lee8	human
@Priscillaphang	human
@ecka_handayani	human
@thegoldcolumn	human
@secretgstandish	org
@ItsTheSoaps	org
@Tonantzin_E	human
@AZianLovatic	unknown
@NatiSpain	human
@serkanselamet	human
@afrustratedchef	org
@MarziaGiacobbe	human
@CalebGraham	human
@LadyShipAu	org
@DavidFongJ	human
@tofsroma	human
@tadasuke	human
@iamsuhtz	unknown
@DesireEmpire	human
@AceLikeAPogi	human
@CafeBleu_Gables	org
@MarianaNikole7	human
@nya_ayn	human
@HomeOnDerange	org
@Ricki_Edits	human
@mz_conejita	human
@rr120189	unknown
@staceyloring	unknown
@akkirej29	human
@ashkeinath85	human
@SmokeyJoesChelt	org
@citabufete	human
@VeganCoaching	unknown
@Itsmejatina	human
@fluffyvg	human
@SiennaVIP	org
@xxxyurgd	human
@marie0000000001	human
@YYZGourmand	human
@opiumgrace	human
@dietplansfast	human
@chefschoolmiss	org
@Just_Reynard	human
@yorlescazu	human
@FridayLiving	human
@JustJansJam	unknown
@AlfonsinaMir	human
@MADCLUBARI	human
@chai1707	human
@FatBaoHouston	org
@tashoppppxy	human
@wcwanderlust	human
@bobui17	human
@122Momoka	human
@Stefan_Nycelife	human
@oneofmykindvtg	human
@KCKristin	human
@dhmeyer	human
@PolarWithin	human
@Roselcakes	human
@Liizbeth18	human
@ValerieBeautyy	unknown
@LlewellynWho	human
@Cottoncandy132	human
@GoodFoodBrain	unknown
@PikPug	human
@empimpimpemp	org
@WellnessbyJill	human
@40alliswell	org
@Vasilisa_Vi	human
@InfoQmin	human
@AgnesPutriarta	human
@obeezer	human
@Kushcooks	org
@YazarEda	human
@Rose__Garcia	human
@MEKA_2KUTE	human
@LopezConsuelo1	human
@Patches2138	unknown
@hotcakez8	human
@iaakshaye	unknown
@mixalisdarin	human
@livelightnl	human
@Galletti13	human
@HungryHallion	human
@nurdyanaa	human
@MelissaGarrdner	human
@1Naza2	human
@EinaVelasquez	human
@ANEWEARTHstore	human
@Motherof_2Starz	org
@NightOwl_SF	org
@ShainaPrice	human
@justme_n_mybj	unknown
@HiHighWycombe	org
@MJDisneyGeek	human
@kittykat22x	human
@ChangSivilay	human
@tootingwurzel	human
@Mummy_Lewis	human
@josuemedina2	human
@MelbTouristTv	human
@dewipangestikaa	human
@pureaizi	org
@Domenikpop	human
@Akb48Zebra	human
@LuqmanNeko__	human
@weshahmmd	human
@DrJEMProduction	unknown
@skullyinfamous	human
@RichardTrusVanc	human
@KH_Nutrition	human
@mrpmcp	human
@yungdweezy_8	unknown
@DrDaisyS	human
@alexoki1	human
@DiegoAca20	unknown
@Oceane_aaa	human
@hentai_sinshi_	unknown
@0phe1iaTweets	human
@frzysf	unknown
@TanyaIvin	human
@bip1030	human
@leancleaneats	org
@WestleighBay	org
@wholesomeIE	org
@PumpUp	org
@kaaaaana4z3	human
@eva_janine	human
@SAKAKiYAMAtk	human
@alecanturin	human
@maryisabel16	unknown
@Bugs_Artillery	unknown
@Lonely_Dre	human
@Rajendr_behera	unknown
@HolyCitySinner	human
@RunTom1984	human
@JessicaSquibb	human
@Saraakl	org
@uchinique	human
@EleonoraArico	human
@oomonakichioo	human
@AlbeMurer	human
@Martin_Sanna	human
@Nueskes	human
@Kumargautamkg	human
@Vivi_Cartagena	human
@AnithaSatez	human
@fazlianamokhtar	human
@thartsalot	human
@iamGraxieh	org
@imma_IAM	human
@RaulsStriper2	org
@DutchWoolDiva	human
@sheri5b	human
@IllestOptimist	human
@tobi09	org
@Brenda_Bren97	human
@RichardDeVita	human
@winny_2527	human
@AprilBeam1	human
@d3sveronic	human
@BenjaNaples	human
@ViBE_ub_grape1	human
@januars	human
@DairyFreeDream	human
@allaalla1231	human
@FunkaTan29	human
@stminibushire	human
@Cam4_UK	org
@kana12345678901	human
@IMTBeverlyArnaz	human
@AlgiersLady	human
@zakcreative	human
@mkizaki	unknown
@ployjm_	org
@AloupiChristina	human
@jewhungry	org
@withD_H	human
@ziahpastera	human
@justplummy	human
@bearemychen	human
@shafiahtairu	unknown
@willians_la	unknown
@partyonmyplate	human
@Louisa_J_M	human
@yukki808	human
@RalphRustam	human
@yannickdrums	human
@casafinahome	human
@HairByRaymond	human
@ITPikachu	org
@Motleycrue1969	human
@Khy2Neza	human
@PamelaHawkiins	human
@SaintsOKC	org
@fitspiration33	org
@MrsJamieJimenez	human
@IMTexican	human
@BobsBigBear	org
@ThreeKingsPub	org
@SnowdenHillHair	human
@REALHONEST	human
@JakeMikolas	human
@acitydiscount	org
@sandyfitz2010	human
@CWedemo	org
@FCFoodie_CT	org
@steffanonetorin	org
@TatuBeren	human
@esmergonzalez	human
@Bluesquarehotel	human
@LiverpoolDTeam	org
@tuty_tutut	human
@cok_newsdict	human
@CINDYCATWALK	org
@moo77hb	human
@Baby_Lexie	human
@beaubobp	human
@SusanneSchilte	human
@ThAtNiGgAjAx23	human
@marianolake	human
@FabioGuzzi77	human
@MJkeeating	human
@stacemcf	human
@marcelaCFit	human
@LAfashionsnob	human
@BahlVidhi	human
@shaicandoit	human
@kellyansbro	unknown
@mm1642mo	unknown
@Haskovoguy65	unknown
@KUSHNERarch	org
@steingartenla1	org
@hdbbstephen	org
@oceanshaman	human
@ivanlovesinging	human
@phnompenhnoodle	human
@mdf2014	unknown
@daddysgirl1118	human
@Reveliez	unknown
@JennaKateKelly	human
@icha_astria	human
@HYPEHAZ	org
@boycm	org
@Andr3wPhillip	unknown
@iliveindallas	org
@sara_hanny	org
@mrkeep3rolled	human
@JennGalandy	human
@nika4evagood	human
@ComparePanda_UK	org
@LisaGfit	human
@Tilsonpremcyril	human
@freicyvillalva	unknown
@ScreallaofBSE	human
@alacarab	human
@annelisesealy	human
@theGFcentreUK	unknown
@stefeatschicago	human
@TalentHous3	human
@morthancoupquen	unknown
@TanzyBocaRaton	org
@CavePaleo	human
@studio_bcn	org
@MikaTrustInMika	human
@kplunketthogge	org
@AllieO94	human
@klaralatinova	human
@ClaudiaMasala	org
@la_laface	human
@CLEFoodies	human
@thechocboy	human
@BungaMarisa	human
@ddeeNNNiizz	human
@bhurnbautista	human
@LaineDoss	human
@kinari0105	human
@urmodernfamily	org
@doylebarnes	human
@imeegian	human
@BoltFreshBar	org
@ninahazrin	human
@visitportugal	org
@Damiean143	human
@DietitianLKane	human
@Radmore_farm	org
@kyatmaja	human
@AliciaFajardo6	unknown
@Gekopaca	human
@Monfon	human
@ElieciOus	human
@ioana_cris	human
@LoraJol	org
@RockMaMaAKI	human
@YakiBooki	human
@KondiFitness	org
@SmackABM	human
@Ganoom_BK	human
@Wandelgek	human
@Melissa_Zunigas	human
@FranDeveze	org
@jmc_332	human
@liverpool200505	human
@happyandharried	human
@youtuber_venus	human
@prawithahsb	human
@LABlackPepper	org
@AnneliseSingh	human
@shellyfromshaws	org
@acboydm	human
@ahmdkhtb	unknown
@isabelbulatao	org
@areeshei	human
@makeitvegancom	org
@erichch99	human
@kaykookkay	unknown
@ThatuWandiirzia	human
@Jam_Adventurer	org
@Ssavina	human
@Ahm3t_	human
@Garnetto_6	human
@FelipeELopez	human
@iHannaHHannaHi	human
@Hollychedda	human
@tioshun	human
@poochinrex	human
@jkachristensen	human
@otome_chan	org
@RosaSelina	human
@vale25dc	human
@Lindsey_Gross	human
@amigo0103	human
@ColetteToronto	org
@mortiz447	human
@Calogea	human
@CdnLentils	org
@HelenBrawley	human
@kariedanho1122	human
@JennSheaAZ	human
@chanffff	human
@CMarsello	human
@PrettySwankGirl	unknown
@rainaraina	org
@DevonLife	org
@lphd	human
@mikecasey24	human
@D3trXDraogn	org
@im_emouse	org
@IamKevinAntonio	human
@BecKnerd1234	human
@MeridianRadio	human
@takahashi126	human
@ngekki	human
@YourHereford1	org
@emanbreish2	human
@1IG_dP	human
@creativesoul28	human
@Heswallcoffee	human
@ParlorOnGranby	org
@TheWildYouth2	human
@HrOrganic	org
@devakali	unknown
@momwhoruns	org
@luvnfreee	human
@MarriedtoHealth	human
@Paleo_in_heels	human
@juicefastdiet	human
@AndreitaSevilla	org
@tridotalexander	human
@rose666xx	unknown
@TheVernonInn	org
@joejly	human
@WeAreADL	human
@jordan_hess4	unknown
@LJWHLEvents	human
@CrustLiverpool	human
@Bantampub	org
@Nicsilvano	org
@deltamontreal	org
@gfcupboard	human
@amyyroslan	human
@emilynicole42	human
@MrEmo86	human
@rheinmarzan	unknown
@nancyfotografa	human
@cafereddowntown	human
@juice_204	human
@HuntingtonGroff	unknown
@yelpcharlotte	org
@fumanskita	human
@gegtiia	unknown
@DartDennis	unknown
@GyouGyou	org
@LorenzoMdC	human
@Rugergobang	unknown
@kjharig59	human
@heymatei	org
@magicj3	human
@FedericaPastore	org
@nono_canz	org
@KourtKersh	human
@WGOINBuffalo	human
@TWFDiary	human
@taylorsbutchers	human
@Cuckoo4CocoPufs	human
@ACronbie	human
@masyu112	human
@CeciLia_Depp	human
@mynameiskimi90	human
@InkBenji	org
@perrettiphoto	human
@a28106703	human
@fatymazing	human
@mapetitesphere	human
@nissa_100	human
@CentenaryLounge	org
@leeraydavies	human
@cyprus_retweet	org
@mrsnataliebrown	human
@chefmnoble	human
@akulahpaklan	human
@hectorii	human
@FoodbyClara	human
@XVBeaconHotel	org
@Kassie_Layne	unknown
@CircusKL	human
@Adolfo_SZ	org
@DrBombChelle	human
@HalalFoodGuide	human
@dhesdayne	human
@ShelleyCav	human
@zel_kapili	human
@COS_chihiro	human
@peanutsgang2004	human
@loriesylvester	unknown
@lovelylabeouf	human
@PDBrixton	unknown
@kiapotkulot	human
@samparkique4	human
@komatsu_risa	human
@RosNadiahIsmail	human
@51mon	org
@gabbyxiong	org
@maemaeejirin	human
@GenoWhirls1002	human
@iamKIMazing	human
@DaveABurns	unknown
@MonYeoSL	human
@Madeby_karen	unknown
@kidzquotes	unknown
@sugasspot	human
@poncharales	human
@JingFongNY	org
@Henry_Doraemon	unknown
@Fitness_ManCave	human
@SonyaKsavings	human
@tulsafood	human
@bloodyrippa1	human
@BeerReady	human
@evoirfan102	unknown
@imtalking2you	human
@Kanaa1109	human
@ViSalusSource1	unknown
@rexbaay	human
@c___a73	unknown
@iamdansuy	human
@itweetepq	human
@lamchiwaii	human
@Filipina_JLOver	human
@CookinGreens	org
@terrileebrown	human
@Luxo_Blog	human
@dnm_sea_travel	org
@Chitoze99	human
@simplycoryann	unknown
@mitchellsdeli	org
@GildaHaddock1	human
@DAVIDSCM	human
@YezeniaNavarro	human
@SocietyCulinari	org
@RogerFerraby	human
@MovillaVzla	org
@theyellowroses1	human
@mhelkoure	unknown
@AustinUhas	human
@tastebuds_news	human
@twisted_spoke	org
@TingTongPaChiKo	human
@elicast02	human
@HiltonPrague	org
@iCraftCafe	org
@heynells	human
@GenuineJenn	human
@carispacheco	human
@UVACFC	org
@ArturoGaray93	human
@anilaaja	human
@diariodeco	human
@OnOurTable	org
@mallofmauritius	org
@mhyotte	human
@moyamcallister	human
@rebelgurljessi	human
@laima_ande	unknown
@firefighterlksh	org
@ACSchlegel	human
@Phattyma86	human
@sourgrape06	human
@dowizaj22	unknown
@CherishMag	org
@philipfillup	unknown
@e_paley	human
@ajwilsonJP	human
@Sophia_STIU	human
@JessManningPT	human
@mattkenny	org
@kaneradal	unknown
@holloway5787	human
@_MsGinaTee	human
@Biglooserkit	human
@BrittyLoveeee	human
@cvdtdnmz	human
@PaintNitePhilly	org
@AlohaIsleCoffee	org
@PABakery1713	human
@EpisodesPokemon	unknown
@DeborahNos	human
@writenett	human
@Xtian_1990	human
@TaraLeague	human
@KlassicKary	human
@Amyfilya	human
@lovemiumiu52	human
@Anngelaklain	human
@domusdavide	human
@mituko1	human
@FarmersDinner	org
@theeastfieldinn	human
@KimberlyFMoore	human
@RCK_Ministries	human
@botmaker1969	human
@itsmeameera	unknown
@alinarenee	human
@chantalguillon	org
@acealba	org
@kDOTflores	human
@MarryinCortona	human
@heana_music	human
@IrmiNaumann	human
@the7thpoint	human
@BernaciseMe	human
@CamiloCereceda	human
@TikaLuvblu	human
@station_break	human
@FarahAng	human
@sbrnsnpdr	human
@AnsomePoon	human
@Erynn_Sangster	org
@Bebiee_Ting	human
@nasz_eiyra	unknown
@MarkGonzalez204	human
@TRHMayfair	org
@surfingthefood	unknown
@VidGajsek	human
@saidydoll	human
@StephZiolkowski	human
@glutenfreefrenz	org
@mjhmjs01	human
@MsUndastoodMom	human
@aspennic05	human
@vivafifty	human
@KeddyP_KKG	human
@FariaMozillaFSA	human
@TiagoGuerim	org
@tudut	human
@thefoodishgirl	org
@sam_shof	human
@bramleys1	org
@july_julie	human
@renai_9UDF3	unknown
@fivefocus	human
@leesherry	human
@KitchenaliaOtt	org
@KimmyTheBlasian	human
@bdsopon	human
@genrique16	human
@snowboy1001	human
@SarahJBurridge	org
@RitaSmiith	human
@DLSRockSteady	human
@Madame_Zingara	human
@GrandCentralSEA	org
@tony_locke	org
@paromitadelhi	org
@mint910	human
@_ayr0801	human
@MarshaFuller17	unknown
@sumdayskinny	unknown
@chriskwan	human
@garifusion	org
@to48ru_ameBoo	human
@ginamostmustasa	unknown
@WeBizR_in	org
@jeannajohnson46	human
@Chango_D	org
@55_froggy	human
@zillahjoan	human
@Renddywr	org
@GreenChileAdict	human
@Ghambit	human
@nassauerc	human
@EligibleZine	human
@Dayvora	human
@JeremyFord2	human
@valeriepiccitto	human
@ltavaf	human
@y7rc4	human
@202Market	unknown
@JuneThiirteen	unknown
@_chinachina	org
@MacKidJohnstown	human
@janina_aurelio	human
@1lng1	human
@pjl1015	human
@saraelorama	human
@liverpoolmixer	unknown
@Jessieelou	human
@ParkHotelAzalea	human
@pikacoffee	human
@Manchild21	human
@_kaartiga07	unknown
@mohammedamer71	human
@GePag06	human
@CatAtVida	org
@KISH_1705	human
@cathypob	human
@thegrindfitness	human
@boss_kaak8	unknown
@swaaaaay	org
@FatGuyFix	human
@karennn_e	human
@extr3mlybl3sd	human
@VjJubjib	unknown
@hyonwqg95	org
@CALivingTV	org
@Thaishow1973	org
@KellyCulinarian	human
@Mr5starswagg	human
@Ally18210	human
@NoraFrost	human
@jessikerbakes	unknown
@NyAppyMiku22	org
@NeddSpeaks	org
@vergilsam91	org
@Corona_GQ	human
@DebraIsabella	unknown
@Abudinho	human
@VonInWonderland	human
@lberzins_voices	human
@FoodPornDetroit	human
@LifeFx40plus	human
@katdaddyxlv	human
@comeblogladies	human
@cafekisa	human
@saochuntan	human
@MelloStMatthews	org
@Brandylion13	human
@eugvignolo	human
@bobbylikesthis	human
@tracybezeau	human
@yunicakep	human
@NXTLVLFITNESSPT	org
@StephensLeah	human
@RoseJarmon	human
@UCIAP7	org
@Dhitanya	human
@FISH_HYFR_O_o	unknown
@sayo_yoshino	human
@Juwi_ta88	human
@JanMarieRico	human
@KilL3rTofu	human
@TheRagsy	human
@LisaNeiss	human
@Cin_City_0509	unknown
@ZuriHotels	org
@CitySegwayDC	org
@Bagusdragon	human
@darlamaxine	unknown
@girasolen	human
@MadoLhine	human
@plancheck	org
@mattspears83	human
@Serna_Smash	human
@Ericfebrian_	human
@YatesRomford	org
@aford21	org
@Cricri_dam59	human
@loveorganika	unknown
@FitGlitz	org
@Search4JStreet	human
@AmTradeHotel	human
@Cornucopia_Inst	org
@Boka_Group	human
@PhoenixPicks	org
@puppymcpooch	org
@ReeseDeLuca	human
@RoamingHomebody	human
@lelunacat	unknown
@Sebastyan101	human
@chinoy_72	human
@dessertisthecur	human
@JeremyWu	org
@mtkilpa	human
@Sir_Galahad_	human
@BYTMate	human
@aimanmohamad	human
@peter82615	human
@DenniDei	unknown
@MymyMode	human
@Clarkes_Bakery	org
@chickulture	human
@BL_AL_XseriX	human
@la_dame_blanche	human
@AeonZephyrus	human
@lynxtaxis	org
@Frz535	human
@stischler	human
@proteinpearls	org
@LegalRunway	human
@ShericeSwant	human
@dissapore	human
@CaliCruzModel	human
@BellaLaModa	human
@sunhoo81	human
@tsun_mana	unknown
@Flown87	human
@installek	unknown
@bevRAGE	human
@jimharanbbx	human
@LeySaavedra	org
@VURecipes	human
@0503_910	org
@BestTownLondon	human
@24_marimari	human
@L_Mojica24	org
@whitworths	org
@flaflex77	human
@NonnaBibl	human
@BeingMommie	human
@SomethinVNothin	human
@Shaneomac248	human
@Amy_F13	human
@CAMIL_LEEE	human
@amber_belle	human
@Franino7	human
@L_KiChan	human
@TajCampton	org
@EatroSocial	unknown
@Bestdietbook	org
@xcxcaroline	human
@InsaneFitness83	human
@MrandMrshowelll	org
@Tassannee1	human
@SEPTPR	human
@boyPITAH	human
@journohammo	human
@Misha_Muses	human
@lilmisstaylor	org
@gdworak1	org
@LellyAwwaliyah	human
@Fomalhaut_blue	human
@fuka_sj15	human
@Lucylovestoeat	human
@AnetaTeislerova	unknown
@stefhealthtips	human
@x0kiSsAbLes0x	human
@Femme_Noir_9784	human
@RachelsOrganic	org
@duckhouse_cor	org
@VeronicaFerraro	human
@StaceyDeGarmo	unknown
@latinlady131	human
@Jabyta	human
@ksenka_penka	org
@mexi_can_do	human
@ebolaboi	human
@dhanangwp	human
@Grotto37	org
@bierreuno	human
@familytravel4um	human
@ShaiyayOfficial	unknown
@ServiceFoods	unknown
@calanida	human
@GLAMROCKX10SION	human
@SharonKin1124	unknown
@jestemdziubek	human
@Vacances_Lac	org
@Frye_Christophe	unknown
@TenaciousMedEd	human
@proudmarycoffee	human
@VaniaNaranjo	human
@LauraHDavis	human
@AngelePrevost	human
@samfafama	human
@steak_stilettos	unknown
@clubhypermaniac	org
@WeatherCee	human
@Frethzia	human
@KasMaxat	human
@nienahino	human
@imsuperkenz	unknown
@martyz4ts	human
@Elener	human
@MadeDance	human
@nayra83	human
@Lucys_Porn	human
@washedrainbow	unknown
@80sCovergirl	human
@ChickenSoupSoul	org
@StephGoesGlobal	human
@chinyan_17	unknown
@ANNEBELLE201525	unknown
@hshouston	human
@alexandra_mei	human
@gomezcindy23	human
@MakoCapone	human
@LeighNokes	human
@awaisjalali	unknown
@sakkkkkun	org
@memotoma	org
@lanoviadelpollo	human
@eVolveSeabroook	org
@MappingtheCity	human
@BCInews	human
@DeborahDevernay	human
@abst_ruse	human
@MrEduardo21	human
@MileMarkerOne2	org
@thecheeseandham	human
@yohankho	human
@ellajane13	human
@tilsonanthony	unknown
@DiamondManeater	human
@NormandsBistro	org
@amir_fird4us	unknown
@BurgessMoon	human
@DCPicks	org
@FamilywomanMrs	human
@TruePrimal	human
@Angel88Lina	human
@hepkaravana	unknown
@stacymluu	human
@pozzietivehunk	unknown
@201UnionSquare	unknown
@Scott_Inglis	org
@KIDSDISPENSER	human
@NikoliUpInDaSky	org
@BreakfstSociety	org
@charEats	human
@TheVikingTruck	org
@MarionTessierHK	human
@Oskor_Binka89	human
@MelindaCJohnson	human
@RoswithaMoti	human
@ilzemeri_	human
@_MarionH_	unknown
@LaVillettaNYC	org
@SoLoVic84	human
@SarahCocos	human
@jhemschwarzkopf	human
@AnmolMD	org
@anamydresser	human
@NikkiWeijdt	human
@K_Thaiesha	human
@KPPhotography38	human
@VIKid89	human
@GelateriaPEPINO	human
@janicebual	human
@railla	human
@PlazaAtheneeBKK	org
@kitchentablewa	org
@adriguzcas	human
@ThaiandLao	org
@GossipWagsFoot	unknown
@ReevaAnnProctor	unknown
@Beckay1989	human
@CindyBearsDen	human
@bellpintero	human
@misya13kae31y	human
@NYCYogis	org
@saballerina	human
@erikaaamags	human
@Meah_BiiTheWay	human
@kbuhrmester38	human
@dantjemoody	human
@cafemocha_f	human
@phatphilliez	human
@DavidRiosRios	human
@abendtuete	human
@penheadnw	unknown
@cefrati	human
@DasRadler	org
@BumpN2MichelleB	unknown
@caraway96	human
@XpressateNet	human
@Vumaaa	human
@NazishMunch	human
@gongjohn	human
@RoxGilmore	human
@michellesyyeung	human
@TTinyMrs	org
@Christinehdl	human
@welshsamurai1	human
@CDiabetesmag	unknown
@RhodaDavids	unknown
@producergirl	human
@Margaret_Tseng	human
@LaziaWFEast	org
@TerriAnn123Plan	org
@charlah17	unknown
@glendroid	human
@GwenRichet	org
@sethlovenfans	human
@975krock	org
@clubdemodablog	human
@OpalDMarina	org
@minami_shineyo	unknown
@DaveVegas	human
@DanieD13	human
@erina0907	unknown
@SandySolis127	human
@TheDressBakery	human
@t3hj1m	human
@rubythevixen	human
@RaizaVillar	human
@Culinaryqueen6	human
@Xhsis94	human
@Antonio10ac	human
@hima_as	unknown
@KarolinaHlav	human
@messieruntukahu	human
@KellyKeelo	org
@MissQuixotic	human
@EmbodyWellness1	human
@Mochachos	human
@zynsuu	human
@ABlaCarolyn	human
@PegahsLenexa	human
@curatorsprints	human
@nhubbies	human
@holisticsprouts	human
@Burntlemon	human
@neeljensen	unknown
@Tyler_Murphy	human
@TribecaGrandNYC	unknown
@MeetMinneapolis	human
@onamision	org
@LilTasteOfChyna	org
@nighsfd3s	human
@JordanJai	human
@soniaoemar	human
@ToyabOfficial	human
@britishturkey	org
@TanorriasTable	human
@Thasy92	human
@ryanperezyyc	human
@minnkyra	human
@theholisticguru	human
@JEL_to_the_AI	org
@stachelbeere	human
@PilcherHamer	unknown
@meirerosy_jp	org
@FannysFineFoods	human
@NAIT	org
@iamsugary	org
@choojenshin	human
@dangleterre	org
@amerikabeau	org
@thehogstopuk	org
@MsQueenEarth	human
@BlueHillYogurt	org
@GaryErdmann	unknown
@eklexic	org
@harisimn	unknown
@Susan_TravCorp	human
@NidoCooking	human
@Donohues	human
@chodingsama	unknown
@MichelleLee922	human
@sollydog	human
@mynameisICYNESS	org
@CeLiNaLaFaMoSa	human
@RobertoCmps	human
@0113May	human
@PrincessxRinoa	unknown
@Shondalesting	unknown
@MVRZYFlux	human
@iRBlambert17	human
@AnaLibiaGM	unknown
@BobsCarryout	org
@fayesharpe78	human
@A8chaaanM	human
@andreaharris007	human
@espresso_robot	human
@kougdsniud	human
@ATrainLive	human
@georginachanice	org
@kent5213	human
@mymanjoe	human
@WilmerOgaz	human
@sophia_tye	human
@EvaBleyer	human
@imuneebali	human
@MirandaErkunt	human
@RebelliousTreat	org
@lk_velez	human
@Jonnon1919	human
@KASKETESRA	unknown
@Mohamad_Osman	human
@BeccaLPow	org
@Kaboom2246	human
@NENaturalBakers	org
@tbrunning	human
@ryn955	human
@SlimStudioNL	human
@carowilchen	org
@stupideasypaleo	human
@ParkArgento	human
@maianzzz	human
@laurelwood1	unknown
@NekoFirefoxy	unknown
@carlocross	human
@RedTruckBeer	human
@lauraalewiss	human
@LADailyNewz	human
@YourDirtyDream	unknown
@wow247manc	human
@Oooohkeshia	human
@fumi_8787	human
@Nadinemh8	human
@JassSooAmazin	human
@TsurikovA	human
@ronggii	human
@CMLobsterSAC	org
@MoneyKushman	human
@ela_yunita	human
@ChantelleLou_	human
@yanto1998	human
@yume_24d	unknown
@thekpcole	human
@CafeGhia	org
@ruealamein	human
@susyanese	human
@WatchCollecting	human
@MyCleanKitchen	org
@WhitEmbroidery	human
@GGlery	human
@Piccolino_Mcr	human
@SamanthaJPhelps	unknown
@AlbertsonsMT	unknown
@Cathytraan	unknown
@Stevenizer19	human
@timmerax	org
@SAYLORmag	unknown
@cokAlkolik	unknown
@MrDiaz4	human
@MomoDntPlayDat	human
@1017cm	unknown
@WebsterLeiden	human
@NYFarmer	human
@GINZAnoToshimi	human
@doublereds	human
@ExploreKC	org
@dettesorianoo	human
@DianePaula27	human
@ma_chanel	human
@TheBlueBell	org
@reinardr	human
@THESUSHIPIRATE	human
@IrisCatho	human
@Prick18	org
@crismesmols	human
@CheLzZ_Ya	human
@lifeinpolka	org
@nophayuliana	human
@Melissa_Weston_	human
@CitricBobcat	human
@DJEMlovesYOU	unknown
@Majzoub	human
@PenrynPam	org
@TRAYdaDIVA	human
@bellsoto	human
@ginafriasdimdam	human
@EarlsGrocery	org
@MarcyFeldPhoto	human
@PugsleyLuigi	human
@DoughgirlsBake	org
@DailyDanziger	unknown
@lilyk85	unknown
@ashxstylesx	unknown
@somanyparis	human
@BeachINNBum	human
@CrizelleXenobia	human
@maurice_jager	human
@debbychen	human
@teenytinystorys	org
@BitchesBrunchMN	unknown
@KarooLees	unknown
@mmm_nachos	human
@fabmamaNL	human
@frugalrunning	unknown
@DowntownCburg	human
@LunaNegraBali	human
@roelgianni	human
@ramoncarlosvzla	human
@sussbelle	human
@Mokatlas	human
@GillouRoss	human
@CristinBishara	org
@mykitchenspace	human
@Mia_Francesca	org
@AMMAppliance	org
@Alicelongyu	human
@AyshenOfficial	human
@BistroToulouse	org
@cornfedbeachbum	human
@michaelcaireen	human
@kt1yn	human
@aster0621	human
@cafeconclau	org
@Next_Kitchen	org
@angejim0531	human
@PrimePhysiqNutr	human
@khpgeorgia	human
@BearsBlueGirly	human
@LAKERS4Life21XL	human
@fitbodfood	org
@sarah_sarce	human
@tehlilmermaid_	human
@modadusktildawn	unknown
@PrnczzArie09	human
@CherylDietitian	human
@LoudPac_Livin	unknown
@barrely	human
@7thPublicMarket	org
@gensteelevieve	human
@anniecharaliao	human
@carifrique	org
@KhanNidz	human
@hotdnnrhppyhome	org
@glambyshylaryan	human
@_haffo_	human
@lastofthemoheak	human
@ZwartSchaapje_	human
@HollyDresson	human
@xiaohao89	human
@tigermum22	human
@Brooknamdude	human
@SportTheraCarl	human
@papepipo69	human
@esperanzafoye	human
@ASipOf_Mocha	human
@osk4r83	human
@AmyMcIvor1	human
@HauteMamaJai	human
@Inde_takhar	human
@Kenjism30	human
@JaySaran	human
@mommygabriela24	human
@joyishalove	unknown
@Shindo_Taira	human
@FratellisNC	org
@goldaaton	human
@Lex18AVL	org
@KEEP_IT_ON_WAX	human
@imasetchico	org
@LankonkawayiT	human
@LosingInTheCity	human
@Peasantryeatery	org
@zumikiss	org
@123maudie	unknown
@kimrobinson17	human
@Timothy12211	human
@eurekangelina	human
@iR3han	unknown
@totztwits	unknown
@maguru07	human
@biancospino2	org
@Dailyrestaurant	org
@dlovadiv	human
@MarynaZinevych	human
@MunierG	human
@beachglk	unknown
@pete_peter	human
@neils_rt	unknown
@sedwardspq	unknown
@VocelliNorthMia	human
@modelsharonwu	human
@quinnaford	human
@healthwithgita	org
@SmoothRob_B	unknown
@VeraPootee	unknown
@smokeshack	org
@SusuBubbles	human
@MumbaiFoodLover	human
@mississippiDAWN	human
@ChefFlannigan	human
@KeithOReillly	human
@aikaisyah_04	human
@takacitra	human
@LeogoesPaleo	human
@LikeATree6	unknown
@Nishakitty_cat	human
@edie_r	human
@cescescesar	org
@EllyCoughlan	human
@CBotha05	org
@GomezJ82	human
@Mackiesonestop	org
@NikkiObraVIP	unknown
@bbuurccuu	human
@Sneha_Sridhar	human
@millionheartss	human
@SimplyChopped	org
@KaleidoscopeJem	human
@monicamuychic	human
@yesenias91	human
@iFallengel	human
@kimtianjoong	unknown
@GustoManchester	org
@60th_Street	human
@azzurracucina	human
@wendilicious87	human
@PITTAROZZO	human
@Funksta_zn	human
@TsubasaCN	human
@ElleArkhipova	human
@skullisla	human
@Kayaletho	unknown
@FireDreamer63	human
@LifestyleLaura1	human
@drSLY	human
@small_squeeze	human
@shamikah	human
@bloodyvengeance	human
@justaddpink	human
@reymundus_CHIU	human
@foodytools	org
@GabiiPriolo	unknown
@BrasserieBistro	human
@NatureFoodPatch	org
@DjKiAnn	human
@AkashBurana	unknown
@bearabledeals	org
@DanielYongzheWu	human
@TheBaconHoarder	human
@maryhelensaba	human
@whitepinotnoir	human
@00Mitsuru	human
@crankyoldguy873	unknown
@MassimoLoBianco	human
@SophiePJ1	human
@Gladz1981	human
@YovinYosveriska	human
@ReyeEdgardo2910	human
@MarkPavelich	human
@michaelctong	unknown
@Man_of_d_Rose	human
@KeyLimeRepublic	org
@rufhus	human
@henshinpower	human
@GregRokisky	human
@ljwen96_carven	human
@MissNL	human
@jose_m_1983	org
@PrettyBitches	human
@VanillaBrownyy	human
@CrosswindsGC	org
@KrisTinny92	human
@Weekendfoodie	org
@asrafheafy	org
@_SHelen_	human
@SixerIverson04	human
@mharlcian	human
@OhMySkina	human
@alchimissabb	org
@urbancultivator	org
@beybi_tomasini	org
@EGHotel	org
@vcsporrazzo	human
@KAlifAizuddin	human
@clairetetteroo	human
@CherrybankInn	human
@tweetheau	human
@Junior0093	human
@LadyLahlou	human
@zumal_official2	org
@rentmoola	org
@CristaTT1	human
@angelahauck	unknown
@myknguyen84	unknown
@Engine2Diet	org
@SimplyKfab	unknown
@ProvoxBlog	human
@SHINee_Anna	unknown
@Infbuckets	human
@ClayPotWaco	org
@Grendel_theboy	human
@lovewhatisay	human
@NandosPakistan	org
@Learning2Chef	org
@jasey24	human
@kenyid	human
@GourmetClassics	human
@WannaBchildfree	human
@_homeRefresh	human
@Gina81225	unknown
@FromMyPlate	unknown
@Music4TheJetSet	human
@Ayana_aby	human
@davidagwen	unknown
@Nadia_Love23	unknown
@BraisenWoman	org
@ipockysaurus	human
@ms_adam	human
@SorayaAnderson	human
@caroline_asan	human
@Engel_Ritter	unknown
@IDontWannaDie_t	human
@andrewgray_	human
@omoshiro_F2bci	unknown
@mipopo0115	human
@MarnixvdBroeke	human
@PrinceNaryk	unknown
@aartiqa	human
@happystronghome	human
@utlmmusicgroup	human
@MadeLVTavern	human
@worklifemoney	human
@iMariela	human
@bkindngood	human
@micki_josue	human
@bakeatmidnite	human
@QuintinKoch	unknown
@PietruczukPawel	human
@RadissonBluYas	org
@beadiafoo	unknown
@orgazmaker	unknown
@AdorableWinner	human
@WendyWanYee	human
@C_P_Fletcher	human
@CaerusMM	human
@JESHealthFoods	human
@Active_Qatar	human
@mobalondon	human
@ryehousenyc	org
@andyauch	human
@hahahatring	human
@noelluvnlife	human
@hiro_bellic	unknown
@kalona522	human
@CorrigansFood	org
@FityourChic	unknown
@SpoiledBratDuhh	org
@KitchMedia	org
@RandyMasseyAuth	human
@lozaneee	human
@Scavorodke_en	human
@GranaryTavern	human
@ItalianMidwest	human
@takiloves	human
@lizzinablack	human
@MonikaPaul84	unknown
@snow_flower7	unknown
@LeeGraham_	human
@batsflywest	human
@JuanKinka	org
@emilymathews6	human
@flygirl_Frenchy	human
@carmelmoments	unknown
@ZsLife	human
@barneybc	human
@RiskEscuelaC	human
@mrrm_1994	human
@NeuvooLogSF	unknown
@AjengRamadhanii	org
@zombievshate	human
@davidgobira	human
@seouleats	human
@joelkilger	unknown
@missnthekitchen	human
@Mentestropeada	human
@carlyurminita	unknown
@Q_mio	human
@Jack_G_96	human
@ChristobalBrown	human
@Sujihome	human
@aidaaaaa_	human
@derya319	human
@IronChefCuisine	org
@gallerytowns	org
@CASADAGO1509	unknown
@DTSmith07	human
@sharnelle20	human
@algreenism	human
@cindyoyama	org
@Soph_Cain	human
@MgGiddings	human
@Ofooduk	org
@MABExperience	org
@Ryearwood	human
@BoxxBoyMatic	human
@J0dieKay	human
@ym1212	human
@geraldo3	human
@SinglesDaNewBlk	unknown
@frenchypoo	human
@ellensagentur	human
@TSzeL1ng	org
@3STR1K3S	unknown
@Tonightnla	human
@BlackOlivePH	human
@stress_cafe	human
@riachicwanderer	unknown
@XRoseNightX	human
@mmcookingblog	human
@MemorialPark	org
@RongQuanz	human
@WorkoutShack	human
@Jasonhoeung	human
@Ladygogo84	org
@kristina_eg	human
@jen_i_fer	unknown
@WaggonerHester	unknown
@DianraDian	unknown
@Gingeey7X	org
@jc_chambers	human
@chocolateguide	human
@Pier64Penarth	org
@LaTronaPanama	org
@APavliencko	human
@_Aitannn	human
@__xocindyy	unknown
@CityCellar_WPB	org
@sarahgreenapple	human
@tightabsfoodie	unknown
@DolceMag	human
@DavisEshelman	human
@PauAyuso	human
@STYLISTEdeMODE_	human
@maxilon	human
@JUSTLYKDATT	human
@tomsfoods	org
@santianastasia	human
@samskitchendeli	org
@Brunchmeup	org
@AngeliMarcus	human
@Jojo123338	human
@ItsShimaa	human
@WorkoutPanther	human
@brincy6	human
@yangyang_712	human
@CarillonAustin	org
@ChilisUAE	org
@Keeny1965	human
@Stigabiga	human
@raviellangie	human
@Nishazhanii	human
@BluLexie	human
@saygo715	human
@MsLauralai	human
@BourgeBombshell	human
@EDNetles	human
@akosimarkieee	human
@iaesteman	human
@idreamofchoccie	human
@AliDadda	unknown
@BoatHouseCC	org
@AngiViper	human
@weddingandweddi	org
@dcro1020	human
@Taurus_BBVIP	human
@angel_ortiz	human
@NazarenoMrnd	unknown
@sincerelystacie	human
@BrownEyedBetty	human
@UR2CLOS3	human
@rinchewahyuli	org
@gypsy_yumi	human
@alexandraowen_	unknown
@180gramm	human
@niza_wayne	human
@Saad_Ramadan	human
@PlayaGuide	org
@KaraamEaling	org
@SMBURGERSLA	org
@shamekakud94	human
@cherrycoke37	human
@chyhI008	unknown
@DawnielleCas	human
@CreAteYaLaneTV	human
@BlogNosolomoda	unknown
@Zoilo_London	human
@Oty8	human
@jAnNa_182	human
@Tennille_Aimee	human
@SirBearCat	human
@erisIsel	human
@healthy_eec	human
@eljay1980	human
@jesicarifin	unknown
@Kokonowa_bagel	human
@ellulopop	human
@Bear_Edward	human
@ThirzahBeasley	unknown
@UDCMoscow	human
@Amath_G	human
@mustbeyummie	org
@jaysonricardo	human
@smitadesai000	org
@YSalandanan	human
@iamquietasacup	unknown
@arafikasari	human
@MarkAGood	org
@KROManchester	org
@jbethjs	human
@MRobertson808	human
@Mafara_	unknown
@EchaEny	human
@pasaim7	human
@Miss_Mousie	human
@i_am_fuuu	human
@levikamanga	human
@beangiel	human
@angelicaferreir	human
@take45da	human
@MichieHii	unknown
@JimblesSpaghett	org
@blueblueMJ	human
@UrbanEpicurious	human
@TuttonsLondon	org
@Ash_Anonymous	human
@twenty20sight	human
@StrateJaye	human
@Florian_CC	human
@deathsdoor	org
@anne_080786	human
@Sapiopath	human
@alexsam_89	human
@oxclubbow	human
@moonlitprints	human
@mmm_radwan	human
@CheyenneMcCray	human
@antonioortu	human
@happytobehere4	human
@shida_rizal	unknown
@cswirohutomo	human
@cocozarbie	human
@omgitsjen	human
@chintavreztians	org
@SidChikte	human
@XxSTEVIECEExX	human
@ChristyMorcos	human
@Hardrocker721	human
@braceandbrowns	org
@PremierPtnrs	org
@ALivedinHome	human
@VinMpls	unknown
@DevonTheHT	human
@seina1012	unknown
@Red_HoustonTX	human
@katelynaday	human
@MrVates	human
@MMHewitt12	human
@UlaCanalla	unknown
@itsmeKLIMIE	human
@GrifcoLTD	unknown
@FollowTheKidd	org
@BlackAcreBrewer	human
@Chris8YaHeart	human
@TheXtaticOne	unknown
@sthenan	human
@Daddy_sGoodGirl	human
@Justine_King	human
@Salad_Girl_Nat	human
@fruloppan	human
@LakeErieMonsta6	human
@IVPizzaMadison	org
@iamhexilon	human
@wutzwhat	unknown
@virginierins	human
@JennBennett	human
@wada_woo	human
@nacron	unknown
@CarlahMourad	human
@GoWellPath	org
@Garlicandzest	human
@HelloKelbell	human
@The614Realtor	human
@McBeardy84	human
@taku0415	human
@jessicamedina77	unknown
@thementalkavity	human
@erika_ursino	human
@ayane0902	unknown
@Life21S	human
@fatinlahh	human
@caramelcoolfelt	human
@bassist0803	human
@FatmaRosyida	human
@loganandfinley	org
@Shantel183	human
@Mandi_Lynn	human
@Groupon_ZA	org
@KinomiNuts	human
@zola_nene	org
@MarieMMao	human
@meisha_b	human
@Mrs_Tata	org
@VeeraRajandran	human
@TOWNHALLOHC	org
@StyleAlbum	human
@To_Holly	human
@wowhateverika	human
@LauraMarieGz	human
@_EllieAnn	human
@cape_town_brad	org
@heyjessla	unknown
@Jenna_Nicole	human
@arolikarolina	human
@foodieshares	org
@KungalvsMattias	human
@syafiqziz	human
@baibai0615	human
@lordberticus	human
@PappaSnoopy	human
@GuidoBarosio	human
@parunyas	org
@Eric9SC	human
@GUDguerrilla	human
@dallas_cam_dall	human
@chun_0724	human
@andiniputriia	human
@DryiiZE	human
@BebeGetsWordy	unknown
@1LoveAndMusic	unknown
@magicitystrteam	human
@michelleeeloves	human
@joj0smurfffeuuu	human
@lacountyparks	human
@YRAdams	human
@forza_will2006	human
@NIOquendo	org
@andrewfreund	human
@EdieSedgwick325	human
@DynamicTrades	org
@weijian_a	human
@N_Waste	org
@RiztaDesiya	unknown
@syirinsaid	human
@hiIMjett	human
@Purple_Enma	human
@sdlondon77	unknown
@akamariio	unknown
@StutiSunar	human
@Zemistr	human
@javaportmusic	human
@_djMO	human
@ToonzIndia	human
@nadzatolrahima	human
@palachinkaa	org
@hannahbailey92	human
@casey_gail	human
@VandanaShethRD	human
@sha_izdihar88	human
@wtcbg2011	org
@DannieBoiRnB	human
@SigmaEsquire03	human
@MRYNNQ	human
@em_sally	human
@Tacoma_Chamber	human
@shalyssaaa	human
@CakeandFoodShop	org
@chameleonvil	org
@StateStatus_DC	unknown
@sarahcooks	org
@CEOmelissaB	unknown
@ImranNerdyHSR	unknown
@ecky	human
@PrettyBoyAcid	org
@THEdjpluto	human
@WSParkHall	human
@5tarPIA	human
@TheSummitSonic	org
@SuzenetteAkijah	unknown
@korpijaakko	org
@SonodaAnna	human
@alacartadord	human
@SunnyCrittenden	human
@_Shanwoo	human
@anhet_	unknown
@SecretLee_	human
@NatashaOnonogbo	unknown
@YapHongKong	org
@lolabelly	human
@JackieMSinclair	human
@a3mirai	human
@wearefreshkids	org
@nicardo49	human
@CorpoSano1	org
@audyr8	unknown
@AntiCancerGirl	org
@andreafitaddict	org
@SarahDSkis	human
@NFLGirl2010	human
@bentoriffic	human
@AspergersDavid	human
@Good_Tides	org
@Jennwoods75	human
@lmariephoto	human
@ayecanovasr	human
@JennaDugray	human
@EatMyWordsBlog1	unknown
@BlissfullyCook	human
@rachelsdiary	org
@BabyGrandGlas	org
@AllySky6	human
@MichieTobar	unknown
@jk_bonilla	org
@AndieAndiee	human
@MorganStJohn	human
@BGolden24	human
@MorrisPartyof6	human
@Fortified_nm	org
@karlitaa91	human
@YAC_ing	human
@jn_silpa	human
@jpretorious	human
@NamHKS28	unknown
@BarBouludNY	org
@EngelmanKay	human
@iluvshida	unknown
@Anime_Lover21	human
@WhiskyRiverCLT	org
@bigwalt9	human
@cjramirez49	human
@Amber_1017	human
@Sinzkim	human
@mizzbrice	human
@jrf_jorge	org
@dwiya_rizkani	org
@itsmeljdj	human
@TemptCaterers	org
@planetapeo	human
@samitravels	org
@OldYorkCellars	human
@sanochan_24j	human
@dashty15	human
@ForeverRejonae	human
@TheYardsDC	human
@House_Liverpool	org
@angelvallenilla	human
@jesucito_12	human
@salvadorsan226	human
@vmpracing	human
@BambooKitchen	human
@DebbieTCC	human
@elizabeth_vivin	human
@MrEasyDay	unknown
@_jkzelda13	unknown
@mialelanixxx	human
@Time2Design	human
@DirectTablet	human
@addiyanaa	unknown
@RexHotelToronto	org
@atlantidasomma	human
@sassyamyfoster	human
@tyjwilkerson	human
@Mustafa_okn	human
@BOCCO_DELI	org
@SeanPerez101	org
@ExactlyThat	human
@SerranoPeppa	human
@lusinandriw	human
@JKALjen	unknown
@Sevananda	org
@arukion71	human
@Breezy_Bambina	org
@bikejourno	org
@heatherkd83	human
@watashiha_dream	unknown
@Sabzz1313	org
@jekketto	human
@lovelyekka	human
@joshuatangcy	human
@ChiyaMalka	org
@CherylForbergRD	human
@c0rall1cyprus	human
@MagdaLuce	human
@ramsdensfish	org
@AmberAlert_90	human
@behvs	human
@peepboutique	human
@Monie_Mo5	human
@healthwealth121	human
@PayetApEk	unknown
@BrookePoirel	human
@YamChopsTO	human
@MooMooCakesSuff	org
@Jesusheadbangs	human
@JuicyBandD	human
@edenside	human
@TasteMYChina	org
@ehlabsyou	human
@NeuvooGloucest	org
@EatLiveSleep	org
@AADarwesh	unknown
@DoozyFAB	unknown
@JilaLuis	human
@andyngan	org
@prueksaang	unknown
@ChrisMontanti	human
@JessabellaF	human
@TheFlipFlopWife	human
@RossMcFarlen	human
@VestiaireRomane	human
@rudyfadhlee	human
@yukirin__paruru	unknown
@CorvoWines	human
@BeanInstitute	human
@ChristenBMusic	human
@PinkSpeedBlog	human
@darnellbote	human
@stregisbali	org
@_xKMJx_	org
@billnguyenvn	org
@snarizpe	human
@Bot_wit	human
@wuyourong	human
@De00	human
@tinapplemint	human
@SeOmAyEDD	unknown
@allphinlibbe	org
@vladabonum	human
@drawde_yaj	human
@OhanaFoods	org
@NawlinsJazzBar	human
@portal_sabor	org
@KatrinaCaro	human
@riddickstgt	human
@FidelisCare	human
@Fatz_FDM	org
@photographercho	human
@avigayildagea	org
@LaSweet_Vee	human
@NithiJung	human
@Sarah_Lou_B	human
@aaylam	unknown
@thedevbalham	org
@dibanyan	unknown
@ennikiema	human
@The_Gale_Force	human
@dodojin9497	unknown
@nigel4036	human
@minchan_desu	human
@dhieradanes	unknown
@hit_lyryx1	human
@sunder_s_mehra	human
@CITYGUIDEMUNICH	org
@iris_tian	human
@SarahLouiise_Xx	human
@Fitri_lols	human
@dorascatering	human
@hotkrust	org
@YouCanCallMeLB	human
@ChickVacations	human
@Original_Pizza	org
@explorefx	human
@thehumbled_one	human
@theroar_blog	human
@DanbiNguyen	human
@PawelWShore	unknown
@KashiFoods	org
@JonnieKutchera	org
@ernelaseoche	human
@NJCreativeStyle	human
@Angela_M_Fisher	human
@MonaLesha	human
@_matilda09	human
@Countess_Reem	unknown
@ShiroPasadena	org
@PolWayne	human
@Locals_say	human
@thomjr1967	human
@SrCareCorner	org
@LOCALon8thAve	org
@MCirkus	human
@thekingskitchen	org
@sassygirlkelly	human
@jimbotuazon	human
@JoesTeaCo	org
@Tianna_Marie	human
@Rebel_ForLife1	unknown
@TheBarRoomNYC	human
@Die_Dis	human
@BlakeCurtisW	human
@LaVieEnAnna	human
@BoMBaCi_GRouP	human
@boechek	human
@elpolito13	human
@PeterAForeman	human
@elezux	human
@kia_001	human
@WhitewaterResta	human
@MalenaP07	human
@aeneasz	human
@kieda_koated	human
@pastaclassica	org
@AlejDiaz0	human
@feb_ryan24	human
@Glamourim	human
@TheKicksman	human
@orchid7106	unknown
@Logine20131	org
@grithale	human
@iBGFree	org
@lissevandegroep	human
@kamaroncita30	human
@MariatheTrainer	human
@KINGABonline	human
@HyndeSantos11	human
@mrandrespineda	human
@ChuBByAkoo	unknown
@AthurunA	human
@MarqueeMarc	human
@Leasfeir	human
@HoneyPotBnB	human
@christiana_poly	human
@Misyu17716	human
@athenatradewind	human
@oscarsofsville	org
@hb_EATS	org
@JanArdenArtist	org
@_LittleLaws	human
@MsRae325	human
@pandptunbridge	org
@CheapasWeb	org
@BOBBYCYRUSLOUD	human
@dianasaurusrex	human
@BoccaccinoFL	human
@aariesh	unknown
@Keno_D	human
@LFATucson	org
@iamjensfer	unknown
@CoffeeWorksProj	org
@klutzylala	human
@DjSituation_RC	unknown
@EmpireRentalSTL	org
@SLN319	human
@bettermaybe	human
@Ly_me_Ly	org
@AlexeyRad	human
@fazkids	human
@gitasatyayuniar	human
@Dolcezza_cafe	human
@monicastable	human
@lovinbreakfast	org
@moorehttgrl	human
@justmebpl	unknown
@stampede1951	human
@chefhari	org
@pchrissusanto	human
@lebonvinfr	human
@2SonsSandwiches	human
@7heartmom	org
@dwongandonly	org
@AbuIssaBubere	human
@Branawesomer	human
@N1kNuu	human
@Nshantelblog	human
@KyanNono	unknown
@U_Ki0211	human
@ColantonioMauro	unknown
@nozombii	human
@Namrata_Joshi	human
@AnjStacansi	human
@callofduty_gph	human
@jbocobza	human
@nabilahrayyan	unknown
@cezovski9	human
@KHannahL	human
@CoachMegz	human
@ArtemisPark	human
@Daems0528	human
@kailiyinhui	org
@CafeRevel	org
@MichelleWng02	unknown
@IAM_SherenE	human
@ColettesEvents	org
@harbourroom	org
@bigstarstudios	unknown
@kimmers_h	unknown
@SMSclare	human
@Ailuv2sing	org
@homesliceLDN	org
@M3Manu3LMigu3L	human
@Soloko16	human
@ChefMandip	org
@poly_lewa	human
@petitpoiscville	org
@Borderfields	org
@dapursrikandi	human
@Rachmb11	human
@RSFable	human
@wrapwithroni	human
@GinosSteaks	org
@MsSillyakaMsFly	org
@geglive	human
@odyalu_malo	unknown
@Farhan_Mizra	human
@LoveMaiNone	human
@Larnerdo	org
@JaviJAJM	unknown
@Midorildivo	unknown
@IEat_IRun	unknown
@michellequek	unknown
@JollyJommy	human
@LucxBoutique	org
@AllisonUrquidi	unknown
@BestinLongBeach	human
@kendellerae	human
@slb6661	unknown
@mbdeckerfeed	unknown
@XoAmandaFrances	human
@QuickNDirtee	human
@chaarbaakii	org
@__solitarysoul	human
@TheGFFoodGurly	unknown
@jasbondoc	human
@missliuphung	human
@CarlosM0402	unknown
@effendydenny	human
@NeMiCyS	org
@Anchal_11	human
@tinkercyn	human
@dhillonshalini	human
@Kieszthis	human
@TiongLydia	human
@andreablu_it	human
@sweettweets94_	human
@aneelamaharaj	human
@solerKing247	human
@SX4_kojiparuru	unknown
@MichelleKamal	human
@TheSaltyTomato	human
@oldmanloudwife	human
@Letsretweetnow	unknown
@ki43mermaidblue	human
@omerchughtai	human
@zkdtdt235	human
@Maxx_Fuel	org
@sieghrt	human
@riiko364	unknown
@Bri_Cochrane	human
@SelinaAiko	unknown
@Caribbean__Food	human
@SMartyMar21	unknown
@MuseYarm	org
@francyav	human
@SANDOVAL_ACC	unknown
@TriciaMcKenley	human
@gaycolumbus6451	human
@KammyDashing	human
@CleaDaher	human
@LulusAllston	org
@shyegurl02	human
@TimGonzalez	human
@RealBrookeAlexa	human
@donovanatkinson	human
@david_andez	human
@drastikodieslow	human
@innshafinna	human
@leiyahss	human
@yr_131	human
@Patmonster89	human
@jhayster13	human
@MillaDaMayor	human
@dugers	human
@BaliHotelsAssn	human
@AiVicious	human
@brianwineforall	human
@iamjajaramirez	human
@tbydaniel	org
@justinebsalazar	human
@jamic_21	human
@IAmCamero	human
@visitstjohnsnl	human
@itsthenando	human
@HelloDaisyStyle	unknown
@LeonLopezSV	human
@Ballerinaambs	human
@ChisouW1	unknown
@OneBeatOfficial	unknown
@BelgianCafe	org
@StrongArmBaking	human
@tebotealounge	org
@htmlgamers	org
@ROBinDmajor	unknown
@FegoUK	org
@yesdadda	org
@nickziade	human
@wendybudrow	human
@adrini16	human
@michaelcarrubba	human
@Mutsumi_Numasa	human
@manuelasole2	human
@ant_surf_fish	human
@JatimKita	human
@1936biere	org
@LesPeccadilles	org
@LKFGroup	org
@Ami_Safir	human
@EditorialKR	human
@cheftonne	org
@apriltsang	human
@0pril	human
@btmcclelland	human
@VeludoBar	org
@mikecute07	human
@seichari	human
@SasaharaX	org
@AudreyLortho	human
@maryirna	human
@HalfVeganGains	human
@craziestangeli	org
@ieatcows	human
@htswjgblues1	org
@mkSportsanista	human
@paresbalta	org
@itsaplusnet	org
@ZioneArchAngel	human
@JaamDemczuk	org
@PuppyAndCream	human
@HilarysEatWell	org
@Nitromealpro	human
@OregonMeadow	human
@mcfleurriieee	human
@MK_QUA	org
@AlveenaDoll	human
@CRAVE1201	org
@yoontarn	human
@ParentPalace	human
@shahmiffahwoii	unknown
@SwaggaLoyalty	org
@ravlyal	unknown
@NicoStaffa	human
@4NBarnsley	org
@ExeterLover	human
@monababesss	unknown
@monkey_michelle	unknown
@RLWorthey	human
@Queenstownlife	human
@DeanoVen	human
@14U_official	org
@soHypnotiq	human
@YasminAmrGaber	human
@PhotographerWRS	org
@Mangley	org
@lena_mahdalenah	human
@ockypratiwi	org
@TorontoVeg	org
@Bheemchiebeate	unknown
@enlightenedyoga	human
@livpaleo	human
@nojiggle	human
@EllieMcHarg	human
@ZieraZain	human
@xWAWLx	org
@Anngela_Rdz	human
@marlynxna	org
@RotanaCafeDubai	human
@MooseheadGrill	human
@joly2u	human
@minidappledoxie	human
@cCharmz	org
@Thanecooks	unknown
@ShoppinhoSAndre	human
@Foodie4you	human
@WholeFoodsPR	unknown
@Yangmixue	human
@jervince25	human
@OutTherefran	org
@Coach_Denise	human
@MothersNOLA	human
@fresaclub	human
@curatedbykiki	unknown
@RightChoiceMeal	human
@FullerMcdougall	unknown
@LittleJiams	human
@cyril_lignac	human
@mariehhh07	human
@maggieisaacs89	human
@johanizham	org
@LovingHeart777	human
@WawanPeaceMaker	human
@Victors2Sense	human
@AperolUSA	human
@boodlebugsmumma	human
@Kramsnevets70	human
@SharellComan	unknown
@laurenpswim	human
@wolfwing44	human
@eriaj63	unknown
@VapingDane	human
@serdans26	human
@simplycrys1	unknown
@blueman102	human
@ReinaStella1	human
@ChixMontiero	human
@Gravity_VibeVee	unknown
@dekesask	unknown
@nakedfishbistro	org
@filemongoh	unknown
@DarrenMcErlain	human
@Glasgow	org
@arlu	org
@riegreen	unknown
@TorontoPigSave	org
@IFEEL_LIKE187	human
@sashaida	unknown
@MikeAgemy	human
@donny_le	unknown
@msdiva404	unknown
@MissssBehave	org
@evelukitas	unknown
@selcenbuke	org
@aixahuergo1	human
@p_lebanon	human
@Hent_Driw	human
@Morerawfood	human
@EmanMohammed_M	human
@SukiNee	human
@JOMYUTTHAPHONG	human
@hugfreitas	human
@schmick01	human
@thegeekspeaks	org
@michaelfn8	human
@hapoymoon64	human
@StevesDaughter1	unknown
@irene_brenda21	human
@DaebakKpopcom	org
@ToriHolthaus	org
@craigcayetano	human
@weilingsin	human
@ssuperviking	unknown
@kchipphoto	unknown
@SweetwellFarm	org
@KleineJAlien	org
@TheHudsucker	org
@hannah_sayfer	human
@GuiltFreeEatin	org
@SohoConfessions	human
@Joy_Doe	human
@Anna_McManamey	human
@IamMzMills	unknown
@bullbarg	human
@MBMulhall	org
@lisa_simpsonlk	human
@lotusflowers26	org
@Prusia	human
@racheldietitian	human
@jayygembel	org
@lilyellowfellow	unknown
@Raflurv	human
@copykatrecipes	org
@NithaRibka	human
@scheongleen	human
@BEYNCEcallmeDVA	org
@louiseeve94_eve	human
@kevinbrownnc	human
@Nutri_UAE	org
@poshsevenmag	human
@jameshedland	human
@newietraveller	org
@nuttynutrition1	org
@six13studios	human
@Mzz_Proper21	human
@FontFallowfield	human
@sir_arch	human
@thatkiddjphilz	human
@Anna_Qii	human
@rishchaii_	human
@lookytasty	org
@Car1ta	human
@evanhanczor	human
@Its_da_R	human
@BlvntForce	human
@FikaSweKitchen	human
@vensyprops	human
@DeeJayHem	human
@rockongina	human
@brokenscarecrow	human
@NaomiGraceBurke	unknown
@big_tx_morales	human
@CoalCityEnt	human
@CardiffTeaCup	human
@CGllrd	human
@HelloToothsie	unknown
@EATNYC_2014	org
@iceculinary	org
@getfork	org
@saucypearblog	org
@Jimbo2Nathan	unknown
@erin_13	unknown
@32w_kuro96rock	unknown
@ValeuForte	human
@RzrEdge	org
@mount_my_cock	human
@gaydarke	human
@GinCharge87	human
@VenusDeMilou	org
@Haute_KoKo	human
@SofiaHauffeM	human
@ameenson	human
@kiffmcmorris	org
@littlelittle233	human
@iamdjepic	human
@cartoonmeister	human
@NapInterrupted	org
@Salamanca_SSV	human
@nanonanononoka	human
@Shoichi25	unknown
@BradshawLaw	human
@Crackmacs	org
@MaZyoOoOnA	human
@viaChiby	human
@SixCity_AR	human
@FrocksAndForks	org
@WanderingKam	human
@iamclare07	human
@Realmadrid18	human
@ShahAam1	human
@ThatBestMan	org
@vladavlada9722	human
@kenbow89s	human
@CristianaMars	human
@itsmemaita	human
@LydiaFayeJones	human
@gracey_sim	human
@onceforever38	human
@fabinafan	org
@planetajoy	human
@JoeKazzi	unknown
@elizabethwcrew	human
@BCLesClefsdOr	org
@v1tusphoenix	org
@CautiouslyD	org
@MzSRT12	human
@JVSBrioso	unknown
@LipStainsSM	human
@gyroshack	org
@musclepro_e	unknown
@iGersooonnnn	human
@theriswardrobe	human
@AbiLaara	human
@AnnaBerdysh	human
@lacysorcas	human
@_Thaydo_	unknown
@MAndreeva	human
@thriftygirl82	human
@PizzeriaVetri	org
@FiftySevenLA	org
@StevenLadin	human
@Irukafishy	human
@itsgoodtobehere	human
@jamieskull	org
@LatoyiaCrupe	unknown
@RedRanger60	human
@Lantzzer	human
@crazykittyclaws	human
@BoomerangRE	org
@irahkarisse	human
@DeeJayEngine	human
@ekputri	unknown
@FitriLinzyus	human
@huangsichia	human
@rominagalvan3	org
@FlCritic	org
@Jay_Tee_23	human
@MaddalenaFulham	human
@knolinfos	human
@theMommapolitan	human
@cokelatmy	human
@misathemeb	human
@mozartianme	human
@yardleyinn	org
@SUCKMYSPIDERDIC	human
@LaSugarlace	human
@wuhh0329	human
@AlexandraJe90	unknown
@thebreat	human
@FierrosBonnie	human
@UrbanBuddy	human
@sissca_fran	human
@Rocketlilly	org
@AlisonShaffer	human
@C_wickedwitch_C	unknown
@Junkfoodkids	human
@ThePigsEar	org
@BeautifuLia18	human
@miriamverz	org
@dewiberliana07	unknown
@lawrencewlee	human
@veetourlew	human
@HiatusBBQ	human
@CarolinaFusi	human
@yuyita_a	human
@sarahds27	human
@highstreetlady	human
@NickBricks_MHC	human
@7bandgeek	human
@abrandt0524	human
@shareplatespr	human
@izoned	human
@LaBiscotteria1	org
@DowntownDCBID	org
@dinglefunk	org
@FisherRent	org
@itsfloydie	human
@meals_shephrdsb	org
@Li26	human
@kanlimya	human
@inspireflect	human
@HaydhEm	unknown
@900Mex	human
@charolettevoge1	human
@CFWATCHCITY	human
@carlmoka	human
@siewlee1818	org
@mrsubtle09	human
@OfficialMickSch	human
@Morichan	org
@ChanmStudios	org
@afyqtwenty4	unknown
@SukrinUK	org
@DanaDeMercurio	unknown
@JovenCalloway	human
@things2doCSG	org
@ainnurul3	org
@ThatJakeLong	human
@JeseniaFoster	unknown
@IppyChowdhury	human
@snoopdaniel	human
@chandraaaaa	human
@Jenny_Jupiter	human
@RLauraine	human
@BaileyKo	human
@cukri	human
@CaravanKingsX	org
@columbia29208	human
@khin_ong	unknown
@sorayaalcala	human
@HTBrunch	org
@AndoiEstupido	human
@emm3016	unknown
@MattNelson83	human
@AtlanticKitchen	human
@browninc1	human
@Angemali	human
@TheCupcakeNanny	unknown
@SpectaclesMcCoy	human
@poetryizme4lyfe	human
@c_lane	human
@Schmackofatzi1	org
@Ur_GuRl_AlwaYZ	human
@proudfoot_leah	human
@BeCreHealthy	human
@heavenskincare	human
@MaxyBabyx	human
@amirahmn92	human
@JPdHotMESS	human
@Morven_MacAskil	human
@tika_rin	human
@BadGalDeeV	human
@dilunw	org
@noerftria	unknown
@AbrilToledanoL	human
@jojopetv	human
@ash_ashes2	unknown
@nathancayo	human
@NotoriousTKE	human
@WettachRalph	human
@chay_laaroussi	unknown
@BurgersSweets	human
@Kittycarebears	human
@GutierrezRommel	unknown
@SielleMusic	human
@DarrenKerr	human
@tomqvaxyM	unknown
@momsfunlife	human
@OfficinaMilano	human
@EastCoastGymRat	unknown
@ThatCrazyIdiot	human
@DeedeeRuess	unknown
@dianallamas6	human
@OfrendaNYC	human
@Miaplusz	human
@OneLifeBFit	human
@WeightLoseCheck	human
@Lavignsen	human
@TeuCreic	org
@peninwonderland	human
@Lukeuka	human
@omoshiro_6fnrK	unknown
@_bliep	unknown
@CoveEleuthera	human
@Xaeyn	human
@ishcdejesus	human
@mibiting	org
@eric_a_kirk	human
@CincinnatiPR	human
@CANDYWONG510	human
@KomarovaPauline	human
@aud1ble	human
@AngelaMoulton1	human
@MandaPlease_	unknown
@jojotj	human
@RapOrtiguero	human
@RedsBurritos	org
@AshikNaruto	human
@HarshCryJukebox	unknown
@IrreBRIStible	human
@HungryFerret	org
@AtSantaBarbara	human
@yoon_ifnt	unknown
@aliffnajmi988	human
@darleneowen1234	human
@shahab82	human
@krupamistry84	unknown
@HealthyHabits14	unknown
@Samira178	human
@clare_kathleen	human
@jordikurni	human
@SeaEliz	human
@NeferteriS	human
@edifashionco	org
@Serendipity_OAK	human
@belitsenturk	human
@mrSBSP	human
@Hollypollywood	human
@Christinrg	human
@Ereek16	unknown
@pewpewpanduh	human
@hanbanSteddersx	human
@HM03ilaxcia	unknown
@zabrinskee	human
@indahnaila	org
@marina_sep8	human
@SpurRestaurant	org
@chris_ab	human
@VeronicaFrankow	human
@DOSmagazine	org
@onshortrest	human
@MyPlace4U	human
@superachako	human
@0918Ldh	human
@RahayuCLH	human
@SardineRoom	org
@DeltaBurnaby	org
@BarneyBlues	human
@bbradleywmc	human
@Vkumar03160145	org
@elizabethpabon	human
@chelinhighheels	human
@Vic_a_lic	human
@vanessazar	human
@hamzapathan	org
@iThink_Fit	human
@Kak_Ceeput	human
@withaOwline	human
@ShaundaTrumbo	org
@PesolaChiara	unknown
@DruugFree	unknown
@SmartCessme	unknown
@arisaa_y	human
@esteelovebunny	human
@aRviiN_MaRc	human
@FaridaA	human
@LuckyCedarlane	human
@zyraRetS	human
@JessicaEyman	human
@greensboro_nc	human
@samarottodesign	human
@EmmanuelMoi_	unknown
@oomanoot	org
@riannasymmons	human
@kimibmoore	human
@AshleyNevis	human
@partycar	human
@sor160770	human
@pleplejung	human
@jeffersonlizar	human
@efth_kalf	human
@loubelleshop	human
@sophieness15	unknown
@lewismalka	human
@abihorton	human
@Birdkagestyle	org
@Linda_Peek	human
@WM_Ali	human
@SimonaBellone	human
@SalarySharkInc	org
@kingcookdaily	human
@illyanihamid	human
@itsZulfikharS	human
@Champagnerlady_	human
@VALkao	human
@Dpk3p	org
@moharu0561	human
@stickifingers	human
@carolavalls	human
@EarthFareSAvl	org
@winniechic	human
@EatLocalSA	org
@RawSkinFood	unknown
@_kumitaku0924	human
@mcAUM	human
@iBaxxie	human
@PekingTavern	org
@santis4	human
@dRushworks	human
@IkeCrooms	human
@robsantaella	human
@Thetaste_ie	org
@BryonyChelsea	human
@DiSportsMom	human
@theBriJam	org
@GiStylinson	org
@iicmon	human
@Lachlanpub	unknown
@DessertForTwo	human
@LaVieUtrecht	human
@syunta022	unknown
@PlanteStansberr	unknown
@sarahmoomaw	human
@bacon_MINI	human
@TheTuRKiSHREBEL	human
@meganbrit	human
@LdnOntDenise	unknown
@SuperMommy_Leb	human
@MadameWeiss	human
@luthfinurzaman	human
@miceliaj	human
@ratna_herma	unknown
@Noblexperiment	org
@MIOLIofficial	human
@HennyandHealth	org
@Shellee831	human
@XAHAAX	human
@tcbnutrition	human
@lokitachikita84	human
@bardandbanker	org
@sll148	unknown
@jessicaflying	human
@MissMimiiee	unknown
@cattricardo	org
@KimMPrice	human
@ShanaDoobyDoo	human
@DukaVani	human
@carrollwoodccev	org
@LisaAgostinho	human
@lavaneradi	human
@urdreamEnzow	human
@tequierojoshua	human
@BullheadPitBeef	org
@colorsbnW	human
@b0ssLadii_mayii	human
@kat_chua	human
@German_guide	human
@Kiki_HM27	human
@shirakashiraka	human
@jacqqqq	human
@peppeirace	human
@serenabuzzano	human
@SereneTrainer	human
@sandiriana	human
@lavendellady	org
@gklogacf	human
@LucianaPatrizia	human
@alisaputra_	human
@CarrieSwan89	human
@yankidin	org
@DonLimon	human
@hndsum_dvil	unknown
@CIREx619	human
@ChelceeC	human
@KHOV_NJ	human
@gottabeagourmet	human
@Harrie_22	human
@themouse317	human
@tom91112	human
@rashonnamoore	human
@SassyMamainLA	human
@KarackObama	human
@memeG28	human
@puteradanielle	human
@jouafrika	human
@FlawLessKid	human
@fashioninablog	human
@insaaaanne	human
@BespokeBrowband	human
@PoppyMaiBrowne	human
@ProteinPantry	org
@aman_fitri	human
@johnbetelgeuse	human
@WaterCoolerCLT	org
@dhllewellyn	human
@MarleneLedi	human
@MeganBrent	human
@goldenroadpubLA	org
@SpanishRobNYC	human
@SuePowell8	human
@RushellTuggle	human
@Sterlingize	org
@ratedRjoker	human
@mfoulk50	org
@deardarlz	org
@BrandonRStaley	human
@ShirleyXiue	human
@HwanjaB88	human
@jlynnstore	unknown
@ameliomcgrath	human
@digitalshooter6	human
@texasoutlawz	human
@SobakaKusaka	unknown
@4EVAMANE	human
@CelestialHghts	human
@ThisIsNickSmith	unknown
@DJBIGBEEZY	human
@AUDIOSTACHE	org
@Josannegregory	human
@KrizMichal	human
@giulbaiocchi	human
@Eminekrkan	unknown
@BrainsNBuns	human
@fredriknael	human
@nattaya_d	unknown
@OlgaLytvyneenko	human
@Tobiusatyan	human
@piggy_choo	human
@BkProperties	org
@akopunktures	human
@SweetGrassMem	org
@anna_friebel	org
@TanCaitanya	human
@bluesapphira	human
@TrampLeeDesigns	human
@EJLouiseBarlow	human
@SelenaChloe	human
@DiG_210	human
@mistermannan	human
@alexajy	human
@PrettyRickyHyde	human
@Acme_Cafe	org
@FiREiCEAnaheim	human
@derrekhull	org
@JQueNow	human
@coachjacksons	human
@themerchantpub	org
@MissTasha021	unknown
@groggits	human
@MohdZahriSafri	human
@_ChefTWill	human
@GreatCountryPub	org
@widyestbelle	human
@sneakermania	human
@DistrictMiami	org
@JihadKitty	human
@terryfinisterre	human
@bufflunchapp	human
@nnn22_fofo	human
@JestherTheGreat	org
@annisazainalm	unknown
@OgdenSeaton	unknown
@AngeliqueKenney	human
@goldietaylor	org
@eroglutuncay	unknown
@MaziNottingHill	org
@lisettemiranda	human
@VaneJPasillas	human
@JuicyMediaGroup	org
@Oshima_Kuan	human
@sourtomyam	human
@AndersensBakery	org
@DJRICKYX978	human
@WorldDilettante	unknown
@koseitekigirl	org
@elyproducts	human
@katherinettyson	human
@Laurra_Lopez	human
@BagLadies	human
@MattiaLicciardi	human
@FamellaFerdian	human
@RobinM801	human
@aokyo	human
@DuanelG	human
@marinagalatioto	org
@carmELApavo	human
@starwoodmilan	org
@Pilar_Ohmyblog	human
@DowoSun	human
@Runningbaz	human
@armasariati	unknown
@sammymccartney	human
@stoopidgerl	unknown
@iamfromgorkha	unknown
@elproximojuego	human
@IraizIraz	human
@samm34	org
@marjanne56	human
@hnyisabelle	unknown
@gerrymandara	human
@PokemonFreeRPG	unknown
@fidheljae	org
@idtipsitaly	human
@sleatham1	human
@iambonnsai	human
@Mich3ll3On3	unknown
@carino345	human
@peg42	human
@jahzsmile	human
@barquebbq	org
@royalwindsorBXL	human
@LimerickCat	org
@alwayal	human
@MattSicotte	unknown
@whoisRashi	human
@ANNEtonovxxx	unknown
@eyeseeeuphoria	human
@smartmobileec	human
@MackyMacatiag	human
@SEExiong	human
@Yung_MoneyChris	unknown
@plbytne	human
@shutterbug316	human
@dawntho04497160	human
@CPT_Journal	org
@JadeLikeaboss	human
@TheJydohn	unknown
@bangkokian	human
@djchrisruelas	human
@IBNutrition	org
@kaf_loli	human
@andyallegory	unknown
@pennethornes	org
@BeansTheWhippet	human
@canadianTML	human
@Parkshore_Grill	org
@bwarsh91	org
@Wong_Li_Xien	org
@thanaratkakhao	human
@Tajaid	human
@Darling_Sabrina	org
@luckysandwichco	org
@liqingchow	human
@SarahLindseyDay	human
@RickyKaizers	human
@summerysk	human
@WillliamCWL	org
@2254Restaurant	human
@versatilityrnj	human
@joeycleeyuee	unknown
@La_Suazo	human
@b_katlen	human
@MiComidaExPty	human
@BigGreenEggUK	org
@healthybluebird	org
@itsRyanHilton	human
@WinnieC21	human
@asoulfultwist	human
@almasgemelas73	human
@freeformdeform	human
@Scheiwijk	human
@toothmvr	unknown
@SaboreaMielyCan	human
@NHVFood	human
@sricola	human
@markleong	human
@BecompetitivFit	human
@LunaCalante_EM	human
@ashleyrdtx	human
@StyleDetails	org
@LauraMatovina	human
@billyjoepascual	human
@trendinaliaUS	human
@manachaan0810	human
@sina_rody	unknown
@Vinna96_	human
@mnc148	org
@FredyFilms	org
@Nenad_24fit	human
@leblogdenono	human
@LHeartsSwift	human
@theonewkwonder	unknown
@linapiano	human
@HurricanePL	human
@dj_cena	human
@jepoyabadier	human
@BuenaVidaCoach	unknown
@jodany77	human
@luluen97	human
@Billiealbar	org
@LuckMedia	org
@Chyateezzy	org
@Amanda_Burrill	human
@CeeGu3rra03	human
@HarryNarvaez	human
@TiffanyRidler	unknown
@itsmaxfit	human
@msmabes	human
@rebbecapib53	human
@BlueNinja3	human
@CorProgression	org
@rvjan2	human
@mirabeauwine	org
@mylitllepie	human
@GOrozcoJr	org
@Parse_ir	human
@nine_pro	org
@TiffanyJManager	human
@Donavanchua	org
@MonicaLauriola	human
@TheJaseYANG	human
@arepaculturenc	org
@MrSpike81	human
@shylovemea	human
@chin80	org
@BenBrooks2309	unknown
@YanitNit	human
@IamMlleParker	human
@LizSingZ4U	human
@reelmama	org
@Jessica_Poulain	human
@srutihari	human
@I_am_Succeeding	human
@achonk_zhalim	org
@UglyBish68	unknown
@sabendschein	human
@nerdska	unknown
@FoodAllergyGal	human
@Kessol	unknown
@secrtsfrmyapron	human
@marinemama06	org
@MichelleyC05	human
@theastorhotel	human
@SamThePrettyOne	unknown
@Fairplex	org
@DC_OpenHouse	org
@chefray69	human
@yyo0305	human
@jnrchefs	org
@123stella30manu	human
@marco_petrarca	human
@ElJavis69	human
@GaslampQuarter	org
@s314756391	human
@DurhamTravelca	org
@masaxjp	human
@feastnyc	org
@CMarangado	human
@jalisasfiles	unknown
@BecksZald	human
@leeleechicago	human
@SUPERGiRL2U2D	human
@HarishVangara	human
@Talya	human
@80PlusAccounts	unknown
@wilsonabula	human
@AletaStewart	human
@aztechbilly	human
@KNXFitness	human
@CedGerv	human
@Ali_Blankinship	human
@Do210	human
@Mom254321	human
@LostLaurenn	unknown
@superburgertj	human
@VladiBenavides_	human
@RoxyMandy	human
@Dandelion0Blue	human
@KarleneTillett	human
@Leoromen	unknown
@worldlove1997	org
@namikabbasov	human
@ctl_dinh	human
@GiovaneseID	org
@VeronicaMederos	human
@wesley0711	human
@zero00107	human
@Jennat0104	human
@DealOfTheDay57	human
@01divyasharma	human
@AlaaDak	human
@youmakemeswoon	unknown
@mphotographer	human
@MissIgoraEvol	human
@fanniemayalba	unknown
@oskarh73	human
@TheNishatHotel	org
@jubelregmadiun	human
@wheresbrentbeen	human
@ly781219	human
@KatRose_NYC	human
@realdopechic	human
@hellosamo	human
@johnoneil1978	human
@cindylou_14	human
@ardiantnd	human
@izuntan	human
@mdemiguel82	human
@megg1ee_m	org
@KevinHawkinsDC	human
@missjover	human
@WordsPaintPic	org
@odieseyes	org
@MaudeWendi	unknown
@Rainey808	human
@lucindalocket26	human
@SligoHour	org
@e2ek1elfire	human
@matmazelnpncrsi	human
@HHaiderMuhammad	human
@NewImgeCleaners	human
@EmyLafontaine1	human
@SnackElChef	human
@vitor__amorim	human
@decentpurposal	human
@Janneke83	human
@Arielblair5	human
@Nila_Aprilasari	human
@nathanc	human
@Athena1ove	human
@NatiNWT	human
@nannymatchLA	human
@HickmanAmelia	human
@PurpDurp	human
@aswinlutchanah	human
@akkoron0326	unknown
@colt114	human
@YakuzaSushiLA	org
@DavidBesharat	human
@JerseyOkie	human
@crazyloufaa	org
@andjanizella	human
@inhouseideas	human
@JudeOuvrard	human
@SamuelReyDJ	human
@Rexzy_	human
@kcmayo17	human
@alison_fischer	human
@lukalang	human
@BrunoKnightXXX	human
@reneefok	human
@CookBakeSmile	org
@JamesSweeneyIII	human
@MiNombreEsMaca	human
@the_chadd	human
@juliomas1107	human
@DanielEscobr	human
@granddarmosuite	org
@Alegnocca	human
@marciprester	human
@Katherine_Jovel	human
@TPCreamery	org
@MonikaDixonPR	human
@vinzfromturin	human
@starry_jan	unknown
@SalmaAlnajem	human
@HolmenMeatLockr	org
@Phooj	human
@rgrierson	human
@Dr_Crystal_ND	human
@Leolovelin	human
@GunmanThe	human
@RialtoConcierge	org
@Gabefu7	human
@ChiaraMosti	human
@JopzNiedo	unknown
@PerolasB	unknown
@welsahn	human
@christipark	org
@Pleasng_me	human
@kunalashah	human
@kel02100	human
@JustLikeFallon	human
@istokkers	human
@Cillan88	human
@FrenchGuyCookin	human
@INTLbolton	org
@marbella_vips	human
@stylesprinter	human
@popsfishnchips	org
@ncnf_4_artwork	human
@Jennifer_evil	human
@PuloCuisine	org
@Adeline_kayhui	human
@FoodEGGcellence	org
@Jangogirlbu	unknown
@VintageContessa	org
@danabaneyney	human
@TheOriginalLuXe	human
@GretelPalacios	human
@aisyahkahar	human
@rachelcolombo_	human
@flannelsfashion	org
@DanielCH13	human
@3_6_0_	human
@CdnBcnOakville	unknown
@ponkotsu_izumin	human
@BuddigLunchClub	org
@ellaineskie	human
@whisperlovetome	org
@peiggeboo	human
@ayapusss	human
@Ningzaa	human
@clairesearles	unknown
@Zac_That_Lad95	human
@Kengerlinskaya	human
@jaimiebeebe	human
@castorvoyageur	human
@RightBeats	human
@jinkyniace	unknown
@leiav	human
@wal_ism	human
@RamadaEncoreBol	human
@MindofGabrielle	human
@prettypoodle90	human
@ChicMusings1	org
@ajengistyarini	human
@myskinnydrink	org
@skynace	human
@HisC23	unknown
@A_M_Gharbi	human
@JakeLX	org
@Events_Niagara	org
@CindyLeeKelly3	human
@ThicknThinBlog	human
@craftaliciousme	human
@MADAME_SOUSOU	org
@NaturalSins	org
@PhoebeWatkins	human
@sheeeqeeen	human
@vichanhuang	human
@LemyKing	unknown
@lisavoc	human
@JaywhiteJ	human
@kalipaykaibigan	human
@AuntNellies	org
@catskillprovs	org
@priskaa9	human
@etlifestyle_web	org
@toyibtirta	human
@Ironstationbk	human
@Japati2015	human
@honzik1322	human
@kristenlew777	human
@NeuvooSeattle	org
@GardenCakesInc	org
@jennrhyu	human
@sweetaleblog	human
@ABxx913_CBS	org
@Phillip_OnU937	human
@little_meiss	human
@rudeboi8806	human
@MatthewLiberty	human
@WorshipBlues	org
@AhiaOnline	org
@infusion_health	org
@Soii_Chan	human
@KiMrEiD95	human
@HiThereItsBecca	human
@Pixie_Peach	org
@sheLoVic	human
@nu_maida	human
@cathylaughery92	human
@caitpatch	human
@RaineBrookes	human
@benomix	human
@kylezzero	human
@cookingl4u	unknown
@CarleySWTakeley	human
@BlaccAllOva	human
@XPOZHER	org
@NoviaAngelina	human
@jxscole	unknown
@jenniferiux	human
@styledrifter	human
@Jack_Vlogs	human
@AnneliePopPhoto	human
@AViqqui	human
@thedensecuisine	org
@FollieRouge	human
@nanehadeli	human
@desertroseauh	human
@DblTreeDelMar	org
@CristinaArce	human
@CherrelleRowe	human
@thepoeticzombie	org
@Barbekuya	org
@khadijahjasni	unknown
@evergreendishes	human
@abdo_mehri	human
@dietitian_jess	human
@LyrroRobles	unknown
@JobsForContract	human
@azoobloodlust	human
@VacationDereks	human
@TagMichAmArsch	human
@Ten8Round	unknown
@djeugeneus	human
@deanescranmore	human
@s__Justmusic89	human
@kajang27	unknown
@DeveeBlaster	human
@Kultbert	human
@darck_angelivy	human
@shrinkingjeans	org
@Dilyana	human
@nety_aniez	human
@Eagleeye47	human
@tastedorchester	human
@gleekshiori	human
@horseguardsLDN	org
@tsught	human
@WineTigella	human
@Jbasil012	human
@achai_effendy	human
@No101_India	human
@Poojaanita	human
@LothianLoop	org
@iamAVER	human
@ayaka_sally	human
@MakobiMedia	human
@ellyna_ali	human
@vdarnelthomas	human
@HayleySoo	human
@London_Bea	human
@SibnavusFrancis	org
@tipandsipcafe	org
@ishisevilla	human
@Silvanabfer	human
@DiagneyGuarenas	human
@bmvaughn	human
@savioursnacks	org
@gigih_himawan	human
@OneFoldDenver	org
@z0hdp	human
@konstanze_fiel	human
@cleangourmet	org
@iamDICKENSON	human
@CookerySavant	human
@hyuklatte	unknown
@BasilaVegaffair	human
@AlfredLn	org
@edo_daniele	human
@gochang	human
@ronaldsipahutar	human
@topluyemek	human
@alexvoncanisius	human
@mariaxjapan	human
@friartucksresta	unknown
@Dawnalees	human
@Headchef	human
@marie_26ers	unknown
@vickyfarrell	human
@MattiaLombardi	human
@luckystrikesoho	org
@She_Baked	human
@PotLook	unknown
@BadmaashLA	human
@Grillight	org
@joannarobbx	unknown
@EbrahimHammadd	human
@fatbottomgrrrl	unknown
@Lore_gutierrez	unknown
@enricobianco	human
@buzzing_trends	unknown
@CornerCoffee	org
@elige_elige	human
@XiMeNaMuNozSDA	human
@vchtrasogan8	human
@AndreiDeulofeu	human
@SalsFamilyPizza	org
@MzGucciP	human
@timetochao	human
@MisDaMina617	human
@imaay_z	unknown
@JeanClaudette	human
@CherylFlowersx	human
@unniwww	human
@CltAquatics	org
@Cafe11onmain	human
@LiviasWorld	human
@collinschristof	human
@djmissteo	human
@largeyxx	unknown
@hnwen	human
@Steak_Southall	org
@Karen2105	human
@GlsrenGnes	human
@ShareeBCJ	human
@NaokiAjikata	human
@julia_manao	human
@aldrich4dastars	unknown
@NoYinKatie	human
@masrdz_	unknown
@MelisaGroser	human
@7thheavenmama	org
@hyperren	human
@JenniferVagios	org
@mariedesouzaxx	human
@rodgerlodgepole	human
@MattTheList	human
@Vee_Up	unknown
@ikummmin32	unknown
@thomaswnance	human
@Burrosbarpv	org
@Obela_Mx	human
@winesbycase	org
@Maantje1208	human
@DaSuperfanss	human
@_NOLAchef	human
@JordanGrainger1	human
@Shyanne_22	unknown
@BeybehJeyms	human
@ObieeeAdaaa	unknown
@marigarce_95	human
@FELIPESwichita	org
@MyrickHaley1	unknown
@MagicCarmel	org
@Nurisushi	human
@1LOMITZ	human
@_Auntie_Zee_	human
@msmarciaolivia	human
@stonehocker	human
@MrsHillermann	human
@ItsCherrie	human
@DulceriaDeXime	human
@thechefinpearls	human
@Phuiwyai97	human
@Naomie_Potvin	human
@arlenefay22	human
@RadRich1	unknown
@DhoreenAzul	human
@patchi888	human
@mariancaru	human
@nastya_yummy	human
@lovejoypeace9	human
@kzendrian	human
@MMathewC	human
@MixFashionWorld	human
@mbonfiglio	human
@GanezVi	human
@BastrikDorianGr	human
@fbrownebooks	org
@miadelatorre	human
@fikaleiva	org
@locdecreek	org
@pelayoscar	human
@MsShanBo	human
@BlueGooseInn	org
@be_alive	human
@LaetitiaPelch	human
@TerryMaggert	human
@Eat_Your_Veg	human
@27Margot	human
@masayuki_1012	human
@domobramantyo	human
@cynthspr	unknown
@emmawestchester	human
@carolynlb	org
@3alyaa_	org
@HZRMJD	human
@MonicaJayNYC	human
@AlejandroGocast	human
@YukihanaSmile	human
@AbyshLopez	human
@0228_Blanc	unknown
@AhemedEzzat	human
@rufar	human
@ClairesPress	org
@TakenBy_Life	human
@FruuglFulham	org
@perolaseassim	human
@Cookwizme	unknown
@cococamiblog	human
@ForkSocialLab	org
@cjgalaway	human
@ginaelena19	human
@TasteSBFT	org
@officialSF13	human
@Texas_Babe13	human
@wollongong_nsw	human
@MalaineGill	human
@BodyBagus	human
@rachaelrox2	org
@umangoswal	human
@SonGoten92	org
@SerWeiner	human
@backstagesonia	unknown
@tashamunch	human
@heyohmyleydii	unknown
@ashasuparna	human
@uevosinsal	human
@MISSONEHUNNIT	human
@MaherGoode	unknown
@mrchin	org
@Paolo_Fajardo	org
@NH_Hoteles	unknown
@raaccountants	org
@kcobainsvoice	human
@0lv3J_tam3tu	human
@jealicious21	human
@ODeckRestosurlo	org
@ReformerP2u	human
@Mr_EmC	human
@shaunnabma73	org
@may_0501	human
@CocoWillow1	org
@sherylbest	human
@EnLightninged	human
@jenjacqs	human
@MartinaConors	unknown
@charly9118	human
@_pamelazs	human
@chachabasket	human
@Linda_Villanti	human
@Au_Fil_d_Isa	human
@adgeralexter	human
@chloee1957	human
@KimchiCouple	human
@metalikhao	human
@CornicheBandra	org
@discoveralbany	human
@areyelle	human
@KawaiArisa	human
@kaidrama	human
@chanelsu	human
@DnBLines	org
@JohnnysOther	human
@ksiebel	human
@rini2389	human
@anuraagkumar	human
@Candacevandell	human
@2B_MACKnificent	human
@cateringCG	human
@TastyPlan	human
@hotvideoja	human
@LeBruhJames	human
@kaykhoon	human
@peterwatches	human
@PrettyHotPink6	human
@1BBclub	human
@Race_TiN	human
@ReGiNAakaJAZZY	human
@LaRaquela	human
@AprilGraffRD	human
@nicolet93901	human
@juewern	human
@Renyka	human
@Sharanyashettyy	human
@VinaHale	human
@NeuvooStPaulMN	org
@BreeBerryQuack	human
@jenniferblancb	human
@Always_Judging	human
@audiopiff	human
@LipstickedBitch	human
@AbiDermawan	unknown
@AURAVictoria	org
@ericarobinette	human
@jesskemp	org
@followaofashion	human
@ROSHAYSTARR	human
@Mahesha_RJ	human
@MarriottPC	org
@souvlakitruck	org
@AbelandCole	org
@Edg_ho	org
@multi4orce	human
@AllawayDeanna	human
@BBillieJ	human
@CWWblog	org
@Dadyougeek	human
@pioneerfitness7	human
@StarCrownVow	human
@JoannaFantozzi	human
@KhushbooThadani	human
@TSand83	org
@jdelavegs	human
@CultureTripMel	org
@Ginaleja	org
@AliciaLouise987	human
@elieciaatkinson	human
@sprtytse21	human
@BogsBellen	human
@ajii_malik99	human
@14lucyb	org
@WFM_Melrose	org
@BiTuTamTuz	human
@LacreshaHoggle	human
@Food2Fork	org
@153grover	human
@thefresh20	org
@Too_SnazZy	human
@thyy_c	human
@emilyglutenfree	org
@ChiomaOphelia	human
@yejinkim	human
@PhilEagles4ever	unknown
@EnnaModa7	unknown
@RosiesKitchenfr	human
@TinRoofBMore	org
@Toasty75	unknown
@nenenpil	human
@EllaKwonnie	human
@LAF3055	human
@akosishutterbug	human
@Yenrav_Vinny	human
@823jelly	human
@Griffith1993	human
@RealKylePage	human
@jessyehipp	human
@lilneezy86	human
@IRWINRIZKI2	human
@omir_SWIZZIE	human
@SimoneSCapeTown	human
@trejo0258777777	human
@elysadesy	unknown
@MakeUpandBlush	unknown
@Kenyihzo23	human
@JJ_9999	human
@yagizoo	human
@xrbo	unknown
@Samiratastic	unknown
@em_milu	human
@RainBautista	human
@DeterminedDiner	human
@mia0227	human
@Chapusolis	org
@moreaboutpeople	unknown
@MizzOby	human
@Binalot	human
@VictoriaRA7	human
@zaty264	human
@itsthirdy	unknown
@taufiqhelios	human
@Tellie_Edworthy	human
@Yulia_Sv	human
@myartisticbliss	human
@thehotelsphere	human
@sorahn_ibrahim	human
@rubylane	org
@CleoTobbi	human
@mori777	human
@RandomCheryl	human
@olinsetiawan	human
@DSouza_Tina	human
@MissSophMag	unknown
@TDHBrussels	org
@IamTorriJ	human
@Timi_Saimons	human
@TLCINOfficial	org
@DjayyCharliee	human
@JewtasticJems	human
@NightOwl_ATX	org
@djHitmanRocks	org
@AleGBetancourth	human
@WhiteElephantME	human
@yatteyaruze	human
@olapaulakoski	human
@145ishiko	human
@DianeIsAsian	unknown
@gsyella	human
@throwback42	human
@MagicMarcusW	human
@londly	human
@Joniel_Music	human
@MSGUBOT	human
@amybleech	human
@lepapillongris	human
@secretmaggiemay	human
@tweet_pt	human
@ykc10000	human
@RecetasMercedes	human
@smittenkittens1	human
@cerurode	human
@cheungways	human
@mediinaas	unknown
@sammy_foodie	org
@PlasticSurgNJ	org
@wontstand4it	human
@ChetrineTan	human
@5122262	human
@bekaldariibu	human
@beluu_ferreira	human
@KelliPitrone	human
@atowers84	human
@rani_grazioso	human
@LadyBlahBlah71	unknown
@Manwinkaur	org
@thesocialaffair	org
@aimeelee1207	human
@RoseAndCrownGH	unknown
@RealSledgrenSis	human
@DolceVivo	human
@iamjai_	human
@CarolinaRuan1	human
@mypurpledahlia	human
@nuts4co2	unknown
@YogiYousef	org
@PanierLanguedoc	org
@ahkieko1991	org
@danihefter	unknown
@FabioPernicano	human
@OrganicFarmGuy	unknown
@iamJHANiiiNE	unknown
@ashleymead	human
@RazzleStardust	human
@Makolasor	human
@deonbenito	org
@sinance	human
@mymonkfish	org
@merriee_sarah	human
@WeightsOver	human
@dhayoradenrele	human
@justmaita	org
@RivieraMama	org
@AliceMcCosh	human
@GuideGlutenFree	unknown
@55Hamyoko	org
@ChiaCheese	human
@WhatMeegan	human
@pat_phatreeya	human
@thejerryheil	org
@MosesSoto	human
@Hojamarais	org
@taifunn	human
@KNJL_	human
@LittlemRX	human
@PsychicDecision	human
@MichaelBisMe	human
@mundoverdesg	human
@VegasFoodWine	human
@rxsquare	human
@SUZANNECARDONA	human
@thebroslife_com	human
@cocoSTAT	human
@daddytimmers	human
@pach028	human
@RN3124	human
@carrieholistic	human
@SamanthaRoars	human
@hanssusanto	unknown
@corneliselander	human
@Eleo_Valentini	human
@vikkiferran	unknown
@MonicaWang_55	human
@teenagefruitbat	human
@rockiehopper	human
@gardkarlsen	human
@PradnyaNanda	human
@leenathequeena	human
@emilia_besi	human
@3sh_02	human
@grippadoe	human
@DelRio_Perla	org
@ReNellGlover	human
@dandelosreyes	unknown
@drkarmon	org
@xoSoleil	human
@JaymeeAsuncion	human
@nerdybethtx	human
@CuzzoSlimm	human
@deefebree	human
@steveendranata	org
@AlhenaSmile	human
@RHF_PTraining	human
@SNaughts	human
@theBANKABLE	org
@BryanOci	unknown
@ConsuellaLopez	human
@JiaSinzxc	human
@annekaboardman	human
@ClairLatin	unknown
@mhenderson33	org
@TxChiliQueens	human
@onekif	human
@SugarBurg	org
@_lostinflorence	human
@PanChancho	org
@BattlingCandida	unknown
@MissEsraa2	human
@tompalladioink	human
@sarahlar	org
@_NicoletteW_	human
@heyitsannyo	human
@Pachsita_Sita	human
@MarceloH6	unknown
@VhonChon	org
@TheCookhouse	org
@paprikaangel	human
@ayanne08	human
@MrChrisAguilar	human
@Rrritaa_Scumita	human
@VanessaAzedo	unknown
@DeathAve	org
@OnTheBoxLIVE	human
@J_Winston17	human
@CookingJar	human
@groundhogcafe	org
@nimsfruitcrisps	org
@DEClarke85	org
@WTCArnhem	human
@KoloaRumCompany	unknown
@Richardisonline	human
@AmiaEstella	unknown
@manofmedicine	human
@rena_t	human
@DubFaceKiller	unknown
@raketrendy	human
@minialagnu	human
@VivaStrawb	org
@boulevardcollec	unknown
@Francesc_ahhh	human
@CaptainCarLdn	human
@NoemisMexican	org
@Tweet_trus	org
@8DEPPOBO	human
@yumyum0112	human
@robsforman	org
@nycallday247	org
@gpoovan	human
@ticketexpressin	org
@adri17rojas	human
@ilyeslass	human
@MasseriaLa	human
@Novia_Dwis	human
@bokutasu3sanme	unknown
@Dana4639	human
@PetitsFoursCPT	org
@Krystina_Lynne	human
@LiatTsarfati	unknown
@VitoSpata	human
@Simpleware	human
@CPTSA1BARBER	human
@breadmanmiami	human
@SuperStar_Ky	human
@Saifulsulong	unknown
@PeterBreslow	human
@juan_manrique	human
@ShigeoWoo	human
@JessicaSilva_98	human
@noommer	human
@CruelValentine	human
@WFMBedford	org
@QArcadeLeeds	org
@syah8879	human
@chika_fukui	human
@Mrs_SullivanCT	human
@Christina_Koran	human
@aieghcee	human
@PKPika89	human
@LacieLoveHester	org
@kris10joyRN	human
@murtaza_agha	human
@craftsmanwolves	org
@rnbbebemiapot	human
@kurumi0321	human
@ImLovinMe4me	human
@IHLbyZee	org
@ataoglutilbe	unknown
@WorkDeepEllum	human
@korul_fakhrul	unknown
@hendrixdubstep	human
@CouponCabin	org
@tylers4jesus	human
@recyclemyname	org
@aochoco723	unknown
@renai_n48UP	unknown
@jakeandmaya	human
@KhooGuoJie	unknown
@TattFReak_KiTTY	human
@MariCenti	human
@jepay2	unknown
@VanityRoxane	human
@FebeFlorencia	org
@nikilouify	human
@Naturalycracked	human
@DLishCurbside	human
@dgreenplumber17	org
@ParadiseRescued	org
@WillyStywn	org
@riddaf	org
@5OutOf5food	human
@tejchahal	human
@gratefulgrazer	human
@adindaMsari	human
@Alexandriaaaa_R	human
@ninatascon	unknown
@Chef_A_Benjamin	human
@3ShipAngles	unknown
@SpringLeshiek	human
@Zufik_ita	human
@Pheifenn	human
@pachamama_ldn	org
@PlymouthHealthy	human
@japnamk	human
@thekoreandragon	human
@iamsantelmo	human
@AinesFlynn	human
@MyBariatricLife	human
@ESFitnessGroup	human
@foodfortina	human
@regend	human
@WillAEllis	human
@ahsamkor	human
@LaPetiteMaisonH	human
@jaysica	human
@Cheria_13	human
@sseymaerkan	unknown
@YkeeQii	org
@3dprmarketing	human
@Makeup4all	human
@HoBrahTaco	human
@BouclesLa	human
@louisechelle	human
@55evi	org
@heeeybeee	human
@paulabassa	human
@EyqaLi	unknown
@mattydeathbro	unknown
@jussizzz	human
@FSB_Bath	org
@helenaholic	human
@abinaderjulie	unknown
@SouthnPurpleVeg	human
@OsQiitar	human
@mkmnloooove	human
@Nathyta1205	org
@Tiffanyann86	human
@RhodoraTomcat	human
@ECWJR601	human
@pastoralwin	human
@555Shanice	human
@mnyn718	human
@RainieroVentura	human
@shilohguevarra	human
@findNicolehere	human
@gio__man	human
@CheckLittle	human
@fleurtini72	human
@eraahroses	human
@BonitaShintaa	human
@PalinaPralina	human
@ari_MiGa	org
@KingBasilio	human
@natalialiezty	unknown
@shee_LV	human
@MrCuit	human
@Betsy_sutanto	human
@isangblacktupa	human
@TheGoodista	human
@Stailista	human
@theclover28	human
@TiffsUnionNJ	human
@cheltee2tan	unknown
@ibryant20	human
@HayleeHatcher	human
@antonipyo	human
@Mersadiesheart	human
@ilcounican80	human
@ElyaHowat	human
@jamakeupartist	human
@soulfulwellness	org
@KellyBMUA	human
@Ernesse20	human
@jessyfanpage	org
@ritylensia	human
@jsypartybooth	human
@US_Oasis	unknown
@SerinaTachibana	human
@LauraB_London	human
@BaronElwin	unknown
@sweetbynaturecg	human
@_lamoz	human
@acmgb1	human
@_erinkayleigh	human
@ImtiazMaster	unknown
@HamletHubRidge	human
@Ontheryeblog	unknown
@LucquesLA	org
@MervDM	human
@jeshleyivy	human
@Loiselsie123	human
@anacadenamakeup	unknown
@sonjiacalit	human
@styleHEXE	unknown
@SBinLondon	org
@SophiiaRosee	human
@styneonwine	human
@Route66oman	human
@bakery_victoria	org
@veraalyanna	human
@itsmis_she	human
@CelestinoOnLake	org
@FreckleMonster2	human
@nicjaakob	org
@_AsiaJ	human
@jembie	human
@LowMaggie	human
@vi_petracco	human
@AlbertsonsWY	unknown
@k_0804_h	unknown
@Melbling16	human
@DANNY_DEFREITAS	human
@aplussizedgirl	human
@_deysemelo	unknown
@golfweimar	human
@travelspeed29	human
@DunesAbuja	human
@Ophelia_Signore	human
@elitecatering4u	org
@cherylslife67	human
@JaysonRemoroza	unknown
@reepicheep75	human
@KevinHsuSA	human
@stikabudapest	human
@TattyanKardash	unknown
@somethingsnacks	org
@asyrafibrahim	human
@mainstage411	org
@koreabox_korea	org
@Alannax_X	human
@other_aSHst	unknown
@lbuss	human
@DropFiftyFast	human
@CristianCao89	human
@McEvansThomas	unknown
@elissawinata	human
@visrecepten	human
@BdeliciousByou	human
@mwhyradio	org
@DailyFoodnWine	org
@kels_yoki	human
@Emma_Cattell_	human
@H_Orlandi	human
@Charlotte_PCE	human
@tezzer57	human
@GuidedFitness	org
@sisca_sh	human
@Suresh6	human
@tapalaya	org
@riccardopastore	human
@robsonandy	human
@food_bloc	human
@andrewarbo	human
@Poseidon0000	unknown
@Foodtiq	unknown
@SolCuisine	org
@mayasphere	human
@dushnivi	human
@RaphaellaFig	human
@ThatTambar	human
@robbatts	human
@fififeelingnew	human
@skottmarsi	org
@Grachyelaa	human
@CoachEric247	human
@TheTadaGroup	human
@yuanitaagata	human
@12abbiToSCM	human
@_makersmarket	human
@Vusiwe_M	human
@ThaTwins	org
@dessyAF	human
@DXBFoodFest	unknown
@ClaretCafeTulsa	org
@andry_tan	human
@MERCURY0325	human
@musicforfoodies	org
@SnowinRI	human
@wileyminami	org
@SillyGillyFun	human
@djSexiiiFlo	unknown
@foodwinephotos	human
@wusa9	org
@Stoneaston_park	org
@SarahGoreReeves	human
@simplyhoney_fmq	human
@tiamcbay	human
@renancampelo	human
@jaytheman44	human
@TREnoY	org
@reunionplanner	human
@Puntoboy	human
@farajiha2	human
@DavidMSandoval	human
@tomoko_1212	human
@dariust79	human
@a_uste	human
@elegantjoy	human
@TheLizMartins	human
@CrazyCowEvents	org
@CornerMagLondon	org
@Pi_Pew	org
@jeff_labelle	human
@nuttadej	human
@Philip9010	human
@prettyxcool	human
@DonnaMartiin	human
@Middy_Middy	org
@ZachGFrancis	human
@iamKarya	human
@denglong	human
@satsu_ks	human
@sirion73	human
@FayBurmingham	human
@ZyZiMakeup	human
@JoseS125	org
@ReeBonnySA	human
@Tomles	human
@SweetFreedom	org
@TalkSportTV	org
@ajmansaray	human
@Misterl2010	human
@SocalSessions	org
@Claudia_N24	unknown
@Icemanjhb	human
@BeardEnvyBarber	human
@CherishDWF	unknown
@whitleygilbert2	human
@fredrickafonta	human
@kogigdgds	human
@beachside_rb	human
@SeasonedVegan	org
@LaShenny21	human
@JudyLala2013	human
@_Missesviolet_	human
@HealthyFoodHH	unknown
@LonelyBoyArtist	human
@kristoferspyrou	unknown
@Dion_San	human
@hhwitz	human
@MsDCharice	human
@DeafMansBBQ	org
@Denise91109	human
@Ottawalimousine	human
@manzorob	human
@mothofgandalf	unknown
@Knotda1	human
@jeanna_lopez	human
@cosmetic_candy	human
@ModernishLife	human
@RMGBrand2Light	org
@pondypopps	human
@ayuhidayu	human
@rimalinda	human
@windha_yuristi	unknown
@duwicmedalla	human
@nicole_amand	human
@KishkiWorldFood	human
@teresita316	human
@haanuholuwarpor	human
@NomaHummy	human
@Getrealluxpart	org
@RestoLaurea	org
@mesh_antony	human
@LyonHall	human
@spectre_silence	human
@Mlle_JASGirl	human
@MayoHour	org
@OLPAEMI	human
@firkinonking	human
@jpcolmenero	human
@Musicjones59	human
@bluebirdchelsea	org
@RavneetK	human
@OpenBookstv	unknown
@bisma_shk	human
@NutritionEdBC	org
@roseannlao	human
@ledeucedeuce	human
@thesirenofangel	human
@Kazzy11	human
@ocha_amel	org
@NurseKarling	org
@amancuso604	human
@carynkaining	human
@spiffykerms	human
@Nienke_Benson	human
@smart_not_hard	human
@gatterwe	human
@Marcuswareing	human
@talal4548	human
@LeMarlyPantry	unknown
@Shana90n	human
@nicolaricolaa	org
@WestThirdStreet	org
@Minnie21Marya	human
@kreal	human
@Sabrinaa95	human
@kiwi0907	human
@capucinno_lee	human
@MargaretMagdaB	human
@ilona_selina	human
@A3aseerManga	unknown
@charlesbunag03	human
@Boatelboat	org
@sushantsanzgiri	human
@sasiferraris	human
@CupsOfTheXo	unknown
@GimnoFilia	human
@anninhemp	human
@Lau_Jen2012	unknown
@switberi	human
@Cloopeccable	human
@Angel_teddy99	org
@Earny49	human
@exasora	unknown
@MyInfo44674660	unknown
@AlexPolianskaia	human
@semonzzz	human
@LalynAlly	human
@IndochineNYC	org
@notperfectbutcl	human
@MitreGreenwich	human
@danialariffx	org
@JamesEtches	human
@leoq00	human
@xNachumix	org
@rapppp	human
@kidREMINISCE	human
@FencesFlowers	org
@robertamittman	human
@itsajacalmdown	unknown
@Wrdnzr	human
@rfl_03	human
@emg_photography	human
@DocsMontage	unknown
@HeadrickSpearma	unknown
@MissChell22	human
@MississippiRT	human
@ElPatioBistro	unknown
@stivenH00	org
@JonsCrazyTweets	org
@SaloOomazz	human
@myMhiKz	unknown
@wellbalancedbod	human
@RHernandezNY	org
@andromedakilled	human
@theclareljones	human
@CriticalEaters	org
@burgers56	human
@OdMoisesr	human
@Nathan1287	human
@DebraHall1961	human
@seraphitashop	org
@elebites	human
@mi2xxx87	human
@lilepr	human
@Rasorblade	human
@alfrescord	human
@Coy_YeoBo	unknown
@ianalexander218	human
@fateeninnanie	human
@BlackGentry	unknown
@wulan_itsme	human
@GrandHyattAmm	org
@btc5132	human
@VieiraGirl	human
@callmeCalves	human
@Meet_Me_Out	org
@Ralphabet	human
@Amalinss	human
@EZolboo	human
@Tia598	org
@Lowdly_blood	org
@taylorswiftpops	unknown
@BlueStovePie	org
@bendan_lui	unknown
@magnolialala	org
@mitadav	human
@ForagerMobile	human
@TryinEverything	unknown
@YukMiu	human
@CantinaFrisco	human
@RicRocstarr	unknown
@TMetcalf44	human
@mes0_0	human
@DanijelaMJ	unknown
@Manc80BeersBar	unknown
@StellaMagazine	org
@DealCentralAndC	unknown
@SecondaBase	human
@littlejeei	org
@chana_jor_garam	human
@LydCanScream	org
@BebbiitahLiinda	unknown
@stephmazzoni	human
@homemadefoodLK	org
@bestfoodboston	org
@CallOfBeautyIta	human
@semisweetsister	human
@Lightlife	org
@EquinoxJazz	unknown
@Barstoolliving	human
@alfonsoNcruz	human
@jedannah	unknown
@CarltonCannes	human
@dionnevanders	unknown
@fowgre	human
@adonaiagatha	unknown
@MorganMelnyk	human
@FredFlnt	human
@MarcNarrow	human
@brascosback08	org
@nijiiroyukio	human
@KGLaLaLandMommy	human
@hannahsview	human
@MichaelButlerSr	org
@MichaelFLyons	human
@mfpar	org
@Stlouislondon	human
@EmpressOfDrac	unknown
@JullyEspelho	human
@GypsyBlue13	human
@Stacy_SCM	unknown
@agusmeteor	human
@ana_calli	human
@Miss_Nyss	org
@HashedFoodie	org
@averagebetty	human
@LarkinYogaTV	human
@naideiacom	human
@JackieJaronczyk	human
@culinaryveg	org
@princesshoper	human
@DeliduApp	human
@casacordoba_usa	org
@MsMirely	human
@ooooyukinkooooo	human
@PilisStyle	human
@SayFishTaco	org
@FBarabinoMercy	human
@trongle91	human
@citylimits3	human
@lady_thirty	human
@LittleneckBK	org
@sugacanepimp	human
@Akash_Jiawan	unknown
@sweetishann	human
@LeMeridienauh	org
@gracia_mochi	org
@CHowIDo	unknown
@shericeajifu	human
@fsareini	org
@aimeerickard	human
@triplenickle29	human
@AWkwrdHippie	unknown
@TrumpToronto	org
@MissNannyLake	human
@Maci_S	human
@allan_jefferson	human
@nonxxxSs	human
@StanmerHouse	org
@angelamccleary	org
@JqLeeJq	human
@TanyaHaChi	human
@lynnkimdo	human
@SaludFitnessBar	unknown
@JulieAMaio	human
@juliyjuanMX	org
@kissyonline	unknown
@BMFUAE	org
@Dionnycontreras	human
@ThMellowYellow	human
@FabianGaLo	human
@AldiMiret	human
@RogerbRagazzi	human
@fliphospitality	org
@leabotteron	human
@caffehopper	human
@luigivco	human
@truedax	human
@ginamariana	human
@AhmedDirie	org
@Pachy_alvarez	unknown
@RachemPixie	human
@theribman	human
@oflynnssausages	org
@joss_mooney	human
@Mookeybaby1	human
@Alex_Cresswell	org
@AnggitDiaz	unknown
@Godgeez	org
@RyKeo_Ri	org
@AUAUAUXXX	human
@s85946171	unknown
@FoodLatest	org
@LisaMcCaghy	human
@cordovahector1	human
@instabashkiria	human
@Josharmastray	unknown
@app_lands2	unknown
@TheFirstEdition	org
@gaucholeeds	org
@andelman	org
@KeukenvdKoning	human
@lsd_tokyo	human
@Alicebigler	human
@FreshTartSteph	org
@flighteuse	human
@sabrinaRW	human
@CameronOLamb	human
@misschutuckshop	org
@IbbotsonJ	unknown
@Naomikisted	human
@EatsTreatsTruck	org
@BluMangoGrill	human
@not_like_movies	human
@christina_xt	human
@TonicBarTimesSq	human
@sampaiodojo	org
@lourzrn	human
@imvalentine14	unknown
@zeemor10	human
@dave_okey5	human
@yilson11	human
@SusanneLeist	human
@Linhsam042	human
@eia25	human
@KompareSA	org
@FitNetX	human
@BangBangSeattle	org
@Out_for_dinner	unknown
@TheDutchSlayer	human
@joshuapr94	unknown
@AlessiaCarosi	human
@1000goodbyes	human
@EJMcEwan	org
@Shahira_Ariffin	unknown
@ExactlyAwesome	human
@sk0921xX	unknown
@FamilyNicheBlog	unknown
@jantoniello	org
@powger_audz	human
@CanonPTY	human
@IronGateDC	org
@kantalaboy	human
@m_ganeza	human
@didianpertiwi	human
@retrofootyboots	unknown
@ThriveFoodsDir	org
@jax_gma	human
@chicfbdotcom	org
@maomatti	human
@jnbwrs	unknown
@Abi_Jane	human
@k_maaaao11	human
@iceman081807	human
@yor_dis	unknown
@ladyeikarasid	human
@erwinbalflear	human
@InsideAsiaTours	human
@leeamariep	human
@buscapromospty	human
@jugie	human
@ChefDanielle	human
@WhatsForLunchUS	unknown
@Kirsty_Eilidh	org
@AgiWAWA	human
@GinnyChan1010	org
@vikkixo	human
@WholeLottaHoney	human
@worthingtoninn	org
@SheannaMarie	human
@veronitawijaya	human
@yoedhieztbri	human
@EngrLEMO	human
@PraderaTapasN8	org
@VIS_Proroci	human
@PaulieHumphreys	unknown
@cornworld_co	human
@hm_3452	human
@littlemee23	human
@claraMallien	org
@kerryndut	human
@TangoBistro	org
@StyleUnstruct	human
@T_Lilly7	human
@Annitsa_Shofi	human
@fabiolamfg	human
@georgesjoey	human
@gimmemarione	human
@IngleseconDani	human
@Alx0319	human
@yeleussizov	human
@NomadOU812	human
@_JoyfulJo	human
@kirwancopydata	human
@bobbluffield	org
@foxypocahontas	human
@judyywhite	human
@mickaghe	human
@TheWEMusic	human
@rusticimages	human
@itsmeAidz	unknown
@HOMHOTEL_SMG	human
@TheChoppingBloc	human
@Sdionne82	org
@attemptitnow	org
@abuboo	human
@AquaCPKW	org
@vaihkonen	human
@blackpowdertav	org
@mamaity	human
@ghulamesposito	human
@lemlemkitchen	human
@madpopo79	org
@Jo_in_TO	human
@Morrica	human
@Miskay29	human
@The_Red_Hulk75	human
@TimWJackson	human
@FerGalindo	human
@lucky_djauhari	human
@AyoClassicRoots	org
@NewmanVillageTX	human
@caesareen	human
@zayyani67	human
@HansLango	org
@LynnzLie	human
@Cynthia_Wink	human
@MLHealthUnit	org
@NeuvooBaltimore	org
@foodNURD	org
@Alsophon	human
@BurkeyFarm	human
@penaberkala	human
@KeithhBos	human
@MIGSDEERTAY	org
@oaxacoma	org
@bomboclaat27	human
@mamuska_net	human
@Bigmikefowler	human
@Osteria_2350	human
@icekingwah	human
@FidelaGwynn	human
@Vod4fone	org
@SmedsonGB	org
@rosiemanning24	human
@gabbatecola	human
@maleygm	human
@CTMezzoGrille	org
@AbuDzarNoraziff	human
@carpicfinder	human
@ChristinnaRena	human
@quetalcozinhar	human
@InMyMemorieOfU	unknown
@kumamio30	human
@NESSASOCORRO	human
@ActressCola	unknown
@Lankatron	human
@Aleaguayoa	unknown
@MellorDuane	human
@ElmersGinger	unknown
@bigdavemelendez	human
@sittinsandbar	org
@90pluscellars	human
@TotalVegasBlog	org
@shearmastr	human
@CostillaLa	org
@deSilvaRukshani	org
@MelinKigali	human
@daniellefromTO	human
@alaryjifa	unknown
@Cassifrass148	unknown
@jjclohessy	human
@ruraljules	human
@gamzedenlii	org
@ha_khaa	human
@AntojitosVe	human
@anizoehq	human
@ikmalFauzan	org
@BestOfCBSNY	org
@TheRealBnE	org
@Glynnperkins	human
@GlendaOllero	human
@Annalisa__Santi	unknown
@IrishCinderelly	human
@PreacherSki	human
@TavernSTL	org
@Clean_Fit_Green	human
@PtSafety911	org
@AkisOneLove	org
@Iya_ReY	human
@dg_beachbum	human
@Newgba	unknown
@NicholeColeman_	human
@SkippysDiner	org
@MelindaHamby	human
@TitofromtxA	human
@CoachChristieK	human
@Asatanui	org
@MarilynHarding	human
@nursimakocalar	human
@JennRouth	human
@Cumberoil	org
@justraymer	human
@smilelim	human
@TheAbbeyWeHo	org
@alimandri	org
@MaddyPagnucco	org
@Daddysgurl214	human
@vinitbhavi	human
@PB_KashCarter	human
@cl_workout	human
@mistererickson	human
@siti_rachael	unknown
@DesignsbyAC	human
@Tyayoi	human
@meeragirdhar	unknown
@WaroengWaluma	org
@JezPerez	org
@Youmi_Ciel	org
@Wilfreg13	human
@Thekeithwilliam	human
@dbyvic	human
@quinkath	human
@KaDevi	human
@cliclor25	human
@EvolveExistence	unknown
@KarneMolida	human
@MasmidaAhmad	human
@alliesgfg	human
@GuerlyReyes	human
@AbbyIxerRD	human
@BMore_Mom	org
@TweetandEats	human
@DJClubKillaCK1	human
@undervibesmusic	human
@QuynhIsCool	org
@naughtypair	org
@atmomed	org
@JeremyShaba	human
@charellischeese	human
@rimitas	human
@mondgalela	human
@MattDogelio214	human
@mikegenius	human
@LaceyLoversL	human
@TwoToneDXB	human
@HeatherNicholds	human
@currynana	human
@philvollman	unknown
@cikGB	human
@BishopLGaiters	unknown
@BeatrizFernnd	human
@njelnova	human
@lloydsbrunch	org
@TangoKraffel	human
@Area51ForSale	unknown
@daniromeu	human
@domsgran	human
@GoodluckMax	human
@AumAimCute	human
@blogvanilla	human
@stephgome7	human
@HelloFood_DZ	org
@BotakzWee	human
@RomieRozay	human
@Sarah_Derrig09	human
@adammgreen_	human
@janwisla	human
@SabrinaMiso	human
@yoga8kris	human
@Nutrition4Lifee	human
@Cisco2011	human
@RawSpiceBarLA	org
@nayatresse	human
@SheKnows	human
@BurgerJointEG	org
@BarbieLez	org
@bistrobanbridge	org
@StPancrasInt	org
@MinervaMetis	human
@1GRANDHIGHWITCH	unknown
@WhiteRosesandCo	human
@JDCulture	human
@PartyJay	human
@waldronmeats	org
@KristineCuer	unknown
@SteveHaweeli	human
@buthelezimandi	human
@willbhealthy	org
@CuginiManzone	human
@NeuvooStJohns	org
@MarriottLONBH	org
@FernFrascino	unknown
@petersthoughts	human
@CrabTrapFWB	org
@SaranshGoila	org
@singapore_style	org
@EatingTipTricks	unknown
@ehgeg	human
@CristianaMilano	human
@Tcup1973	org
@silvi55_sil	human
@FlowerPassion13	unknown
@nuyorican35	unknown
@petula458	human
@RuivaCosta9	unknown
@seanJVNJ13	human
@YosraA__	org
@MostlyMenus	human
@AwesomeGordon	human
@HiltonCity	org
@Philipchee91	human
@IreneStrick	human
@moazeem88	human
@AmyMyLady	unknown
@DavidMo71305151	human
@xandeeh26	human
@donnakylebecker	human
@dexciscruzat	human
@harpman61	human
@iknowangelm	human
@AVN_SGambhir	human
@XquisiteBeauty	unknown
@alcuervos	unknown
@MaricuOrtiz	human
@SofitelParisArc	org
@vindrarawrr	human
@MA777iae	unknown
@MariaAzulEjeCaf	human
@SarahArrow	org
@Darealtaste	org
@LUXELIFETORONTO	human
@vaibhavmulay2	human
@Chefneilmorris	human
@SoyUNLaM	unknown
@DashTaz	human
@ButchersSocial	org
@marzukbinrahman	human
@GemmaJZervaas	human
@fashMargarita	human
@skiptonhour	org
@habzhabz	human
@stefaniapalyi	unknown
@PaulinalexDE	unknown
@CafeCaprice	org
@mihoko_aroma	human
@Aggieville	human
@DRAS_killa	human
@ArceoRy	human
@chimlimchailai	unknown
@kikis79mty	human
@ThickDeeva	unknown
@vivianlhlee	human
@kaitlinannrn	human
@beeadoredior	unknown
@TimeOut_SF	org
@aikoaikoaiko	human
@JustTwenteen	unknown
@MoNStER_BaRbi3	org
@mclaren_janelle	human
@andreiramoscruz	human
@starshine_92	human
@Manikiii	unknown
@ShareTgs	unknown
@ClareLydon	human
@TodoCoders	unknown
@tracyxiong	human
@girlgamy	human
@Rasna_Resturant	human
@kellogg0002	human
@Mhaviejose14	unknown
@SyxDaModel	human
@ChaAzalea	human
@rubiGarza10	human
@BrunchBabyNYC	human
@iispoii	human
@befitwithivi_	human
@DJ_YOUNGIN722	human
@VivaLaPaz	human
@YeseniaTorres05	human
@MeyrickWill	human
@MangiaGroup	unknown
@sancarlos86	human
@hyzanD	unknown
@2BoroughsLarder	human
@epudkv	human
@mcgimpseymike	org
@devinzhen	human
@EddieGreaser	unknown
@coffeebohemian	unknown
@djrae1981	human
@Serenefairy_2	org
@IvoryErfan	human
@SophiaCVarga	human
@yoeyuu	org
@minamo7111	unknown
@Angela4design	human
@PlentyGoodies	org
@Soph_Mcloughlin	unknown
@cosmicnoise46	human
@RuudjevE	unknown
@AnekePalmer	unknown
@tapplaymedia	org
@AureaulisParris	human
@LadyEatsMission	org
@Shibanibawa	human
@BethanRHarris	human
@a_egawati	human
@KeithKing	human
@LUSIANANA_	human
@hannah_ross	human
@Nostalgia1313	org
@UghCila	human
@MT_Fitness	unknown
@tvalcorn	human
@lukaferone	human
@ohaithurrabbie	human
@EchoesofLaughte	human
@TashaTaniea	human
@YumChaHut	org
@vegsoc	org
@GFreeSanity	human
@5STARREESIECUP	human
@Eees_leone	human
@chuysca	org
@niiqqiili	human
@iZulmira	human
@KooKat420	org
@LavanaYoken	human
@TechMASHUK	human
@NinoLucasSoFly	human
@StudioRecipes	org
@fnweet	human
@WorrellMcclain	unknown
@CirclekCa	org
@comedian_mzcash	unknown
@solvifannar_is	unknown
@EmilyChok	human
@Kendy13	human
@becb_	org
@AikanpuleiHou	human
@PlatesBaltimore	org
@ChefDeeDeeC	org
@Char_LThomas	human
@Barococo_DD	human
@raamparmar	unknown
@esmy_gonzalez	human
@AntonRodriguez8	org
@Lattydaddy07	human
@YELPbe	human
@JB_CHAR	human
@audreyd27	human
@MMaraDini	human
@BELLESnREBELLES	org
@montanaswatrloo	org
@FujairahRotana	org
@bazilinbukhari	human
@LonniGilmore	human
@ElleByrd	human
@TyToo	human
@3theanswer	human
@xaniz25	human
@PKeaveney91	human
@_WatchMyProcess	human
@smacula	human
@aileeeeeeen	human
@Sourapariga	human
@GracesBest	human
@crazeerayzee	human
@babymollymai	unknown
@iamriavelasco	human
@scandal14alysha	unknown
@ichcha117	human
@foodplymouth	org
@eVanZa	human
@Bhoomik13554309	human
@vczarina	human
@ImpulsivityApp	org
@riz_94	human
@indianfooddiary	org
@GinaMontana_	human
@sssaloniii	unknown
@tommysw	human
@peiqi_ng	human
@lunch_plate	human
@BenWirtz	org
@BigFoodie_UK	org
@xuxu31	unknown
@PRTNRSandCrym	human
@bookoo1953	human
@MNGobbleGal	human
@tutumaina1	human
@RebeccaSherrow	human
@jimmyhoshi	human
@kumitaguchi	human
@BettyKnowsLeeds	human
@BofSantos	org
@aartisonigra	org
@burda_boris	human
@khairulsanz85	human
@rinarusli	human
@VitalDining	org
@DeCdestefanoitp	human
@dianainfanter	human
@DYEpdx	human
@RinconGables	human
@_Marian__	human
@BerrySPOILED	human
@EmiMalcolm	human
@lohsharon	human
@yuyu_teeter	human
@nisakhairuddin	human
@amchamwatch	org
@taralezhkov	human
@KiltedCatering	human
@jeppyparaiso	human
@GoAwayWithJae	human
@mikusheeeeeena	unknown
@CarlaMorta	human
@RaValDavis	human
@asrinindya	unknown
@mariadelatex	unknown
@TheReviewAddict	human
@pheleciyout	human
@ScarfAbsolWhirl	human
@ShinyPhua	human
@ZeenatM	human
@Shootsntendrils	human
@matchola_food	org
@padeltuki	human
@LeahViveros	human
@MisterPromoBlog	human
@HeikeHenke	human
@pudding_purin2	unknown
@JanePang	human
@_MiguelCoelho	unknown
@k2rolyn	human
@Gurdip_Slimming	human
@juripinkfloid	human
@ZahSura	human
@rictvsempra	unknown
@bonnielu66	human
@J_burnspizza	human
@LouiseHenry812	human
@PlatinumPuzzy1	org
@franngaab	human
@micahfionah	human
@kasandrauno	human
@ViBE_ub_grape2	human
@RachelNegus	human
@CONCRETE615	human
@foodbookfair	org
@Tammylynnredd	unknown
@anklebytr	human
@szanyka_	unknown
@MarcALittlejohn	human
@viamissxo	unknown
@ABlondesLifeHFB	unknown
@Fushimi_ny	org
@AsterMedcity14	human
@joinhugodotcom	org
@ISayOrganic	org
@thatnigga_lexxx	unknown
@velifp	unknown
@DaleSRogers	human
@TiffanniT	human
@BistroLaTour	human
@ishai1178	org
@KenBorne1	human
@ReventonManiac	human
@feli_ta	human
@franklovesellen	human
@Transversalrrpp	human
@JetSetSarah	human
@SaintandRogue	org
@Kold_Konexion	human
@marinafortini	human
@albinakg	human
@BentleysMom913	unknown
@Sarandipity_85	human
@Its_me_edrie	org
@aliinlondonland	org
@NOZE7	human
@ccmarie86	unknown
@MelSinclairCook	org
@writelane	org
@fredwhitecap	human
@EmiilyDrayton	human
@priyaksantoro	human
@angelhidalgodeb	human
@lukegoodhand	human
@BBUA	human
@Belotea	org
@Livikinzz	human
@Cafe_d_ex	unknown
@kekkobros	human
@nlanduw	org
@djpinkystarzz	human
@footnotesbylisa	human
@dilaraschengen	human
@TotesJuices	human
@DeniListaCott	human
@globalramblr	human
@dremarshall	human
@lugoedelyn	human
@scorpiock8	human
@isaaaygarcia	human
@lytvinamelati	unknown
@madeleinefussth	human
@sak4it0	unknown
@djalkimist	human
@MayaraGobeth	human
@layaisabelle	human
@thelunchdepot	org
@CherrieTanadi	human
@HTsang151	human
@BEN_Mlle	human
@JasonDkenzo	human
@AnaEm_xo	human
@funtasticlyfit	human
@valentinaarr	human
@Latin_Stud617	human
@Zyrelkis	human
@ronaldtannur	human
@darrenkelly1988	human
@fadhil_angda	unknown
@2202Willy	human
@gillianbalcombe	human
@ranggalaksana	unknown
@LeahMackenzie	human
@FeTheDoc	human
@shihopui	org
@blogcmsite	human
@VirginiaBalder	human
@ohboy1967	org
@Basuhail	human
@DenisBraunstein	human
@bluenosebear21	human
@GuapShop	org
@kiyala8	human
@xStaceyVITALITY	human
@TwoRowsGrill	org
@Shelly__Marie	human
@Juniver08	human
@Macello_Chicago	human
@TonyRomasEncino	human
@WeddingMagazins	human
@AndreaVPhoto	human
@ballsofjoy	human
@issheonanything	human
@TheRealChelle_	unknown
@loyalvoice	org
@Plissetskaya	human
@tini820226	human
@phil_food	human
@aaronq8y	human
@Zulfa_Chu_Ex	human
@mayuyu99122	human
@firehailtree	org
@bacsidJerome	human
@joyceannet	human
@AlMuroojRotana	org
@CirocGirlYummy	human
@IvyTeves	human
@karinawhitefans	org
@Anflo2	human
@Dirty_Diana81	human
@koeniginMaya	human
@SharonAu1019	human
@YoLo_CL	human
@GrainChain	org
@LaraineCrough	org
@JadeElizabethBr	unknown
@Wellburncare	org
@lymingtondotcom	org
@intanminooz	unknown
@SneschanaKoenig	org
@Dora_Chelsea96	human
@Unbreakable_Raf	human
@CellaFit	unknown
@bahamaboi76	human
@p_mlp	unknown
@moon_sun_bunny	human
@annasui_anna	human
@a622s	unknown
@SimoneSonay	human
@PaniTrawa	unknown
@robfitandspark1	human
@MEATSONLINE	human
@UNDERYOURABAYA	human
@LeaStar30	human
@kichito555	human
@Hequal	human
@igracedianne	human
@kat_hart03	human
@SandPham	human
@gonsubtil	human
@CairoScene	human
@ourfoodie_ng	human
@REAL_NYC_Market	human
@ryanbruyninckx	human
@drinkwellaustin	org
@SpiceyWifey1	unknown
@Chum_Cho	human
@CHRISTABELSFDE	unknown
@na___m1	unknown
@phoraphat	human
@valsedameliee	human
@miguelfdez1987	org
@amycharlottehop	unknown
@vladimirtanring	org
@gabirufaustino	human
@ritewhileucan	org
@ChocolateKADIE	human
@mlainas	human
@missjshopaholic	human
@farmersbelly	human
@MaryGoings	human
@NiccoloGennaro	human
@Rykielkelv	human
@EevornLee	human
@Melrose_Morgan	human
@squaremealvande	human
@JessyYam	human
@IAMZIGG	human
@KarlNavz	human
@larissaguiar_	human
@janine10mcg	unknown
@Tonkouesaka	human
@luis_Voztokoll	human
@KumikoMing	human
@iMeze_	unknown
@RestoDining	org
@NcisLuscious	human
@90PlusAccounts	unknown
@MsNjStewart	human
@CorinaVanMarm	human
@healthcaresbe	human
@premierepku	human
@SushiTamon	org
@jesameca	human
@Eli__Zion	human
@LauTheantiquer	human
@Imar4life	human
@benkenn57401192	human
@edvardkadic	human
@_jpwxo	unknown
@guitarnub	human
@SleepKokoon	human
@100driiine	org
@Rommyly	human
@YoungWinosofDC	org
@Outdoorlux	org
@milluzz	human
@HeatherPipkins	human
@stylentonic	org
@MIlhamTaofeqH	unknown
@AidaPichardo	human
@Exquinnsite	human
@KINGBENJAMINZ	human
@jvbalilis	unknown
@moodsandfoodDK	human
@chefbytesdaniel	human
@baby_TJ8	org
@Captain_AdamOh	human
@xBootsx13	human
@retorta	org
@Catch22mke1	unknown
@Just_Numine	human
@TheRazRiot	human
@rodcalavera	human
@FebyTG	unknown
@TKBGC	org
@Astridllicius	human
@24Wellness	human
@WeRepostit	human
@oor3t1r_mfs	human
@interferencies	human
@JuliusCaesarDad	human
@Integrativchiro	unknown
@mattmunn	human
@linedevos	human
@APlace4hertogo	human
@RachelBakam	human
@LFlowerVintage	human
@AhmadHyatt	human
@conciergente	human
@MissHannF	human
@FloraUbaldiBors	unknown
@sugercoatit	human
@luu_gandarillas	human
@xXmkorXx	human
@dpereda	human
@mynameisputu	human
@DRgeekEW	human
@Lexilana	human
@cramz07	human
@LuvFitness	human
@TriposoPerth	human
@yourgymgf	human
@RiaanWest1	human
@mikachan315	human
@phillyr2001	human
@kath_prettty	unknown
@hrblock_21	human
@thepotterbryant	human
@CuppAustralia	unknown
@themaxeffects	human
@tinapayson	human
@jnaswhat	unknown
@SSpiegoski	human
@JoseLuisRguez	human
@bigmoesdiner	org
@CashChasing_CJ	org
@plough_dulwich	org
@KeetSmakelijk	org
@ianclarito	human
@LikeIguana	human
@ellenmkelly	human
@emilyfonnesbeck	human
@MaloolMandy	human
@Sportlooking	org
@Jayantoneeette	unknown
@SingKeeChinese	human
@musicnerd101	human
@glpLondon	human
@BeautyNtheChic	human
@tiffyjadec	unknown
@sundog925	org
@Metrogypsie	human
@petshouse01	human
@msjessjohnston	human
@arcaneallusions	human
@attamuncar	human
@kugfsgdsgdk	human
@JacqTeh	human
@brckkaya	unknown
@foxykat085	human
@zejalext	human
@brendasillas	human
@ShannonViewRI	human
@mbshinya	human
@Digitalques	human
@sing_watermelon	unknown
@__YiKES__	human
@rubiesOpearls	human
@AugeneMontolalu	human
@SmartEnergy2015	unknown
@KawaiiPeachies	human
@sha_roundface	human
@ssturlaa	human
@MisterMusik	org
@HootReid	human
@chaitanyagala	human
@botkun20130614	human
@petiteblogueuse	human
@WildSteamedRice	human
@thepigandcow	org
@brann_de	human
@Umut_Altuntas	human
@luchoarakaki	org
@Chefjen101	unknown
@serena_vd	human
@ThickFitandFab	human
@mi_perdo	human
@MGFsite	org
@jomskieee_	unknown
@RealliGrilli	human
@jayexiomo	human
@mattelboy	human
@ThCookingDoctor	org
@manni1411	unknown
@kdalve	human
@GalaBrand	human
@syidahsani	org
@m0nicag0zum	unknown
@s_Utti	human
@131nnyy131	human
@michaelbh90212	human
@Une_nicoise	org
@GlutensTheDevil	human
@kNOw__wELL	human
@v_surgute	unknown
@MBJury	human
@HaasMarie1	unknown
@So_Goa	org
@TrvlnMtgsGal	human
@ssammygirl1	human
@visitcanberra	org
@StephyMAlien	unknown
@CruBistroGaySt	human
@rebecca1287	human
@megwhittaker1	human
@MojiFred	human
@bubbletCosmetic	org
@calio_app	org
@_JevhanDene92	unknown
@TalibanWAVE	unknown
@OrlandoChris	human
@MiddleBarLA	human
@LiXLiFirenze	human
@andrewkkh	human
@OpieYovita	human
@MissTannyP	human
@BFinnAustin	org
@Athena_Robsten	unknown
@10shiyuki	human
@MoraviaHealth	human
@monicamontenero	human
@JoanaAmeijeiras	human
@CahraP	human
@goldanitv	org
@NashraShah	human
@iMT00MUCh	human
@lebazardalison	human
@sabrinacly	org
@martona_90	human
@FitBiologyGirl	human
@sid0ni0	human
@jericbienne	human
@MattFarrell29	human
@MGAdInc	human
@Marto_xD	human
@porn201	human
@VanniJust	human
@SleekMaverick	human
@sabormagia	human
@yadigomez	org
@itsemilyrhea	unknown
@Saverio_DP	human
@im_riska	human
@FeicRa	human
@tinyparadise	org
@ulasal	human
@IaretheFoodSnob	human
@PlayTravelLife	human
@brillyantsirait	human
@beautysorority	human
@cananyon	human
@dhoofreaky	human
@encikdamak	org
@dr13isthebeast	human
@idrissss77370	unknown
@jessywoman	human
@D___Allen	human
@TheMagMile	org
@OlivieriPasta	org
@amweeks	human
@eatrevel	org
@AndreaLitsch	human
@orangutanne	human
@johnmark07	human
@ms10valeria	human
@gimmick18	human
@Renato_fs3	unknown
@TurboRed325	human
@maiatokiohotel	human
@Yeyopan	human
@idaredig	human
@MicheleTrainer	human
@SuziAlbracht	org
@WelcomeToDot	org
@Tamiixox	human
@SherrieFlick	org
@JeriMahon	human
@usbplastica	org
@paul_a_young	org
@kovinyoong	human
@v_a_y_s	human
@salah_alqady	human
@Cicitannous12	human
@ThePublicSlate	human
@sneakerpimp	unknown
@tomomi_archives	unknown
@ARealLogCabin	org
@aizzing	human
@TorGism	human
@dg2f_mentality	unknown
@SevenBistroNY	human
@Wreckk	human
@hiramatsu7	human
@Waterakkers	human
@andyrlapin	human
@GrapplersRus	org
@tpbrum	org
@tkal	human
@agfizmu	human
@pirikitti	human
@downtown_la	org
@HeimGourmet	human
@SameerTwi850	unknown
@Georgie_Be	human
@chrisfc99	human
@Vor_Pa	org
@roxxiofficial_	human
@merlydoucebleu	human
@nikhil_makwana1	org
@01lupe1990	human
@410Maomao	human
@eatgreenlemon	org
@SaporiDitalia_	org
@TheCrazyFoodie	human
@obaka_tuito	unknown
@caffearomi_jp	org
@MySweetPearls	human
@summerwildx	unknown
@amirulnadzmy	unknown
@WISH_FRESH	human
@YourTripleA	human
@Rubybeets	org
@notyetyuko1017	unknown
@DheniesIjaya	org
@SK9DotOnline	org
@leazeitman	human
@Warumono84	org
@faith_licious	human
@erokamichu	human
@allypayares	human
@junior809rd	human
@soniabgr	human
@NickChopperDigg	human
@dvj58	human
@Kirramisucafe	org
@happy_galzz	human
@gogocir	human
@natashaeleonora	human
@CamiiCanete	human
@thisisamorette	human
@rubysapphiree	unknown
@stevenanggrek	human
@aikenemmanuelq	human
@Hisae11nao	human
@MizzAnaBanana05	unknown
@x_nemo_x	human
@drewslaugh_xx	human
@FavaPot	org
@SteakhouseKSA	org
@mimatagalpa	human
@pawsandshoes	human
@DanforthEast	org
@Arnoldo903	unknown
@FcukMyTweets	unknown
@cafe401rd	human
@samuelwiedia	org
@rommelandrew	human
@crosskeysleeds	org
@fangwoei	human
@lipzter420	unknown
@davidbradshaw91	human
@OdyGirado	human
@HalfPintOfInnes	human
@lishamisha22	unknown
@ClassyAsFck	unknown
@eirayana1	human
@Pink_Frenzy	human
@AG_RyeNH	org
@lopezmatti	human
@RobinRussell52	human
@_xoxo1005	unknown
@fatemeh_azad	org
@Lorna_Kerin48	human
@UniqueHunters4u	human
@GoralG	human
@WafiyHM	human
@LuckyLizzys	human
@fatheesaleh	human
@3Ahmetcan	human
@wokeLaydee	unknown
@TyFAMOUS	org
@catarinafs15	unknown
@BambiniIni	unknown
@jalfalee	human
@RJCWellness	human
@IgnazioFailla	human
@Leahismine	human
@kfitnessdiva	unknown
@Ish_1988	human
@TgAmiruL__	human
@SohanDsouza	human
@miroskauffman	human
@MillieandMe1	org
@EmPowerseu	human
@Arleeeeeeeen	unknown
@Ybme2day	human
@MommaMojoBlog	unknown
@cagansmommy	human
@KokHwaLie	human
@MaryBackholer	human
@ShawnaCollage	human
@giovanniUbaldi	human
@mgvn2fly	unknown
@MacKidYork	org
@TerryG218	human
@HotDogOKC	org
@Citizen_Grace	org
@zeppy_newyork	human
@pxdianaestelle	human
@shahzad_Husain8	human
@guarnaschelli	org
@IE_JeffreyS	human
@MyAlonsoWorld	org
@4HealthAndMore	human
@aliceari	human
@P1st_collective	org
@DrBigotes	unknown
@TheFreshMarket	human
@suchamom	human
@shellbica	human
@ham_forcoke	human
@PI_Engineer	human
@Dianaaaaaa97	human
@takaomyu	unknown
@gekaspeedmaster	human
@Nugraha_AdeP	human
@__liiilyyy	human
@kamthornp	human
@Regina_Huang	human
@polombo1113	human
@clocklair13	human
@annaleys	human
@Mollybecoolin	human
@Carolicen	human
@SPIN_Restaurant	human
@AnmolAleena	human
@afifahfelani	human
@superfilthy	human
@jujabling	human
@Jacks99World	org
@adindadiin	human
@senek26	human
@kuammarkuharis	org
@steph_recruits	human
@Bronszewski	human
@K12Learn	org
@Vengeful_Kisses	human
@chicoryapp	unknown
@1300MI	org
@TenRocksLounge	org
@dai7250	human
@FlaglerFishCo	org
@Racheljennielee	human
@LunchWithIngy	unknown
@TootsiesDiner	human
@WuWanChing	human
@eurasian929	unknown
@dimitrizetzsche	human
@choicedelhi	org
@IndoPopKitchen	org
@serhat5407	human
@itaiwan7	human
@MmmisforMommy	human
@pauloanfaria	human
@akaBionicMark	human
@wild__heartbeat	unknown
@TomWright_Fit	org
@TwoBitsNash	human
@Vegg_in	org
@BlueSmokeNYC	human
@joshlunzaga	human
@keth786	human
@pakent1	human
@scottryantisch1	human
@dorriansnyc	org
@ngjunwei93	unknown
@Scott_Co_Uk	human
@justageekboy	human
@incucinaperamor	human
@vyqunahawof	unknown
@FannyMkn	human
@th8rt	human
@shantyfatmawaty	human
@Chelsea_Cholla	human
@BigCityTavern	org
@aiamchai	unknown
@RestauranteKho	human
@DeanMercer	human
@mezzymom	human
@southernseason	human
@SoniSandhu	org
@WordRomancer	org
@jOhNjOhN506	human
@BostonB78	human
@ambyrosia	human
@spoiltpig	human
@Azreen_Rahim_	human
@agrcosta	human
@carliambrose	human
@TasteSpanishFly	unknown
@SharonDraws	unknown
@Luiz_Waldorf	unknown
@ElCaminoDC	human
@cikmimiiii	human
@vallentinasme	unknown
@MasonSurvival	human
@THEMartiniMike	human
@MICKJ24	unknown
@DrSolmazA	human
@melayfroilan	human
@ShazDePinto	human
@aceviolingirl	human
@designerupdate	human
@KalyDiaz21	human
@mami0811	human
@ragusauce	org
@Toryjsmith	human
@mina_dalung	human
@gocommonwealth	org
@OzDeLaVoe	org
@wheelgatepark	human
@HYPODIVE	org
@Black_V_Bridess	unknown
@batpixieboy	human
@yoshuayosia	human
@PizzaExpressdxb	unknown
@CollinsLentz	unknown
@SassyMsJazzie	human
@Damien822	unknown
@KOCK_JEE2	unknown
@mjeeeyy	unknown
@wlyit	human
@MyFoodMinute	org
@KashahAqasha	human
@Sewstitchquilt2	human
@divaj_dj	org
@andrewncarroll	human
@NeilReadingPR	org
@fleurdecuers	org
@inedodoc	human
@phillyrealty	org
@NNaylee__	unknown
@FarmerBobsEggs	human
@where2eatCL	human
@lempopot	human
@ITraveler_i	human
@jusantos182	human
@theemariec	human
@foxytk23	human
@_eila01	unknown
@azadiagent	human
@g0rdit0pr0blems	unknown
@kneadybakersla	org
@OliviasAlias	human
@RobinMadeley	human
@goodvibesarchie	unknown
@AverageJoeArt	human
@tassiastewart	human
@2_point_0	human
@IXI94IXI	human
@mrmercury36	org
@eknyshev	human
@superman237	human
@imageraita	unknown
@iamanorazileyaf	human
@ThirstyMooseNH	org
@MrsWalkerJr	human
@ROCKSTERINFO	human
@Jonathan_D_Bird	human
@mickjagga5	human
@faizjenar	unknown
@THETOUPE	org
@dustkicka	human
@FlippinPizzaME	org
@emmacountrykitc	org
@mitchikeuchi	human
@AAPremlall	org
@mariomujer	human
@SandraIshMe	human
@JJCrochets	human
@TheDalRae	org
@suad12158	human
@LuciaA77	human
@Viv_Mahbub	human
@AwkwardBano	unknown
@Just_dhiK	human
@jingwei2729	human
@BornGQ	human
@kadijacamara41	human
@davidsheff	human
@NothingtoWare	human
@Homeschool4Me	human
@Shotta_Breez	unknown
@koenbekkering	human
@yenirakiglobal	org
@BnBSoBe	org
@ash_ashleyme	unknown
@PolandStreetKM	unknown
@__rtt18	human
@jaburks	human
@melekbulut20	unknown
@TheRealB_QUBED	human
@Drenners	human
@AccursioChef	org
@Grand_Aquila	org
@NittPitino	human
@kiminpei	human
@angelprl	human
@forloveandfood1	org
@verraxtina	unknown
@ItsRichmond1524	unknown
@mishriexport	human
@HimeMeyy	human
@anissadjanbi	unknown
@NubianGlamRock	human
@BornToBeFIGHTER	human
@CurlyJodie	human
@no1_frenchie	human
@LeoCurrently	human
@ThermomixBlog	human
@hannabanans	human
@IrishPubAC1	org
@ohhpiquelovesme	human
@Ayangbeb	unknown
@BendersArms	org
@mammyprevost	human
@msmarguet	org
@xxxlococoxxx	human
@GimmeABite_blog	org
@Corp_Prophet	org
@ketiswary	human
@itsSweetyClaire	human
@AnOlive	human
@WuendyGomz	human
@NeeAmaral	human
@amycaseycooks	org
@DorothyOnTV	human
@KueOma	org
@jcrpoker	unknown
@ashiescorner	human
@witidesty	human
@shin_fransisca	human
@xavierjthomas	human
@Alex_Bobsleigh	human
@2Eat4Health	org
@malvarezds	human
@Cruel_Diamond	org
@carleotwitarun	human
@aycaergiin	unknown
@BexPadenUK	human
@FaizalOrtho	human
@aldrich319	org
@kornastic27	human
@MsBevanChuang	human
@kd_kissofdeath	human
@21cDurham	org
@shemypic	human
@jhuztmezty	human
@DaiSevenants	unknown
@GoodbeefAlmaty	human
@luckynaka	human
@annawasntheree	unknown
@Beautyfoodme	human
@otter1803	unknown
@MalissaPaterson	human
@FranciscoBrn	unknown
@cutedougla17	unknown
@RGStringer1	org
@ChrisBinTO	unknown
@OneSmallWindow	org
@BewilderedBug	human
@tashazzey	human
@WhyUBitter	human
@phcdesign	human
@KennethKBC	human
@DevtyDevty	unknown
@AyshenRocks	unknown
@Svenhansonbritt	org
@mayuka0804	org
@Madalynster	unknown
@eliter1	human
@MyFrugalFitness	human
@Hudachan	human
@panlasa	human
@porrocardiff	org
@bestoflowestoft	org
@piemonte_is	human
@BeamerzZz	human
@GlamorousBite	org
@engelspavlov	human
@ryojiokada17871	human
@Rayen_Vegano	human
@Le_Swine	org
@marquinho_cruz	human
@RestoCommunion	human
@EngineerPau	human
@atwood_ny	human
@slberry89	human
@xocheekiesss13	human
@NicolaMorganN	human
@hengshuqing	human
@Jasmine70X0	human
@itsmebiancaaa	unknown
@bayuadhasi	human
@Gyadee	human
@FavianLam	human
@ChinaGonzalez14	unknown
@KitchenLTO	org
@shiatsu119	human
@european_jobs	org
@joepimentel	human
@MitshReyes	human
@MountClemensDDA	org
@paulinewright2	org
@poppap	human
@ErieGrill	org
@jensdish	org
@firestormfury	human
@mem_a68	human
@sasutty	human
@vanessamendoza	human
@jenspili	human
@mrs_3m3	human
@VIVMCMXC	human
@hiiStephannie	human
@Elzetbester	human
@KollywoodTrends	org
@legrma	human
@NerdyCompanion	human
@ShanAshleeT23	unknown
@c_h_i_l_c_o	human
@IKEdeviloi	unknown
@AleChioetto	human
@KarolSuclla	human
@HoCoBlogs	human
@weroutdoors	human
@TreehausNYC	org
@teawithleigh	human
@cikyuyiyui	unknown
@restuseby	human
@Bedivereleb	org
@j_winslow21	human
@JessicaHamlinB	human
@_DewiAntari	human
@andfaris94	human
@Fit_Marl3y	human
@s0813_y0715	human
@ARCOTELHotels	org
@AUSTRALIAAARON	human
@TheBlackHoff	human
@NCBeef	org
@ilvolointer	human
@aguirrestexmex	human
@VillageTaphouse	org
@THEHUMANFAUCET	org
@JoshuHasT	unknown
@SahinAlew	human
@animatedgifplus	human
@kieeee1	human
@madamehighst	human
@Eva_MizzKiya	unknown
@Koa_GU	human
@meboyle1989	unknown
@iGLOsolo	unknown
@TomGeeTweet	human
@Lie0227	human
@KinkaIzakayaTO	human
@goldstandardpr	human
@GCandrix	org
@AwesomeCurtis	human
@JustCarolineH	human
@nydiam74	human
@JerrelleGuy	human
@magnifika	human
@bluedogeek	human
@HannahRachael	human
@ceppeeromeral	org
@BS_GlutenFree	human
@elimwong	human
@Miss_Pao_88	human
@NiniRose99	unknown
@lisawbwalker	human
@BelizeBeauties	human
@Familia_ilha_SC	human
@IgorWeisbrot	human
@JenniHearted	human
@mariekennedypt	human
@Rolandoalberti	human
@ccastle80	human
@sgrecruit	org
@rickyflorack	human
@ptilu	human
@FlurriesofFlour	human
@megisapokemon	unknown
@KStewFan123	unknown
@BreakfastMilano	human
@1life_loveit	org
@gippo_cafe	unknown
@gabyellamaya	human
@Hae_Hyuk89	human
@gopinkballs	unknown
@theslothwoman	org
@gift_yan	human
@essjayeff	human
@DNM_NYC_Travel	org
@EricNRamos	human
@LocoCocoa27	human
@laabhul	human
@EatSeeListen	human
@NishitaChandra	human
@AOR_Health	human
@JKimonaboat	human
@Frenchydiary	human
@CourtyardNYC	org
@DaisyWings2	human
@Chrislutz	human
@sasvimprirodno	human
@RoveenaMusic	org
@Raqueel1004	unknown
@TTT6993_2	human
@RianiIndradewi	org
@BooyaFitness	human
@Moryiah	human
@BIGSTEVEGEE	unknown
@DickensFood	human
@Dannys40girl	unknown
@unorthodxepicur	org
@nestrioka	human
@JohnRacerer	human
@PhilippovNikita	human
@AlexanderV__	human
@Lisha_carpediem	org
@FashionViiictim	org
@ruhulchoudhury	human
@TheYummyYank	human
@OrphaToh	unknown
@timberelk	org
@myburntorange	org
@Duncan207	human
@andreiita_betis	unknown
@bakinleye	human
@martiniced	human
@thutwotoo	human
@getpregame	human
@Gormandizer73	org
@burcuselanik	unknown
@wbnewquay	org
@NanaOmidvar	human
@viaumbriadc	org
@fatoxicbawarchi	org
@ISalaioli	human
@lidut4ever	unknown
@pearyeung	org
@Moneymagpie	org
@haraganesh	human
@Utcoozhoo	org
@fontana61a	org
@bannananna	human
@Team3Bundlez	unknown
@tarbear7	human
@putripika	human
@MarshellaKoh	human
@kira_greene	org
@Hina_ansari22	unknown
@Angelchoe	human
@R0bertaLee	human
@Subalisid0704	human
@DeniseMcAdam	human
@alBalad_Lebanon	org
@BuffaloGrille	org
@cKianLee1	human
@MOMOII_II	human
@simplycrystal3	human
@jenwsyx	unknown
@izdiharr17	unknown
@alexjsilvester	human
@JehovAllah	org
@martasantospiri	human
@puspita_virna	human
@daydreamer2490	human
@Veidehii	unknown
@kialogist	org
@sesevalbeauty	human
@michelletgrandy	human
@condogroup	org
@KurlyKactus	human
@PHILGORGEOUS	org
@TaylorHoward	human
@five67ate	human
@JackieAlpers	human
@MrsQC	org
@PrestonLing	org
@lauren_filan7	unknown
@missfrancy92	human
@bun_daa	human
@Mstock_dk	human
@fitzroyboutique	org
@NeuvooOshawa	unknown
@KolkataInsider	human
@BuildMyEvent	org
@GodessMoi	human
@lady_puspita	human
@ChanelPics	org
@davidkingmozart	human
@ingcmm	human
@whatsarahate	human
@ShannonSaoirse	human
@alyandevie	org
@baddadyvegan	human
@lin_tan	unknown
@Vie_H	human
@chrissypeekaboo	unknown
@wfmv953	human
@bolzfield	human
@BrunetteMystery	human
@gradillax	org
@42TheRestaurant	org
@YukiyYoshiki	human
@Virgos_Empress	human
@PhukenCrumbs	human
@RebeccaFollman	human
@KODAnators	org
@mahobekon	human
@ladyjenchase	human
@MCsam97	human
@kyuukyoku_	unknown
@gziforah	org
@Alvinyacial	human
@JacobGrandson	human
@shevyvision	org
@joyace_	human
@alexaf_93	human
@martosjocel	human
@qw2e	human
@KINGARKE	org
@JennGrimmer	human
@camavito	unknown
@FandeFoieGras	org
@agorzny	human
@DayOneWellness	org
@ystadlunch	human
@JTTW_WWJD	human
@BinMohsin	human
@anthemkitchen	org
@jejamuran1saja	human
@PhamishB	org
@enepunt	human
@amaliatulizzah	unknown
@fitBlisstv	human
@WeightlossMjt	org
@msanecoronel	human
@7080pao	org
@Fely_M	human
@bianca_bartolo	unknown
@thejenomatic	human
@CertQueenStatus	human
@royobrienford	org
@Reneeswaynyc	human
@monika890	human
@BritishHills	human
@carsonloh08	human
@hafsakhaan	human
@RubenUrgell	human
@ProlstoOlena	human
@sikigirl	human
@Rie_Crawford	human
@kanpattara	human
@mamarosies1	org
@mbhide	human
@jwsparkles	human
@7HRIronman	human
@ochinmay	human
@AndreRudlis	human
@agusborzo	human
@sumiloasby	human
@tasteandscene	org
@BoneHat13	human
@cheif_sir	human
@1SeasideLounge	org
@M_Shokoladova	human
@DawnGoddard	human
@yknfqm	org
@Crust_Crumbs	org
@cookyoursecret	human
@GucciSantucci	unknown
@WeHarlem	org
@BeautifulDoll_1	human
@Lisa_Mills_64	org
@maylin7255	unknown
@jadgutierrez	org
@Meztes	human
@fabrienne1	unknown
@Danfrench26	unknown
@MillennialPubs	human
@JackKetsoyan	human
@fr_josse	human
@Chew4lifeNaymac	org
@Ziateresa	human
@pipinhaam	human
@Goldan21	unknown
@Daniarmstrong88	human
@CANNNNNNNNNNY	human
@Airs80	human
@COKEFLiRRT	human
@bebeyanbarbie	human
@MaanZaini	human
@kandou_anata	unknown
@BaconEvangelist	human
@moshiii	org
@Huitinqq	human
@chapmanphilly	org
@ssaayyaaooo	unknown
@Stockport_Ads	human
@huri_zzz	human
@RossStylist	human
@DjLedz	human
@alvaromarchan	human
@JosiesPizza	org
@Kobsupang	human
@crystal_956	human
@B1LAL23	org
@FairyNiceTradin	org
@pattiofstyle	human
@juicetou	org
@JehBrofar	unknown
@TheRock_WFK	unknown
@brkaktas16	org
@_chinacho_	org
@1511lily	org
@lilfeefif0fum	org
@Pukarita	human
@misstrendybcn	human
@Vamshiavk	org
@ashxeliza	unknown
@AssisPatxi	human
@Th3Alexander	human
@jaxfogg	unknown
@ZakariyaQasim	human
@dinera_recepti	human
@LsMuffin	human
@bittimalva	human
@RFMH411	human
@Yuzukisf	org
@ElizabthAngeles	human
@adamarosa	human
@loveshanglam	human
@ChrHung	human
@alinaboholtan	human
@Jioker891219	unknown
@EmmaCoach	human
@CallumHackney	human
@MattyDorf	human
@dcelectricband	human
@LluviaDesigns	org
@VincentChandle2	org
@poohsan1980	human
@DennyTryanto22	human
@jeitak	human
@SonomaDC	org
@EvilAwkeye	human
@Hanoum	human
@iripina	human
@tzveti_official	org
@JeneeJ_ThatMUA	human
@tapformenu	human
@afroballerina	human
@MyNewHealthGuru	human
@Fatoch4	org
@FinishatTheRim	human
@ECrawfordwrites	human
@LEICA9000	unknown
@dronninganja	unknown
@AllyssaMariiz	human
@Zan_Amazin	human
@SobeysDietitian	human
@LiangSunday	human
@GraemeCurley	human
@CBSRD	human
@hardzdong	human
@krissb71	human
@Thievesfire	human
@lucyfoodsnaps	unknown
@klarkkent06	human
@matthewrios4	human
@AleksandraSanya	human
@supahstarn9ne	human
@Pa_Tok	human
@ALTNCorp	org
@DrKarunaSabnani	human
@TanyaBolina	human
@sezineker	human
@24hae	org
@piyomochan	human
@funkebucknor	human
@Red_Biz_Hour	unknown
@hellokattyfromO	human
@TomGoing	human
@MarkStockVids	human
@ThirtySevenNL	unknown
@CAJAVAUSA	org
@DineandDish	human
@gautamnitin	org
@osangsoliven	human
@illigraphics	human
@itsmeMajiee	unknown
@Toshi_Riku	human
@RaqelC	human
@RahmaniaCintik	org
@Pure_Elm	unknown
@bex7176	human
@lunamaria87	human
@OliviaBaranes	human
@serggiiovc	org
@ClementineDaily	human
@John4507	human
@GirlSipsWine	org
@edoeding	human
@ajrl_29	human
@MsUniqueBeauty	unknown
@LonDan	human
@dekil_3b	human
@MantamarBC	org
@omoshiro_vR3Fp	unknown
@MBTAInstagrams	org
@Sean_Koski	org
@TheEfahyasmine	human
@TheDiningRoomie	org
@TheHippieNerd	human
@lucabagarolo	human
@BonitaBoogie	org
@lux_line	human
@dyandrarara91	human
@IRenepiii	human
@tikanaomi23	human
@ryanathorn	unknown
@james00008	human
@chingface	unknown
@rusonda	human
@B_Kruise	human
@BettyAnnQuirino	org
@docwaller	org
@AbsoluteSpice	org
@carito_jauregui	human
@3ShipFormation	unknown
@dvreisan	human
@Divazincmeke	human
@schumilova1990	human
@RestoCo_in_Oslo	human
@luscious_s2	unknown
@SelmaRomola	human
@shy_gal12	human
@impaulamadla	human
@soojung_f16	human
@KettleandTin	human
@Muneeb_Ul_Haq	human
@florinebchq	human
@ElvyJRodri	unknown
@iTsmsTir_russel	human
@Bea_Awesome91	human
@HappyNoodleTV	human
@akaalexmac	unknown
@RichardPGH1	human
@Julieabante	human
@jordanmcd	human
@Doitinlondon	org
@mycn_happy	human
@cheyserkae	human
@URANbUS	unknown
@Kaziiir	human
@Ciel_dia972	unknown
@Clawds	org
@HollyMcGill	human
@FlorezBarNGril	org
@dazazid20	human
@FlappyTeam	human
@HandyMcnutt	unknown
@krizfitri	org
@foofoo_tei	org
@realtymaria	human
@Wiggle_Waggles	unknown
@CarmenC_	human
@jessicanwood	human
@instantbarbie	human
@aubrey__law	unknown
@ellepennerRD	human
@CrossfireUnity	human
@dzideesdenana	human
@SamiraSamira1	human
@CelotehBandung	human
@ikaikaspace	human
@letsunwindxx	human
@eatinggoodfood	org
@uxo1894	human
@straw09baby	human
@k_cai0806	human
@ishmendoza4REAL	human
@Gabriellaellis	human
@Eat_Car	human
@jazzymbf	unknown
@ettamarielove	human
@romesf415	human
@akbske48rena	unknown
@WorcesterLover	human
@Matteos_Photo	human
@leidy_boscan	human
@cupcakesinrome	human
@tobivard	org
@Tumi_Manamela	human
@genecell	human
@thierrysibarani	org
@megminmi21	unknown
@agnestelianto	human
@jiongjiong92	org
@no8kitchen	org
@kenichijosh	human
@TajMahalMumbai	org
@xiamensi	human
@ChaseThomason	org
@fiismoos	human
@LammDonovan	unknown
@mahchamberlain	org
@audreyfromont	human
@DENISEVASQUEZ	human
@BOBBYBALBOA75	human
@ClassicSeagulls	org
@DEricsonPR	human
@BeeZyRecords	human
@fbmkk	human
@CoachCorrieMac	human
@Lplcommdistrict	human
@WillianAleman	unknown
@PinkLabor	human
@TheOnlyJerzey	human
@y0u5u0k1i	human
@roseandomingo	human
@shuenKamaruddin	human
@mioxoxo925	unknown
@ixDeelicious	org
@winsoar	human
@Gov_OneShot	human
@JArdoin_814	human
@DoddingtonHall	human
@KALMA_BCN	human
@MarvinTheBomber	human
@RyanMarquida	human
@MyBitsandBleeps	human
@blogfia	human
@mredinburgh	human
@FaisalAlhozaim	human
@Cindytambo	unknown
@mehntalsis	human
@bike_strong	human
@JumairaSpice	org
@apkangas	org
@philipnichols	human
@allyj69	human
@RosalieDech	human
@luna_malacutie	unknown
@object_company	org
@PopolizioAndrea	human
@PrincetonMerch	org
@alfons3992	human
@ITS_da_QUEEN	human
@BradChampagne	human
@paigeey1993	unknown
@MilesCate	unknown
@gene_bdc	human
@TheYogaBeeHive	human
@robyrosati	human
@JulesRenae	human
@linkinbee	org
@jackyflk	human
@julyannanatalia	human
@MrsSBeasley	human
@GT_Promo	human
@SeanMyrand	unknown
@xuani_	human
@DayangRathnah	human
@xaviercoiffic	human
@PHLovesLacquer	human
@rogerloayza	human
@ADANIASBoutique	org
@ac1773	human
@basten1016	human
@Samantha_lwc	human
@Remedios304	unknown
@Alissjacky	human
@gmoylan	human
@aveef	human
@Pichuberry	org
@FitnessAdd	human
@JamesDerouselle	human
@BrendaVelasco89	human
@Julie_Clark21	human
@hiekal81	human
@Daily_Drinker	human
@TasneemDhukai	human
@giannacaputo	human
@mirasuhaimi	human
@LizzyMac	human
@tatertot374	human
@Markesavan	human
@amplllamp	human
@ChrisSitorus	human
@ChefJohnDeLucie	human
@allison16484967	human
@likeme247	human
@RainyMacaluso	human
@radeknoxville	human
@iHRH	human
@DenRawwwr	human
@JordanAlexis007	human
@kaky_MH	org
@nutrtinclub	human
@chiarabiasif	human
@denainjapan	human
@MCoill	human
@JMaritaly	human
@Lukey086	unknown
@BittersBocknRye	org
@fitfunfoodrun	human
@maryhanson	unknown
@divya22seth	human
@putri_CMS	human
@JasonAKeenan	human
@FoodUnderFire	org
@ha_na87	human
@seevggi	human
@MsNatashaWarner	human
@kazcuz	human
@ParkinnPB	org
@NatsYummyTreats	human
@carlajmm123	human
@TwoTenOBG	org
@LittleBitsofLov	org
@gordonreef	human
@asshuu100ni	human
@IcemoonPromo_PT	human
@bxgthxiv	human
@CBSNewYork	human
@OrganicPrimal	org
@Victory__R	human
@Deveous	human
@ATastyHike	human
@iammissmulan	unknown
@MissDoing_Me81	human
@EamaneNox	human
@andrymanrugaga	human
@fabelation	human
@Arealtease	human
@eRuwPitHria	human
@littleSpoonCLT	org
@boognhagen	human
@mahgulrestaura1	human
@bateaurose	unknown
@GeneFWuThailand	human
@RestoShow	org
@TapperijTeun	human
@mephisto19lomo	human
@MoringaWorkout	unknown
@CoachMisti111	human
@SSeafoods	org
@_HOANGIIE_	human
@ItsJustDe	human
@PiaMopo	human
@KenixVamPireX	human
@erid_amaro	human
@craigfraserwood	human
@LeahLee02305189	human
@Insik01	unknown
@LegendsShopping	org
@RhiannonBlog	human
@marcia_aysel2	human
@honkong_bestpic	unknown
@nealbrothers	org
@RixosHotels	org
@JMPandD	human
@whysee	human
@omin_97	unknown
@epicuredubai	org
@AVintageLullaby	human
@INSTAJESS	human
@GoingCrazyNick	unknown
@pollypencilplow	human
@CJayZhou	human
@MissBlissLashes	human
@MelOnionring	org
@AdaLakutkina	unknown
@seatoskytraffic	human
@GNColchester	human
@FrauWundertoll	human
@voiceofmercy	human
@CaseyDolezal	human
@yuyu_razali	human
@dude_macha	human
@LaflammeFrancis	human
@darlingclems	org
@kellychantique	org
@teeruk85	human
@imohammadhasan	human
@Jggamao	unknown
@EdurneXaus	human
@n3v33d4h	human
@jjjeenh	human
@dietinthecity	human
@JessiMeimei	human
@azucarsf	org
@gymakoda	human
@iannonelisa	human
@fussyee	human
@wrbputri87	org
@syark_kebaboomm	unknown
@ladyinchgo	unknown
@RealSports	org
@DaciaLene	human
@Indie_Kitchen	org
@TomasNovillo	org
@ninaniena828	unknown
@LPQLA	unknown
@mgrorie	org
@azietahir	human
@PLANIT254	human
@subbook	human
@kjwrite	human
@djkum_y	human
@bve1234	human
@ArgaYo2001	human
@NikiScalera	human
@musizohebuvo	human
@gokhanalban57	human
@TwitchSharer	org
@Mini_Engineer	unknown
@eat_veggie	org
@YosuaOcsam	org
@TimsPlaceWad	org
@coquinaria	human
@MichaelLotfi	human
@GoldilocksCafe	unknown
@fhyzalhakeem	human
@AlexMXBaez	human
@UncleBodee	human
@AnastaciaPeadro	human
@AnneQuestionME	human
@Miyaxxx55	human
@Luv_03	human
@UrbanCamou	human
@AXLSN	human
@mariacorezatapi	human
@Eriggy_29	unknown
@szelesiza	human
@VickiiUlloa	human
@NaShall_Castle	human
@mirachanxx	human
@smunizdavid	human
@LaurraCatherine	human
@Natalie_M77	human
@Talkinfood	human
@stevengch31	human
@herfavfood	human
@Emma_Ho	human
@MidwesternGypsy	human
@TomHeap2	org
@tdlove5	human
@Bryan_FX	human
@ThePikeyLA	org
@leonitoothfairy	unknown
@ThisIsARS	org
@coprather	human
@CoffeetoaTea	human
@KawarthaMums	human
@moleculo77	human
@PRETTYBLAK	human
@Merupipipi	unknown
@YFirmante	org
@sneakydeeCREEPS	unknown
@adonis05	human
@KevinBednarz	human
@Suntimes_Splash	org
@tjohansmeyer	org
@WVirginiaLover	org
@joed	human
@jencloss	human
@GertsenPR	human
@Schoenesscheint	human
@IAmChefTodd	org
@ReCarloMagno	human
@RacingBananas	human
@JobsFromLanger	human
@trippyjedi	human
@gemmaclarence	human
@EmptyJang	human
@kibentee	human
@freedeaikei	human
@rita_depp	human
@HippieChicPao	human
@TABASCO	human
@kendal_tourist	org
@Jez_cee	human
@springallCE	human
@_93sarah	human
@TarteChic	human
@weightloss1on1	human
@RichJOverton	human
@FaatAlive	human
@FoozeApp	human
@AKittipan	unknown
@m9udn83	human
@VelvetCalgary	human
@AmoreMioCaffe	human
@RedTheTrucker	org
@SevenSundaysMN	human
@Ploonge	org
@IrelandCheck	org
@CarpeNux	org
@kimbeepasquin	human
@StVincentResort	human
@Chumbak	org
@Trine_E_Olsen	human
@mema_horran1D	unknown
@YuyaEyqa	human
@bellawella59	human
@MormorJan	human
@ddanno39	human
@ladykingadejavu	human
@sssseimi	human
@CafeBlueJA	org
@RudysTenampaKC	org
@nicolesaidwhoa	human
@mekemeafool	human
@BlackSheepTix	human
@framptop	human
@charlee_buns	human
@micmeronemua	human
@lukaswijanarko	org
@ImChloeSlater	unknown
@Eat_Out	org
@LeCreusetJapon	human
@thewickedSin	human
@ars_1492	human
@Irisramosm	human
@Fifinyiri	human
@pokorna97	human
@Joana_Vieira10	unknown
@URaStella	human
@BrunchWithJoy	unknown
@ricyaryuk	org
@SanyaG_1	human
@HBFitspiration	unknown
@YowDanise	human
@Danielle_Crepes	org
@dragonztoh	human
@QueenofHeartsx	human
@stylecrazeindia	org
@KermitsBG	org
@flirtyman2	human
@maricutii	human
@jiinggwenn	human
@RRVCupcakes	org
@VickysMelody	unknown
@ihop_ph	org
@justsopivasti	human
@iamsuSHING	unknown
@beepouzank	human
@jcradle	human
@TourdeFresh2014	unknown
@va_va33	org
@MamselleLaurie	unknown
@beckimasseyxx	human
@SiawJean	human
@Souppyah	human
@victoriaortiz	unknown
@VintageWorx	human
@angelaschoolcra	human
@PBCrave	human
@mrtimncorrigan	human
@LetsEatLK	human
@yutoppp	unknown
@AMVLIVEVENUES	org
@akfagan	human
@TeamIsabelli	org
@SoulFoodProject	org
@Tristensmama65	human
@AllynsTruth	human
@LeHappy	org
@sarkiste94	human
@MilindJada	human
@vladrums	human
@NeuvooOrlando	org
@javier_munarriz	human
@DJGBillington	org
@OXO	human
@Castle_dairy	org
@jose_david07	human
@ainemct	org
@WineCountryTW	org
@ThunkSkunk	human
@Sasha_Verb	human
@keshia_east	human
@mycanadaeh	org
@LanaLawrenson	human
@Farracheetah	human
@ChicoCrush	org
@bbya517	human
@Haymarket840	unknown
@gleeee31	human
@gonpola	human
@LeoteLee	human
@casperkoggens	human
@andratsmith	unknown
@tasha_sm	human
@purpaulapoppins	human
@nagahashiaya	unknown
@VercTess	unknown
@StonehengeScene	unknown
@mgreenhalgh1	human
@ynahdanica	human
@saridelmar	human
@phoenixfire615	human
@JamesKoroni	human
@steph_marston	human
@CresenTiana	human
@Mayasbigglasses	human
@RikoKaine	human
@DinoNahumury	human
@tiarachsalim	human
@lulu2764	human
@wesenbergre	org
@fionad03	human
@margarethines1	human
@polaroidmoments	human
@crumblyjas	human
@tsickles321	human
@ddutdave	unknown
@Dabby1220	human
@AcerolaMa	human
@YaseminRichie	human
@Night_Omega	human
@Quibbie_	human
@ShadowDogDesign	human
@ladyjinkie	human
@mcd_joplin	unknown
@Gooley83	human
@mbang_vet	unknown
@DetoriousDe	human
@webeehaananto	org
@TheSueMee	org
@theAAoAA	human
@TheGlamCorner	human
@DrNovellus	unknown
@alphachetsoup	org
@serene_rene91	human
@RaegenTyrer	human
@micheleleeberg_	human
@EggFarmersOnt	org
@neilathayde	human
@EasyOnUrPocket	org
@nicksplitter	human
@RTeamDetroit	human
@ScalesCocktails	org
@batakym6x	unknown
@farahbk95	human
@NYNDA	human
@VillaggioBread	org
@Phioajah	unknown
@kemmiemoore	human
@knuthen	human
@MeatingPlaceCDF	org
@LamplighterOC	org
@V_R_E_Y	human
@OwensMommyRocks	human
@underlondonman	human
@blackcatrichie	human
@SereneSeeYan	human
@JessRath	org
@SEA89	org
@_YaniM_	human
@WATERSEED	org
@YourLittleDubai	human
@sue_tangomango	human
@SouthbankBarWB	human
@vontadesingular	unknown
@EHR0N	human
@RootieFoodie	human
@Dazzle485	unknown
@maiabey	human
@GiorgiaSibau	human
@Sean_POG	human
@RomeforExpats	human
@Nature_Fresh	human
@RameeGrandHotel	org
@mackerelmatt	org
@DistrictOvenTO	org
@brendapoopscoop	human
@SGU626	unknown
@Kleidermaedchen	human
@yuu_nyan0609	org
@EnligtAngelica	unknown
@Devilcified	human
@LydiaHall1994	unknown
@Kiikiey	human
@BBBbyKatie	human
@mrarthurious	unknown
@P31GIRL	human
@Viamarttha	human
@heygouter	human
@yanlaw	human
@numeros_unoz	human
@KinsaleOnline	org
@jsquaredink	human
@Mairun	unknown
@Alexx_AndraM	human
@withMagda	human
@anniexkuo	human
@planetelldrew	human
@danilorodio	human
@LIB_ertybell	human
@sophiemarie666	human
@HuiyiTina	human
@Snemally	human
@JesseLipe	human
@kuni_yamaguchi	human
@InOtherParts	human
@lksolima	human
@maryrosetacuban	human
@backstagecafe2	human
@dyochabi	org
@Helin_Aytac	human
@Xaven101	human
@Vsplyshka	human
@CafePapi	org
@hi_citla	org
@wookie300	human
@stefaniahsucre	unknown
@willowwisp74	unknown
@mouthshoot	human
@chefprocrown	human
@DazzleKaoir	human
@Baubles2Bubbles	human
@iffi_nur_ain	unknown
@thebeatlehotel	org
@MaferCaceres9	unknown
@AncReporter	org
@EstherrGihae27	human
@joel_corpus	org
@Helvecia18	unknown
@djltaga	human
@RadissonBluAqua	human
@sancarlofficial	human
@lebellexx	human
@jhayvague	human
@preezydakid	human
@ItsdivaD	human
@iamjamlim	human
@__EVS	human
@CCMCANDLES	human
@krobinson5788	human
@zamzuriabdmalik	human
@chriswotton	org
@KatherineGF	human
@IGA24H	unknown
@kevinbaranao	human
@lisaalinh	human
@fitterworld	org
@pearly29	human
@SmilesNSunshine	human
@JimJ	org
@CDMonly	human
@officiallyimjem	human
@065mK	unknown
@brilliantshine_	org
@unknownvirgo	human
@AletaTrue	human
@Luknutz78	human
@povyteng	human
@TracyKaler	human
@glowallie	human
@Redee33	human
@Pinchusa	unknown
@ohjustfrog	org
@lucia_milagros	human
@TheBoutiqueRE	human
@solutionprintz	human
@JoeyChin411	human
@carolynjbraden	human
@Kim_Schon	human
@palesighx	org
@MuffetRBoyle	human
@BrettDelgado	unknown
@miyare38	human
@anggittaaa	human
@cui_vs_kitty	human
@kayeeRN	human
@mercimid	human
@S2Mstation073	human
@VinayNBathija	human
@dheaqotrunnada	human
@FratellosGL7	org
@cinzluvpink	human
@mohdalhamadi1	human
@frankiedunbar	human
@BuliG	human
@JoJoMcColley	human
@myprivatestocks	human
@healthy_life5	human
@DannyR07	unknown
@LifeisPoppin	human
@itskhaledmd	human
@4lexKhan	org
@adrianjkshum	human
@bryantroossel	human
@seededtable	org
@eddy44848	human
@fadelamecheri	human
@Sammie212009	human
@Wison	human
@barkTHINS	org
@jvhradionet	human
@MesielD	human
@BaRed_Denver	unknown
@AnanyaSave	human
@JORDANARIAS8	human
@ShopMerrickPark	org
@VisitHeswall	org
@Parthuu7	human
@OfTeflon	unknown
@nelson_xw	human
@BEYOURSELFWELL	human
@v4jhm	org
@ss_wellness	human
@SplitBread	org
@YuNaYuNa714	human
@PaulinaEmCee	human
@ineedmylipstick	human
@kimyhwang18	human
@timchew	human
@PizzeriaDaMiche	human
@MamaB4209	unknown
@AubrieSpencer1	unknown
@TravellingBobs	org
@foodsaurus	human
@SOUPSTARTW	human
@LeeDTonks	human
@eastiekitchen	org
@Macon4Lunch	org
@itelhere	unknown
@ingridandersen	human
@ezadmajor66	human
@piccolino_bram	human
@ebar2010	org
@BenfleetFlorist	human
@reggilicious	human
@Supergal007	human
@PineValleyDairy	human
@ArmarioyEtc	human
@OprahComeToMKE	unknown
@JoesLiquorCT	human
@IAmWhoIAm_SKOOT	human
@jay_jay089	human
@thelizzyukz	human
@fesha_casti78	human
@EmilyDarcyAdams	human
@UNLDigitalarts	human
@SammyViolin	human
@_justkuks	human
@akoamira	human
@3riky	human
@madiansandoval	human
@fionajdawson	human
@RachelHolmes	human
@LottieEdmondss	human
@iamrobc172	human
@RoseMartinez721	human
@carol_denton	human
@linzeex0	human
@LHBCarolina	unknown
@ShivaayDelights	human
@WoodlandsVB	unknown
@bethofagirl	human
@parisfinesse	human
@LORILEESAMSON	human
@onewiththefood	human
@upstatmissy2	human
@alexandra_cam	human
@yourplateonly	org
@audacious_ace	org
@gigimaire	unknown
@_sativakush	human
@itravelwithlove	unknown
@ginger_sofya	org
@LoveFromTheOven	human
@brandandbuzz	org
@ZeilerTara	human
@SHMOKEY	org
@MavenOmega	human
@NicolaDenyer	human
@alyssaandrino	unknown
@MissCJC86	unknown
@brownbeauty35	human
@JaimeNadine	human
@famousmailman23	human
@GinaRoseRF	unknown
@simplygloria1	human
@Hindrelations	human
@laugh_sick_10	human
@eldika_keyora	human
@FoodologyMaster	human
@ElenKolt	human
@fefefly	human
@RhinoCarney1	human
@NibsnScribs	human
@AALAMLLCTV	unknown
@HollieSyd	human
@c1assic80	human
@Cruzah5	human
@fukutoshin	human
@VictoriaGallan1	human
@PrettyFace_A	unknown
@butchiboy922	human
@iondecorating	human
@saltmeatscheese	org
@laurahinderaker	human
@SplendorRoma	org
@voinaw	unknown
@MojoMucho	org
@mybalaji	human
@garygaz1978	human
@T__Aiya	human
@BurkhartArellan	unknown
@Obrilicious	human
@rosquete7	human
@alignedsigns	org
@Wii_Jai	human
@MindBodyChi	human
@iBookLove	org
@barrylawson07	human
@da_sukiya	human
@wenoucare	human
@BarbieShandy	human
@PopRoGen	human
@RipleyMcFly	human
@AlicePotenza	human
@fivepalmsaz	human
@WilliamD_IV	unknown
@tantribenarto	human
@KathleenBaggio1	human
@mrandmrs_amos	org
@Giovannini8	human
@48bsloaneR	human
@Jossassy	human
@tomoog11	human
@genc_mavi	human
@Mal0rieP	human
@latinprince	human
@ana_brambila	human
@thaiselect_ca	org
@iamfayee	human
@fabriambroso	human
@Althofi	human
@SamMrSleek	human
@lusiarnesya	human
@shoestringtrip	human
@MarysiaT	human
@sarcasticcook	human
@pbkup	human
@ForwardSpace	org
@Sifibeats	unknown
@BreadAhead	org
@DavidCSTHousing	human
@IsilKate	human
@HappyMama_NNJ	unknown
@meljoyharvey	human
@collegekid_91	human
@vegantarier	human
@JamesAntoCoffey	human
@zzazainal	unknown
@rynn80	human
@goodljournal	human
@MysticManny	human
@Adalida	human
@doriecelcom	human
@chefjup	human
@farafazleen	human
@Cuchara7	org
@MattARinehart	unknown
@Criky_90	human
@HomicidalVEGAN	human
@kunicobejo	human
@NanciVazw	unknown
@MercifulWisdom	human
@lovexyzjebs	human
@cloud_ka	human
@Ro8ertTs	org
@jubeljember	human
@lovenikki09	unknown
@sarina_kava	unknown
@getsavingsuwdc	human
@dannyboykiev	unknown
@TOIHealthNews	human
@karly_glenn	human
@FamousPixs	human
@Steps2Nutrition	human
@littlestylist	org
@JordyGarM	human
@Marjani_amore	human
@yeevenus	org
@THISISVT	human
@justrivals	org
@eekie75	human
@April_Barnett	human
@SSSammiSue	human
@eddypierre	human
@beckyweckers	human
@Fiena_Phie	human
@OctopussyHowth	org
@Nattsvarium	org
@stsubacey	human
@jackwatson05	human
@Ki0510Surfu	human
@nitaalnora	human
@truvia	human
@WorldofKelli	human
@Housewife_Mom	human
@joncarbungco	human
@SukmaUpDate	org
@Jammibabyyy	human
@Ahmedhaggag	human
@DianesTalking	human
@prettymommyceo	human
@Evitamieke	human
@MrsPumblechooks	human
@Juneau32	human
@itsakeeperblog	human
@yurin_1404	unknown
@rycaquino	human
@SayCheesePhilly	org
@DonnasStuffMore	human
@cgarceau13	human
@DurazzoImma	human
@CellDMG	human
@yummyfeeduk	human
@fina2102	unknown
@angelogiliberti	human
@NaZy707	human
@LEOSTARZ	human
@slugcornerhouse	org
@LauraVissers	human
@LetiColombi	human
@MaherRizwan2014	human
@TomDaBomb7	org
@TweetDSC	unknown
@donajiespinoza	unknown
@CecileWallt	human
@jheo10	human
@LonerAhCong	human
@BoomBamLos	human
@manueldd_23	org
@UNFICanada	org
@ChopStreetLDN	unknown
@Gorenje_UK	org
@CMedellada	unknown
@arienvalo	human
@AllisonDorsett	human
@eloisethinksso	human
@kagemori_ohgiya	human
@SuwandiNie	human
@FoCo_Cafe	org
@212asskicker	human
@PimentOiseau	org
@czedx	human
@shane4688	human
@vilmicrissien	human
@BowsandGirls	human
@nikkigardella	unknown
@Maeja_Movez	human
@CornellMilitaru	human
@marinaaaaborges	human
@Lola_Dashuri	human
@keyofjae	human
@jRamirez000	human
@heathbecks	human
@karthik_sripath	unknown
@bleixenrumbau	human
@xblankbird	human
@Becca115	human
@amperture35	human
@410jaglady	human
@ResourceLegal	human
@BigChiefBeef	org
@thinkasaurusrex	human
@yudhitaprawesti	human
@Val_sudrajat	unknown
@RANAkbw	human
@mnishi0622	org
@OliveanB	human
@arnaudthery	human
@gilv	human
@brandon_1388	human
@JuleGeng	org
@cj_buzzM	human
@ma0721yu	human
@Unocodrinks	human
@IrlTricePhoto	human
@bone_daddys	org
@Dyona_09	org
@JWMarriottPune	org
@AlPortoItaliano	human
@katierenee88	human
@Pashanov	human
@MikaChu254	human
@TheresaBernabe	org
@27KARAT	human
@GinaD_316	org
@danielleXart	human
@VinusandMarc	human
@TheQuarterNYC	org
@lolypopkitchen	human
@gettinpaid4real	human
@IvanDSEO	human
@TheGeneratorCa	org
@thakingcruz	unknown
@SwaggerScan	org
@ButterEggRoad	org
@cestsibontruck	org
@hayleymcalister	org
@OdysseyMG	org
@romanempire1213	org
@acidtainton	human
@nytrixKushFlo	unknown
@zeppy_dog	org
@OhRioFamily	org
@alextweeting	human
@Cloutman	human
@Edwiin0396_	unknown
@Rosalinaalii	human
@WhatGabbyDid	human
@iyvettevargas	human
@ShannsView	human
@HassimCafe	human
@NicoleWhitelaw7	human
@rambeau76	human
@legrand168	human
@cynthiaakwon	human
@CarlyFarlyFay	human
@xaviyau	human
@joshbagofficial	human
@LANGMarMendoza	unknown
@YYZMag	org
@aj_arnauld	human
@noemi_bujoy	human
@laurareginz	unknown
@derickbernardo	human
@omaki53	human
@KierInIowa	human
@OneMoreDish	human
@Ala_Lemon	human
@R_Assal	human
@theeKemper	human
@nikolatosic	human
@EmilyRaw2	human
@chiyow28	human
@ilhan1871	human
@theonlypaulina	unknown
@Butterfly_org	human
@viguychad	unknown
@OndhA	human
@VxExx	org
@mizupon_046	human
@Igotenery	human
@misstempo	human
@MarinaDuartee	human
@getsidekix	human
@jasonhuynh	human
@accelwos	human
@Jaynielicious	human
@HOOD_CLASSY1	human
@PPPPairRY	human
@lilianhiemstra	human
@OutWithLeila	org
@InstaGurzuf	human
@JeSuis2much	human
@villamor	human
@AllieBornstein	human
@0924_kana	human
@jm619	human
@Dolce_Italian	org
@BongoJohnnys	human
@Vfleischlust	unknown
@MarlaSwoffer	human
@marthabrooklyn	org
@hairandtheir1	human
@AlwaysEating__	human
@JodieFrances	human
@KatieMacBK	human
@shankarmitra	human
@AfanLodge	org
@afro_staner	human
@dxbdiva	unknown
@ceddynyc	org
@windylaa	human
@theonlyYuan	human
@connitalupita	human
@Lucadistanio	human
@agungrinjani	human
@pcastillo17	human
@ianfits	human
@Asif_YYC	org
@mydietreview	org
@HemsleyHemsley	org
@robwmedia	human
@jujuallover	unknown
@newsnowtrending	human
@bestofverybest	human
@Charl0tte_BB	human
@gljksr	unknown
@alittlelyrical	human
@viaggiareapois	human
@BernaNeyisci	unknown
@TweetMelG	human
@windenburg9513	human
@kerriheather	human
@dialoque	unknown
@elainewying	human
@AiEvelyn	human
@cmaskeroni	human
@SilverSporkNews	human
@jiwa_food	human
@whiskeyqueen	human
@ReganAnnT	human
@BakersAndBest	human
@TheCryingCook	org
@Duswaterpolo	human
@Fanieee_	org
@ROBOBRODRIGUEZ	human
@SIO_phisticated	human
@450bujin	human
@emreozturk57	human
@renzpo15	human
@FoyleFlyer	org
@LinzBrooks	org
@dneveu	human
@OfficialAffe	human
@andrewzimmern	human
@EmiliosAlmostFa	org
@asyrafrizan	human
@lovellpr	org
@jeeyahtisuru	human
@missalpao	human
@raysanjeet	human
@Gastronomical_A	org
@Turnitinsideout	human
@Caribbean_Blog	human
@Pching0701	human
@foaone	org
@EmpireDogsUK	org
@adina_bocsa	org
@leonieash	human
@FromRecipe	unknown
@crassshintome	unknown
@AMillerFoto	human
@ClaudiaAshleyT	human
@ajgiacobbi	human
@thepaxmachine	human
@mehandi82	human
@Lalessandra7	unknown
@LadyLaura79	human
@yamatoma_kojiyu	human
@FornoPizzeria	org
@terrytravels1	human
@SyaSaari	human
@TheHouseNY	org
@simuulka112	human
@culinaryhealing	org
@Vgrillmuseum	org
@holdthepeas	human
@MessHallCanteen	human
@aceimage	org
@DellHalliwell	human
@JayStackz313	unknown
@DVineChandler	org
@bedlamNdelirium	org
@JacquesClarijs	human
@RYOmen_Humming	unknown
@GezondVBU	human
@rhumphrie2	human
@ASHgweeedo	unknown
@NikenPriyono	human
@jammyjamshaggis	human
@marliyantibahri	human
@viniQueenmeLon	human
@SheratonHyd	human
@rinkito88	human
@basilandoil	human
@Naaaoki1130	human
@tyannaa	unknown
@jessamaedarle	human
@charliejburness	org
@ArturoCastill00	human
@Raquelmjackson	org
@TaniaUncensored	human
@lokovaako	human
@robblee	human
@Rulini	human
@SirMillian	human
@ghadayami	human
@AprilWright5	human
@FLXCoffee	org
@CIRIAAERBA	unknown
@kaiyah_jhay	human
@Erie_L	human
@NYCWAO	org
@RCityMall	org
@philipsfree	human
@LemonaidLies	human
@NicoleRice10	human
@613style	org
@juniors_world	human
@sophie_hyam	org
@JustHeff	human
@keyholeespresso	org
@SpaResortCasino	org
@comicnate	human
@mikeihere4u	human
@DetroitSEOExprt	human
@ladyemsy	human
@FleurishImagery	human
@joel1510	human
@BrownsSocialize	org
@mvpics	org
@YesBrixham	human
@C_WOL17	human
@soccer_boy_WC	human
@KDubWard	human
@gabrielgordinho	unknown
@Mathild_Mercier	org
@vickybracho	human
@compaanita	human
@JAYelko	human
@PinklLeyla	human
@antoniomarielle	unknown
@djyimin	human
@dphourigan	human
@jocelyn85419	human
@uchieDW	human
@_ExoticDoll	unknown
@InstaKrskAkadem	human
@Nobuhiro_Sato	human
@bluumanchester	org
@bendrumin	human
@ClaudiaEvaMaria	human
@HowToLove99	unknown
@cabby08	human
@Ixodoi	human
@ilipapageorgiou	human
@mahomiebeat	unknown
@NaddyNg	human
@ekarisantyputri	human
@mikuchoco0510	human
@belmondomx	org
@millicentnnf57	human
@SeanLDurham	human
@_SAORICH_	unknown
@kevinives	unknown
@clefis	human
@TripWhisperer	org
@keisuke_yoshida	human
@bcmouser	human
@pablodicken	human
@MrHotells	org
@Ditchykay	unknown
@TheCulturePearl	human
@lynnahlynnn	unknown
@ChristineFang	human
@LOLACHYNADOLLZ	human
@UNBTME	org
@Monhautecouture	human
@Alex_____Wilson	human
@EnjoyRestaurant	human
@_Temoche_	org
@TheRiseIs	human
@Sprizzo_Vlc	human
@MariusSoU	org
@FitnessFreakk1	human
@RoderickMndoza	unknown
@chenmay1005	human
@yorkiegirl007	org
@becky0020	human
@UseYourLoaf1	org
@Najeero	org
@JennaZim	human
@sato_59	human
@DrMichaelMol	org
@Deathbycandy	human
@coveDC	org
@shimeikomatsu	human
@ZeomeyMeoki	human
@yenniferpenadr	human
@raetheenigma	human
@KazeTsurumi	human
@iJuA	human
@CinnSweetShoppe	org
@BrianaLayfield	human
@meals_baroncort	org
@lezpezdimepiece	unknown
@angeaud	human
@solo_noodle	human
@MKDMastronardo	unknown
@aprilhubal	human
@NanaMilkTea	org
@Miotechi19_	human
@MauroPortillo	human
@lidiakellie	human
@RevivalPhotos	org
@MaiteHeras	human
@Juelsofrome	human
@TonyCDKelly	human
@Rradrienne	human
@ArlingtonCPRO	org
@4eva_Precious	human
@RangnekarTanvi	human
@haileydryburger	human
@Romeo_Hotel	org
@robpotograpi	org
@MommaYoung	human
@thespottedpig	human
@SACKgluten	org
@georgia_meacham	human
@CapitolCellars1	human
@itsmegretcheee	human
@oggyforry	org
@Sassy_Bish_	unknown
@dellihyunaa	human
@hiddenfruitnveg	org
@AddieWuensch	human
@CHospitalitys	human
@KikoFLAPJACK	human
@nutrio41	human
@Orishasound	human
@PaintedBurro	org
@1tayyabs	org
@LaurieWalker7	human
@shelleyj85	human
@riarearia	human
@MondoTaco	org
@RugbyxLover	human
@JuliaGirl715	human
@geophf	human
@TheParlourBar	org
@Mividmaker	human
@DivineDCatering	org
@alamodedesigns	human
@izrawr	org
@pattykuo930	human
@VampireMony6	org
@KaliGuin	human
@widyoaptantyo	human
@akidahood	human
@jbchang	human
@eMazingDeerfiel	human
@TacomaKen	human
@richardjackson3	human
@foodsandme	human
@iRudiFL	unknown
@MrMccGoo	unknown
@_RealestYet	org
@VizualDope	unknown
@DreamySim1	human
@geeelaaaii	unknown
@maricelspbueta	human
@jomaire	human
@one_step_closer	human
@Tony_Kwong	human
@BritishHc	org
@1527_rajshri	unknown
@NATASSIADREAMSX	org
@erinnsimon	human
@dinneraday	org
@Haleyadair2	human
@limcharyee94	human
@LOVExtraRomNews	org
@ummuruqaiyah	human
@VFashionela	org
@Rosa_LindasMex	org
@lucy5137	human
@biwakko_sakko	human
@JPaquetteNY	human
@Benitez221	unknown
@mkcol	human
@Rainboww69	human
@ticov161	unknown
@TheChahatt	human
@bedoy102	human
@Sam_F5	unknown
@2createme	human
@hechi0824	unknown
@IamKarines	unknown
@RaulDGonzales	human
@redsuitee	org
@shesgotatickett	org
@CookpanionApp	org
@MDFoodBlog	human
@Tchakayiti	human
@bbcweather	org
@Jhenny77Marin	human
@Tresinhaaa	unknown
@choc0lei	unknown
@HealthCompare	human
@ioanamartin	human
@amirahfaridza	human
@partysick	human
@getfitkenya	unknown
@yemekneredeyenr	human
@MaddeCali	unknown
@Blandosa	human
@lolitabrigante	human
@JeremyKennett1	unknown
@jrandrews72	human
@Portland_John	human
@CeceCalabrese	human
@bryangraf	human
@TSelvaggi	human
@posermanda	human
@lysyrypejite	human
@heartniagara	org
@whenwespeaktv	human
@drifter0702ayk	unknown
@SaadeHungary	human
@ximeebandini	human
@TorriJ	unknown
@Bray_Baby	human
@maizatulnazrinn	unknown
@0831_oku	human
@m_a_r_i_0_7_1_9	human
@Lukybulk	human
@callmeskinny2	human
@lindavidany	human
@AlanPerez7	human
@KayOiii	human
@erickyin	org
@costastone	org
@ChelleDuBose	human
@lacarli	unknown
@AmoreGlasgow	org
@CrisFoodBlog	unknown
@joanamrosado	human
@Jay2DaKellz	unknown
@t_ettinger	unknown
@dawnbonbon	human
@ImMartu	human
@TA_Fitness	human
@Liza_Lola301	human
@Laila_Angel	human
@FlyingBiscuitNC	human
@Valiolin	unknown
@Tvdekikiz	human
@cloud9_8	human
@86ashman86	human
@JadeEmma92	human
@DennyTesarova	org
@KasmitaFikar	org
@ryouuuuka	human
@laddning	human
@nancydellolio	human
@EnCaboMx	unknown
@Acquafortis	org
@FerrettiFoodITA	human
@TeenVGN	org
@axelweidemann	human
@SJ_Healey	human
@lisawaty29	human
@AIRMAXRMLVOL2	human
@TheVrealESTate	human
@ArqNelsonGarcia	unknown
@MaryleboneJrnl	human
@quillon_degen	org
@KittKatt_99	unknown
@Ogarytv	human
@drewgottswag91	human
@ricoplus777	human
@eroxursox	human
@dawatpk	org
@JustKevYTP	human
@omarsherifz	human
@blogpinch	human
@GladysMcInas	human
@crzylov4clothes	human
@Mert_Bozdag	human
@andianiSR	unknown
@ChanrithE	human
@cyressnolasco	human
@iollieleyva	org
@saywhagain	human
@BlametheBrand	human
@_Dubscribe_	human
@Lumaberry	human
@BWTF_Ben	human
@iAbdalla_MA	human
@Biehua	human
@bestofguildford	org
@ChrissyPenney18	human
@LilyLilKitty	human
@Didovski	org
@inmyskinnydream	human
@sugardadio	human
@MavenMeals	org
@phaiysk	human
@Royal_George_	human
@MyQ105	org
@thiathieun	human
@sadicamente	human
@Sweetestevents_	human
@tastefulbuds	unknown
@Juan_Kafka	human
@iamcrizzia26	org
@BetterHealthGov	human
@iMiglio	org
@Yina94	human
@BramLlewellyn	unknown
@_TheOldStation	human
@Ohshesoamy	unknown
@JohnJohnColer	human
@nata_dee	human
@missiesup	human
@eufrasiaatika	human
@AllisonNJacques	org
@atejoy74	human
@DJTipz	human
@eko_ivana	human
@kogiasgtdfs	human
@jichael	human
@fannysuen	human
@tutut_gurih	unknown
@PhoebeParke	human
@TinkaTinik	org
@blitarjubel	human
@peyton3759	human
@xDayDreamerzx	unknown
@czboogie	human
@thedropforge	org
@Paochiita	unknown
@juliaajennifer	human
@jennywren10322	human
@anniekruse	human
@HannaIbrahim	human
@BascomCarrie	human
@PaulRaynerFit	human
@HarmonyG	human
@MozellBilly	human
@miruton0723	org
@arinhan16	human
@david_earp	human
@WineDineDIY	unknown
@GoldPeakTea	unknown
@JimikaM	unknown
@DavidJClaxton	human
@AmyKTay	human
@i_m_reyes	org
@AliceWorsick	human
@rahult90	human
@joselafleur	human
@MyRoadToSanity	human
@HidayatJohan	human
@towmusings	human
@YasemenKW	org
@PrettyInsane143	human
@Jose_LitoQ	human
@alissaponzurick	human
@ArunasHotma	org
@G_E_Finkelstein	human
@LiiiiiiiiinDz	human
@LRYWIN	human
@sheminluv	human
@vivinjohnkurien	human
@johnkoh_au	human
@dylanuy18	human
@storm_juicy	org
@paolapezzatti	human
@streetkak	org
@altin__hasan	human
@pinkypeiling	unknown
@jessica19860121	human
@NadiaMVenere	human
@soribel5	human
@doraficher	human
@Elaryen	unknown
@lilmizzruby	human
@TiMEoFPoSTiNG	human
@SarahLizah	human
@HK2583	unknown
@PrimiWorld	org
@Lipxsticktwin	human
@Westcoast_Mommy	human
@allrecipestips	human
@BrakesIreland	human
@KoDeeCakes	org
@TheFoodGurly	unknown
@tjstpier	human
@datoikmal46	unknown
@CassyChavez	human
@BangaloreBhumi	human
@Sonkoerant	human
@dHeeAn1990	human
@Jog_On_Love	human
@BrinchuJS	unknown
@kusumawardani13	human
@qyu_pi	human
@greenphillyblog	org
@elena_mares	human
@activefueling	human
@yvette180	human
@mklc2009	human
@winnyjessica	human
@aldee_oops	human
@AdamWakely	human
@hollyjf	human
@ohxmegan	human
@Plantsrule1	human
@CS_CREW	human
@oppaioppaioppa2	human
@whatsupsammy	human
@fyqaarizsya	human
@chili_lili	human
@TC_McCarthy	human
@INDJuara	human
@edfitPT	human
@just0dara	human
@PumpkinLiu	human
@kidmike001	unknown
@Lelova1	human
@FRS_MoonHopes	human
@pizzarossaUK	human
@lindsayamabile	human
@manya2175	human
@blu3p1nk	human
@marklrosa	human
@IvyManhattan	human
@HenyaVegan	unknown
@LoveRawEats	human
@Styles1723	org
@AifStuff	human
@GuillermoFood	human
@cricket24live	human
@LimSpaced	org
@alexdepinto	human
@for91days	human
@mayoANDcheese	unknown
@erams7	human
@foodloves	human
@HellahPhresh	human
@WELLinTHIShouse	human
@BrightFieldNote	org
@EmmaWhittall	human
@chrismelotti	org
@BayEssenceBlog	org
@hamedsaharani15	org
@thatswutjessaid	human
@SophroniaDesign	human
@Alegria_alex7	unknown
@LISAtheKINGDOM3	unknown
@Ycia_828	human
@poletheworld	human
@MsSam714	org
@StephanieJWong	human
@jojolu2013	human
@bwild121	human
@Nanis_63	unknown
@oga_nt	human
@picsfromist	human
@LESCLOTHINGCO	org
@Tianna1989	human
@AmmyNS	human
@CivicScience	org
@lily_crawford	human
@yuno_728	unknown
@Cafe514	org
@NelPolished	human
@kevingab08	human
@GabrielMaaliq	human
@lambandlionyork	human
@KeasiPrescott	human
@hanyakay	human
@TheCrickettGirl	org
@Splendido_TO	human
@wagamamabelfast	org
@mysisterknows	human
@iamleobartolome	human
@triandrini_cw	org
@TiniGalle	human
@amandalong_1	human
@excampro	unknown
@jerseymikes	human
@nadiarrxo	human
@GauxmarLouise	unknown
@CatherinePorte1	human
@KatarinaSurjan	human
@DeasyDC	org
@jeanbrownill	unknown
@rosysglutenfree	org
@GreaseGoddess16	unknown
@elissecelina	unknown
@GoMan1403	org
@tyreasworldbaby	unknown
@Cindy_Hwang801	human
@eightjeannie	human
@Karinehnyc	human
@annarchy_blog	human
@izy_bostany	human
@teatonics	human
@Mr_Lucianno	human
@ThreeDRobot	human
@Guneetsiinghh	org
@ronyximenez	human
@MoiiV	human
@LaRuBra7	human
@sohostrut	org
@MacelleriaBondi	org
@MandaLioness	human
@getchoicys	human
@AhmadCurlz	human
@DessaDarke	human
@divaacc	org
@flintobox	human
@tallulah3112	human
@WellnessRebecca	human
@Caillean85	human
@GGsDeliCoffee	org
@tf6869	human
@104Inakisan	human
@GGDundalk	unknown
@2020GVTV	human
@JMNashville	human
@SimonSaysMow	human
@LemmyVedutti	human
@exnchu218	human
@Johnny_Lacerda	unknown
@RoxanaJullapat	human
@CavalleroKaty	human
@PerrineSvy	org
@FalconFarhan	human
@shailis_07	human
@rhonziixoxo_	unknown
@Romichilipepper	human
@anikis_sikina	human
@amyamoeba	human
@MK16SW16	unknown
@mebuzihulejy	human
@eritsukimoto	human
@xyntienveloria	human
@_toriisue	unknown
@MandyJade	human
@JenniferJIrvine	human
@eetschrijver	human
@Fitchick_nz	human
@HI_Kharyne	human
@freshtheblog	human
@rochumodeon	human
@ken_sakda	human
@masloots	human
@RuthElcocks	human
@roscel_v	unknown
@RestonTwnCenter	org
@zxzdzcv	human
@Karubermudez	human
@ValerioGuidolin	human
@Kittaayy	human
@StockyardsAz	human
@sparalasamigas	human
@PaBLowMoRillos	human
@archivetro	human
@ashley2922	org
@Lui_dVAP	human
@CBurmaian	human
@vera_moss	human
@erikwill	human
@RituReimer	org
@Jules_Francais	org
@lilyciric	human
@MonAmiGabiChi	org
@Lmoujahida	unknown
@LaidlersLimited	org
@ChunduruBhaskar	human
@pascatifa	human
@justin_coop	human
@boch4000	unknown
@CollectionsX	org
@JosephBenGarcia	human
@avaconfuzzled	unknown
@thevillageresta	unknown
@Joseph30Young	human
@Superstarr5x2	human
@sarahzimbo	human
@alex_trueba	human
@OswegoVictoria	org
@CMacD82	human
@naze_sinri	unknown
@EricaDiamond	human
@kirstywats	human
@Animated_Anna	human
@JonDKC	human
@DreiandJons	unknown
@riwolulelyha	unknown
@alindtiwari	org
@viajacomeyrelaj	human
@sydney_grossman	human
@WFMLakeNorman	human
@squeaker542	human
@Thebathpriory	org
@JulieMann01	human
@IndianGypsies	human
@get8rewards	unknown
@ElysiaHF	human
@Ariencilla	human
@Kangbumm	human
@WFMY	human
@GreekBros	org
@cutejenjen	unknown
@kleversonbrito	human
@ItzTashI	human
@Carolita_04	human
@Kingstersx	unknown
@LizziesFood	org
@Amiilu4	human
@aylaglass	human
@ShereeDeen	human
@pkJonJon	human
@Cloudsofcoton	human
@MarineBalmette	human
@raquelvl93	human
@DanielRJW	human
@DelMonteArabia	org
@marsims23	human
@HopSnobbery	human
@Oleta_Mari	human
@VAShopperDor	org
@VINTAGESOUL85	human
@mitzyathome	human
@_gogoparis	human
@IamNJ25	unknown
@gkmcfc74	human
@kimiibeanz	human
@voidmoney	human
@Fede_Zucchi	human
@HornyBlonde69x	unknown
@907SHAWTY	human
@troyshomebiz	human
@imperfectL_	human
@vandy_0v	human
@irisbilly	human
@RatnayakeChi	human
@SITAMAA	unknown
@Join_Savvy	unknown
@RupertSimeon	human
@veeeya	org
@ShelbyPolacek	human
@EmmieLulu	unknown
@Alcazaresto	org
@JFATS206	human
@sasopapp	human
@Prettymhae_07	unknown
@RockinSantino	human
@Wizznutrition	org
@heltryna	human
@ThePassengerTO	org
@thatbluejeansme	unknown
@VillaPenelopy	human
@gorby_lingad	human
@SaadiyatBC	org
@goldenboyatl	human
@trichert_95	human
@ImSarath7	human
@AlexandraBCohen	human
@TROYBOI143	human
@YuliFanloo	human
@weisheng0401	human
@MediaMaven3000	org
@SandySandmeyer	human
@PrincessModels	human
@DLGMediaNYC	human
@cezcachanelle	human
@vmakarova12	org
@AndinyCakes	human
@fortunadebbie	human
@viacullen2	unknown
@ShopEms	human
@BibicheNamour	human
@haywardo84	unknown
@cikguazamaziz	unknown
@MsPrincessH13	human
@latleger	human
@roderick8997	human
@dhiyaadri	human
@TominasCookies	unknown
@EddieCatzLtd	human
@MissBosson	human
@DulcieKirkwood	unknown
@Fariaa13	unknown
@HAROnola	org
@NewJingosrest	org
@Elizzy_91	unknown
@Aguss_Ballinari	human
@BarneyBlather	human
@just1morespoon	unknown
@dietlossuk	human
@BobbedBrunette	human
@chefjessicasd	org
@FreshAtMelissas	unknown
@gokcerkaan	human
@JBSCompanyStore	org
@coupondunia	org
@crasch	human
@tkohwei	human
@rosaritoatx	human
@mervynleung	human
@cateredbyjules	org
@beachpotatobaby	human
@HanBlight	human
@queensassysasa	human
@ZeishaK	human
@PreppyRebellion	unknown
@srz	human
@frndlycityxfit	human
@ujanojan	human
@VeganStella	human
@mao_stabalian3	org
@HeavyDiamon	org
@torourun	unknown
@DeeDeigher	org
@lucus	human
@sebekbicool	human
@lovelifenatural	human
@antoniadeluca	org
@anitab1984	human
@simpligodz	human
@Mennnah	human
@ZaraaZameen	human
@_lovechild__	unknown
@rita90	human
@BIGCCONSULTANCY	human
@stevenpastores	human
@AriDanialYeusof	human
@carotucha	org
@DisguisedFoodie	human
@DigitalDani21	human
@DCPA5	human
@mydailygreenDE	human
@itsSarahMira	unknown
@ernieborts	human
@niektwiet	human
@dcamargo75	human
@TheBeatlesHub	org
@sophiamusic	org
@suleymanzdmr11	unknown
@MBPaperPackages	human
@haz2win	human
@SMARTgoalsBook	human
@RivieraBuzz	human
@MakaylaMacey2	unknown
@irrayyan	human
@Love_Starchild	org
@ridhuanmohamad	human
@Kira_chan93	unknown
@JaniceDCraig	human
@AJWillen	org
@millers_field	org
@Jillibean11	human
@minkflamingos	human
@missfrid	unknown
@necocook	human
@janetcassidy	human
@robicellis	org
@MIKAAFFANDY	human
@creative_ami	human
@tbchicago1	human
@Ak3ofCT	human
@Caligurlsd5	unknown
@LiquidRadar	human
@ZenkiKallin	human
@C_KittyCat_C	org
@Mike_Angelo30	human
@CupforCup	human
@liswth_obinmuni	unknown
@cngoolsby2014	org
@ginnnana	org
@MMJaye	human
@Soma_R	org
@Kouturely	human
@mygifttoyou2	human
@MelsBurgerBarNY	human
@Moe_halo	human
@mizzjld	human
@GourmandizeUK	human
@MsReeces	human
@Caram_el_ppA	unknown
@WBGiftShop	org
@AudiaTheMegaSta	human
@fabyfarma	org
@FitCwitzz	human
@mistgunlive	human
@indri_Melody14	org
@keepSAreal	human
@OSamanthaLouise	human
@BeautyByJLee	unknown
@EmiliiaAle	human
@Jayne1412	human
@RobeUrieta811	org
@gilagoddess	human
@_emilee09	human
@RafaCano82	human
@Stephie_xo	human
@Fortnums	org
@ElCan0	unknown
@GilbertEvents_	org
@PechezMedia	human
@curb_cuisine	org
@Officially_Hugh	human
@BrunosBrea	org
@NorthLeedsLife	org
@eclecticool	human
@iamjhoker	human
@DanielKalan	human
@ernawulandari19	human
@LMLifeCleveland	org
@julianrizk	human
@UrbanPhillyMom	human
@Thegeorgepatt	human
@RaquelRoldanMor	human
@armgabrez	human
@rosao21	human
@beckylovatt	human
@JaisMommy	unknown
@mohdsahrizam	human
@BostonOrganics	org
@AnishaRahma_Adi	unknown
@MartitaRodri13	human
@LindaModernThai	human
@moocchhiie	org
@arni_023	human
@vintageNsome	human
@wyzijaxokod	human
@janerioussteven	unknown
@cleanslatefarm	human
@km_tomoda	human
@scores_pub	org
@MrJonBurk	human
@MajorsAsher	unknown
@colorcoatedlife	human
@CharisReese	human
@Cleve_Leigh	human
@ohdelicatessen	human
@mamapnut	human
@flyingchefgeoff	unknown
@afef	human
@The_Scullery	org
@seon_thompson	human
@YokoMasatomi	human
@ViiMariie	unknown
@HamasakuLA	org
@ThisGalJulie	unknown
@HannyTanz	human
@thafoodtruck	org
@eatalychicago	org
@RamonaMih	org
@apriyannto	human
@clt_foodie	org
@charityclubcc	human
@JeannelDolcy	human
@zuleika_conte	human
@soysaucesound	human
@RobP__	human
@yaasinta	human
@tsillaah	human
@CafeDijonCT	org
@najeafidri	human
@sjsteiner926	human
@Taylor_Go_Bang	human
@jojos_HI_summer	human
@SagerCreek	org
@evil_yoghurt	human
@nsdoyle	human
@Mr_MRGN	org
@kkkennnyy	human
@island_HC	human
@MattStarkFOX13	org
@kennyman338	org
@iamjamestai	unknown
@SaraBorgstede	org
@Zijun_S	human
@LareinaLana	human
@Antoniosejaan	org
@kelleyclarke	unknown
@momoedarlie	human
@SerenaThirlwell	unknown
@Striving4ZenNYC	human
@metha_metyas	human
@cstebb88	human
@Beautiful_Cro	org
@OfftheHookNY	org
@Yairb18	human
@klairvengco	unknown
@georgiafittie17	human
@christysouisa	human
@gillianlot	unknown
@CathyTsaur	human
@Forever_Boyced	human
@koala_han	unknown
@classydiva4God	human
@road_honey	human
@MelissaLGerard	human
@hi_rooka	human
@JackieE1108	human
@inito_uk	org
@Huang_li_li	org
@essmaeel	human
@guamboas	human
@ErinCalandrino	unknown
@Chef_Lindsay	human
@ant_cyrus816	unknown
@ItsMoniqueBaby	human
@elainemacleanxo	human
@nicolparker_e	human
@VivaTravelMiami	org
@FreakiDolphin	unknown
@dirghakay	human
@amirhazril	human
@ikarusbysarp	human
@soozeeannax	human
@CarlosDC83	human
@changing1005	human
@TheBentleyHotel	org
@TotallyEmirates	human
@TheDonMenace	org
@vasdrfeelgood	human
@naughtysquishy	human
@ny_giants_ny	human
@kanozyo_kure	unknown
@francia_leon	unknown
@BillieAcer	human
@Sweetnessoffshn	human
@famiizuu	org
@immaturealice	human
@JiraachiStar	human
@Neko01	human
@AmandeepK2	human
@VFWPost1273	org
@christy_suan	human
@Beeutifullgirl	unknown
@Sadiiiiiiiiii	human
@CoverShotImages	org
@noiresse	human
@ElishaYoana	human
@WebTament	org
@MissBG314	human
@angel_kaho	human
@TheMayFairHotel	org
@wmhtx	org
@dliotta	human
@P3sQueen	human
@garboviola	human
@hendrisupomo	human
@ill2daPhil12	human
@DoeBoy53	human
@Follow_Felix	human
@greendisease88	human
@FeliBLerMa	human
@vale3madio	human
@claudia_merrill	human
@ButtercupBmouth	unknown
@alyssahu	org
@EatLocoCoco	org
@CorinaEnde	human
@MainStreetCook	human
@Jeeen143	human
@DrkCDesigns	human
@samsyulsamad	unknown
@EmmaBarrton	human
@TilitNYC	org
@48hrsincapetown	human
@grahamelliot	org
@Pinkkatsyah	human
@Leejcharles1	human
@Kim_Delsuites	org
@unclewilco	human
@sxhe0727	human
@Sucre_AR	human
@iztomook	org
@Jennysen81	human
@lydiamelian	human
@Jayyysl	human
@OfficialNick4ta	human
@krisrific	unknown
@hausofevvy	human
@DXBhiphopmusic	human
@BotVine	org
@NeuvooWokingha	unknown
@htrebor	unknown
@_YUKIAKASHI	human
@celiafriedrice	human
@Sobe_Lash	human
@CupCakeBosss	human
@Marc_Jourdan	human
@Snacksatworkapp	human
@MaryLeeCatering	unknown
@DeOcioPorMadrid	human
@elisaelvira	human
@hianchuankai	human
@HinataTKD	org
@HollyWilko96	org
@kishydrover	human
@The_Mafia_Boss	human
@SamsamPeralta1	human
@CopiesAndPrint	human
@nurse_chrissy	human
@almialmialmi	human
@patspreserves	org
@MarketinPB	human
@squirrellyearly	human
@kelsweeps	human
@OmarKhamisDiyab	human
@Lablabkosibiboi	human
@Akash_Specta	human
@_PinkiiDiamond	human
@aniauk83	human
@NordWestchester	unknown
@ninobrown_ETP	org
@ClaKunterbunt	human
@Slrpable	human
@Dheemahi90	human
@FarahPink	human
@debdebbaleleb	unknown
@YuuhjiRawr	human
@mariam_gui	human
@KT4ORD	human
@Tiananana13	human
@AgiKovcs	human
@ElianaMelndz	human
@kitaboots	org
@NationalHoney	org
@philippa_moore	human
@angelapong1124	human
@YulsMcFuls	human
@LyfeIsGood_	human
@Isi_OhLaLa	human
@MsSunshineCity	human
@pizqlla	human
@Ssource6	org
@camillemcdonald	human
@Wen_Teng	human
@Cammi_Boo	human
@farina_jennifer	human
@TyakaKomrade11	human
@iv_23	human
@PolRotiya	human
@chyndrella	unknown
@mfenggg	human
@sergmark	human
@VegetarianDays	human
@3449_dance_us	unknown
@THAREALJABEZ	human
@helena1745	human
@TheMidletonPark	org
@drewseybaby	human
@GeorgeRiveraJr	human
@iamgauravpundir	unknown
@yoland_yen	human
@sathya_cfc13	org
@LettsC	human
@onlyconancan	human
@vipboss82	human
@Eimanstella	human
@jaeshiika	human
@saltlakeyoga	human
@princespido	org
@candismagazine	org
@qoqpro	human
@SisterShareefah	human
@839reboyz	human
@dessyria11	unknown
@JeanetteRiver18	unknown
@larsboehnke	human
@ercfji	unknown
@adasibayan	human
@itskoolkase	human
@CityK8	human
@yogiedwitama	human
@girlgreatsmile	human
@kennett_n	human
@JuliaPetrovaya	human
@JetSetJeanne	human
@LuckyMza	human
@iajewell	org
@Inquisitor911	human
@Nasara_Gargonnu	human
@WrapswithTaryn	human
@hafizrahmadi	human
@WindsorCourt	human
@Jaelbelieves	unknown
@Miss_Loaiza	unknown
@MauLopezDeBrea3	human
@PollitoGrilled	human
@x0T0x	unknown
@stephgutz	org
@Jemrah1	human
@KayceesHere	human
@LAfood411	org
@darylakongtt	human
@JFRahamoni	human
@GaiaFit	human
@air_rick_	unknown
@paperdollsuk	org
@Feastmaster	human
@BellybombZ	org
@T3stikills	human
@_Davidjll	unknown
@happyhourteam	org
@thats_s0fetch	human
@Pen_chen	human
@ShopMargate	org
@flakeandcake	human
@Maggette408	human
@JessL83	unknown
@HiltonAbuDhabi	org
@realchuckcarte	human
@MadCatGardener	unknown
@shetty_pri	unknown
@osyaberi_mike	unknown
@DjBabyfaceNYC	org
@HCF_brenda	human
@BecFitness	org
@Sab_1908	human
@sean201314	human
@thisizd	human
@CarolineTarzii	human
@WeekNightBite	org
@NongshimUK	org
@doane_15	org
@MingosHTX	human
@salvatoreboy	unknown
@travelndfoodww	unknown
@tsaboca	human
@c3L6_dutz	unknown
@tarm1an	human
@J_C_Davies	human
@Annette1Hardy	human
@georgjlloyd	human
@RH1LL	unknown
@jhoyabolanos	unknown
@Taraustralis	org
@Crudo_Suzie	org
@ClareMcDonald31	unknown
@eeeeeeimi	human
@AstridMPaul	human
@PhilaCateringCo	org
@TomMic95	human
@lockett63_	human
@SophiaETamaro	human
@Eric_R_Acuna	human
@omppudesign	human
@misspuputh	org
@liyenkang	human
@PlanetShoes	org
@Ty_Summer_	human
@foodfixup	human
@MargheritaKSA	human
@Elizar209	human
@SonjaMcCree	unknown
@Limbic_Lullaby	human
@UncleJsKitchen	human
@LisaJayne95	human
@moritastyle	human
@wefoundwaldo2	human
@kleinolive	human
@ashley_apolinar	human
@inspired_lifeSA	human
@TriciaMcNatt	human
@DameFrusquin	human
@melancholicKID	human
@CuriousSun	human
@IvyJumpCactus	org
@AltaHeightsApts	org
@KonstandinosC	unknown
@COLBYSTILTZ	human
@VABangerz	human
@HonorUrBodyTW	org
@kyrinhall	human
@gegeovanny	human
@KirklandPrice	human
@MochaCabanaCafe	human
@amackattack	org
@MarinaHoy	human
@BenLaube	human
@okonag	human
@kamolijuicebar	human
@veralaetitia	human
@tranzilla	human
@SuzysNest	human
@kimdiddy38	human
@Ommmcat	human
@TaniaCLewis2	human
@tabitha5121725	unknown
@fabfrugal_12	human
@_HamdanBS	unknown
@EarlyBirdSnacks	org
@HeySeto	human
@chetmancini	human
@DreamStudios_	org
@bytheseaog	org
@Smith89204	human
@dentognorizo	unknown
@MoustafaHadary	human
@StephenCaggiano	human
@CookBrite	org
@hawthorngrill	org
@EmmaH1123	human
@Falasophy	org
@Playurecards	org
@Grande_Roche	org
@bayangull	human
@azzurromane	human
@ekozz_nj	human
@rolandrattai	unknown
@Melania_Valle	human
@iamgedster	human
@nina_tess	human
@Pan2Pendotcom	org
@reineran	org
@asami_n712	human
@alwaysalicex	human
@hectic_filo	human
@ohyabedabedu	human
@MiniNoy88	human
@nuniek	human
@FranshesOvalle	human
@mikaxxxxxxxxx	human
@annelawz	human
@adityudhaap	human
@mceehops	human
@ecevahapoglu	org
@QueensArmsHotel	org
@s_pernutrition	human
@AnnGoLean	human
@LagasseGirls	human
@Shake_and_Make	human
@IcelandWedding	org
@da_rudepastrana	human
@wllang	org
@BeBodyWise	org
@Coolinarytrends	org
@CharleensM	human
@kozima48love	human
@montserratram15	human
@WYNTERHEAT	human
@hiichannX	human
@waugh_mandi	human
@SCOTTYWELLENS	human
@iamGheeFortich	org
@HiltonBKK	org
@PhatG	org
@opheliawwn	human
@Schneider0621	org
@milklooking	human
@rebeccajacobs50	unknown
@RevengeIreland1	human
@NYCBaby	human
@Mrdavon87	human
@miyo76767112	human
@MuppHits	human
@saranoguerolp	human
@ClassyB_1	human
@omompiglet	human
@informasi_iklan	org
@CasaPiPa	human
@AgusCabris	human
@juanjvargas	human
@MauchiiDay	human
@mrverypicky	org
@FayLiles1	unknown
@LaDolceVita_22	human
@JamiesVanity	unknown
@FabioLavezo	org
@FornerisLaura	human
@SexybackBoutiqu	org
@minslee11	human
@marj_mj	human
@enogastrogarden	human
@Dewi_Eand	human
@davidkeckmusic	human
@HoutBayManor	org
@TonysCafePE	human
@NeuvooALBQ	unknown
@SMLimerick	human
@nicktedd	human
@ebonystaff	human
@anuncomplife	human
@LazyEpicurean	human
@ritfsc	human
@JunSix	human
@RedQTee	human
@BarbaraCuellar_	human
@lsbg56	human
@abgfadzli789	human
@ShawnaKnows	human
@ACO_tree	org
@makeupbytashab	human
@FuzzyMonzstar	human
@heatherzilla8	human
@mejayxoxo18	human
@Amydolface	human
@midlifeblvd	org
@ChakkiAtta	human
@austincbelisle	human
@Shuting0429	unknown
@EmilyPasser	human
@dr_barri	human
@yemekyolculugu	human
@MarioJerome	human
@jeaniemj6	org
@MarinaKatura	org
@MJ2307	human
@LSari	unknown
@noriamlki	human
@kat_vavrovskaya	human
@Furfear	human
@gracias_senor	human
@reneesme491	human
@alienbuffy	human
@Maggie_Mah	human
@promocoupons	org
@VeganBeerFest	org
@globalrollguy	human
@yourFMbyAndy	human
@FaithMortimer	human
@r1n1rawan	human
@inyourhug	human
@fashionofphilly	human
@hubcitynaturals	human
@iAmRafael69	human
@2224Tori	human
@ruddingtonarms	human
@YkrRui	human
@iamErv_S	unknown
@TheKellyAnne	human
@in_noein	human
@veaftr	unknown
@DarrenCombrink	unknown
@bradipoalato	human
@aj_aligam	human
@FerraSandra	human
@sohappies	human
@lulythecurious	human
@amehazmi	human
@Gwen_shf	org
@erknysl	human
@missadlife	unknown
@jakatak4	unknown
@QnChcko52	unknown
@BDreamz	human
@CenSevigalz	human
@TWBaggage	human
@wwwkingkoteicom	unknown
@BKinDC	human
@superduperfatah	human
@BHEBHEMAJA	human
@608Hirata	human
@SushiArtUAE	org
@musicneyeliner	human
@DebonairBlacksz	human
@MlleGinger	human
@hanapyon59	human
@goldfries	human
@FFFpetesimpson	human
@ditnmat	human
@MaryMEchelon	unknown
@iTuckkyz	human
@jony_ry	human
@NurNadeeyah	org
@esteban_cadena	org
@itsjillgardner	human
@nyorita_nice	org
@SdpYuki	human
@aoonsafdar	human
@Oneofakindsm1	human
@cynthi283	human
@desouza_lana	org
@Judith_90Sweet	human
@MCri9	human
@Ip3tech	unknown
@TerryDullum	org
@SanDiegoCALife	human
@Travelodium	human
@beths_tweet	unknown
@jasteajastea	human
@Stang_Pondet	human
@rbreeze	human
@PanQuePanLoreto	org
@FRomiyo	human
@Kalm80	human
@CRISTINAD17	human
@TheDutchNYC	org
@BurrawongGaian	human
@Arttmayu	unknown
@LyraSkye	human
@AMINULSWATFADZR	human
@TheVillaHC	org
@VividLoungeUK	org
@ImmaShoeWhore	unknown
@drkenthe518	human
@_TyMcFly	human
@WillyWins_Duh	human
@julie2434	human
@sandu_iuliana	human
@princessjomanah	human
@mandyR33	human
@HagitWong	human
@ScusiMN	human
@Penelopebix	human
@shaozhou	human
@PuiPuuii	human
@ReginaBDentata	human
@HailKingJeremy	human
@Mamanbooh	human
@Flako318	human
@abhavsar	human
@poyoyo1007	human
@ElenaEletta	human
@bintalal_70293	human
@JimRudloff	org
@lisaortolan	human
@UYulian	human
@fattygotslim	human
@A_HA_MIJA	human
@HavenRooftop	org
@MichiganClothes	org
@retrotakukon	human
@SMYanie	human
@HafizAlbar	human
@archieandtherug	org
@Niella_G	human
@OrganicEating_	unknown
@paulmorenophoto	human
@agungnandito	human
@iamsupergilbert	human
@runealnervik	unknown
@NtwanaYakoKasi	human
@FitWayDre	org
@AnitaAnimalkin	human
@tturner1977	human
@cheokboardtweet	org
@JenniferGlickm	human
@ESMERALDALBA	human
@HolidayAfrica_	human
@gadistikaa	unknown
@dwipurwani_	org
@UUnista	human
@ACSlowCarb	org
@blaxel_rose	human
@zHeinzme	human
@AdventuresTea	human
@FifiandJamie	human
@Rmedinaabascal	human
@JKTBanana	org
@pharzam	human
@BagatelleMIA	human
@BohoCC	human
@AnnyeongSoshi	human
@Katsloving248	human
@ImogenNgm	unknown
@Jollygood_time	human
@BecaBeco	human
@770Social	unknown
@Melfrausto	human
@TheWoolworth	org
@DeniseMickelsen	human
@FloraTherizol	human
@jlampon	human
@ezzyboi	human
@shelezzetli	unknown
@MissBlemish	org
@moome74	unknown
@HelensBeauty	human
@RidgewoodBeat	human
@Im_ur_Ploii	human
@thechiclife	human
@gabbiekk	human
@CantBrunchWthUs	org
@slatka_sladja	human
@DineInNow	human
@mylifeofpics	human
@bestversionfit	human
@OhOhDivineGrace	human
@simplybeauuty	unknown
@ShokoBebe	human
@Ophelliia	unknown
@zairasa_	org
@HagueKaren	human
@TrapMadonna	human
@jess_723	human
@DJ_MiloSA	human
@greensvillegour	org
@HindmanGracia	unknown
@Restaurants512	org
@aleenchumel	human
@EdithHan16	human
@sweetmamabrady	human
@melissa49	human
@Stadium_Favs	human
@EtyranTyran	human
@NeuvooSaskatoon	org
@veyChiara	human
@magicmikefit	human
@chivestalkin	org
@KAKOCORP	human
@MobellaEvents	org
@MsNaturalTee202	human
@SKMakeup	unknown
@takaw_co	human
@belizehub	human
@landabee	human
@martinasinigagl	human
@ZuneraSerena	human
@bassidhruv	human
@alibauer	human
@DahabiOman	org
@DrunkenNouis	human
@MajjanYamashita	unknown
@EtienneMarques7	human
@HookahsCafe	org
@wendywrocks	human
@ms_prettygrl	human
@wagamama_mxx	human
@BiggHerb	org
@BGradin	human
@AmazonBeautyHOU	human
@tonyschiller	human
@RAJEdesign	human
@IdealWorldTV	human
@AnneDoli	human
@lindzyee	unknown
@lindzstalnaker	org
@AKIKOLOVE14	unknown
@ElChefdeMilagro	org
@MarkAllner	human
@TheBossyWifeCo	unknown
@imanexclusive	org
@diggdeepfitness	human
@mynameiskio	human
@jlprovideo	human
@marie_yau	human
@kimberleymckell	human
@jomardemello	human
@Yasmine_CheeYan	unknown
@ankerbraut	org
@freaksmilebaby	human
@FoodThumb	org
@Robelen	human
@senasako	human
@SMMathios	human
@NourishBakeryNL	org
@shinny3	human
@Alexandre_Pinto	human
@Slateware	org
@jonahquerimit	unknown
@AceDestroCaps04	org
@Missthuringer	org
@ChannaeReynolds	human
@maryann_rose200	human
@JaniceCheryl	unknown
@jacqvaldez	human
@sKavenger718	human
@EthosFoods	org
@ftisland469876	human
@Broderick1893	human
@YecalChantelle	human
@_ratika	org
@shellcroz	human
@JohnnyHidalgoC	human
@jorgeousjo	human
@yahoo7lifestyle	org
@BobbandCole	org
@giannaloise	human
@rehenayhay	human
@mschimp	human
@ViaVenetoBB	human
@Cellini10	human
@mmcherry30	unknown
@zen_reporter	human
@tajexperience	human
@seanloom	org
@postwarinktrap	human
@AntiochHannibal	org
@CityHawkLDN	org
@Lare_dioen	human
@likefoodchicago	human
@lauraredrose	human
@cherishsey24	human
@TangoRaindrop	human
@euse4dr	human
@SergioKleen	human
@TheGadgetGoat	human
@EPSTEINS_BAR	org
@JenniferHeal	human
@glorennis	human
@NewJerseyPlaces	org
@smongaki55	human
@DeniseVonParis	human
@84alfoAlfo	unknown
@Piece_of_Italy	org
@ScallywagsNYC	org
@TheDealCutters	org
@MooreItWorks	human
@selanTselan	unknown
@Todo_Acapulco	human
@ladykaty92	human
@goodfoodforgood	human
@OlafBarken	human
@marinaponzi	human
@beerles	org
@NurziahYahya	unknown
@iikara_	unknown
@Veroni_Deco	unknown
@maintanosdotcom	human
@DrewBrees8bit	unknown
@MissVeganTips	org
@DJSelmSelm	org
@DallasFarmer	org
@angel_chavez99	human
@techie_88	unknown
@mimioka	human
@FloydsShrimpFL	org
@Else_Solicitors	human
@77esteler	human
@urbanspoon	human
@RedHotMagazine	org
@mariedelais	human
@thamakeupartist	human
@tamajiro21	human
@the_jackal20	human
@julie_maloney	human
@iPaint_Fast	human
@hexastan	human
@wearecarabella	org
@ichiilley	human
@wakanyandaaa	human
@ssm81322819	human
@Elna44Elna	human
@msmonikaj	human
@williammsimms	human
@wilson_tee71226	org
@musitowski	human
@Laisa_82	human
@monkeysportsIRV	org
@We_are_Cornwall	org
@Hugs_Kissesx	unknown
@TasteCateringNC	human
@sorellatoronto	unknown
@95BethanyBrown	unknown
@Earl_da_Bassist	unknown
@westgaby	human
@london2024	human
@dariquo1	human
@societyfair	org
@AmberJeanne36	human
@Alice_Ptz	human
@shengrow	human
@Starblazer74	org
@breakthrufacts	unknown
@Lisa_Lucker	human
@siska_cutez	human
@hanaecchi1028	unknown
@TBWZE	org
@FruitionFitness	human
@louisdeli	org
@cwibi	human
@mzsy0160	human
@hunnybunnywunny	human
@LavenderConcept	human
@TAREKPARKER	human
@AssassinB_	unknown
@Liz_cwp	human
@Enmanuel_RR	human
@RiyanBB	human
@MaximizerCRM	org
@Phillipsfamx4	human
@susanknight	human
@atakautsara	unknown
@khairulrossi	human
@pmcerenil	human
@bigbusinesshq	human
@GarfiW23	human
@RocentBata	unknown
@blbourassa	human
@shai57	human
@vince_neil	human
@ImSaditty	human
@PintHouse614	org
@CafeDepartureL	org
@TheOneJokerette	org
@omegacrunch	org
@FitFantastic1	org
@PrefabEatery	org
@ohjayy20	human
@viani_y	human
@YamilexSan	human
@MyDailyUK	org
@StephanieLange	human
@orgrandomness	human
@ButcherBakerYYC	org
@WhatsEatonEatin	human
@baoluo8	human
@soipetcharcha	human
@victoriajulie	human
@Regina_Kartika9	unknown
@DatBoyReadyy	human
@YPJ2013	human
@Real_Mr_H	org
@piggyjamm	human
@ChenWeiLun	human
@nadezhda34444	unknown
@ietsist	human
@PNNatasya	unknown
@AguaCayman	org
@OrganicFreak	human
@onesweetadikxun	human
@RMnandhini	unknown
@AnniekjevH	unknown
@A_Raeisi	human
@renai_342Ko	unknown
@PjSaet	human
@LainDarlison	human
@RiasSWjourney	org
@Intripp	org
@GlamGourmets	human
@SexhibitionFi	org
@Mon_Luvs_Lola	human
@HOURStechno	human
@Dreyuskids	human
@KitchenUnionSq	unknown
@amyelise_b	human
@StrangerOne	human
@miiniemmaa	human
@RoseBallerina	human
@onebode	org
@WiperMovement	org
@saladspotFL	org
@BoozyBurbs	org
@DDCloverdale	org
@NYChiroPT	org
@ZagatHouston	org
@kikiclassics	human
@shaktifreshblog	unknown
@lilbit3022	org
@Nielsen	human
@EsterPelawi	org
@GlutenExchange	org
@ShamrockCityPub	human
@Dolcetweets	human
@francisDrarity	human
@AgusPaezperea	human
@joeyzazatweets	human
@KatJaramillo	human
@lillieblatt	unknown
@MadeleineInfo	human
@ImMoonhee	human
@NewsBeeStreams	org
@sunnyboybrklne	human
@Berejen	human
@johnmart88	human
@ratherbsweating	human
@ckun150	human
@madihahedroos	human
@JoanaCloe	human
@bmawardi	human
@Sisteris	human
@liondogart	human
@driftsojourn	human
@RainBisou	human
@TheCarltonNY	human
@harmondolorosa	human
@RhodyBites	org
@TrailingIvyCat	unknown
@siotravezyo	unknown
@strangeheaven14	human
@M_ky84	human
@CLHNews	org
@Waywardkitchen	org
@World_Sommelier	human
@arantxadomingo_	org
@RenzDanKim	human
@k8tekat	human
@DanaAsturi	human
@chrissim5311	unknown
@Flacaperversa82	human
@SlameTux	human
@TweetCheshire	org
@ErinDebaillon	human
@ruddytumtum	human
@kjslater84	human
@chefjmelaurita	human
@Dr_Gail_CC	human
@AngieHasemannRD	org
@RosaMerisca	human
@samantha_lied	org
@tiatalula	human
@SweatItAllOut	human
@fashionchic03	human
@LocalTacoLEX	human
@diaper_archive	human
@FoodFanatics	org
@julianbaker01	human
@sosh	org
@PaparazziLV	org
@PesaPal	org
@Mrsmalory	human
@KristineLynn327	human
@doterra_reviews	unknown
@WhichWichSTL	org
@IAmRoKEN	human
@ChiaraGrieco	human
@RoNilai	human
@miss_soyabean	human
@RinuDominic	unknown
@Maegendeee	human
@CristhianmOk	unknown
@IzziTwentyNine	human
@NickJoshLeong	human
@cadamswellness	human
@Lurveen	unknown
@elizabe42976987	human
@leotheo8	human
@LH_Espresso	org
@FamilyWelcomeRM	human
@Princessdjv8	human
@CheePrinceton	org
@happyxy	human
@nasle15yuky	unknown
@chubbybunny_bdg	human
@hflight	human
@raniita	human
@SurpriseURAmom	human
@HARLEMUNIVERSE	human
@iLeeJiHyun	human
@AntoniqueSmith	human
@_Carrasco_	human
@GotVintageShops	org
@cjordanchef	human
@jacfreese	human
@ABCucino	human
@Megmn1111	human
@RedOnlinePh	human
@Cess_____	unknown
@Greg1954	org
@ChefSammyD	org
@DanielFulham	human
@RhoneRangers	org
@vedsmusings	human
@faezaabuzarin	human
@awireonabmx	human
@sarah_schu	human
@1chicacomotodas	human
@AdrianaHatcher	human
@MisterFloSr	human
@janebled	human
@GiovannaSun	human
@PhotoWizHTX	human
@kimberlytriana	human
@iamGeloTiu	human
@Isbel91	unknown
@curtisp007	human
@RevistaDYN	org
@barborsavicenza	human
@mobayproperbar	org
@DeeChattaway	human
@k_rosenk	org
@AnnFantom	human
@SetItOut_ForBeS	human
@AppleandEve_	org
@warai_gekizyou	unknown
@MemberNews	unknown
@DakotaTucson	org
@KedraSimms	human
@Chippy15ocse	human
@MRNICKELCITY	human
@Jlm_86	human
@ThePostHouseST	org
@PRMrkting	org
@Singaporeblog2	human
@IowaCCRR	human
@TrafalgarAUS_MD	org
@DonohueAllison	human
@SpartanZero87	human
@BenjiKnows	human
@NatalieEbanks	human
@bumichan_xxx	human
@ryjoje03	human
@MariasMusings	human
@ValdiJohan	org
@AjiebRosdi	unknown
@electo_mind	unknown
@amandamarrshow	human
@ShabbyShabby	human
@crinababina	org
@jmcostarosa	human
@arlanjen	human
@NYCCheap	human
@BDimalibot	human
@JohannaMarie20	human
@shrutideora	human
@90265mag	human
@NH_SHAPIRO	human
@GZ_Padang	org
@tinawaikiki	human
@moonshine152	org
@calvinlove29	unknown
@syraasheikh	human
@BoraLaMar_sw	human
@LearnistTweets	human
@ElenaRicikos	human
@CraigNews3LV	human
@BroodjestijdBV	org
@MINAMILANO1	org
@michellehoro	human
@MakeupByAngelH	org
@Sammy_Boo27	unknown
@lifemorecowbell	human
@YayaBaka93	org
@BlueFlameCuli	org
@TheParkNJ	org
@itsannheysel	human
@Blu84	human
@ErikaSlampPR	human
@JETFILES	human
@hendy_miekj	human
@klreilly10	unknown
@SuperSoftKnits	human
@CandidRD	org
@FIDOUBLEG	org
@AQuietRiot	human
@mississaugacity	human
@ChristineHaze10	human
@GiftFrippery	org
@VitaMan411	human
@coolchickmae	human
@ekinariey	human
@Barry_Miller76	human
@johnmiltonlim	human
@NutmegJordan	org
@hkazoee	human
@chikaliciousme	org
@MontpelliersNQ	org
@feralwildflower	human
@tetech75	human
@yourlondonbelle	human
@sanchodogwood	org
@JeymiA_	unknown
@Wagstaff_LA	human
@KMPhoto1563	human
@stellarraleigh	human
@deansdip	human
@justinus1	human
@mameawsri23	human
@TaydeRubalcaba	org
@Demelza2504	human
@Drjohnson100	human
@Daven19	org
@Rafiqua_Israel	human
@wenkai05	human
@MaisonLeGrand	human
@holmcooked	human
@piratehari	human
@MMadomoiselle	human
@Pripsreis	human
@Higuccini	human
@nelene2	human
@AnnelieEng	human
@imperialdelhi	org
@TahminaNasimova	human
@cathryn1	human
@rehilly	org
@leongwaikeng	human
@iAmMrFollowBack	org
@_MartinaZoe	unknown
@Louis3421	human
@lamer_osumi	unknown
@StopHungerToday	unknown
@tsukune_ojisan	human
@imjingdemesa	human
@remcoco	human
@fashiondiction	human
@emziemski	human
@audreyleroy_	human
@whatisawayteam	org
@Jessybah	org
@DarPrints	unknown
@Louis_W8	human
@SUMIRobata	human
@barkavellc	human
@iameurydee	human
@tony_lappostato	org
@torres_juni	unknown
@suebeads1	human
@evil_june	unknown
@debukuo	human
@_lorenaamelo	unknown
@Delightinpink	human
@michiganavemag	org
@mangiapuglia	org
