@itsINFA	human
@azmijaleel	human
@juancar_2010	human
@chathuranga3000	human
@A_E_Alhaziem	human
@caseislandglass	human
@FitBananaChick	unknown
@NeuvooNorthCha	unknown
@gourmandhaines	org
@EcologyJapan	human
@rulerofmind	human
@stefanyy_17	org
@SacredAura	human
@DlushW	org
@JuliaBermejo	human
@mercadeo507	human
@Thanhheo2012	org
@NeuvooTraChi	unknown
@priya00711	human
@fernandocultura	human
@ChikaChik12	unknown
@ealmazora	human
@ym_meg	human
@FancyLifestyle	human
@_KANAKORO_	human
@marin0z	unknown
@biobodycoach	human
@LaDolcePita	unknown
@MeSheHerChrissy	org
@BrieParker	human
@travelsundance	org
@DammitJacqui	human
@i_kaya	human
@rachel_vacca	human
@tjeWhitejr	human
@NtlDairyCouncil	org
@BlackTieTrans	org
@fansJavierP	unknown
@AMW_77	human
@StratosPreston	org
@Athiek	unknown
@Nik_knock	human
@getklinkd	org
@ionuca	human
@izatrini	human
@Stephreedpeck	human
@AkikoSiwon407	org
@DeSeanDillon	org
@Mzz_GG	human
@chardyPops	human
@cevalentine_	human
@davius19	human
@wanfadhilah	human
@HHelenlopez	human
@91_lyn	unknown
@LibrantoGuitono	org
@iAlexandar	human
@mundhanafiah	human
@Roadhouse_Grill	human
@FedericaTommei	human
@MondiLodge	org
@true_ajrul	human
@BuckheadSamHurd	human
@charellysan	human
@foodhistorian	human
@dougjaeger	human
@perttyboydan	human
@nic0le_stam	human
@msblondebangs_1	human
@taemana_cyji	human
@alfieandbillys	unknown
@TinttuS	human
@infitandhealth	human
@SaraQuelSamp	human
@quishatweets	human
@iamIYAM	human
@bunnynahoi	human
@KtO_Kom_til_Opp	human
@MVRamsgate	org
@ariel_elisefull	human
@corinneisabella	unknown
@CountryGirlBlog	human
@stefani1603	unknown
@farahaledruce	human
@OutStandinGirls	human
@disney_fanatic9	human
@dsd_rolo	human
@ayaccxoxo	unknown
@Grounds__Coffee	org
@GRBrewingCo	org
@sotto13nyc	org
@LeGrandeurMg2	human
@anitaruri	human
@jesuselealc	unknown
@Vanesukki	human
@Danny_B01	human
@BeckyKellymodel	human
@Regards_Dining	org
@mckellark	human
@esmeraldafrias	human
@mmmamix	human
@OxsrfC	human
@ziannevalencia	human
@xxme2uxx	human
@direkiko	human
@raenism	human
@TheDockKitchen	org
@kellieannem83	human
@justJulyi	unknown
@TheGrahamBar	org
@SunButter4life	org
@NinaKloos	human
@trapaoli	human
@kimmpetersNY	human
@OntarioFTA	human
@EMP_0911	unknown
@sexyMrs_tisdale	human
@Breakfast_time_	human
@zkharmaz23	human
@CalibroSupport	unknown
@QuickTypeRT	human
@ElvisTomaz	human
@KBM_Angelous	human
@cloantonia	human
@chasingluck30	unknown
@Dillah_KN	human
@Manoz_Austin	human
@vonkustosart	human
@FriscaFriscaCa	human
@Bellaevangel	human
@QuintaTO	human
@giftpmnovel	human
@sebaker88	human
@SSpencley	human
@theChancler	org
@DJSCOOBAY	human
@FuckinPrincesss	human
@Daniel_Julianto	human
@SayWellness16	org
@MillisKitchen	human
@JoeT1000	human
@Fryshoppingfest	org
@keri_mo_teh	human
@Hungry_Pirish	org
@caseytato	human
@babble_monster	human
@MrDangleyBits	human
@AmericanAir	human
@Marghe_S	human
@LouJWatson	human
@pennylotz	human
@Justsay_NOPE	human
@daniespersonal	unknown
@dhan_puertas	human
@Sungardencafe	org
@i_Choi	org
@timiyakuza	human
@KillerKupkakex3	human
@EllieTruffle	org
@_loujeemae	unknown
@BMiraMarshman	human
@RoomCritic	org
@HAWT_C0C0	unknown
@CB2weho	org
@themimble	human
@Vaness169	human
@kusumbhutani	human
@christellar	human
@WorksPTStudio	unknown
@spatulamedia	human
@alice_ldnm	human
@yoboytoy3	human
@NattNattawuth	human
@dan2night	human
@KoreKitchenLA	human
@Muffinmorgan	human
@ahxrh	human
@subexistance	human
@LesDrink	human
@ContinentalEspi	org
@Freddie_Heart	human
@AmandaJWessell	unknown
@Stanvillicious	human
@eLeepemADAM	human
@lylacmuse	human
@TJHughesBelleek	human
@VillaBiancaNW3	org
@FeMontero	human
@BidanyaBarassa	human
@preventcancer	org
@Caesarpanda	org
@RGrullon	human
@TaylorSMichelle	human
@freshandrunning	org
@fravverella	human
@polaris_mg	org
@PwgnqM	human
@bakerelf	human
@yoanapuspitaa	human
@DDSotelo	human
@TheSassyRD	org
@OoooohLaLaMon	human
@devy_suhn	human
@SweetP9587	unknown
@LeroysLounge	human
@marmongeee	unknown
@yuichigoppi	human
@smithshotel	org
@Dee_Daugaard	human
@LloydReign7	human
@Taylor_Dean__	human
@JaneMoyen	human
@decertocotidie	human
@Fit_BA_Angel	human
@brookiebaybeee	human
@DiarioLauro	human
@AnasMallick	human
@DeesWholefoods	org
@AhiMahiFish	human
@dreaminmymind	human
@CnMarth	human
@whatsyourf	org
@LakeEffectDiner	org
@BrunchandSpa	org
@rosejaejoong	human
@savvykat9	human
@MeliaBcnSarria	human
@BentoMomma	human
@ArtisanHouseLA	org
@michsue	human
@Jigsawhearts	human
@chhunnoeun	human
@foodrootsorigin	org
@KatyWellhousen	human
@revivewellness	org
@hopefully86	human
@Aroma_Thyme	org
@CassandraWhitee	human
@SkbnNur	human
@AnkeHeijnenFood	org
@FerryLomani	org
@edyanaisa	human
@HICambridge	org
@KatBrockavich	human
@baudsley	human
@Ahtongheehee	unknown
@BrookeOfficial	human
@Melon16	human
@Travelaviator	human
@SalJac1	human
@Danica_DawnT	human
@GoodvibesMr	org
@ValKPloughman	human
@nassi1290	human
@HI_DelhiArpt	human
@kmj808	human
@natureskid	human
@pansynsnowdrop	human
@Shashyie	human
@Christo02305155	human
@anarkalli_world	human
@_kelsey_marie__	human
@MsZeineb	human
@JikJamesStevens	human
@SayWellness37	org
@labreabakery	org
@KristineKainer	org
@ChefHerbalife24	human
@peppercornml	unknown
@hndilicious_	human
@Dss1962	org
@bankingonkismet	human
@zkharmaz17	human
@NE1fmBreakfast	org
@KeefersIsland	org
@YudhaSYR	unknown
@SonokHakan	human
@beachbodymaggie	human
@chiperez_ccc	unknown
@TapiolasPhoto	human
@shidodeh	human
@BestFatBurnDiet	org
@CloverThePuppet	human
@patriciamow	human
@andybdeg	human
@Joletiom	human
@iosonoRiCa	org
@PinkysCrochet	unknown
@mhaaarose	human
@MrHockeyTemper	human
@jazfitmd	human
@oh_taste	org
@TheRunnerInPink	human
@mydOllh0use	human
@catanescuRobert	human
@UrbanbitesUAE	org
@rikayika	human
@sunhunnie_fit	human
@KarenpPreston	human
@SvenSalz	human
@anitam852	unknown
@evulbeauty	human
@miszxenia	org
@Amandamawarni	human
@rebel_kitchen	human
@amymoffat87	human
@natcapdevila	human
@MelaniAdsley	org
@lesmads	human
@JuanFMartinez08	human
@Jack_Pots1	org
@stefanie_schfg	human
@ChinitosBurrito	human
@MamaOutnumbered	human
@juskeepsweating	org
@MrHyde1010	human
@PeruDelights	org
@chefdominique1	human
@cocolatte1222	unknown
@fluteee	human
@JitsieJots	human
@NerdMom	human
@alessiodidato	human
@ZGs_V_I_P	human
@Saoud86	human
@BigFaceORG	human
@namedFelicia	human
@insurcom1	human
@doublewidegrill	org
@cuddly_gifts	org
@PIRJIN	human
@EddieThomashiro	human
@TheEggmanCanada	org
@Novanana	human
@Deniselykke	human
@AzzyChill	human
@Jodenecoza	human
@HerRoyalBano	human
@trulyvintagefot	org
@except4kenneth	human
@verhaoven	human
@Yheela	human
@SayWellness28	org
@lisaemusic	human
@Destructiff	human
@JeanSchindler	org
@iamdko	human
@Shahila68	human
@janinetoro	human
@restoranslaivas	human
@alo_pa	human
@DarronDiesel	human
@Haute_ACQ	human
@PenelopeGreen38	human
@sin_1985	org
@cherylyou308	human
@redglassbead	org
@lei93xotic	unknown
@ahmed1650	human
@girlygeek82	unknown
@bobbyluvdabeach	human
@imthatcrazygrl1	human
@danielxang	human
@JoscelynRC	human
@gagtraining	human
@flythecoopblog	human
@jennacokerjones	human
@PrestonMitchum	human
@CaffeToninoCP	human
@BayanAlSadiq	human
@BlacangelNews	human
@minamublair	unknown
@innitboc	unknown
@TAG_URIT_	unknown
@Hermes7171	org
@RelaisChateaux	human
@KayleighCW	human
@julioaraujo107	human
@CafeMenuSystems	org
@AlkalignStudios	human
@NoteWorthyVIP	org
@SayWellness7	org
@NORNSDesigns	human
@yeseniaTHEgreat	human
@ankemeijs	org
@JusBlack24	human
@grodhome	human
@ysa_bratinella	human
@mcoymclog	human
@leeeyahferil	human
@WawaShan	unknown
@Yansen_Gane	org
@KarsynBrinton	human
@MileHighMenus	unknown
@FoodAlertLtd	org
@kenjretuya	human
@francis_alabama	human
@Tattle_Waffle	org
@_sassypokemon	human
@NCL_Guide	human
@jglmac	human
@sklhokie	human
@boobykwok	org
@SiComott	human
@KCPutts	human
@dubsone	org
@tasteasyougo	human
@HBsbarandgrill	org
@arapina_uk	org
@Scarlett_House	org
@Jorunz	human
@missleighcarter	human
@LUXETIGERS	human
@unculjanter	unknown
@WhereRichardSty	human
@ShereeStringham	human
@MLSexton	unknown
@50sweety	org
@InstaDamascus	human
@RanchOne	org
@wfhopkins	human
@abrilovy	org
@Linzy1103	human
@czerwony05	human
@walkypagnanelli	human
@versatileer	human
@sweetkay78	human
@BrownBearSnoosh	org
@DandyBsAs	human
@_pauline51	human
@mimosasblog	human
@theSnapMom	org
@MongosBrampton	org
@kenko1026	human
@LythamLifeStyle	org
@InthewoodsJenn	human
@Royalty126	human
@cowart_kathy	human
@MedicasoLuz	human
@EarlsPress	human
@JadeGOLDFit	human
@SerendipityJm	org
@CindyStacey1	human
@FieldOfGreensKS	org
@shareeselogan	unknown
@toffo93	human
@stokoe_c	human
@wawanmulya	human
@LeCordonBleuMY	org
@nisya1705	human
@MissJulivie	human
@manolovalspin	human
@wordsofasahm	unknown
@TheFeelgoodDiet	unknown
@Fitfor4	unknown
@stephan74241817	human
@Triciabbn	org
@octovanny	human
@ChristianSlzs	human
@Dreochoa805	human
@LaCucinaDelSole	org
@shann_midge	org
@wirelessradiouk	human
@RifyAz	human
@cinthyaco_cindy	human
@heidilarose	unknown
@sarahcraves	human
@t_diederichsen	human
@JAnneShort	unknown
@YULIYAINOPINA	org
@QuirkyGirl12345	human
@Manhattanpeachy	human
@pacific_seafood	org
@RolyPolyMobile	org
@edconyau	human
@TatianaRidley	human
@HaRBiRzInc	human
@bagnolelia	human
@MylieMagic	human
@shecancooktoo	human
@barisdinconline	human
@vilo836	human
@just_only_human	unknown
@JanineNickel	human
@WedBasckets	human
@XyLexQueen	human
@KimberlyHahnArt	org
@feistySTURR	human
@CapricornFM	human
@HiIndonesiaID	org
@romain_joshua	human
@pie_humble	org
@sarikurabiye	human
@theryemagdangal	unknown
@JoBrettAD	human
@raleighwhatsup	human
@Luisaevangel	human
@donnasawrli	human
@xiao_Max	unknown
@escape2215	human
@DawnieEA	human
@gerrymedina	human
@typicalgirlv	human
@OldTownRefinery	unknown
@Susana__R	human
@linz_bee22	org
@yummy11	human
@sharon_williams	human
@eevonchua	human
@tets1003	human
@LiveOptim_US	unknown
@SandraRojo	human
@warmdaddys	human
@AnnaPalinkas	human
@beachtv	human
@marleysyauqi	human
@shentail222	human
@Matth_Ftw	human
@gabzolina	human
@heidiGroess	human
@ShopSereneSky	org
@StrawberryBlu	org
@ChristeenDelucc	human
@KatharinaKnirke	human
@RivasG7	human
@weedgal	org
@50pasento	human
@GarethWalton11	human
@KarenLiesens	human
@TanjaMohl	human
@Kingswaykebabs	human
@tsukasa_tg	human
@PetalumaNYC	org
@UAccents	org
@CocoButterBlog	human
@vanillavelvett	human
@Folkloriquero	human
@Marvszlionheart	human
@shoponsanibel	org
@jopaygtn	human
@ddey67	org
@Jackson7V	human
@lauschofashion	human
@SayWellness34	org
@PabloMassey	human
@xxxstalkerz	human
@laurzcjg	unknown
@teddymanangka	human
@Twenty_Twenty_G	human
@RickGriffin	human
@Anna_Watts_	org
@jjkassim	human
@eatmeetdrink	org
@InspiredFully	human
@covides	human
@fabioneural	human
@divaminor	org
@BHChichester	human
@Oneblueonepink	human
@JennieJamesRSL	human
@robkennedy0	human
@HealingTiger_3	human
@Mizukin2014	human
@rachelklloyd	human
@Intiwellness	unknown
@CiaraAdaobi	human
@ninaszasz	human
@burpeestobubbly	human
@sergevc	human
@LightySinAzucar	human
@B_Honolulu	human
@allierykahye	human
@kdykes7	unknown
@bodyandsoul_au	human
@AlvinCampana	human
@ryeongut	unknown
@osnujo	human
@Your_AMBITION	human
@NewsCRT_	unknown
@jordanchan	human
@FaridNik92	human
@heidz0802	unknown
@bhcoffeegirls	org
@bettymile8	human
@SimplyWorktops	human
@hey_imanika	human
@bruleicester	unknown
@tocotoco__	unknown
@Little_Miss_NE	human
@alpe_school	human
@RocFoodTrucks	human
@EatWithEspana	org
@Dcokah7	human
@faulhabercomm	org
@Simply_Suzy93	unknown
@yuyyieara	human
@JustynReyes	human
@kpopcrazy2010	human
@thecakebar_ae	org
@mandy_mount	human
@AnchaHaryadi	human
@mexfoodjournal	org
@Atroshenkoby	human
@Diabetescouk	org
@yannnyisaac	human
@John29020897	human
@Bbhamani	org
@yhomarth	human
@Becky_Temple	human
@XPNAiiMODEDX26	org
@TheMotherList	human
@loveandcakeblog	human
@MrCBeverlyHills	human
@rachmapuutrie	org
@woodgnomology	org
@SkinnygirlFresh	unknown
@RyosonX	org
@sabreezye	human
@shoplocalloans	unknown
@lilibethhepburn	org
@michaelmet	human
@LearnMaxforLive	human
@Fitfiguregal	human
@bennaker	human
@NikkiGi3	human
@ITPR_NYC	org
@StolenSays	human
@newgirls_milano	human
@bawsnitti	human
@kiranaran	human
@pintaanggita	human
@cibumbum	unknown
@bryanb82	human
@dedyap	human
@Sato_Meg	human
@EpicLinen	org
@loveonfireonly	unknown
@seasonalsavory	human
@CosmOxide	human
@vvvmsvvv	human
@Laura_Volpe89	human
@kwittiegirl	human
@SamIAmmm_	unknown
@MissMelodyyy	human
@ModafferiLaura	human
@KKadsuo	human
@stellarmagazine	human
@GreenBEANMO	unknown
@StayLiveHawaii	human
@fatema_painter	human
@BCSouthCampus	org
@miamianncruz	human
@marionflipo	human
@Bibi89Bibi	human
@FelipeWinterSE	human
@dreaschmea	human
@karenmessick	human
@gogoanri	human
@SaveToKnight3	unknown
@chefpetecuellar	human
@BohemianBoudoir	human
@AGlindoni	human
@TheWayYouWearIt	human
@rinierahman	human
@JoshPNamm	org
@GordonRamsay	org
@AkridgeBlue	human
@SirsQuarters	human
@FirebrandSaints	org
@FreemasonsPub	org
@rory7889	human
@EadsLeah	unknown
@mandiraemusic	human
@WoodwardTable	org
@MixandChic	human
@traceypiprogers	human
@kulopungky	human
@SCD_AB	human
@LikeMannequins	human
@KirkJaco	human
@JorgeLuna35	human
@panerabread	org
@misa_kuzuno	human
@VegetarianSnob	org
@hostandcompany	human
@OneDeSouzaMagic	human
@aleegxo	human
@daniellegamache	human
@PotajeMix	human
@ChrisX_Xzb	human
@charmig22	human
@shiipaopao	org
@ristoSibilla	human
@Miss_cater	human
@burningraynes	human
@vonic22	human
@altcityme	human
@kingabmVIII	human
@GilmoreGags	human
@gospodjica_AMR	unknown
@RamPrincipe	human
@Voiceof9jathugs	human
@CaptCurt	human
@chipon777	human
@TampopoEats	org
@snowwwyy	human
@WELD_ALJASMI	org
@ArhyanSyra	human
@ourseasidebaby	human
@EloyQuez	unknown
@iamneilbryanu	human
@HelloGranolaEat	human
@rafabs20	human
@EnergyWeBring	org
@msorganicgurl	human
@5amWriterMan	human
@ichangemysleep	human
@pierre_victoire	org
@OliverEthan	human
@wennygurlxx	human
@LazzaGTI	org
@ladytorresr	human
@reginekdt92	human
@aksru	human
@LiriosRestauran	human
@simply_merge	human
@Shesolay	unknown
@KitchConundrum	org
@donaldderp	unknown
@PriyaZinta	unknown
@vicky_hendy	human
@nestdrivethru	org
@DariaMukasheva	human
@Sporiabi	human
@SambajoyArt	human
@Isaac_Rivera	human
@eringaines25	human
@u_bits	org
@fireandicekol	org
@jackstevens365	human
@riotanitnot	human
@sunvenusbeauty	human
@centrotaco	unknown
@RichRodzz	human
@paulanicoledp	unknown
@Patricia_Gamboa	human
@lanitaxX	unknown
@Oranka12	human
@ChefHosea	org
@BirdsNestOrg	human
@TheShelterKandB	org
@rainmysoul	human
@atiqahazahar	human
@FusilliGrizzly	human
@JalehMala	unknown
@SkyBlueEast	org
@HUNKSrHANDBAGS	unknown
@Candz24Candice	human
@empointer	human
@FDBoxingHub	org
@FitChefKaty	human
@Eykaevens	unknown
@emilybethgarner	human
@priscicillaa	human
@ZeBrandao	org
@lukerodrigues1	human
@WTorres88	human
@EHEventDesign	human
@olabri_cafe	human
@Lexyledesma	human
@jnewmanwriting	human
@JonathanRiveraO	human
@imel007	human
@Mr_Tru83	human
@bringmeredroses	human
@MDWAN	human
@Loli8842	human
@_eRi_k223	unknown
@JBecerraIn	org
@netHamman	human
@LivBambi23	human
@MusyMusyarofah	human
@GreenCCatering	org
@brown42080	org
@kstonewriter	human
@reieek	human
@xxplumcrazeexx	human
@BakersIGA	human
@selfmadepixels	human
@Kayla_Routt	human
@CarmsNorthEnd	org
@nodangs	human
@Clari415	human
@Im_Jus_Ty	human
@blueberry32a	unknown
@LanaMetzger	human
@Q_theChef	human
@jasonlumberjack	human
@just_britain	human
@krrishon	human
@gemaspice	human
@jessthegrrl	human
@K_Princeluvluv	unknown
@jann_travis	human
@mei_yohana	unknown
@MorelsLasVegas	human
@tntcollective	unknown
@BigHyjak	org
@jianaizi_m	human
@_carlostoledo_	human
@heymissvirginia	human
@chrstnchiao	human
@WheatFreeMom	org
@PastaBoxHQ	org
@Rmfrye	human
@BlowfishResto	org
@monamourmegan	unknown
@adwildflower	org
@bebbiiegie	human
@tetsuyak9	human
@18601960Fashion	human
@textileinst	human
@iluvtruffles	human
@iamcpaige	unknown
@ValerieVu_	human
@skinny_flavored	human
@ElementzPro	org
@renstoppable	human
@zehradundar2	human
@tacticalories	human
@heathersedit	human
@kkmeals	human
@howling9	human
@letsrollittruck	org
@Atanchel	human
@charlierterry	human
@musthavemom	human
@SolanaCrush	org
@knicksselfie1	human
@AmericaEatsTvrn	org
@traveltonia	human
@MielleLoves	unknown
@zkharmaz11	unknown
@LaLaSyieLa	human
@MO_MIAMI	org
@dhshepherd	human
@TheChrisBarker	human
@thelovebump	unknown
@MyLifeWellLoved	org
@nikipk	human
@PhillyPhilMe	org
@my_screen	human
@irenesharie	human
@nata_nula	unknown
@GraffitiJ2	human
@onespeedvelo	human
@IyaBoto	human
@Kiki____	human
@BilgihanP	unknown
@ChameleonGrp	human
@TweettoDine	org
@seanafenner	human
@SofitelAbidjan	org
@amber0345	org
@SGoedertier	human
@23Daviso	human
@KamandakaIndah	unknown
@Thabo_Geek	org
@AmemeZaks	human
@aloha3618	human
@MostlyAboutChoc	org
@MoonStar_World	human
@jennhaden3	human
@saou3u0805	org
@animaniac_	human
@LeighsHome05	human
@yuri_ota	human
@lanrek	human
@Lela03	human
@FarmGirlShelley	human
@ASMARAapa	human
@kymie_GTi	org
@ImTheSarahEpes	unknown
@jeccmarie	human
@justSamli	human
@adiyuka	human
@jspwilliams	human
@PATINICOLAS	human
@therealGernyvel	human
@airayaziz	human
@iN4nN4	human
@MrrrDee	org
@CrazyWrapBiz	human
@GustinaS	org
@ChefEdwardWatts	human
@LockwoodKnutson	unknown
@papalodown	org
@sliceD7	org
@coy_the_third	human
@yogavicky79	unknown
@MommysEss	unknown
@NavaDaniel	human
@ShawnArbeau	human
@Only1Stace	human
@gigivictorio	human
@spoon_FAU	org
@luisamoron_foto	human
@GraceGodGospel	org
@Andre_Flipper	human
@TINAHILLSTROM1	human
@iolsi	human
@clockingofftime	human
@boberika	human
@shamasikander	human
@nsuri20	human
@danceinmyheels	org
@HappyStove	org
@elmegwinning	human
@MakeupArtKlare	human
@AMMARY7	human
@AmedArosemena	human
@pinkypearls	human
@gwapzbaako	human
@patrickstorms	org
@Bonniefacex	human
@THEJUNGLEFEVER1	human
@jatrinh890	human
@F_Addicted_gr	org
@SOUTHRON	org
@chefmichaelpaul	human
@shinshin63jp	human
@youandhomeblog	human
@PaoloDeCastro4	org
@amor_por_comida	human
@KellyMorganID	human
@SproutWholefood	org
@berrifongym	unknown
@kjfnddlkhl	human
@Moggie78	human
@Tanya89Vega	human
@JoEatsFood	human
@DepotMpls	unknown
@Valentina_lu92	unknown
@cvh86	human
@xxGraciexx	org
@dannyrizal	human
@ChefRojoLoco	human
@aoyuchan	human
@mesupistravels	org
@hellomag	org
@iamsabdiaz	unknown
@andrea_ripa	human
@ABikerBar	org
@LustLocalDC	unknown
@SkinnySmoothies	human
@CindyNgo85	org
@JuValcezia	org
@Naomimargareth1	human
@ggoorroo	human
@Kokstars	org
@Straight_Cookin	human
@pearlsnprotests	human
@hmorgan13	human
@michelllemicell	human
@addictiveeee	unknown
@azncurves	human
@Soini_S	human
@SaraNaveed	human
@LizSamantha_wh	human
@ajd29	human
@burimamajiji	human
@allyssalwt	org
@DamienZuch	org
@matttyoe10	human
@AFDON_M	human
@To0ni_13	human
@angel_ling	org
@FedevValeri	org
@SPTapRoom	org
@PatpongRoad	human
@ShaggyKDM	unknown
@miniiegagaween	human
@michellelaratan	human
@IamMihirPandya	human
@DARRENMUSSO	human
@untidyvenus	human
@Setarra	human
@saifullerene	org
@suppiiii_27	human
@brainofrich	org
@CourtLynnS	human
@HongryKong	org
@MsPrettyLThings	human
@RHYTHMANDSOUND	org
@boardsuitenpo	unknown
@QuerStella07	org
@intanROhayu	human
@silviofig	org
@24Nata06	human
@JocLugo	human
@RosanaDupouy	unknown
@FlyKnives	human
@cakegirlkarend	org
@lollypoppiper	human
@shoppingunion	unknown
@bonzaimusic	org
@aravindbk	human
@AveryJamesPhoto	human
@marika1113	unknown
@kerigit	human
@AlexGotay	human
@lukedesailly	human
@SexyChefATL	human
@JC_gouketsu	human
@Janelledakid	human
@AssadEslah	human
@tohonostexmex	org
@Dasani605	human
@geofffahey	human
@applezdashiz	human
@Krissy_0_7	human
@dreambigchamp	human
@fierytale	human
@bigrigbrewboss	org
@ZARADAMIA	human
@SamsBrasserie	org
@martinealvarez	human
@cumberbabe105	unknown
@Cocina4you	human
@CosentinosPChop	org
@nleighc	human
@Dursy92	human
@tahitoLON	org
@inspchin	human
@AmericanFoodBev	unknown
@GirlyEverAfter	human
@HaleGrill	org
@RealDennisFC	unknown
@BowsandBeauties	human
@DanielaMartins3	human
@TheOnyxPlate	org
@IslandAthlete	human
@Onlyyouknow_me	human
@bvchok	human
@AliciaMMusic	human
@EderSunshine	org
@MarisunH	human
@maaeeyan	human
@drawingdrew	human
@FoodAndWineDiva	human
@autobanco	human
@SLhteenmki	unknown
@ElizJacksonSays	unknown
@hugegaldones	org
@Kirstie_Quilter	human
@Eu9enewcf	human
@amylou152	unknown
@tatsuyamaR	human
@BlondieCamille	human
@DairyUTNV	org
@thephunkyjedi	human
@cikgu_botak	human
@peachykins531	human
@deanskinner	human
@SarahChu	human
@GymDatBody	human
@LEclair29297402	human
@KellyNBC6	human
@YvonneDzifa	human
@theklb9	human
@WEBUYJAPAN	human
@Rest_sa14	human
@VivaLinaYew	human
@HonestandTasty	human
@SutherlandChan	org
@Dr_SAYAKA	human
@DJANONYMOUSDRG	org
@shawnwilmoth	human
@RockinMikeW	human
@everyone5	human
@wrapwithbreeezy	human
@TweetMattLevine	org
@kmlaot	human
@Squarebars	org
@TS_Napier	unknown
@natytheprincess	human
@DiningOutMiami	org
@ttt6991	human
@caffefurbo	org
@ThePerfectShee	human
@T_Canada_II	human
@ntanzvsheila	unknown
@littleleahs	human
@JerseyFreshNJDA	human
@wen_bubay	org
@thebattleaxegym	human
@SxyNani19	unknown
@KevinAksama	human
@forebiz	human
@Decopulse	org
@SaYl0rRyAn	human
@JQTeamBroccoli	org
@1620News	unknown
@FairyTipfy	human
@SerendipityInMy	unknown
@mmmcravings	human
@msbrookelauren	human
@sam2orillac	human
@MaeghanLucinda	human
@LHomStonne	human
@rach_f1fan	human
@Danielle_J_O	unknown
@parrlox	human
@ClauRMaldonado	human
@FloridaPlunge	human
@FettleVegan	org
@Mr_JFlow	org
@CrownePlazaMV	human
@NurseRegine	human
@jaymemaurice	human
@Bhakti_Lfstylr	unknown
@Mias_Fit_Club	unknown
@HEATHER32PHILP	human
@nicocanada	human
@ViaMarisa1	human
@SustainableEats	org
@AdelineXinYi	human
@LaainStudios	human
@BridgettEzzard	human
@EatMe_MonRoe	human
@nordicbakery	org
@mintea	human
@evans_kk	human
@Kimmy_ATL	human
@hamptontastes	org
@Isabellaalida	human
@JerryCamm	human
@larrywrites	human
@sylvia_mushuu13	unknown
@jemmademi	human
@jayndatou	human
@vinosdeamerica	human
@EliaMssawir	human
@lita_gorman	org
@sheilanimooooo	human
@kanouchka113	unknown
@iloveairplanes	human
@wendybpolisi	human
@ophdfw	org
@XiaoyingTANG	unknown
@wine_millennial	human
@hataipat70	human
@YTdistilling	org
@aaravenous	human
@ChloeSell	human
@soigneesue	human
@dazoomaui	unknown
@LAsPickyFoodie	human
@theolivetree405	human
@LovPhoebe	human
@VesuviusATL	org
@RealpacInc	human
@wherelunch	human
@kukoominkoo	human
@mariko_dayo	human
@liannesykes	human
@VisitRichmond	org
@kitchencultures	human
@retrobanks	unknown
@CulMaatwerk	human
@jhoyesh	org
@AgnesB36	unknown
@anaemtz	human
@IDBldg	org
@FirstChoiceVeg	org
@LaffsInc	org
@lolong1892	org
@plezKID	human
@KayeObal	human
@GHooliganESQ	human
@whyneful	human
@cata_arias25	human
@SpencerCrumpton	human
@FinestraNYC	org
@phil_lai814	human
@ainabrunch	human
@brokensaint	human
@DesignerTanya	human
@bangedgirls	unknown
@vidatayebi	org
@winterofwishes	human
@Gastronomique_	org
@Rare_N_Unyque	human
@conlechenl	unknown
@orlando_tina	unknown
@Isa_Patsioura	human
@TheGirlsNY	human
@iamHarshada	unknown
@chechegumban	human
@mheilovespurple	unknown
@vistamaldita	human
@GirlFromUrComix	human
@_AUHNasir_	human
@freddfit	human
@Suwanada	human
@hanzubo	human
@JamesonsPubs	human
@TheLadyOttoline	org
@Trendsetter_Sy	unknown
@WellnessKMC	human
@marcelldmulja	human
@JA_Talks	human
@iamdjmaddog	human
@OldsValentine	human
@worthygranola	human
@MichealDormaier	org
@SushmaBindu	human
@withanopenmind	human
@sing_loud	human
@Ryans_Bar	org
@BoulartBread	org
@JesseFoden	human
@Minlilovesyou	org
@KorillaBBQ	org
@lin1290	human
@zdenekbarinka	human
@KilburnHerald	human
@LandonCLedford	human
@_a_y_l_e_	human
@LevainBakeryAgu	org
@xaviware	human
@LiveItFitDrexel	org
@itoyuru	human
@GaryHior	human
@chloegracea	unknown
@susancarraretto	human
@HashtagCapeTown	org
@Dinkyart	human
@NazirulAimanN	human
@Lenax15	human
@LobonaPorta	human
@mrt_ckk	unknown
@MealsWithMel	org
@mszgabbii	unknown
@MqyvaS	human
@DboraCa39199913	human
@ColorJoy	human
@JdgGarry	human
@stephgeist	human
@theblueFROG	org
@TravellerChef	org
@boacampbell	org
@agungridhs	human
@alex_teh9290	human
@kittimorocz	human
@DomoxTweets	org
@RoniWoni	human
@cookeatlife	human
@xWithoutWords	unknown
@TheVegasFoodie	human
@MariusEriksenNO	human
@AmazinAm	human
@basalarmembrane	human
@danrichy	human
@lilmayito	human
@1104denise	human
@photojdoc	org
@HazeHannaa	unknown
@GoodOldMedia	org
@VTDallas	human
@GiuliettaCafe	org
@jin_uchida	human
@myjoyceheart	human
@Lia_S_P	human
@MikeDosPhoto	human
@SweetScienceBkl	org
@ElleTexas	human
@M_ArtNinja	human
@imbeingerica	human
@PrintableMotive	human
@ChrystalKellyRN	human
@helen_hchl	human
@ShangriLaTO	org
@AwehOfficial	human
@ndrestorresfaba	human
@Joasana_Yoga	org
@AlyssaJLong	org
@LOCALEKingCity	org
@shattered0ne	human
@hasnaafghan	org
@paulilow	human
@TiffanyKatharin	human
@DidsburyRT	org
@cipqx	human
@Maghdallenah	human
@liwencui	human
@edinburgh	org
@subsidice	human
@kpopfemalesnaps	human
@chuckpryor	human
@Bar_Gumbo	org
@Vizziatissima	org
@shiang7282002	human
@DESIblitz	human
@ScottieMcClue	org
@angrianan	human
@FoodExplorer044	unknown
@olemissgal00	human
@_Polpier_	unknown
@sweetd914	org
@cocoYoshiki	human
@emannyray	unknown
@danewssource	human
@LIBERTINEBISTRO	org
@FleetwoodFats	org
@GoalOfLosing	human
@Jodiejjensen	human
@aldrinmacabebe	human
@PandavaCoffee	org
@adams_helen	human
@villesullarno	human
@johnecottrell	human
@Stylearachie	human
@CGwidl	human
@mipo03101	human
@Panorama120wine	org
@CaveInnBBQ	org
@JasmineHoffman	human
@MrSizzlesCurb	org
@EnoShandy	human
@theehomemademom	human
@MizzFitness	org
@gochicbylu	human
@OneluvPromotion	human
@laurasinar	human
@J3ssieKitty	human
@fermorton	human
@leoniekathy	human
@CayirciBekir	human
@LeeKimeun1145	unknown
@shzox	human
@lesbananasnyc	unknown
@KoolKat_86	human
@shellymarierd	human
@jereimei21	human
@Bernard9Sone	unknown
@madhureshsethi	human
@afoodielist	human
@leslie_ching	human
@RiaBurki	org
@ErrnestaV	human
@eatlikeagirl	human
@slimmingworldiv	human
@yolksandspokes	org
@MrJensenY	human
@dayardcoke	human
@uticasquare	org
@NikNasreef	org
@ms_marymacc	human
@mrveneno	human
@DiniAmira10	human
@lenilovely	human
@william82sg	human
@iAmLaNina	human
@gwendolynnlee	human
@BBowlVegas	org
@chintakaprazad	human
@CheeseWeb_eu	org
@FebiliaTine	human
@44chicken	human
@GcbjxBsmhf	human
@MrLKingJr	org
@jjcucu	human
@jessie2206	human
@DanielaAndrews	human
@DietDeepDish	org
@luferrari	human
@blonde_and_tall	human
@ValeriaDOrazi	human
@SidewalkNY	org
@gibaragiola	human
@KotonoTakahashi	org
@caffeinehusky	human
@brigittastri	human
@LaceyMomma	human
@rejas_rejitas	human
@LucyBiella	unknown
@shawellness	org
@EmiGrechi	human
@DublinTown	org
@chipa_izu	human
@NasyaRob	human
@AliceCerea	human
@UrbanRoyaltyJL	human
@iamchloecarlos	human
@footunjin	human
@BriansBookhouse	human
@ymasterchef	org
@fluffypunkfairy	human
@RazzleDazzle923	human
@cupsaucerblog	unknown
@SugarFixDessert	org
@BanningsRestaur	human
@ShakespeareKent	org
@anaMARIA0521	human
@Cantinecousins	human
@JAYTHERULER_	org
@mrlawrencelopez	org
@JennyLeCreatif	human
@thisguyhere627	human
@BBQsauceBel	human
@francesco_bigno	human
@miguellaureta	human
@potrillionaires	human
@ThatTuxedoCat	human
@lemicheleyoung	org
@carlabritten81	human
@MissRae7	human
@tyson1050	org
@lonasastro	human
@EatsEatsEats	human
@noemymilan02	unknown
@kosuke_yahata	org
@lusiicant91	unknown
@richardsonad	human
@Dinosaur_BBQ	org
@datinkoya	unknown
@ladyleanneg	human
@jajahboom	org
@kaoo_26	human
@JJSaturno	human
@BigeatersclubOR	org
@watanical	unknown
@IrishComps	human
@qmkhq	human
@hotelassen	human
@mingkkey	unknown
@gfreeedinburgh	org
@LuluFromMontmar	human
@ShopXtraLush	unknown
@EleRossi17	org
@colleengreene	human
@ShioriMatsubara	human
@minakobb	human
@ShotzLounge	org
@lucianalasus	human
@BullandRancher	org
@FlorianNYC	human
@hepekiz	human
@mprmf	human
@danielwonder	human
@dustinh11261	human
@thisisherberts	org
@S2kskinner	human
@16_Aquamarine	unknown
@Styufeeva_Irina	human
@Lunch_bento_box	human
@LocoGringoCom	human
@LesleeTT	human
@conquest357tk	human
@Bowl_Me_Over	org
@florspace	human
@L33MTL	org
@BeyondLovely123	human
@MurielsCafeBar	org
@tomokochuu	human
@davelhudson	human
@Cape_Royale	human
@Cookhouse_Cater	org
@LEsenina	human
@LifeOrganics	org
@steelermoe74	human
@aguspalazon	org
@StealingEmily	human
@ambervanderzee	human
@RocksaltAscot	org
@GeordieVarek	human
@GruddyeuGobrwy	human
@DANNYW0W	human
@Dellydoll	human
@DonkBoard	human
@GrasslandsTO	org
@diddywheldon	human
@ChicagoCabbie	org
@AguaFrescaNYC	org
@SunjayJK	human
@tulusira	human
@BW_Grey	human
@zkharmaz2	org
@DaleelahZainal	human
@SbarroDR	org
@MrKrispsDubai	human
@theprettybee	org
@marynalberto	human
@cruzhanna79	unknown
@imeherejusty	human
@ayYO_Dai	human
@meli_holcomb	human
@lo2012_la	human
@YTPauL124	unknown
@foodiedoddie	unknown
@Jizzle_wen	human
@inguaribile	org
@DavideDiodovich	human
@WHOREvina	human
@halifaxscb	human
@iB_JMarie	human
@harithdaudCLNK	human
@PjRattigan1	human
@abellielisa	human
@LA_DIMPLES85	human
@candidlyjulie	human
@worlack	human
@annilytical	human
@coffeeprojectOn	human
@AddamTansley	human
@Skinny4Xmas	org
@PeterPrins	human
@tonykkent	human
@SlimArmyTwit	org
@francescasarg20	human
@GiacomoAst	human
@ayaibaggins	unknown
@krizostomovdc	unknown
@Runningcrazy24	human
@PreparedFoods	org
@evonne1984	org
@RDexposed	human
@kensyap	human
@CalbeeUK	org
@broodjebrenda	human
@Sonjabee	human
@ElizaY_AZ	human
@zaidasphyxiated	human
@PlusTaxMUSIC	unknown
@DiabeticLink	org
@SedosButcher	org
@RunWithRabbits	human
@EfZinCreations	human
@Ckolb	org
@Simplycalledfoo	human
@Rachel_Janice	human
@upperclassmen	human
@chatissa	human
@icanbeDYNamic	human
@QbanKendy	human
@Joansstory	human
@HongJieOng	human
@Cappuccino1789	org
@mariacarms	human
@bgourmet935	org
@BluePacificTaco	org
@deeniseglitz	human
@CraigDryhurst	human
@beatrizii_marie	human
@ClothiesSarah	human
@SpottinUpFor_3	human
@michaelmahor	human
@w_singapore	org
@kkbreakfastblog	human
@SproyJr	human
@sthrnfairytale	human
@LeTerrier_paris	human
@JRCPascua	human
@Kajsicken	human
@lamar_vb	unknown
@tomcolontonio	human
@NNaru	human
@StillStacie	org
@kobezzz	human
@audacious729	human
@Le_Di_Vin	org
@tataari68	human
@readendless	unknown
@paezan8	human
@Shauna_Shines	human
@JUSTJOY28	human
@OlallaLima	human
@tobylok123	human
@TIMNSHARON	human
@CrossingLambeth	human
@b76	human
@yamadaslim	unknown
@CurtiSWesT	human
@LaMadiaCHI	unknown
@gemmakate10	human
@sweetpea297	human
@IShaktiDal	unknown
@RogeyC	human
@aurelasrainsong	human
@MiraHashim	human
@Spinoholic	human
@Ivemel	org
@tjaycalano	human
@melevans16	human
@BrandedSteaks	org
@vickypcarrizo	human
@funbeingmum	human
@roycearellano	human
@BurckardDenise	human
@0107_01	human
@Loco_1925	human
@royricardo	human
@behindcatiseyes	human
@nazelross	human
@BlogForTheCause	org
@takeoverradio	org
@BEN_coffee	org
@sevenquartstav	human
@MakeupbyMethela	human
@DivaniApollon	human
@duccnguyen	human
@ChrisSpiegl	human
@ComedorGrillBar	org
@SnapDatPhotos	human
@StyleByYvonne	human
@cookschanel	human
@JoniLoveVWBugs	human
@megunprocessed	org
@NeuvooAddison	org
@Volgograd_life	human
@vanillarinko	human
@m_carter92	human
@RickardDee	human
@SouvlakiTruckNY	org
@sarajiw	human
@momousseline	human
@Blaqmozzez	human
@zainab_2152	human
@JonasBakery	human
@eatthegains	human
@PapaPingoCafe	org
@JuliaHoXinFang	human
@my_own_mood	human
@Melindesign	human
@theSofiadeSousa	human
@TraceyHalpin	human
@FRANKOSH	human
@GlutenFreeMama1	human
@iHNZL	human
@NadiaNivela	human
@aaataro53	human
@hanrytanto	human
@createdbydiane	human
@SaraGracia89	human
@Cctrivianni	human
@mrdoc	human
@SarahMJConnolly	human
@spotding_com	human
@Mommy_NeedsANap	human
@NourAzreen	human
@YogaLorna	human
@kikiingkong	human
@TaboonNYC	org
@foodie_pedia	human
@JapanIn3D	human
@soniademacedo	org
@lil_fitme	human
@AlReeM_S	human
@PrinceLex	human
@aqchixtina	human
@fairyaoi	human
@carcarmenn	human
@NeuvooAbbotsfor	org
@BloggingMamas	human
@ThirtyOneCran	org
@CafeItalianoUAE	human
@NourishBelper	org
@Nawaf78	human
@salvationjaneUK	unknown
@SugarShoppeLA	org
@princesstanvi	human
@PeanutAllergy1	org
@OlaLeNikki	unknown
@emmaplowman	unknown
@michellecabralx	human
@blah_brian	unknown
@colinkorbelas	human
@deJabs	human
@mezy	human
@lunvreclipse	org
@Deegemi22	human
@pubaret	org
@chizuchama	org
@kogifdgfdgfd	human
@DionneMagouirk	unknown
@itsEmanMade	unknown
@HermiiHueto	org
@hasuncalo	human
@Rylins_Mommy13	org
@BH_Bistro	org
@cjnatsu	human
@dramaqueenjs	human
@27ANDREACS	unknown
@PrincessJuJu	human
@Madam_Heidi	human
@Airforceata	human
@helloimsl	human
@tia_otaku	human
@iaminfinity	human
@wishkosana	human
@alisaali23	human
@TheRudeDevil	human
@EsarnKheaw	org
@infofer04	human
@geniusdmo	human
@PinkyFoe20	human
@TheInsaldWriter	human
@VictorDragono	org
@DearJohnBr	human
@rrno14	human
@RayvonMckenzie	human
@jun19531	human
@DarrylAhBoi	human
@MigraineMgt	human
@Dualcasting	unknown
@valecolette	human
@engineer2207	human
@TwoLondonLadies	org
@bourgeoissnob	human
@Nathaliesader	human
@FitVIP	human
@BombShell_Nesh	human
@ThalySotelos2	org
@AmandahMaki	human
@greengurl02cute	human
@AniKuthi	human
@goodculturefood	human
@GourmetAnyDay	org
@vale_loark21	human
@SaCozzolino	human
@EL_MENNY520	human
@colleendorazio	human
@BrittneyLLynn	org
@tastesam	org
@DowntownLouies	org
@MadDogsMesa	human
@HealthyFFBlog	human
@al3xhouston	human
@maryel_p	human
@1802House	org
@BelcampoMeat	org
@Ricardo_Laguna	human
@lapetiteoliviaa	human
@leonorajane27	human
@MuanteaChinzah	org
@MindBody_RD	human
@saraprv	unknown
@Quantuml3ap	org
@phillygmeats	org
@hamimaro	human
@mona_locpe	human
@imchriscollao	human
@cikrosehjtumin	unknown
@CamdenHeights	org
@Hannibal_Doctor	unknown
@yaelsara	human
@adoreyou1107	human
@KajusaKil	human
@STFU_IMGorgeous	human
@EzreenaD	human
@BeriColak	unknown
@icemanmase	human
@e_tse	human
@GreysonVeronica	unknown
@TastebudsOnTour	human
@yourboykiss	human
@privededessert	human
@nebakgokcebak	unknown
@brtKOREA	human
@jlebena	org
@_Jstratt	human
@NobleProtection	human
@VinoVisit	org
@mydubaidiary	human
@Crumbsyyc	org
@JeSuisFoodie	org
@bbts	org
@thepansclub	human
@aroraanmol	org
@snivelyphoto	human
@Ruthdsouzap	human
@DannyGirlMTL	human
@CoffeeeTime	org
@meganwallaceRD	human
@NinaBofa	human
@SALSIKandar	human
@santemarbella	unknown
@JadePTraining	human
@YerinLee_51	unknown
@AmatoProducts	org
@frostingdiva	human
@litblossom	human
@iheartnaptime	org
@kristos68	human
@xinystar	human
@ray_m_en	human
@Agentluxe1	human
@HGoeschRDN	human
@FollowEmmaB	human
@XKalaba	human
@VITLhealth	human
@chexiche	human
@HFreemanPR	human
@EndOneArt	human
@MarcoEulen	human
@SophiaWSB	human
@gucchan_akbingo	human
@margiena	human
@k_plumley	human
@ld130fam	human
@HeyLetsApp	human
@Caryncann	org
@voodooangelrah	human
@huiyingyeoh	unknown
@Jcdisla	human
@ariewulandarie	human
@FoppishDork	org
@Eler4Ever	human
@rileyton	human
@healthcoachMR	unknown
@nackrufs	human
@YPototska	human
@curiousfurious9	human
@hksikga	human
@gusiffer	human
@panzie_devil	unknown
@Geschmackstraeg	human
@born8450	human
@kSquaredGlamour	unknown
@TryMaple	org
@RealDivoDaniel	human
@itsfrenchben	human
@ZeinaaQ	human
@BarduCentral	org
@blacknthick	human
@Run_Pray_Eat	human
@BubbasAstoria	org
@MirrorsIbiza	human
@HonorGold_Rena	org
@ExtravagantG	human
@HellofoodJO	org
@jerryjvl	org
@chefmoicheftoi	human
@Kerstiin_Berlin	human
@IvyTongtong0330	org
@PutrieJrs	human
@Chai_IZUMI	human
@laplayaluanco	human
@nslhncnr	human
@PetrocciDesign	human
@pjosh227	human
@eswright18	human
@K__u_u	unknown
@RobiMagno	human
@KTCooks	human
@C_Selection	human
@Junbucks	human
@DenverBizList1	human
@iorogisan	human
@fiercejohn15	unknown
@mhaimee	human
@creamyncookie	human
@NoochVegan	org
@bin26boston	human
@Wava6678	unknown
@hestondwiva	human
@MakeUpByCamila	human
@LondonsNightKat	human
@SayWellness26	org
@kcadpchair	human
@silverchicken1	human
@rinae_bc	org
@Chic_sik	human
@wadahiro0929	human
@yourladytee	human
@radiodreamer	human
@immajiro	human
@CliffsideDining	org
@devinapathak	org
@aasyraf135	unknown
@SeattleWeekends	org
@Laurenwilson512	human
@arisaueji	org
@JOSHYCONKER	human
@enne_23	human
@dragnesdc	human
@miyumiyu_0614	human
@RegenceOregon	org
@Foodtruckstars_	org
@BisanzioV	human
@iAmBeff	human
@DanielaNRibeiro	human
@jacky_lo	human
@Harley3287	human
@Q_Designs	unknown
@_goodeats	org
@WFM_ProspectSt	org
@huntmeister82	human
@nazmiyusuf	org
@roeder128	human
@babyonze11	human
@CV_cutieee	org
@CoreStrategyCo	human
@ItsJust_MiizH	human
@YokifurFashion	human
@BittersweetOT	org
@ApronSneakers	org
@thyasPRAtiwi	human
@OZZRESTAURANT	human
@haleythu	human
@AversaPR	org
@DamGoodCooking	org
@Lapucadelmercat	human
@Lalopez1	human
@Dorinablog	org
@MukerjeeHT	org
@StylesavvyJA	human
@dinnerdesign	human
@kitchen35com	human
@5StarInCebu	human
@I_Cant_Breathe_	unknown
@permata0610	human
@ItsYaBoiO	human
@blonde_factory	human
@BilzMusic	human
@annacucinasana	human
@SSohaard	human
@unionfooddrink	org
@EmmaJensenID	human
@megatmizan	human
@elaineguarin	human
@AbbeyCateredMtl	org
@Brizy_B	human
@lifendafastlane	human
@1_Narz	human
@RyanPricey	human
@KristaKyien	org
@Chrysant_	human
@TheSatEvePot	human
@mamos4life	human
@mpoukia_mpoukia	human
@KrissyFlakes	unknown
@bionic_chicken_	human
@KRYSTEL002	unknown
@ruthhill74	human
@Phatbootylove	human
@AlisonBHodge	human
@IE420	unknown
@BCubedFitness	human
@Maika_Tremblay	human
@iAMpiper	human
@AvaTaylor23	human
@hamitu92	human
@helen_monday	unknown
@ann7297	unknown
@stephaniecarles	human
@mie_621	human
@ButerasRauhling	unknown
@VERNSULLY	human
@0501_myka	human
@doubl33tak3	human
@mllegeri	human
@LoveHedonia	human
@SanoChisato	unknown
@SouDoCaraio	human
@MomsInTampa	human
@LittleParawhore	human
@scorpiomvp	org
@AshleyLaneFit	human
@Irf_Foodie_News	human
@Click4Name	org
@acupofdisney	org
@johnube12	human
@veritomonetta	human
@pavsdhaba	org
@VanillaCakeFi	human
@gienahvia	human
@Xarian70	human
@LisaWheat922	human
@Crazy_Latina217	human
@BrunildaTT	human
@yukieshiina	unknown
@tsp_tea	org
@leesolo143	human
@parksrecdiner	org
@BanChokDeeThai	org
@GreenGuyBruce	human
@Hel_D_	human
@RumahNgemil	org
@VAMEvents	human
@MaridoCozinha	human
@safieullah	human
@tequilajoesnz	org
@MDose	human
@SeanBrownePhoto	human
@AbsandIceCream	human
@MiszOlivia	human
@chanienk_noura	human
@CynthiaSMatos	human
@blackyannyann20	human
@2real2b_Fake365	human
@BestHe_EverHad9	human
@redshirtdave	human
@Guilfoyle1301	human
@FayeEvette	human
@cha0ticaptain	human
@m_acevedon	unknown
@destingoTO	org
@LAFNGUY	human
@keshgonzales	human
@HannahPorterr	human
@pflviola	human
@ceotrillionaire	unknown
@jessicapair	human
@HugoPuppyDog	human
@schanmer	human
@kristine_sawit	unknown
@ThistleCEO	org
@renai_VmrA1	unknown
@mirkodemaio	human
@MaritzeniaL	human
@ChronicDancer	human
@katelynnpedrie	human
@miggs_tonton	unknown
@boyswhobrunch	human
@mioh28	unknown
@officialHSTV	human
@hotnessaldrin	human
@wchrisburcham	human
@MajorCREATES	human
@Deb_ELLE	human
@taylorg95	human
@MelvinEwe	human
@RaechelAReyes	unknown
@James_Republic	org
@CNCBIGDOG	org
@mama_lite777	human
@Plumbing_Expert	human
@Luckys13Pub_2	org
@WiLLoWs_FaTe	unknown
@BuczakHirokazu	human
@bishokubu	human
@xepiphany	human
@One_New_Change	org
@DheeRiany	human
@MangCouture	human
@tichetiz	unknown
@TerryEckersley	human
@TelasMarket	org
@MewzMe2	human
@the_goddamn_wu	unknown
@yozefff	human
@Lakapati	org
@NateG83	org
@Imanolneira	human
@VEREALTY	org
@mojua	human
@Michelle_Anne_M	human
@Chumpaking	human
@Trendvintage	human
@__Ywengyan	human
@Cairo360	org
@Rilaaaaaxxx	human
@newfashiontales	unknown
@BottegaBaracchi	human
@RevsRichmond	org
@chataignestyle	human
@aMissiontoSave	human
@WeirdBipolar	org
@LuciaChoiSweety	human
@hashico0625	human
@acviens	org
@MichaelAusTx	human
@amagarabistro	org
@rachelcoffe	human
@MZMUSIQSTARR	org
@zeljun_02	org
@nantizz	org
@FredRiedelG	org
@BellHotelDriff	org
@Garshuu	human
@B3beautybyblanc	human
@janeyjulian	human
@FabioBresciaTwi	human
@sonoko_amethyst	human
@adalinelau	human
@lennski	human
@sbalderson	human
@deliago39790540	unknown
@MonroeHotels	org
@Beef	org
@CL_Andrews93	human
@pilgrimandpearl	unknown
@EleonoraCB	human
@mymcmcool	human
@CapelesDesign	human
@owenfarr92	human
@NVOSF	human
@southbanklondon	org
@GokuGang	human
@NicolaBidgood	human
@hKamagi1905_	unknown
@AafinaZamil	human
@Mimicraks	org
@JESherrill	human
@ortiziana	human
@bill_eslove	human
@Imjae_bytheway	human
@BStylingLife	human
@realheatherlynn	human
@nicelittlestar	human
@MamaCsKitchen	org
@FreedomDiner	org
@ElbaronFIM	human
@Jenni_W	human
@ARZUYA_GORE	human
@MollyBrownsBar	org
@_animatix	human
@5pmFL	human
@TuscanFields	human
@chefcherbiny	human
@robertbevan77	human
@NourishEdLife	org
@Linda_Xtian	human
@Bebodysmart1	human
@nateridgeway	human
@CharlestonCraft	human
@ViallHortman	unknown
@SalemOpus	human
@WLantin	human
@cheekyCheery	unknown
@MissMiaDoll	human
@blog_cttc	human
@_kt_rulz_	human
@LisaWolansky	human
@LaosLove02	human
@Amaliamardiyana	human
@XJackieBabyyX	human
@haizaa	human
@HappyBakeryInc	org
@LeVirtuose59700	org
@GWAPOkoMEN	unknown
@Justine_Simpson	human
@Pr1ns2n	human
@sixyofo	human
@ghlun	human
@BrenBrenERAZO	human
@MarcoMottolese	human
@hime_qi	human
@LonerTrav	unknown
@DesyChan1991	human
@koigagdsf	human
@IsaacZakyLoke	unknown
@gadgetshopuk	human
@Missylynn83	human
@MeyMey_lin	unknown
@Kokkeriet	org
@NinaEPhotos	human
@rainine8158	human
@taalz	human
@kdunc33	unknown
@ohayobento	human
@sevendwarfs84	human
@_franchescaboo	human
@BokuWaVampire13	unknown
@FujiSushiSea	org
@MichelaMuratori	human
@bacspin	human
@FollowbackAlien	unknown
@OOoAYNIHSoOO	unknown
@thebunnythebear	human
@DavewitDaJays	human
@justsaladuae	org
@marina_021	unknown
@MrStonedAllDay	human
@DConstructs	org
@CynthiaMorneau1	human
@BullfrogBagels	org
@kentycrush	unknown
@ForeignGeek	human
@Restmatbiten	unknown
@Jo_STylin	human
@Simply_P_F	human
@EggFarmersofNS	org
@codeblue26	human
@ShipleyDamnit	org
@pmdias	human
@TheStilltop	human
@needketchupstat	org
@absolutemitha	human
@ImanFit	org
@HealthStart	org
@JacckUK	unknown
@MizzlesWorld215	human
@jacsar03	human
@pin_Sanpatanont	human
@msjoyluckclub	unknown
@IvanaCujova	human
@second_second	org
@Lili_RHS	org
@MerviHuu	org
@smith98710	unknown
@offyzminogue	human
@KapomCrafts	org
@Stephy_Graff	human
@pennbury	org
@JenniJenni7	human
@4N6Gal	human
@michiganmyway	human
@mybutterflies	human
@Vron821	unknown
@ssulfer	human
@Urban_Traveler	human
@zoebowx93	human
@are5th_xoxo	human
@relishpdx	org
@tintin092479	human
@00_risa_00	human
@umiqsNews	human
@ChefMarkTopps	human
@luvyorkshire444	org
@1lysh3	human
@WillAAW	org
@spoondipity	human
@Animalwhiz	human
@Vee1Vixen	human
@FluffyRJ	unknown
@anys_005	human
@OlanAnna	human
@itsJennelle08	org
@joiceBOCAH	human
@aralovegna	human
@OKPromoservices	human
@AussieWoei	org
@ethnicspoon	org
@smokeringatl	human
@CynthiaWeather2	unknown
@RNaas	unknown
@ZacharyLong	org
@anthonycojeq	human
@abjorkbillings	human
@comeonletsgoo	unknown
@OujoM	human
@daizleen	human
@saritax0115	human
@DTangoCharlie	human
@lov2puf	human
@robertashton1	human
@TWCNewsSTier	org
@AlSalamKoeln	human
@VANESSA_NOEL	human
@PapaSerraJr	human
@on_abbotkinney	human
@Y3S_ImH3R	human
@davidfcastle1	human
@colorcoatedlaph	org
@mollykimballrd	human
@darylrose18	human
@SarahDinonTweet	unknown
@CaseyGUNS	human
@robertabenson	human
@Mandy_koong96	unknown
@TeamHappyPlanet	org
@Andie_aka_D	human
@foreverfreshyo	human
@Pizzeria_Ortica	org
@kimdc	human
@ConnieCasazza	unknown
@KatePinkSmith	human
@PimmsBrooke	org
@XanderXero	human
@tingxii	human
@antoniotwitts	human
@1stNightStPete	org
@esterrick	human
@thehiitmum	human
@HollyH1921	human
@Amerah2pm	human
@Potteri78	human
@tdsdavis	human
@AmbaHale	human
@penelopejmorrow	human
@RonRussell2	human
@willbasset	unknown
@ritasilvamakeup	human
@zharifghazali	org
@abee_sytian	unknown
@Mdlint	human
@tech_pearce	unknown
@NotTheFakeMicah	human
@AhmedK	human
@RainieWms	human
@jenni_xie	human
@theyummytummyco	human
@Eliankx263	human
@fumiya_kiyohiro	human
@charlbabybell	unknown
@khriscat	org
@TheDylanDias	human
@AlfonsinaLotito	org
@MidAmCl	human
@eflicciardello	human
@callMeBry_	human
@NikkaCruz95	unknown
@888Scott	human
@sato_kayo1226	human
@labfpto	human
@HernanCastelazo	human
@HealthMatters_1	human
@sabbykat8	human
@eRiC_Bz1	human
@AZFoothillsMag	human
@Olga_Sunshine	human
@ForestFisher	human
@Memoriestoyou	human
@skullgasm	human
@edercastro25	human
@JacksonMSEvents	human
@myjejunelife	human
@AllyssOrmS	org
@enpitu_iro	unknown
@djesonis	human
@skyegauzza	human
@sexybootytube4u	human
@SpaceCityTO	org
@islmyst	human
@KnifeandMise	human
@_TrialNError	human
@GettingFit64	human
@AnuskaRose	human
@MaralenMusic	org
@N444TYF	human
@TCOriginal1997	human
@akuXIII	human
@ClaridgesTweets	human
@dww25921	human
@ptyniki	human
@LadinaBar	human
@ursriegler	human
@cornwallchamber	human
@PenguinsinPink	human
@laura_adney	human
@PatchworkCactus	org
@Jeddah_Info_	human
@RutAmaro	human
@PriPerez17	human
@kati_lyn89	human
@boogiebLA	human
@VillaCampari	human
@tamarasabine	human
@SherryinLA	human
@sukibhamra	org
@CherryColors	human
@EmsGood	human
@TheNext23Hours	human
@ilurvkitty	human
@BlackMarketGP	org
@MarigoldSteele	human
@ChicagoLovesPan	human
@tomoyo1205	org
@indieguy777	human
@cyancat_	org
@JMOfuxwidit	human
@ADrauson	human
@Letty88brown	human
@_LadyAQUA	org
@cnvasquez4	human
@NurulAliyaSofri	human
@ebinokimono	human
@OquendoBradberr	unknown
@galantine0506	human
@FIITbyMegan	unknown
@Diana_Karenina	human
@ABLuxury	human
@kaox	human
@melbella_mocha	unknown
@EjatSpike	human
@EmtMorato	human
@MichaelC1210	unknown
@indra_hdt	unknown
@drew_venturina	human
@phileb39	human
@VisitBanbury	human
@Tamy_Ayelen	human
@tara1966	human
@Miss_Sunshyne86	org
@HolidayInnAruba	human
@adhie_ale	human
@JaNetAdamsSpeak	human
@FERTLEJAMS	human
@WindyCityLIVE	human
@Embem04	human
@makecoffeebot	human
@CC_314	human
@WishFarms	org
@TaraLaValley	human
@daaa_maaae	unknown
@Darlyn06	human
@KareemmaBernard	unknown
@Skullwany_	human
@ShibuiTeaUK	org
@tokyo_baseball	human
@alonamartinez	human
@MindaFraser	org
@4everRnbGenius	human
@Harem_Satalin	unknown
@BinSultan17	human
@anceLita	human
@minaisms	human
@iamsherylyn	human
@fillpraycloset	unknown
@LeonardJeannine	human
@ArtisanalBistro	human
@rere_rere_re	human
@WahminSC	human
@thecountrycat	org
@scandilicious1	human
@Shorty305	human
@anaisrekus	human
@zara02	human
@malia1119	human
@yofntsmnl	org
@TheBreakfastRev	human
@tnt_uyen	org
@PattyCUTtE	org
@ami_ami_0819	human
@kikis5577	unknown
@newworldfilmsco	human
@TOMOHONinfo	human
@noryannecarpio	human
@Catalan_Cali	org
@Harvest_Susqhna	human
@RafaChee	unknown
@Ivanaperkovic	human
@MercurioCafe	human
@LALLnutrition	human
@PressRoomKL	unknown
@Hollymw004Holly	human
@CompassBoxHvB	human
@earlsWillow	org
@ETHNOTENDANCE	human
@emily_the_gray	human
@Klynzer	human
@Restorantes	human
@ParisisFoodWine	org
@jajakanberdua	org
@arvinhomaaya	org
@lynneatslocal	human
@siemn	org
@LRRNorwich	org
@code75_	unknown
@2BeRed	human
@stepstevie	org
@MeliaBali	human
@SaraEmotionally	human
@bdlongfellow	human
@AshShrrcksays	human
@angelkantik	human
@Marleen_Vonk	human
@RekaBeck	human
@ilovenh812	human
@sparesoles	human
@Ibertakanes	human
@youandme110	human
@MomsInMadison	human
@sfasteak	org
@MeisaYkk	unknown
@underthecrowd	unknown
@nrgbabe	human
@lyzsalyzsa	human
@pariscuisine	org
@bigbearswife	human
@philipdamanik	human
@RokaAkorSF	org
@Krisartsee	org
@GetGoodbites	org
@nophietcha	org
@LizAvery	human
@RivAlejoT	human
@shuei_sasa	unknown
@CitiviewLou	org
@MaheshLunchHome	org
@secretcookingb	human
@SwansonVitamins	org
@Carilyn_YHL	human
@nathacalista	human
@JoyceLXL	human
@Renatus84	human
@NBSAssist	human
@fabiogarcia1	human
@diCHEcrian	human
@kidsccg	org
@Vishnuatcarom	unknown
@the_arttable	human
@thickgurl856	unknown
@MarketKitchenAD	human
@huzaimin	org
@lapeople507	human
@YUchenISH	human
@DelanceyandCo	org
@MyMyDaEnvied1	human
@vitale_pat	human
@Take5Deli	org
@fab_cup	human
@ZenCupcake415	unknown
@s_mk0718	unknown
@Sabrinabuizza	human
@srchscrumptious	human
@anstasiaprisila	human
@LoseItMag	org
@plymfitness	org
@Lod8506	human
@wolfelephant3	human
@InItalyFood	human
@tedcatalyst	org
@Weiz0310	human
@jpbdionisio	human
@7MileHouse	org
@KristenRod	human
@RiadQuara	human
@yoursundaybag	human
@desafio29ok	human
@MelindaSVasquez	human
@thefaradaykage	human
@Serious_Coffee	org
@SayWellness17	org
@MicaelaIusem	org
@Dan_Sollis	human
@NazSelda	human
@LunchesWithLove	human
@BoulderIBA	org
@beachrambler	human
@RynahRee	unknown
@SamPhen	human
@Massmafiamusic	human
@SusanaLubo	human
@MRS12_	unknown
@DelnavazM	human
@CabaJf	human
@terrorist_snack	org
@cicadahuahin	human
@Rio_HipHop	org
@Marllov_P	human
@ShadowGammaD	org
@everibe	human
@Gastromaniac	org
@kerbear77	human
@andywhisney	human
@AlbertoLondres	human
@adammilliron	human
@ElDiariodeNovia	org
@ChoiBoink	human
@NoLaMoms	human
@KNFConsulting	human
@Kingsley57	human
@didelcal	human
@partlypixie	human
@Ramlieee	org
@NasmukCitra2	org
@SereneSocial	org
@Airportmag	unknown
@ThreeTwins	org
@AGCzombie_style	org
@eBookOfPhotos	human
@KatieShmatie25	unknown
@m2famb	human
@CoventryIs	org
@Theboozycook	human
@martin_oxley	human
@madridmuychic	org
@eatatPorkchop	org
@Fitriyalam	human
@RadanaHruba	human
@HowardFlowers	human
@WubbaStokes	human
@Shiny_Glitter	human
@e_l_r_i	human
@kathrynsproule	human
@suburbansparkl	human
@Pinky_ANGEL31	human
@moriya_kuma	human
@roamingforkNC	org
@fabulousmissmsm	human
@amandabarbier3	human
@WeAreBullied	human
@TheRealRuncey	org
@itchiescratchie	human
@YAjengui	human
@dizzjess	human
@braaianNC	human
@MartiniMonkey70	human
@kisseswithteeth	human
@AzureGirl007	human
@BoneLickBBQ	human
@turdctr	human
@nontaband	human
@wrathsqueen	human
@faz_laca	human
@hoffa140	human
@LocksofGold	human
@IgorJosif	human
@MarisolRmzC	human
@cakescorkskids	unknown
@SteveSchaum	human
@OasiHotel	org
@BoykinBros	org
@Failsnet	human
@DelishDishCincy	human
@nuraycatarifler	human
@bhavan1	human
@AraceliGRodrigz	human
@ElFederalRest	org
@Begina85	human
@LifeOfJewels	human
@sleepingcutie07	unknown
@OAK77uk	human
@xiaoalien	human
@CntBg23	human
@Reecy23	org
@tessvowels	human
@novisony_4ever	human
@JKolt33	human
@Stippy_eep_eep	org
@my4oh7com	human
@ObiterDictumNet	human
@MedotiA	human
@Ri_No_Ki326	org
@rasta__babe	human
@jaimemckee	human
@xangeliquex	human
@GeorgeGoGlz	human
@__ku_ra_ge__	human
@SdotGold	human
@Waldorf_Chicago	org
@Judy3543	human
@CTRLZAK	org
@Wait_Y0ur_Turn	unknown
@puunya	human
@seminolehart	human
@sunyaph	unknown
@CouponsAreGreat	human
@metro_cafe	org
@cleaneatingteen	unknown
@reaskha	human
@JeremyNewman	human
@VillaRealeMonza	org
@SparrowBloor	org
@dc_deasy	unknown
@MetKate	org
@Tavern_Kitchen	human
@grazia_ru	human
@PonceCityMarket	org
@Photography_JMC	org
@thefodmapper	org
@WalterJMarvel	human
@NotensatzWeebly	human
@restaurantCRFN	org
@StacyLagrasse	human
@konggy	human
@kandawestcurry	human
@jye88	human
@fierce_miles	human
@aggieskitchen	org
@darlynmeyer	unknown
@wsoutomaior	human
@Blurosepixels	human
@wakacham_	human
@ShanettaJamere	org
@tanyainwales	human
@toris89	human
@DionFinocchiaro	human
@elettrotangobar	human
@Biagio71To	human
@_BrkfstAtTiffys	unknown
@Vanessa_Cajucom	human
@NOOMiiE_	human
@Nos_venimos	unknown
@Chazzeex	human
@astoriacafewine	org
@Bokhalid85	human
@AbundantlyDre	human
@FromMeats2Beets	human
@ayankmimiew	human
@kcobuffalo	human
@almalorenasr	human
@KayTorcuator	human
@DexYeoh	human
@lucymakesup	unknown
@peace423	human
@SViola2012	human
@TheLifeandLena	human
@pupuPOW	human
@Uncorked_NYC	org
@TeamDinnerThyme	org
@JacqBroder	org
@CoganPJ	human
@RichysDubai	org
@schreckco	human
@MoonRaven83	human
@Darkeclipse2222	human
@NaturallyHollyN	human
@cypress_benefit	unknown
@jmall219	human
@B4zach	human
@KizziRock_	human
@robfox81	human
@Ppurpcia	org
@BrandonFrohne	human
@monajain	human
@RiversideEpiCtr	human
@girl_strange	human
@oppaoneday	human
@Mary_moniqua	human
@icookwithbutter	human
@KirkiMegaStar	human
@susan_goh	human
@LocalLex	org
@TwistedLaurel	human
@LauraLambATL	human
@thomas_ferrer	org
@lovescouture	human
@RoadschoolFNW	human
@RestoVisio	org
@Anitra3567	unknown
@Rishard2u	human
@ZumeSpot	human
@4theloveoffood	human
@R1S4	human
@NuraanAckers	human
@janis_jp	human
@GunnarALawrence	org
@msglitterz	human
@dewioctaviangan	human
@FrenchBasketeer	org
@Chinatsu44	human
@BBWiley	human
@JennyRMarceau	human
@CHAAKLIT_MAYU	human
@bijoujess	human
@AmyAebersold	org
@NotableE	org
@yesitsmebeka	human
@maxesky	unknown
@ToniSullivan18	human
@Biggatorsims	human
@KatieShimkus	human
@khurinFN	unknown
@Priyakk2	human
@CorsiaGiardino	human
@andreup_12	org
@StefanoVedovati	human
@icemark2la	human
@FSLAConcierge	unknown
@tiago_lima1	human
@AtkinsonPablo	human
@livingfairy	unknown
@RSejor	human
@IamSamHenderson	human
@ConceptNatural	human
@ShastaPina	human
@raysinsay	org
@crazyratdog	human
@SograSutherland	human
@LidvinaWellness	human
@PannikoSzokai	human
@gabesdowntown	org
@CorianderQueen	human
@mikuniwildpea	human
@HideAndSneak	human
@newtritionsavvy	human
@W2accommodation	org
@HourglassDenver	human
@chefbop	human
@HannaStaley	human
@heyAmeer	human
@campbell8200	org
@Rachel1Mahoney	human
@handmadetreatco	org
@llrockeroll	unknown
@chrisw3b	human
@Monalisachicka	unknown
@miraianddiana	human
@caraWINS	human
@KerrieMckay1	human
@DJeddyrodriguez	human
@AisyRumaisha	human
@InfinitiIndore	org
@88Sing88	human
@socobk	org
@HITClifestyle	human
@PatSchen67	human
@diy20735	org
@zeppy_christmas	human
@rafaeltatz	human
@FoodPicz	org
@NoCarbsNoSugar	human
@IndraMex	human
@nic_pat	human
@PeriodistaOrtiz	human
@iBranchout	org
@Chenoiserie	human
@caviarehumaova	human
@highsenberg_inc	org
@hiyokogang	unknown
@AshJoLunchBox	org
@siesiechampion	human
@StretchFitOz	unknown
@icsaopaulo	human
@PabloPucheta	unknown
@drewhush	human
@tyramukti	human
@WurstHSchmitz	org
@DominicWong	human
@saffron_Jade_x	unknown
@whoismuymia	human
@ekin_zali	human
@dahlia_1023	human
@Brickellista	human
@MakobiKelly	unknown
@tellalatte	human
@CornwallFood	org
@TakaTakaNY	org
@XoGalenaoX	human
@TigerPortsmouth	org
@iHaveaMoustache	human
@OhiaModern	org
@Lean_Ansing	human
@SignAndPrintMac	org
@JeremiahLIONEL	human
@hozuhoangdung	human
@iffkie	human
@WinnStedman	human
@Pinp0pper	human
@iadorejewelry44	human
@MBIntelnet	human
@jcgfilms	human
@carlos12374	human
@SocialMedia305	human
@thisis_ilse	human
@sexyhotfriend	human
@TweetKolkata	org
@_chloe11_	human
@gomezee	unknown
@rejinzensoukan	org
@vickiabelson	org
@amiloquemegusta	human
@BlackJesus2u	human
@Cedric_COCreA	human
@BangkokGardenTO	org
@dmfknc23	human
@BrundallHH	org
@428no968	human
@adam_serrano	human
@neilmol2009	human
@gusto_la	org
@nkamakele	human
@KaixinKang	org
@NGuerzon	human
@LeynaTopete	org
@jettmamma	human
@Schuuu	human
@potatoandmelk	human
@AutumnNAlston	human
@VHortizuela93	human
@westerp	human
@SWEDENJEFF	human
@PaulChung19929	unknown
@VintroKitchen	org
@Brodalumab	human
@bill_nizzle	human
@math0ol	human
@bewellbykelly	org
@SternePT	human
@remaxcoldwater	human
@EmmaTho02305187	human
@CharlizeJo	human
@WvdbW	human
@HerbaZest	org
@215RawHipHop	human
@ffw_pr	org
@srishtiuniverse	human
@dav1dhohoho	human
@AndreKTav	human
@glocalyoga	human
@ramengal999	human
@EviBuzasi	human
@TheKarltopia	human
@ClonakiltyBP	org
@earlskingst	org
@Italy_global	org
@DiorellaCua	unknown
@1Atsuhimerose2	human
@louwilko	human
@dianacstylist	human
@AirellRezell	human
@MichelleCCK	human
@rr_manahan	org
@PimyYoung	human
@dan_cortese	human
@_Better_Moon	human
@BarthTamsyn	unknown
@accrimar	human
@hariesdesign	human
@KaTi_Panita	human
@Awomansaffair	human
@gundamkola01	human
@blackbearpub	org
@WeberGrills	org
@PalaceOfDawn	human
@LaLiLuLeLONTA	unknown
@winetimesUS	unknown
@LYRICMyHEART	unknown
@KenzaGO	unknown
@michell4240	human
@nonsoloarancia	human
@danseco	org
@LovelyArtist	human
@sleepyheadjom	human
@S_T_ha	human
@onlyAhLee	human
@daboix	human
@guzzogigi	human
@MoonshineBoot	human
@bozobarr	human
@RobertZubiate1	human
@DuangjaiKonberg	human
@MetroIBA	org
@forget_dieting	org
@marvelousmollie	org
@BV_Alabama	org
@SFOKMiami	org
@TAISHENGYU	human
@Rita23492	human
@bumpsteed	org
@mkpelzerRD	human
@ReaLeLno	human
@supafly408	human
@mt4cb	human
@dianamaxine	human
@DeborahGarlick	human
@norcalnick	human
@YWHTeamNoSleep	human
@txstarkeeper	org
@gemmadevine84	human
@JaNeiceMusic	human
@carldesales	human
@Veroz91	human
@LisforLOIS	human
@i_onori	human
@SickAtSpacecamp	human
@BryanH1963	human
@Dinni_Wang	human
@Kuyou13	human
@JustCallMeAJ_12	human
@ScopePic	org
@Hektah	human
@BenJaminWigmore	human
@HappyMe_Love	human
@micmezle	human
@olya_loui	human
@JoshAllOver	human
@lucindadennis	human
@kathswanson	human
@tweeterofoz	human
@ARMANCH	org
@Miss_Teenah	human
@Makishou	human
@DawnMGibson	human
@bmurphy99	human
@geeneo	human
@tgizzurudin	human
@CrossroadsBIA	org
@FoodforHealthMX	unknown
@BBykHAt	human
@AngelicBerrios	human
@AmarilysGA	human
@apeacockevent	human
@Intenzekg	human
@Oosoitt	human
@SquidandPear	org
@WarwickDoha	human
@AndrewGerrioor	human
@onemorebiteblog	human
@taiki_indonesia	human
@LaylaScully	unknown
@YatesWSM	org
@1STn10SportsBar	org
@hoopdanse	org
@FromCity2Suburb	human
@EritreaRT1	human
@yowclr	human
@ikay_filchic	human
@AYINDE	org
@md_faust	human
@AyakaCooks	org
@xNB0Nnm4nEnDaDr	human
@MarilenaBorio	human
@NorwichTony	human
@moominmeee	human
@melaniamunx	human
@TopratedTips	human
@justivaluc1	human
@StreetChaat	human
@chefserenapoon	human
@wkyc	org
@zajeda	human
@apbayer38	human
@ImCalledRiho	unknown
@leptitbatteur	human
@cecilias_cafe	org
@issachook	human
@CinnamonCyn	human
@hih_alexei	unknown
@dusty_ssr	human
@imkristinereyes	unknown
@Italiankiwiblog	human
@santhiya_1624	unknown
@camerondunlap1	human
@EricaMToliver	unknown
@TCUSAMobile	human
@GThang103	human
@CLEEZEPURP93	human
@jessijordantv	human
@TheCookingRD	org
@21Valenca	unknown
@_MarcoLocatelli	human
@tulangow_inry	human
@magnificoeat	org
@miutiki82	human
@TheSnapDecision	human
@MichellesRecipe	org
@SenhoraI	human
@bbqdave916	human
@ERrisk	human
@RonCruzOfficial	human
@ShirazKun	human
@MikeBarzacchini	human
@adastra1	human
@bluberrymorrie	org
@BoginjaShakti	human
@Chrisconnectit	human
@OlesyaPuris	human
@the1stMe420	human
@FieKhalizaa	human
@kkkacy	unknown
@CountryStorePan	org
@mhkusa	human
@fionaET	human
@oneyearroadtrip	org
@Churros_Ulalaa	human
@Florenciah10	human
@AmriZailan	human
@HydeoutTampa	org
@janbariuad	human
@adeyemi_ope	human
@_guren	org
@EgaArchangel	human
@eebh17	human
@LefayResorts	org
@the_freaky	human
@fortwilliamcafe	human
@waliiik1	human
@sienafresh	human
@ZanyWilliams	unknown
@kiraselina	human
@livediebleed77	human
@DanielRX3	unknown
@gibzymiracle	human
@BelazuFoods	unknown
@ces_frnc	human
@WickerPark06	human
@SimpsonandVail	org
@Suilatchu	human
@MNlovesdreaming	org
@DenisseOcasio	human
@cutedevs	human
@EmpanadaLady013	org
@studentepercaso	human
@GrubGreat	org
@ChessPartnershi	unknown
@ClaudioPradoE	human
@thatgirlneeli	unknown
@geocorreia	human
@erichinvitaminc	human
@alexiiboo	unknown
@Choco_Mocho_	org
@VeggieFocus	org
@Anroyhoreca	human
@willdeleon02	human
@Boricuajimmy	human
@Kiky_Ayyas	human
@BsThorsen	org
@FionaTan905	unknown
@toki4code	human
@ShiftUpwards	human
@otok_n	human
@malistria	human
@arikaps	human
@mass_writer	human
@HolidayMeal	human
@DoubleDworks	org
@GPratas	human
@HounaidaHarrabi	human
@nardskipaps	human
@OmeletteParlor	org
@TheJessicaHugh	human
@tan_model_mom	human
@TieDyeBBQ4U	human
@littlecocktails	org
@PlaceLouisRiel	human
@EncodeThis	org
@Athrennaakira	human
@JoeySegura	human
@superwoman_blog	human
@caine_katkin	org
@FineTissues	org
@ServoYul	human
@zher_uy	human
@tigercitychance	human
@charcoalbrunei	human
@vannalyzza	human
@eda24eda24	human
@EhFany	human
@Expo_Lounge	org
@JoelMoonwalker	human
@_jadenetherway	human
@SuzanaLay	human
@CELINE_CME	human
@eva_elizabeth22	human
@ecocountrytable	org
@riepiice	human
@MikaelaYarwa	human
@kwittman	human
@GRStellas	human
@ZhenMeimei	org
@five_monkies	human
@disco411	human
@tonynryner	human
@ChaiNashta	human
@AznbenM	human
@0802_shoko	org
@LEBRISA	org
@COCsouthjersey	org
@OchreMesa	human
@lancashirelass4	unknown
@cheyenne0228	human
@MsHabiToure	unknown
@indrayust	human
@QuadClub	org
@Hey_Stacey_Kay	human
@cheng9987	human
@tspbasil	human
@TheEggWorks	org
@r818083	human
@melissalamberti	human
@AlistEvnts	human
@AmethystLily77	human
@KennyFreddy	human
@SJoannaReid	human
@MatthewNagy	human
@palepinkradish	human
@LucWitt	org
@ILCountryLiving	human
@siskafelicia	human
@FlemingsMayfair	human
@Snickericky	human
@H_and_H_Pub	org
@juliee2729	human
@Consciouslook	human
@wsredneck	human
@JanesGlutenFree	human
@tayganrob	human
@yeosmint	human
@uhetvkitchent	unknown
@Ameyapil	human
@comidapracasal	human
@TtotheAtotheB	human
@Snooh	org
@JaclynBailey13	human
@brunetteonbroad	human
@TastedChannel	org
@Gomelov	human
@StephDonoghue	human
@SePhotoCrew	org
@SproutfieldEats	human
@im_vanTOMS	human
@buckles86	human
@TheSingleBite	unknown
@Jenn_Jean	human
@marygoossens	human
@yunxyoon	unknown
@BelsizeVillage	org
@TraceyFromCali	human
@simplycooked	org
@slipperywillie	human
@puguhgandi	human
@renahuseini1	unknown
@thecountryview	human
@Mooseandmar	org
@mikanotubuyaki	human
@gieyow	human
@ea_chefs	org
@MMINGTT	human
@Louisa_gomez16	human
@katieapoos	human
@NewJerseyLovers	human
@flowkdj	org
@shocolinJP	human
@N_Redheart	human
@Goin_Japanesque	org
@DeloresOfori	human
@cfernando6	human
@juicepirate	org
@super_vinzky	human
@ane_sokolova	human
@KELLYBROWN8	human
@madisonlogan1	unknown
@Boly18	human
@cooklikeja	human
@EllenKaroline1	human
@janicecroze	human
@thecooluxury	human
@IvanPusceddu	human
@94Phoebe	human
@TyAdamsTV	human
@Maanglary	human
@thorn_of_drama	org
@retsieh108	human
@PencilsPancakes	human
@Ce_e3	human
@AkkoEarth	human
@MiSsKaYlaHuNt	human
@tilly_lock	human
@feastdining	human
@lomargie	org
@ViaEllex	human
@JenniferLamboll	human
@VCvanessasofia	human
@theredlippie	human
@Ghate_Ranjan	human
@lvpgh	org
@AngelPhuay	human
@TheBookWheel	human
@lasanchezv	human
@Simo_fm	human
@AllAroundMBrown	human
@Rebecca_CNP	human
@LivingRichTips	org
@NaTtAVolosevich	unknown
@charliepaw	human
@elainiepooh	unknown
@MAUROMCASTILLO	human
@blueyblinx	org
@sophiejay_xo	human
@AiameAzamai	org
@RedSis80	unknown
@mathiastillberg	unknown
@tastingmarche	human
@TMITR	org
@Hellified_Juicy	org
@DockandRoll	org
@Hantverk_found	org
@DunbarKandT	org
@andkap	human
@AmyWatson96	human
@a0930508861	human
@ttaamiiyy	human
@morike91	human
@DJVAR	org
@Adams_LadyDi	human
@Rachel1383	human
@LorenasHabitat	human
@leroyplz	human
@HumbleHeartbeat	human
@PatWhalenNC	human
@nicolampreston	human
@nicocheng	org
@AzNsPaRkLeZ	human
@hamxisays	human
@feezarevival	unknown
@wineanddabble	unknown
@giladb87	org
@chiicocco0418	human
@MihoWTW	human
@BrittLavenski	unknown
@The_SBK	human
@realcharmin1	human
@clareandtribe	human
@101phenex	human
@Sianeowen	human
@brylleQuirante	human
@esmacaa	human
@BrunchOfPros	org
@zurichflughafen	unknown
@ciccioricceri	org
@therollingfeast	org
@MayramVelazquez	human
@allihagendorf	org
@cordeliaevans	human
@Jose_OSheas	org
@KitchenBluebird	unknown
@greceres	org
@syifaCHS	human
@imaginaryfry	human
@ward170889	human
@Wilson_4ever	human
@WindyCitySole	org
@leandro_picanco	unknown
@OMCocktails	unknown
@DJBIGRIG	human
@ThatRedHeadGal	unknown
@WeLikeLA	human
@VixZhuangYiYin	human
@winelinkitaly	human
@Rimboltblack	human
@heathyrnasence	human
@njlor91	human
@DJGIRLBOT	human
@LucyWillShowYou	human
@PazziPizzaCaffe	org
@VTLi	human
@hollerjoyz	human
@BrianKamoie	human
@msmakeup1829	human
@reyes_fede69	human
@EGiraldo1005	org
@CorkBilly	org
@mhlcoach	org
@aeybee227	human
@frugalfarmwife	human
@ClouseGeraldine	unknown
@MaybellPisano	unknown
@pampleluneh	org
@thisisia	human
@Tigerfowler1986	unknown
@leeanneclarke7	human
@julestopia	human
@Miss_Vyen	unknown
@bokke1969	human
@RobertLopez_	human
@TharseniS	human
@LaurieLeroy	org
@toddschnick	human
@Jillyann_L_M	human
@GravWeldon	human
@killgirlx	human
@Crhis_BC	human
@cottonbistro	org
@belhunt100	human
@heatherbeattie	human
@connieconsumes	human
@Mattz_Money	human
@lindakie100	human
@honeybeediner	org
@enrique_pera	human
@Eloiza_010	unknown
@SerenaDinh	human
@5han5han	human
@BettyKabir	human
@juliaHattingh	human
@shaunak_m	human
@sandeepkoikal	org
@tariiitaroo	unknown
@bearandlionmama	human
@chicagocibo	org
@KCLoremia	human
@ErinSchrode	human
@jasmine_landa	human
@akosidrew32	human
@MDenizT	unknown
@OldwaysPT	org
@NHskt	human
@DollyPR	human
@AtYourTable	org
@FHLangewold	human
@PaulDowdakin	human
@Namukwambi	human
@DealOfTheDay23	human
@GunaGuna_snack	human
@AlderleyEdgBuzz	org
@kumenari	human
@GreatBigGlobe	org
@BeefcakeBurgers	human
@rashimanerivera	human
@GFT_Gb	human
@hutchchicago	org
@GrottaAzzurraNY	human
@SimplyNourished	human
@Dean_Warwick	human
@itskm_1	human
@starsinthecity	org
@emilybland88	human
@curium_504	human
@nardiux18	human
@jacqng17	unknown
@BassamUmar	human
@jaapbrakenhoff	human
@soulfulrebirth7	human
@BeckyOhaire	human
@snowwhite_xo_	org
@ditrihbrown	human
@LittleAmericaSL	human
@williatan	human
@OneLifeToBuild	org
@SuzyCook_be	human
@Kat_HaSfF	org
@nicanorgv	human
@sycookies	org
@josuejafid	human
@awtemoosiq	human
@Jona_Olsen	human
@JaneMenloPark	human
@modifast80	human
@snazzynez	human
@Doraeaum	human
@KarenaTT1	human
@AFNBeauty	human
@ASCFTL	org
@SayWellness24	org
@ParkerBowlesBER	org
@MOSTO_LA	org
@smithbrossteak	human
@ChardianC	human
@LeMenarLondon	human
@gegraves	human
@PorsenaNYC	human
@florbernabei	human
@santioj	human
@cafeoperapanama	org
@arianneandrade	human
@ilovegerwevs	human
@mboucquiaux	human
@Midtown_Truro	org
@tndcrtz	human
@sal11182	unknown
@indahbunnny	org
@Bisbetical	org
@SHEPP4KING	human
@ghinasays	human
@Temi_Daydreams	human
@Jerald_Ian	human
@workxtine	human
@myzMycel	unknown
@michelledudash	human
@jenjenii	human
@tein89	human
@Kung_chonlada	human
@WhatTannaSaid	human
@Jazz__rockz	human
@cabaretesocial	human
@HyungHoney_22	human
@Indigodining	unknown
@StylebyBru	human
@MommaGof4	human
@DJUCH	human
@LarnAzrai	human
@Tinkalabell	human
@chuckfallaw	unknown
@thekosherspoon	org
@gingercatgames	org
@november42195	human
@tusharupreti123	org
@FynesDesigns	human
@Balance_Akt	human
@SHIBUIROBATA	org
@freckleface_kev	human
@royalmailhotel	org
@tamtiewww	human
@JaySolis	unknown
@ShopEverettMall	human
@KonLi90	org
@byHoRRoR	human
@Mamay_hmclo	human
@CoachSuhanna	human
@6ALI6SIN6	human
@jencole0809	unknown
@pablogarcialoza	org
@Xtell08	org
@OnionYeong	org
@CelineSerafin	org
@ced0924	human
@spicers1976	human
@InigoSaitua	human
@senorchefft	org
@RickFla	human
@becka_marie1	human
@javiermailan	human
@elbertfavorito	human
@visitalderney	human
@livewellwithJoc	human
@Cooleygirl26	unknown
@SoCal_James	human
@MariaVKat	human
@NoWordsNW	human
@didi_6868	human
@STX488	org
@cary2004	human
@ronlocke	human
@misera1990	human
@MGrimaus	human
@Ettiennela	org
@TariNarwanto2	human
@giobbepelle	human
@BarrasfordArms	org
@fluidlondon	org
@BeccaOnTheRun	unknown
@PtiteBulledElo	human
@floridarussian	human
@MegCastagnetta	org
@nattycrossaint	human
@_lvmatterhorn	human
@mOimOipOika	human
@WELCOMEITALIAUK	human
@FoodandFruits	human
@ChasinCaroline	human
@Surrinderella	human
@bgdboy1	human
@myoga_studio	org
@sorooshisonfire	human
@ViBE_ub_cherry4	human
@killer_kitsch	human
@kandn0213	human
@VianeydiSinai	org
@momoka_michelle	human
@Caravia_Beach	org
@33Taps	org
@Nur_Sharmilla	human
@guavabeach	org
@Maayarida	human
@TonyDortie	human
@HintOfBeautiful	human
@kamalfondueman	org
@okie_randy	human
@caffice123	human
@ichibankan	org
@andjazuly	human
@Booboo_Terence	human
@kamefay	human
@Well_Solutions	org
@cdemetriadis	human
@petescafeandbar	unknown
@RivieraFocaccia	org
@Riva1968	human
@mshafiq_azhar	org
@PrunesUganda	org
@DatzDough	org
@BBNHAmour	human
@xoxo_yellooooow	unknown
@Stephs_Twittah	human
@Penny_Middleton	human
@SuperMa_E	unknown
@ReaperYm	human
@I_heart_Meenyan	human
@xOahuBeachx	human
@TheLionNYC	human
@pennkarn	unknown
@KandMsLaBella	human
@paolocampillo	org
@kerumica	human
@joseiz	human
@ImagenesFerrero	org
@Ya5mine_87	human
@brandykisner	human
@lisanorfolk	human
@vinceomana	human
@mayach1	human
@NanaKato_	human
@JustForNewKids	human
@BummyJeans	org
@MotherThyme	human
@SeanWetstine	org
@Oziah	org
@Shnitzburger	human
@stevethewreck	human
@tjack25	human
@gaaaya8829	unknown
@theonefish	org
@TheStyleChic	human
@teenlove1988me	unknown
@NeuvooAdmTor	org
@auawaw	human
@adoremydiet	human
@wittychubbybae	human
@paulina_palian	human
@wfmbrooklyn	org
@RazorCrank	human
@shahidahvictor	human
@CorrChilled	org
@GirlandBoyThing	human
@RecessionBites1	org
@emilyamccord	human
@anythingtuscan	org
@MassimoMainella	human
@LxreC	unknown
@LJHardie	human
@lalita_pui	unknown
@HotBodyDotCom	unknown
@SayWellness18	org
@cubbybear	org
@FrankieBibingka	human
@ImortalSamuk	unknown
@demma_martha	human
@NelsonTan82	human
@min_shirley	human
@AmeeLivingston	human
@glowingfridge	org
@MartinaBattist	unknown
@SpooneatParis	org
@Daany_ok	org
@VVianNG	human
@CapitalGrille	org
@ytmxx	human
@BostonMoms	human
@LuiLui06	human
@YHACoalport	org
@style1717	human
@The_Bizzz	human
@HannahNovell	human
@LJW_x	unknown
@DrOetkerBakes	human
@AndiWredonkulus	human
@elsie2518	unknown
@dianababe_lee	human
@mikemanb	human
@ubcitybangalore	org
@MeejoMiss	human
@mrjovifly	human
@WilliamArlotti	org
@kyokopops	human
@sarahjaneRD	human
@bneweekender	human
@SuperMommy830	human
@ffneeguhh	org
@AnnamarieTT1	human
@VisitSouth	org
@VeganistaFoodie	human
@CaymunEsther	human
@stevealty8	human
@SophyMav	human
@Saputos1	org
@aisahlorenzo	org
@yk__2323	human
@minhaj7	human
@SLN93	human
@nazrinzaini	human
@chef_ahoy	human
@TwoNightStands	unknown
@PalmaDy	human
@mazeau	human
@ChangingBeauty_	human
@GeorginaTippett	human
@myeasylowcarb	unknown
@hankerie	org
@carlonechris	human
@FlyChick_Vero	human
@HypoxiSW3	human
@pdus	human
@aina_9524	human
@SandJMills	org
@CinnamonGrandC	org
@Shallyisme	human
@dutchraspberry	human
@MyLeov2013	human
@FuriouslyFit23	unknown
@BennyNova	human
@thuantran01	human
@BakeretteJen	org
@THEMIKEPRESTON	human
@KristinaLea5	human
@FabbyEll	human
@Fouinweightloss	unknown
@CBCinthekitchen	human
@DrChangsta	human
@Muna_Suriana	human
@TRUTHcoffee	org
@310_7e	human
@CathKristhiofan	human
@T8pVp7	human
@Riho0730	unknown
@AnoshAlee	human
@MICHAELHOLLYWOO	human
@Pokemon_MMO	unknown
@QHRye	org
@21Muto	unknown
@Blown517	human
@superegomithi	unknown
@AdiTheDino	human
@sidlava_	human
@enyii94	unknown
@jenialcalde	human
@FaceBoysEnt	org
@Best_Vine_Users	org
@stayatpalladium	unknown
@SearcysGherkin	org
@Fallon007	human
@Ana_Is_Cute	human
@lovemydoppio	human
@WEA_EVENTOS	unknown
@cafe_tallulah	unknown
@richardsimamora	human
@mayumi_kino	human
@BrooksandDavis	org
@Zakuskilondon	human
@NeashamRdMotors	org
@DiamondMari	human
@YUKITAKIZAWA_GG	human
@jackolanternzzz	unknown
@Carol0926	human
@JerzandDaFatman	org
@FriaGlutenFree	org
@mytwistedrecipe	human
@ginosorbillo	human
@crazeektitty	human
@TenderNYC	human
@SamanthaChamNYC	human
@ginnjewell	human
@JUPeunITER	unknown
@LadireddTatted	human
@antostwit	org
@enynm	human
@ItWorksWrapsByM	unknown
@WaneyZainuddin	human
@sweetlady2960	unknown
@DelCampoDC	org
@BecP83	human
@KAbramshe	org
@BarrackLane	human
@2MonkeysTravel	human
@Brakes_Food	org
@dyanhope	human
@chimoong	human
@RostieGroup	human
@Ommlett	human
@OhCoolItsChris	human
@jmcd88	human
@UFashionStylee	human
@ChicagoMoms	human
@emilymariebb	human
@bamboodovestein	human
@BarnabyHatcher	human
@arnoldmyint	human
@Cereslys	human
@SmokePlano	org
@Ruthian	human
@REmeave	human
@syun_wadai	unknown
@Charriedades	human
@NaiCherelle	human
@Fallen_Fran	human
@jane1203a	human
@CAUGuildford	org
@AFitPhilosophy	human
@ymkamilky	human
@RocketGum	human
@nosportsforyou	human
@lovelyimperfec	human
@SexxxiiByNature	human
@CarriageHouseWP	unknown
@PropertyStaged	human
@Apostolis_RT	human
@StageBuddy	org
@OlalachickFR	org
@poppy_1405	unknown
@MO_PUDONG	org
@Shayla_J	human
@feguims	human
@OnTapSportsCafe	org
@joshuasu	org
@Triona_C	org
@DevilGourmet	org
@MyDrugKlaroline	human
@ScratchKandB	human
@_ericgumat	human
@Smullenspelen	human
@vhidye	human
@startimekid	human
@RelishPhilly	org
@Bre_ROLLIN	org
@ichiaguinaga	human
@_MphoRanko	org
@MrCleansUpNice	human
@rob215	human
@elledit8	human
@alidoulos	human
@vrsn91	org
@DiamondDreamin	human
@jakesburgers	human
@MarleenVimont	human
@KidnapPle	human
@TammiSinger	org
@muffinjai	org
@Andi_merpati	human
@p_a_cameron	human
@HollyTQuigley	human
@LeilaKuwait	human
@viridianasoriab	human
@backyardbite	human
@MaxArtaza	human
@KraftySims55	human
@NwlyWdNutrition	unknown
@ThinkEatDrink	org
@leigngamit	human
@Kiki_Got_That	human
@claireechan	human
@jibarichan12	human
@MAHAMOSA	org
@ohhitsmarie	unknown
@mrraviator	human
@DealOfTheDay14	human
@SeuBar_	org
@EducatedEating	human
@MelPVillada	human
@umutsari	human
@carrieellenbell	human
@Cougar_TJ	human
@DeltaSSM	org
@mlh42812	org
@markus_1903	unknown
@PazBecci	human
@ercolaniF	human
@Imp3ccable	org
@AmnanBasyirs	human
@CaringWonder	org
@HansSpek	human
@jasonlehuy	human
@nurturingfoods	human
@daughnmas	org
@ALIVEMagSTL	human
@nessyvan456	unknown
@avilla_dewi	human
@Morgaine2009	human
@mackygraphy	org
@iErick1284	human
@ElizabethSoon	human
@karenharold	human
@alyssajwhy	human
@TabbyLou_	human
@thesmlvictories	unknown
@eelayste	human
@FoodRevMontreal	org
@meiyin96	unknown
@VoiceDictionary	org
@vickerz92	human
@RoastedShallot	org
@IPoxita28	human
@kodance1	human
@KSeamour	human
@Chef_Rinz	human
@bwAccessFM	org
@RaineKps	org
@OCoGoing	human
@5_0806	human
@RachellSHC	human
@dukjiayitan	human
@nickimonilaws	human
@LittleMissChisi	unknown
@ClarenceF3rd	human
@PanamaPDVamos	human
@MammaBearsWorld	human
@punekar	org
@eddiesattic	human
@GeriaVacation	unknown
@te4ries	human
@alleniec	human
@ViBE_ub_cherry1	human
@wimpysguelph	org
@ginnefine	human
@melwalkerm	org
@Candidafs	human
@SalasCallback	org
@basoxoxo	unknown
@WTOPLiving	org
@jymmster	human
@oilcabinet	human
@jetzskies	human
@FangDaShark	human
@VickyEcstasy	human
@sl_blue78	human
@guidi89davide	human
@nicwhy	org
@FanningBenoit	unknown
@JenaBen1	human
@langSamfood	org
@ubranYu	human
@SauceresKitchen	org
@radlacorte	human
@MelissaASimon	unknown
@thenutribullet	org
@LYNZINTHESUN	unknown
@bewitchedbaker	human
@CosyClubCardiff	org
@halfwhiteboy	human
@srakate	human
@DelyanneArjona	human
@SamPrimeaux	unknown
@weareprinton	org
@BYOBuzz	org
@Bikinidotcom	human
@LindsiotLindsay	human
@B45XORO	human
@ParadiseBranson	org
@Noemi809	human
@azrulsatar	unknown
@Semprin	org
@lullabysfacets	human
@nofanmail	human
@VisitNapaValley	org
@syzwanizalil	human
@Trafficologist	human
@YakimaMoms	human
@andreapiutti	human
@eryna82	unknown
@deemancpa	human
@Axiom_Brands	human
@Nicole_Paterson	human
@Miaawcom	unknown
@we_are_rwe	org
@mnfairman	human
@RajG87	org
@Emilygtree	human
@kathysamores	human
@SayWellness15	org
@hill_p44	human
@Mary_Caitlan	human
@MarceloJCalvo	human
@foodable	org
@SayWellness21	org
@cacelico	human
@_BraulioRR	org
@KlementeCS	unknown
@gempottt07	human
@Djemalist	human
@KeitoSays	human
@Ms_Michelle_Roy	unknown
@Nashman	human
@JuuliSwag01	unknown
@Sammy7Sunshine	human
@silver_lies	human
@NgidamDoeren	human
@Incoherent_Subc	human
@Wokin123	human
@NikeFrancis	human
@wokkies	human
@BSpodNetwork	org
@ParadiseR106	human
@TiniWilson	human
@johnraymondgaza	human
@SusanDapuzzo	human
@drclays	unknown
@TrippyStix	human
@Woody_Elly	unknown
@AniaIsabella	human
@Eydi_Lim	human
@msainnordin	unknown
@KayyChow	human
@FoodiousMaximus	human
@MazinAgbegah	human
@JUNpery	human
@BaoPhotography	human
@iamAarooon	human
@Thomasaellis	human
@TheSavingsOpp	human
@gourmet_living	org
@TizianaBontempi	human
@julieruble	human
@SuziG	human
@bodjescasura	human
@CarlaFinch	human
@Diamonds614	human
@Kidfolio	human
@stephydollx0	org
@LepangFerguson	human
@MegaWei	human
@sho_ishi	org
@ItsMeSIHANN	human
@xbbwdivax	human
@benro22	human
@leglambeauty	human
@nattsu_76	org
@omgggiuh	unknown
@AnisaBharmal	human
@CamilaPizarro92	human
@HFHradio	human
@LorenzettiAnnna	human
@MsJYT88	human
@22Camilla22	unknown
@DrVinzzz	human
@zornsofbethpage	human
@baggus_WS	org
@ioranaaaa	human
@AmandaCallas	human
@MarialtR	human
@SarahSharp80	human
@psychotic0_0	human
@_Youngkid045	unknown
@SlsbryFoodstore	unknown
@NirajPopat	human
@howiedoin07	human
@Queen_V77	human
@KicksPlayer	human
@markomorciano	human
@IamLeodGreat	human
@SunkistLizbit	human
@NiixPunzalan	human
@MzTuesdaySophia	unknown
@DailyKitchen	org
@ArmsOnRoids	human
@sophiesblend	org
@rekikiskander	org
@NaturalBios	org
@ig69	human
@kowalska_gm	human
@FieldsAubrey1	human
@asucculentblog	human
@MARK_4BENSON	human
@abubasteak_	human
@Lily_Kay_S	human
@kimberleydenise	human
@PaulaPozoH	human
@yoboylpz	human
@vania0905	human
@bingbingos	human
@sixcranberries	human
@thelevelmks	human
@notperfectwife	human
@BurningSmoke_	human
@sianmcnicholas	human
@DeSantosNYC	org
@Facushk	human
@GariWatkins	unknown
@neetigrity	org
@GDgeek	human
@chloe_slipknot	org
@iAmJuicyBoss	human
@Hillcrest_PS	human
@MissKatyMartin	human
@PurpleKisses711	human
@Kimmazzz	unknown
@eiannaie	human
@SonyaPlay	human
@NawabzadaMKB	human
@josiahontheedge	human
@carladfb	human
@WilliamCivian	human
@poisoncrazylush	org
@Moonlolly	unknown
@thirahsafarudin	human
@KorrValmoria	unknown
@thelookoutsea	unknown
@AnisaKitty	org
@SayWellness36	org
@requestletters	org
@gurrlwithacurl	human
@DarKye	org
@Foodtruckya	human
@HDConnaught	org
@Rogue_Sun	human
@JodeanLTownsend	human
@Dinou37	human
@RachaelLBall	human
@CrazyRichardsPB	human
@Flavortrotter	org
@EdlundEric	human
@Clinkerdagger	org
@Anything4MyDog	org
@VanBird	human
@tengps	human
@M_N_Herrmann	human
@The_THG	human
@bytesofjoy	human
@DrEckskerl	human
@jduc_hoang	human
@CheremyFin	human
@tinyurbankitchn	human
@ZagatPhilly	org
@TheFoodSnobUK	org
@LaurenKermelis	human
@RamiahLazo	org
@nickfredimartin	unknown
@BazzB70	org
@Remysecret	human
@FairCapeWines	human
@CryssieKitty	human
@NoveeChabelita	human
@missfusionvzla	human
@TimaMariaLacoba	human
@SibrenaStowe	human
@skylineperez	human
@dea_was_here	human
@maddieklippel	human
@halilj35	human
@JosephTornaben	human
@igotbanged	org
@EssentialKit	org
@OzaetaMark	human
@arjosephsantos	human
@tedix	human
@CGeorgiana19	human
@astrojoeuk	unknown
@L2GetherFitness	human
@FitWrapsbyPatri	human
@juandaplaza	human
@karmen_siew	human
@TipGarden	human
@nyfoudis	org
@jinxlarsson	human
@Hoagiesnmore	unknown
@JVazquezCruz	human
@_DeJour_	unknown
@HellaWellaEats	org
@UpToWn_ShizzRaw	org
@emilysteashop	human
@MissChanelleSP	human
@Candiswtpea	human
@rachmaarazak	human
@ssott43	human
@epicbeergirl	org
@PubDonna	human
@Basti_69	human
@xmfblack343	org
@TrentonScholar	org
@Khawlasad	human
@ELEANORDIANAA	unknown
@marys__kitchen	human
@Andrame04	human
@MissMarieCox	human
@lesgourmands_re	human
@OakleyJC	human
@pierwcleveland	org
@ScienceOfSmut	human
@corseL_Lia	unknown
@Market_Bar	org
@OrlandoWeekly	org
@Valentinel	human
@Dunmirecrochet	human
@gracecaroline30	human
@MamacitaCupon	human
@paLHANGga	human
@AraqueKimahri	human
@cathmaison	human
@HealthKitchenUK	org
@obsessivshopper	human
@iamtinytarn	human
@LunchNorr	human
@bostonmomsblog	org
@MartinaPardini	human
@winetimesUK	unknown
@tuliolessa87	human
@TDSRestobar	human
@Rosmini86	human
@FloridaCookery	unknown
@voc210	human
@AuthorBee	org
@Me_l7	human
@InGoodTasteDen	human
@SAsLeSHIZ	org
@ebomonline	human
@TaraTNA	human
@VirginiaSent	human
@royfire7	human
@njunitaaa	human
@zennkoku_	unknown
@rendyfernandez	human
@KellyBriana88	human
@ricardo_fabiola	human
@TheLegitDon	human
@kattsun_yuto	human
@thekitchen45a	org
@jeananouk	org
@RosarioRdguez	human
@RTCreatresstv	org
@travelingpandas	human
@RachelFedora	human
@Ajilityfitness	human
@elkatrn	unknown
@TrueFactsDeals	org
@AmauryCeballos	human
@GeneralLee01	human
@ATAlice1	human
@FitVeganChick	human
@m_indulgence	unknown
@40Sanitonbiz	unknown
@frdemoi	unknown
@614Re	human
@bbifebii	human
@thatgirlathegym	human
@sekinina	human
@GEORGYANDREW	unknown
@FlatscreenHD	org
@CPOrlandoUniv	org
@ByOdeon	org
@AlSeefMall	org
@dRichProject	human
@JsAngel9911	unknown
@ZulfiaMasgutova	human
@OurMarriageTips	human
@ChiaraNaomi91	unknown
@NewRowCoffee	org
@ravenwing226	unknown
@Yoo_RinN	unknown
@Drockvp	org
@ummultauffek	human
@JeffSokolowski	human
@indriyaneu	human
@CafeXpressoCT	human
@aiyuki_adelle	org
@jki82	human
@ISSA_from_DP	human
@inusanewscom	org
@rendell_ching	human
@WKFadzli	unknown
@SineadCashin	org
@eatnlondon	human
@ghiannelovesyou	unknown
@CansuEskin	human
@EmiliaYana	unknown
@HerreraNoticia	human
@laura_C7	human
@SyscoMinnesota	org
@vinnanatasyar	unknown
@accihandayani	human
@fionamaclean	human
@iNPDesign	human
@aurorapierce_	human
@Vania_Tanaka	human
@KeilaHamilton	human
@XsimplyitalianX	human
@therealandy919	human
@HealthiNation	human
@areRiantini	human
@AshviniMashru	org
@riocarlo	human
@liga_andika	human
@haruca0727	human
@Naturalboxcom	org
@shrmiza	human
@sophiamalacaste	unknown
@babsncats	org
@MichelleKimC	human
@greyditoffano	human
@tinamegan	human
@CoachGoodLife	human
@dwitakharisma	human
@DavidPietzsch	human
@Nana_3005	human
@mjce	unknown
@MarqetaGrocery	unknown
@Techtembo888	human
@iedafuzi	human
@avtv	human
@HldCw	human
@galle_tini	human
@LexyFood	org
@aknmssm	human
@World_o_Gabe	unknown
@JulemiJewelry	human
@SWEETLiSAxo	human
@LecksGETitON	human
@kit_kathhh	unknown
@kate_moody	human
@ThePureK	unknown
@8BellsAlehouse	human
@MunetoshiKoda	human
@ChandaraPico	human
@Outback	org
@GoodMorningBSpa	org
@FitnessMagazine	org
@Waldseepiratin	human
@agnpramana	unknown
@salamanderalley	human
@arabesqueUK	human
@YxTuZ423	human
@VCSoCal	human
@hentaigirl82	human
@jazzyjoyy	human
@DipInCafe	human
@NICKIEISIS3	human
@Crushtours	human
@DiannaDB	human
@aldi_tita	human
@angelwow6970	human
@papina_gendis	human
@Fifendekel	org
@TDLCI	human
@HelloAgain82	human
@infatuatedChill	unknown
@PuertoRicoEats	org
@ghita_nf	human
@nara_photo	human
@Bespoke_Art	human
@JudithElsroad	human
@monicalistiyani	human
@Tastebook	org
@HerrBinHongKong	human
@JustLecomte	org
@ElAlmacenNYC	human
@slothtokyo	human
@Meagan1Dullack	human
@luisitabuitrago	human
@T4R4K	human
@MissThorogood	human
@MegQua	human
@NNSBhiromiogata	unknown
@RizqonFaisaL	human
@tefi2stefanie	human
@ADarkInTheDark	human
@yurikaelizabeth	human
@JohnyC03	human
@miabaginfo	org
@rankovucinic	human
@ScandiStandard	human
@sheroncrane	org
@EvilRegal1978	unknown
@_NoFilter_	human
@wellesley3rd	human
@SaminaqRD	human
@nk472893	human
@superlelezinha	unknown
@AnjelicaAvra	human
@TaniaTarrega	human
@CaityRoseParker	human
@bill_coo_suites	unknown
@eunikeninda	human
@kina_tam_0314	human
@gahhvinn	human
@marathonjp	org
@TailorLofts	org
@pcenserver	human
@citywalkerapp	org
@hojadealbahaca	human
@maruubnd	org
@Kashlynne	human
@MeishMGM	human
@RealChowBaby	org
@Alice_Shihya	human
@MilestonesYale	human
@officialhamidj	human
@caroli841	unknown
@StreetGeekEnt	org
@onefashionpint	human
@ishikawamarie	human
@dewintaifang	human
@glamourgal18	human
@mvstudiosphotog	human
@CutiePieCo	org
@chachahuang	human
@Teeee_Ceee	unknown
@nissakaye	human
@angelineheyday	human
@meicheniva	human
@writerfotogirl7	human
@ChefChicJoshua	unknown
@datswhatuppp	unknown
@EmanuelaMax	unknown
@chatterboxcgc	human
@IdaPapandrea	human
@voodoolilycafe	org
@GiantLeaps	human
@jujucleanse	org
@NateGarlick	human
@detourcarmel	human
@MuscleMLKCAN	org
@LeeDusen1	human
@BlissAndie	human
@MF_Attar	human
@AkidoForde	human
@_saffronstocker	org
@marymemary13	human
@Finkorzak	human
@kheywie	org
@itsuka_kuruma	unknown
@misznaniejr	unknown
@Daniel_Donson	human
@RPGMMOGame	unknown
@SophiaJacobi	human
@CherylKumiko	human
@FALI_ruizdavila	human
@Betterthanitwas	human
@Madame_Cuisine	human
@daniealhazique	human
@taybeansxxx	unknown
@MonaJud	human
@ISpeakLY_Female	human
@djbeluccinyc	org
@crispyme91	human
@CannesIsYours	org
@tita_inmycloset	unknown
@Scene_Styles	human
@carlsbadtavern	org
@MisquittaTanTan	human
@TJLisoski	human
@Official_MJG	org
@CharleneOoi0228	human
@OurBicycleThief	org
@followmellvin	human
@TEvelino1	human
@BelgaCafe	org
@PCA_LosAngeles	human
@HarshaliHp	human
@cesz_11	human
@CartwheelPrint	human
@DaPryz	human
@annDchilli	human
@EclecticoCafe	org
@WiseChoiceNtn	human
@akirax_xoxo	org
@ENRIK_DJ	human
@lo_snickers	human
@PerrynCarroll	human
@DnyzPeraltha	unknown
@Jveganet	human
@InstaFoodApp	org
@realily	human
@kosenrufumama	org
@FieldRoast	org
@kimmiechau	human
@aliexru	human
@keithrevenge	human
@jessikabroderi3	unknown
@maddymandy	human
@alish_aaa	human
@arini0401	human
@golchha21	human
@SusanneEifert	human
@ysl807	human
@foodloven	human
@Britni640	unknown
@Rodalme	human
@FoodlosophyNews	org
@erwin_erwan	human
@Zannafix	human
@WablyOnline	org
@markjbhansen	human
@FVNTOM	org
@SylkEFyne1	human
@ChuChan99	human
@heavypop	human
@CarlyKenihan	human
@rhaty07	human
@shahidabanu	unknown
@vivsfgfgfd	human
@Spunky_Seniors	human
@DarkSkinBelle	human
@chloebowler	human
@The_LizMarshall	human
@HugoFerreira_91	human
@ApplauseMedia	human
@CrazyTrain17	human
@Tou_Muung	human
@tabzmokree	human
@ServetKodak	human
@monkeyjonn	human
@NoisetteBakes	human
@alaynechan	human
@Recipe411	org
@czaifcute	unknown
@TheRealWatCom	human
@oddfate	human
@MahoMqho39	unknown
@AlbertoLNegronA	human
@ToyayayaBrown	human
@toddyflores	org
@brizzydbest	human
@kingson_kate	human
@dellyVybes	human
@yannie21599	human
@maria_kara1	human
@iamnatthakan	human
@FertilityChef	org
@MartaPeseiro	human
@ericlunaRD	human
@KatieNavr	human
@cortonawine	human
@renatavolley	human
@anjjelly	human
@Shergs1228	unknown
@IanChappers	human
@YANEFFATDSTRKT	unknown
@ArabBoyPutney	org
@WHATSUPBRIANCOM	human
@ChaseChamber	org
@PrinceNiea	unknown
@beyoncefansyes	human
@blooddogg757	human
@VisitTheMarket	org
@jiia_huii	human
@amchi_foodie	human
@DebbyJeanMarie	human
@MEERA_MC	human
@musicalhouses	org
@nutrieteam	human
@ricodmd	human
@azref_refer	human
@Tstyleinventory	human
@joleneandrea	human
@gingquenano	human
@MandalayFashion	human
@josealvarezdg	human
@gina_marieeeee	org
@GaluhAjeng	human
@SheelaghMairi	org
@jettaset	unknown
@sodapopsonia	human
@TattednMixed	unknown
@nasimaaaaaaaaaa	human
@Litassi	human
@ik__ku	human
@Vanvillegas	org
@UnicornTheSweet	human
@alexnunezart	human
@taraquepase	human
@tinkydudy	human
@hjamellos	org
@kayo_koa	human
@xxxgoingtohell	org
@akosichloe13	human
@510foodie	human
@yyhmnstr	org
@Cookzi_	org
@itsmeAllyzonMae	unknown
@laugh_andloveit	human
@JamesonChin	human
@VhanDivaMusic	human
@VetGourmandises	human
@MyJustDesserts	org
@BethVaughnRTV6	human
@mollyrose	human
@TatianaMinaeva	human
@danrevill	human
@famine_to_feast	human
@SuralEmel	human
@91_Rachel	human
@SeptiaRahayyu	human
@DoubleTreeChels	org
@schoaib	org
@ninthandco	human
@es_ha95	human
@JoordanJr	unknown
@adidas1990puma	unknown
@from_venus	human
@AmritaRana	unknown
@etenvolleven	org
@Meli_Zapata	human
@theveganseed	human
@mediterraneaBox	human
@onesortwos	human
@rlrushsr	human
@Miliomo	human
@oktalisha	human
@love_patissier	human
@sevildenizz	human
@MatthewSeltzer	human
@epulsoda	human
@Chilly613	human
@makamizzle	human
@biancabowyer	human
@fhen107	human
@TasteSmartHK	human
@ReeceDarlene	human
@StTuang	human
@happytooting	org
@leukerecepten	human
@Tnebollen	human
@EloiseMalone	human
@missninasworld	human
@anacloty	human
@Rbasty	human
@sophist_ratchet	human
@GnarlyFaction	org
@bayharbourmkt	human
@Thecibo	human
@SpringRewards	org
@Le_Nosh	org
@scdoratli	human
@AnaMariaTatucu	unknown
@lacontentanyc	human
@lynnedupuis	human
@vinhloitofu	human
@AnnIsabel_P	human
@regdaman	human
@ChichesterLover	human
@DivinelySent14	human
@Homegroundcafe	org
@misojosnegros	unknown
@chaimdog	human
@firegirl2000	human
@LeeTSanders	org
@stlinda2	human
@ribota83	human
@anoosie811	unknown
@hairandMUartist	human
@hktiger_kakei	human
@watersfdn412	org
@Devsmagic	org
@mydearcheskie	human
@EgyGabrieL	human
@p_luisru	human
@ElaineLeydon	human
@LafayetteSqApts	org
@ItsShayGorgeous	human
@skannabauf	human
@follieskent	human
@kachiko828	unknown
@YshireDalesMeat	human
@Dina16Bahri	human
@sohighsohell	human
@ballabla	human
@DorienNewyddIl	human
@Mishell1972	human
@FoodCaddie	org
@HermanFeeds	org
@XXFASKXX	unknown
@hudson_olivia	human
@acklin_15	human
@maaayucla	human
@arubatriptips	org
@maRICAngkong	human
@agunkzsa	human
@Alfia711	human
@FoodCycleCafe	org
@Lozelator	human
@sarganryan	human
@AboutNothingLDN	human
@Gillian_daSilva	human
@MissTinaamariee	human
@yoshimi73	human
@airaqutic	human
@Gourmet_Bangkok	human
@CarenFreeman	human
@VendomeApps	human
@TheTrooperWall	org
@nlprince	human
@gzdekrli	human
@Alexandrafunfit	human
@CeceliasRisto	human
@themacfac	human
@MichaelRies	human
@solbillordo	human
@eppingclub	human
@EchelonKi	human
@RealMelissaRiso	human
@zeroladdie	human
@SayWellness12	org
@roffeLdotcom	unknown
@GastroBrighton	human
@shirleyawicks	human
@beni_chika0497	unknown
@cerestable	human
@z3wright	human
@Destina_Asia	human
@Save_ve	human
@nkmr1_sy1	unknown
@a01oi	unknown
@NeroHagai	human
@ElaPrez	human
@Linda12122011	unknown
@ccookeryschool	org
@RossFitPT	human
@LucyMxox	human
@ShahShwta	human
@alchemyhealth	human
@m_b_yasuda	unknown
@DJrules1972	human
@_WithinReach	human
@ENOANutrition	org
@MilasRestaurant	org
@justingalvezfit	human
@delishGF	human
@ashiiMS	human
@amoger1	human
@Caronizer	human
@joeperezkc	unknown
@iampretty721	human
@vemariea	human
@JackieVera28	human
@DoEventsuk	human
@melinaphotos	human
@JudyHoch	human
@GBDchixndonuts	org
@TechFreak_	org
@DarianLie	human
@celebdirtylaund	org
@C0F3E	human
@ItuaFreda	human
@imdexg	human
@jaijin	unknown
@LusciousLtd	org
@Organicalism	org
@sparkleabbey	human
@sunnymanbb	org
@0966010	human
@kateeeeyyy	unknown
@LateAfternoon	human
@blackayako	human
@Re_New_U	human
@GT_R_densetsu	unknown
@Chantefabulous	human
@JordyCannon	human
@echadeka	human
@mscupcake420	human
@wyattmoore1	human
@whereisbaonow	human
@Asiliaziny	human
@WebSelling4U	human
@SBolanos88	human
@IvanoRun	unknown
@DolceLabFirenze	human
@Foodietiando	org
@MarisLilly	human
@BahiaCaboHotel	org
@Belime	human
@michelle__avila	human
@hungrysharebear	org
@aaronnakama	human
@GranaryLeith	org
@lillianakos	human
@RealQueenze	human
@joshmc0810	human
@cennds	human
@AprilTock	org
@JoseMiguelPG	org
@Phil_Kylie_31	human
@mjaikanth	human
@KimChoks	org
@OrganicFibroMom	org
@AltasCafe	org
@CorkedandPorked	human
@corgi_corgi	human
@66perristreet	org
@StevenWibi	human
@holybarbecue	org
@tabpayments	org
@alain79	human
@kevincadabra	human
@NoNgriam_	human
@TEGAMAVIN	human
@NewJulie	human
@TheNeonLeopard	human
@ElSieteMaresSA	org
@PelotonWineBar	org
@Marco_Padang	human
@MaryCode	human
@ShotgunBBQ	human
@ilugoo	human
@selna7545	human
@iiBeatFaces	human
@pi_xx03xx	human
@cafelamour	org
@Andaz5th	org
@MismatchNismat	unknown
@MrOscarValdez	human
@hjennifer	unknown
@Yeaa_SheTooFine	human
@BelovedSariNona	unknown
@Steph_TheRock	human
@lusianasusanto	unknown
@maipyon178	human
@KampongSpeu855	unknown
@MuratAri93	unknown
@Wez_Stuart	human
@NelsonCJW	human
@CrucialFood	org
@jchrisss	human
@OddBallzPaid	human
@danasartawi	human
@koybabygirl25	human
@KariiChoii	human
@mandyjeanc	human
@CaoilfhionnRose	human
@Knaus_Michelle	human
@Kp2004	human
@ArmsCarpenters	org
@NancyMarissa1	unknown
@aRainbowMama	unknown
@JanaSkloss	human
@GABBYiSACTiVE	human
@nickachy	human
@jeffreymlowe	human
@2MuchTina	unknown
@zinti21	human
@GerardAndrews2	unknown
@molossus1	human
@melnation	unknown
@mitch2cosep	human
@heyyjesse	human
@RestorantesMza	human
@vkn123456	human
@AngelaHadlNYC	unknown
@sanjuanberbis	human
@healthyeating13	org
@immachiqniks	human
@laijinfong	human
@LillyHiggins	human
@24InMyMind	human
@Hassan_Sefrioui	org
@curiousculinar	org
@firstprioritymg	human
@MOJEH_akikano	org
@james950417	human
@Gabriella_Sings	human
@RegenceIdaho	org
@healy088	human
@javierseow	org
@krewelladeville	human
@angeloedades	human
@greatkidssnacks	human
@GBK_MENA	org
@_LFBAH	org
@doncaster_hour	human
@BlackSeedExpert	unknown
@RailroadCafe1	org
@HannahWilkes6	human
@joyceestrelas	human
@CicciosWater	unknown
@Sarnie_p	human
@GospelOfIHM	human
@hmaroliadsilva	org
@callme_AHJI	human
@itsautotweet	org
@ChefG510	human
@PacChristopher	human
@madgede	human
@wfmgalleria	human
@tribuszerzs	human
@SeongGino	human
@iDixie0054	human
@GlutenFreeHack	org
@ChefDmorrell	human
@D27Lewis	human
@luveeer	unknown
@busyboysbrigade	human
@danniekurniawan	human
@Wriwri	human
@coco_zee	org
@drsmpg	unknown
@misssugarjones	unknown
@Gavingus	human
@Beachbody	org
@IdeasYolo	human
@jonny_cartier	human
@djaskew	human
@Lave_chamo	human
@ajidarmawan2	human
@kendall_square	human
@lisardovivas	human
@321Amandav	human
@theralphishere	human
@LadyJei757	human
@andrmiggy	org
@FreroMedia_	unknown
@8_pacquiao	org
@SharphamPark	org
@RTCHRIST666	human
@mistyriousness	human
@FifthAvePizza	org
@678Metin	human
@shichino_risa	human
@EvanWelcher	human
@MrSaiNshariF	unknown
@NutritionistITK	org
@kamcb29	human
@eviltechguy	human
@pprater46	human
@SwedishMoon	human
@kavitadadhe	human
@HajiIshak1	human
@JoanneWheatley	human
@val_2402	human
@jsmilktea0604	human
@sarievalencia	human
@concrete7	human
@DominosTuxtla	human
@LabyrinthusXXI	human
@KikoSnacks	org
@LuvNee	human
@YUKIMIKAWASHIMA	human
@nalinte	org
@lemonsandlaughs	human
@gedge72	human
@Harmonydinsdale	human
@MigFTL	org
@BlackMilk_Mag	human
@The_Fireplace	org
@InsideJapan	org
@atingngpex	human
@leah_pandalove	human
@karen_tayeh	human
@PanaPsychDoll	org
@FSMarunouchi	org
@STARSTARCHUN	human
@Rickeya86	human
@mariacadavida	human
@sillycookieluv	human
@farhanvedder	human
@NadaLottermann	human
@_YoungWildCrazy	human
@kota_n	human
@ProjectJuice	org
@Da_One_So_Icy	unknown
@TweetyPie_03	human
@gsummers1972	human
@BrianFH2	human
@EateryA_DSM	org
@ColorsDetroit	org
@LWong3000	human
@AlbrtoEnt	human
@_leahpeace	human
@bmack904	org
@NegronGall	unknown
@wxiong88	org
@FraeuleinFit	unknown
@brendaclaud	human
@JagValdez	human
@MrsDanyelleG21	human
@bryanmastrbaker	human
@yuuki019	human
@VeganrevAMP	human
@jogzzz	human
@jaaanduran	human
@DjGallis	human
@CindyBlunk	human
@tolgagulen	human
@HalloNicNeu	human
@AllinaHealth	org
@NomansRoni	human
@foodscapegroup	human
@tongnushen	unknown
@davidhalesmith	human
@mgquiggs	human
@lesaann98	human
@active_eat	org
@karina_sien	human
@pretheatres_com	human
@daveytrain70	human
@Yash_redasani	human
@JRBphoto	human
@GSBMusic1	human
@1993yt	human
@dealFanatic	human
@SelenaGomezGram	human
@Rayinamsterdam	human
@TastyFoodSnacks	org
@AsmaJuliet	human
@eldjsmokey	org
@Plumplips44	human
@Kamel_onek	unknown
@Ndaylens	org
@Downtown_Chic	human
@nikkiideta	org
@SofiaSuju	human
@ETHANLAM1119	human
@CrockPotLadies	org
@pmgomez	human
@AndyTLe	human
@LeoL0808	human
@Ariaina	human
@sabrinalinke	human
@Prettigurl28	human
@ACMEcarrboro	org
@ben0fficial	human
@cin513n	human
@JESUSREYNA	human
@michelshaker	human
@hanstylist91	unknown
@Hedley_Verity	human
@tabelog_us	org
@debtbusterz	human
@xenofonvasilopo	human
@onmycoffeebreak	human
@jcollinspr	org
@Shairalles	human
@VetaGuilbeaux	unknown
@sammy1506	human
@kiyonam	human
@EnedinaTT	human
@Rebecca_inLA	human
@nobu_sang	unknown
@ScribeCat	human
@ThisisMack	org
@showmasteryork	human
@RodolfoJimenezM	human
@TulipFairy	human
@i_Cimi	human
@scatteredmom	human
@NanakFoods	org
@whizkidwister	human
@semtinkizi	human
@cabralarmando	human
@islesofjane	human
@kathmasistin	unknown
@DiiiFernando	unknown
@natsu_o	human
@Miqa_Bangster	unknown
@palak_bubbly	org
@Samara__life	unknown
@vfilloy	human
@realtorpremier	human
@SpicyFoods	org
@MArashi0709	unknown
@LynxViltrist	human
@asanoyukimoto	human
@GANZcafe	human
@davechristianb	human
@RossdelSalento	org
@rethinknutr	human
@whatnowmyta	unknown
@Hoshinyappyneko	human
@JayCooL88	human
@bellasfeast	human
@BerylBeryljones	human
@HungryToTravel	human
@JessStarrCher	human
@MarinateMeBaby	org
@edithgarcias	human
@hongloan281	human
@GraceLamhk	human
@fondalo	human
@technocalit	human
@marce_spence	human
@kapustinarussia	human
@crosscorner_	human
@zazny	human
@donheremilio	org
@Jasonradon	human
@jenwilson	human
@vanessainboston	human
@FolcSA	human
@MissNgadiaPham	unknown
@mimsrachel	human
@JennyNicole03	unknown
@RainbowLightNS	human
@StamfordHotels	org
@TheWanderboi	human
@abhinavjain93	human
@CarissimaK	human
@Belleza_Beatriz	unknown
@fashiondiyteam	org
@alfiecezar	human
@TheFarmPA	unknown
@somethinglamode	human
@RUNAWAY88LTD	org
@ultraben1	org
@_callmetina	human
@TheLadyJersey	org
@DeborahWelchuk	human
@PassioniandC	human
@ScottysPhotos	unknown
@bnutritious	human
@juannajuannita	human
@ElleAlberto	human
@glambyfarahk	human
@esp1231	human
@Ian22HeanChoong	human
@eatPrimos	org
@_greeneve	unknown
@jhoburgh	human
@rufinachang	human
@sassykitchen	human
@theswissvegan	human
@mimienadhirah	human
@SlayScott	human
@UrbanBlissLife	human
@PhilipSmithEu	human
@captck	human
@LuCe_DeUcE	human
@gift_festival	org
@AAlampi	human
@SaskiaOfLiberty	human
@n3lau	human
@kelssx42O	human
@MAKOSI	human
@NeuvooOklahoma	org
@Caropoulin70	org
@Papaya_jeddah	org
@nico78832111	human
@gaynor225	human
@melzwitschert	human
@cocosala	org
@ArumbearPanama	human
@fabiormachado	human
@TknZtkn	human
@VeronicaVolpi	human
@MMarias2000	human
@nine_lemons	human
@amgenove	human
@PartyFowlNash	human
@JohnGCWood	human
@VEllisonne	human
@MozambiqueOC	org
@EmmaJCasey	human
@tanyasaks	human
@JCSFishLtd	org
@jienchy_	human
@paulongpetiks	human
@essofresh	human
@shorelunchbrand	org
@Ansuken	human
@StrtegicRetweet	human
@yuka_fuk_cf	org
@Andoman_Ceo	org
@KitchenSnaps	human
@LatinBites	org
@DragulaSunny	org
@IlVoloLasVegas	human
@The_Westminster	human
@LauraAndric	human
@BariatricPal	org
@warp5	human
@djjojoflores	org
@julianafachetti	human
@punkin7426	org
@Winiche	human
@AWOL_MM	human
@areume11	unknown
@GreatBrandonio	human
@deejayglerix	unknown
@thenormantlv	human
@KatjaRod	human
@elsewheremuseum	human
@Ultan1Kenny	human
@erineleini1984	human
@HappeninginVaHi	org
@gossipgirlie	org
@abrillabin	unknown
@TheHYMTeam	org
@chiedialladani	human
@TomDouglasCo	org
@lilsiscafe	org
@JusstJessie	human
@arampuzon	human
@bakedbyjoanna	human
@cookedco	human
@teddyshee	human
@Lodykb	human
@NekFlaherty	human
@TinaKaikkonen	human
@FioreDamerval	human
@mirandatruitt	human
@Reza10_Gooner	human
@morgbu	human
@PunjabByNature	unknown
@SzebastianOnne	human
@ForestAnn	human
@TLBCandles	org
@Anna_lyzes	human
@TheEyeKon	human
@snowtsuyo	human
@yowjiawen	human
@Jazzyvegetarian	org
@agrivelt	human
@chiaracondemi	human
@spoon_upenn	org
@MaafValadez	human
@ASho4Sho	human
@E_PartyEvents	human
@Lucy_1D_Fan	human
@TippyRye	human
@elifgokoglu	human
@OrganicTwisted	human
@SweetBFoodie24	human
@sexy_lady_bug	human
@MZagurskiy	unknown
@LourdesKarolina	human
@JCOPYoungAdults	unknown
@Bloodz82	human
@thefavecast	org
@Lorenzo90	human
@edore	org
@SossysBBQ	org
@elkiestylist	human
@SAVEURNOLA	org
@MrAvila_	unknown
@dnbvabeach	org
@JohnnyNiight	human
@GLIVECREW	org
@austin_langlois	human
@NaturalVitamins	human
@benlashomb97	human
@wewalkthelineuk	human
@JDE3021	org
@muscats_bot	human
@LunaRLuis	human
@caleighmary	human
@refugensfood	human
@roomandpoolbcn	unknown
@maruluzar	org
@DowntownHouston	org
@andreeasdxb	human
@JourdanChaTaun	human
@Jaannniieemuah	human
@LaurenMillar_x	human
@VeeATheArtist	human
@DolceBakery_CT	org
@fashionissa	human
@JarAbbegayle	human
@aLyssaLoneLy	human
@lilpil99	human
@Lifebalanz	human
@BerlinPieLover	human
@BBungaroo	org
@FozCornwall	unknown
@shelenecoward	human
@BenignAngel	org
@eatatsurfwiches	human
@LLeopoldseder	unknown
@Farplants	org
@mogura2009	human
@FeralCarol11	unknown
@mohd_hidayad	human
@nanananuneo	org
@torothebull4846	human
@shane_cantero	org
@Lee_M1911A1	unknown
@CuisineGlobal	human
@WillTheLandMan	human
@guapayculta	human
@AlianthosGift	human
@BuellaMarie	human
@hustle_marsalis	human
@sweetie_ria	unknown
@SDRivers	org
@MacMargi	human
@LosVerdesUSA	human
@SECONDHANDSTORE	human
@TheHomeEcRoom	human
@MrsSuty	org
@HoltHarlequin56	human
@LadyJ_SA	human
@BFG_IsHere4U	human
@Lacyluhu	human
@KirstenMalmberg	human
@okuchandayo	human
@Earthly_Choice	org
@ChompRI	org
@FGMoria	unknown
@lizbarnet	human
@ThingsLancaster	org
@maika513	unknown
@DePaC_B2M	org
@chj8055	org
@DonckersOnline	org
@evancobbjazz	human
@Michaelsplumbn	org
@RusselCador	human
@irsyalhrp	human
@BrotzeitPH	org
@fungifoodie	org
@DBGBKitchenBar	human
@hersideproject	human
@bondichai	human
@AdhaSanif	human
@Eldonko	human
@luca_cip	org
@20PhazedFashion	unknown
@HyattOHare	org
@BarbaraNicchi	human
@thymeoftaste	org
@breadheadbakery	org
@JeahnCBermudez	human
@thepieaddict	human
@bbacpy	org
@thecamelrva	org
@Bashmankoush	org
@sim_mick	human
@MissFXVincy	unknown
@whatsinmybag	human
@IamAzri	unknown
@Cellfire	org
@ArmiraJDBLove	org
@Haa_die	unknown
@SeanLerwill	human
@Hamza97Cakmak	human
@Triplejjjfarms	human
@reypeace	human
@ShineonRaw	unknown
@EvanChan1107	human
@tesodb	org
@NoraGhabi	unknown
@GlossyFitness	human
@CarloMambro	unknown
@KennyTallier	human
@CascinaG	human
@pueypueyyy	human
@anissalwati	human
@anjiconnell	human
@___MiOak	human
@BriannaBegg	human
@SarahTamashiro	human
@BWestBaby	unknown
@SoLeiFiEd	human
@WazzupWally	human
@ChefCarlDahl	human
@emilytakespics2	human
@kevo65sg	human
@LaFemmeFem	human
@kweitz03	human
@CLRowell	human
@Sterfpappy	human
@KobbyBrewoo	unknown
@elwinramos	human
@JeremyJacobs	human
@zilyca	unknown
@FrezitAlkatraks	human
@carolinearo	human
@MakTycoon	human
@hudabubbly	human
@fodmapfood	org
@SlimPicksKitch	human
@truecooks	org
@Mz_CrazyStorm	human
@OrdinaryAffair	human
@HarvRidgeWinery	org
@SayWellness9	org
@nathi_saraceni	unknown
@KutisRestaurant	org
@adamprovenzano	human
@IzzKho0ii	org
@marianmesales	human
@tc_shaun	human
@hyna15	human
@ekhlasur	human
@jodiebridget	human
@MrMitsuC	org
@2rubyLips	human
@Vegan_African	org
@ohthesimplejoys	human
@skyxsky27	human
@aces08ss	human
@tomsgob1	human
@IdahoPotato	org
@sfdhawaii	human
@KlausAgnes	human
@ukworldnews	org
@ThisIsLivinL23	org
@BeyondOrdinary_	org
@skalatoiuox	human
@BestOfDelMar	org
@Marco_NY23	org
@aMAEzing92	human
@lifeofyourdream	human
@MrsReeves1	human
@chucho_mtz	human
@belgium44	unknown
@GreenRoom_JN	unknown
@fishkitchenking	org
@ItalianUnicorn	human
@TruemanNick	human
@BrunaSantos098	unknown
@Daizy_Flower	human
@apkdownloadapp	unknown
@WendyPauC	human
@ParkerMeridien	org
@RhondaBoo89	human
@AspireSocialite	human
@matsuokamisaki	unknown
@SkinnyYouTea	org
@ellascafes	human
@HighlandCraic	human
@OnSpecial	org
@MeganPfiffner	unknown
@RootdownLDN	org
@sandwichdelici	human
@Josep_Xavier	human
@SoshDC	org
@doolins	human
@MayiiAlex	human
@LambyPhonics	human
@upnair82	unknown
@billyzimmer	org
@alexon1210	org
@jobletters	human
@charieannpalad	human
@Wimlans	human
@janetakishi	human
@crystalMic	unknown
@TomasYudica	human
@francwip27	human
@kc_ching	human
@Monika_Echelon	unknown
@ITEM93	human
@hannahrenbling	human
@Cavashock	human
@pathesu	human
@SaraCastroDJ	human
@puput017	org
@dr10596	human
@adrianachavira	human
@gofunkychicken	org
@SydneyTimeOut	human
@kathy_89s	human
@JanetLismoyo	human
@VitkiGurman	human
@thefatherphil	human
@TipsyCowLA	human
@BijhetStrand	human
@ToqueNous	human
@sarahjanewalker	human
@EastVanSpoke	human
@spyasin	human
@rachmarsden	human
@Jobs2GoLtd	org
@OberoiDubai	org
@Iriqua04	unknown
@UrbanBrunchCo	human
@Andhansel	human
@cbobfoto	human
@sharon__wu	unknown
@Rita_Serio	human
@adi_nopri	human
@The_Careeralist	human
@lgeood03	unknown
@ArtByHelga	human
@LBC_Group	unknown
@ramzanirahman	human
@mystylediaryeu	human
@Nebellos	human
@NIA970904	org
@geek_Grey	human
@Jarvdesign	human
@ployyb	human
@astonpluit	human
@noelsacay	human
@MrijkTK	human
@HeAboutPop	human
@37CeoWorks	human
@timurdc	human
@GROUNDWORKZINE	human
@WorcFoodieFest	org
@israelgurl07	unknown
@oilliverpool	unknown
@AAlessandro86	human
@HotBestRecipes	org
@stardaneke88	unknown
@daniellefebe	human
@kjsmietana	human
@pauladeiros	human
@casaoui7	human
@Nadervandi	human
@PhebeOhYes	human
@steffclef13	human
@Eats_nTweets	org
@gillyburbur	human
@Quiznos_kw	org
@fordgal4ever	unknown
@FashionLoonatic	unknown
@SeaToSkyInfo	org
@kmbsk80	human
@gothintheraw	human
@ratihiker	human
@kviladashceline	human
@TheRealDevJo	human
@KarineAmaya	human
@jessicakbrown	human
@BlueSaigonTruck	org
@ShamiraMitha	human
@lovebug_4ever	human
@Keetons	human
@colourlesswords	human
@robynwebb	org
@mvermakant	human
@CarmillaLusta	human
@remarksbylaura	human
@zeppy_wine	human
@oymie	human
@popup_gourmet	org
@nayami_rescue	human
@TheWorkshopL22	org
@jbullman6	human
@SandyJunction	human
@GymTings	human
@REIdrigoMenezes	human
@Aye_Artiiee	human
@rbatkins	human
@DeltaGrandHotel	org
@surekhapillai	human
@miyuu90210	human
@InfoMarios	org
@soldeabril	human
@Creative_Mine	human
@mhej1_	human
@TreallRealla	human
@SarahConteP	human
@eljx1988	human
@CORINEHesme	human
@rizuky_88	human
@Algerivoirienne	human
@estherloopstra	org
@R3lishApp	unknown
@RAGZIZFRESH	human
@CAULiverpool	human
@Miss_Cassy	human
@collins_jk	unknown
@commoncentsmom	human
@NGJGFIT	human
@ttaylor2u2	human
@thepancakeloung	org
@DatRandomBot	unknown
@DinaDeleasaG	org
@MyresChris	human
@CynnedCynner	unknown
@LangersDeli	human
@GullyFaEver	human
@seaso2sea	human
@elymiralles	unknown
@Martin_Wine	org
@adellahany	human
@Deron_tck	org
@myraavecilla	human
@NalouDesBois	human
@Debi_licious	unknown
@classichomesch	human
@CoutureChicBTE	human
@Belkina88	human
@DigitalLA	org
@alexisrae_photo	org
@Mhackhoiey	human
@sweetandsour01	human
@vjhollywood	human
@JuneIrani	human
@HighLinerCanada	org
@QueenB_24_	unknown
@purehwayoung	human
@erhfen	human
@Keithpng	human
@HotelFortWayne	unknown
@NYSideways	human
@GregoryJnB	org
@Cbruni1	human
@akkiy_721	human
@3HealthyMommas	human
@KenyanGrl	unknown
@AlsonMC	human
@nikin_n	human
@mokalocks	unknown
@MalhadinhaNova	human
@KevinBmore	human
@Over_A_Cuppa	human
@QuinineTan	human
@EttoPasta	org
@AmysBakeshop	human
@ThatGuy_Patrick	unknown
@MaxXtreme	human
@woodsmantavern	org
@storm_baines	org
@katherine_sszoo	human
@EmreOguzTatar	human
@LaCuizineNL	human
@Memelao_12	human
@JEMangione	human
@djCristyle	human
@Pabloazcarate	human
@sarskhan2	human
@DoniPeterson	human
@betulp80	human
@ozgucagiran	human
@mimieyo	human
@JamieDarst12	human
@hachan24a	human
@nomnomnomsnack	human
@napoleon60_leon	human
@prelogs	human
@djgarcia_filthy	human
@LiveSeasonalMX	human
@SayWellness13	org
@SANDYBEL10	human
@MrGilyard	human
@rayrarayray	unknown
@foxgourmetfoods	human
@PlayMMOPokemon	unknown
@aliasyuhada10	unknown
@headinoven	org
@ranyyanawidya	org
@putabornthisway	human
@Mk1991sara	unknown
@raptureponies	org
@MusicHostNet	human
@wx1gdave	org
@ggeorgette30	human
@amandatopper	human
@Jill_1480yui	unknown
@FionaSecola	org
@PinkKitchen	unknown
@djneilarmstrong	human
@mechmontecillo	human
@pmichellexuanyi	unknown
@aicooro	human
@graveygranule	org
@mchingl930	human
@PaperieLane	human
@THRUSTby_Elie	human
@lafilleennoir	unknown
@KaluaMykonos	human
@MaryMacN	human
@Where_You_Goin	human
@omoshiro_izZtp	unknown
@smoothiesapp	org
@Ascil85	human
@yourockmylife29	human
@rozborn	org
@Lynz64	unknown
@Djeceozalp	org
@limyeeteng	human
@RecipeTryout	org
@pocotweet	org
@Eek_ikrima	human
@rhose1221	human
@james_jmh	human
@USIfood	org
@BruceWineBar	human
@adlg13	human
@atlimbo	org
@winthenextlotto	human
@rekendri	human
@HarajukuSpain	human
@marshalcerasar1	human
@fleckgetsfit	human
@ImChrisDamart	human
@JJelly_Swag	human
@gillsondavid	human
@rezaMkZadeh	org
@Danielluca11	human
@abbd7	human
@dufferslounge	org
@neteszti	human
@DegustaboxUK	org
@manifesturself	org
@ZLATANSPORT	human
@AndreasDoerich	human
@AnxAnxter	human
@AnitaHargreave1	human
@CityGirlDraws	unknown
@MoneyMakingMala	human
@AleemAkhtar02	human
@Enddy_Mart	org
@gailbouw	human
@ohMariana	human
@ShadaJ2012	human
@ViviannChow	human
@michaelnemcik	human
@healthRIO	org
@KeroKopi	human
@_Domainhaendler	org
@RaffyChiarella	human
@BoozyBrownGirl	human
@PennylovesJazz	human
@fabuloustorture	human
@marcialoft	human
@tawneegellerart	unknown
@Delphiine_A	org
@harrys4876	human
@SheldonCPF	unknown
@purple_cath	human
@FiREiCEProvRi	human
@Dubaitrvlguide	org
@muu4977	unknown
@drewhamm5	org
@VeronicaT_PNJ	human
@eastcoastmp3	org
@cooljanedesign	human
@CutlerRidgeLAZ	human
@leannechuk	human
@24DinerATX	org
@Ysilacosa	human
@ladiesofwin	org
@VeliNikolova	human
@DUMBOFoodTrucks	org
@SteveErics	human
@Jim_B60	org
@forkandpork	unknown
@AngieLSiu	unknown
@sbourne1031	human
@Monikers027	human
@abbyrdzz	human
@moses_green	human
@matthiasgu	human
@moselvroni	human
@_Mangez_Moi_	unknown
@malvescardoso	human
@timothy_marsh	human
@CHANKUUUN	human
@heyitsmiko	human
@Joe_captain2	unknown
@jhvyrzn18	unknown
@KSamoro	human
@otakugirl	human
@any_yeah	org
@Kidultlife	human
@VeganVero	unknown
@VitiAcosta	unknown
@SalizaSaliz	human
@ObvlyQuizzes	human
@zomerfeygele	human
@optiflo	human
@mynameisGDmcboo	human
@nurfazliyana2	human
@classicemperor	human
@Jeds_food	org
@JulietteG	human
@ZackMorrisun	human
@FaLLo_VeLa	human
@PrairieHeels	human
@Snicholfritz1	human
@risadaccha	unknown
@javentura66	human
@tatanishapw	human
@elisabetheats	human
@AndrewSpurgin	human
@His_PrTncess	human
@SAGardenandHome	human
@SagaUK	org
@mariamilito	human
@jhndryl	human
@StRegisSaadiyat	org
@lilmsitchyfeet	human
@bbptfitness	org
@vanbloggt	human
@ClockonQueen	human
@DJConstantine88	human
@joirikanoi	human
@sarahdungworth	human
@Rachel_Thomps	human
@Tonii90	human
@NextIssueCanada	unknown
@AlexisXGonzalez	org
@ReichenbachHall	human
@TacosYMasDallas	org
@hane_np	human
@CaroCamusC	human
@Loutarwen	org
@MeGuM1221	human
@navid110m	human
@millaquitatfe2	human
@MerceTaus	org
@danishojha	human
@mafe_dymfc	human
@Kwan92line	unknown
@MatchBarLondon	org
@SpkandStrngr	unknown
@kathryns_41319	human
@the5oclockrush	human
@JTS4H	human
@NOISE_cut	unknown
@airborne072167	human
@CTManinNYC	human
@ChelleRegan	human
@humbe2279	human
@ChefFatat	human
@mattbissell	human
@DiannaKennedy	human
@FoodieMcBooty	human
@TheTyraG	human
@NycSubwayFreak	org
@w_stefanii	human
@Lervinia	human
@rainluvs06	human
@rennbird	org
@LifestylePearl	human
@MomsBinder	org
@cgdesignslondon	human
@APiquantTerrene	human
@musicblackrose	human
@LivCrick	human
@erikacquinonez	human
@thunderay	human
@amandakyme	human
@Hi_Bi_takaban	human
@Lauritamapa	human
@R3_Ventures	human
@maizdemar	org
@masatosaikyovvv	human
@emilybaileyrd	org
@JOeLE_ITALY	human
@cup_keki	human
@VJsidespin	human
@NeuvooBirmingha	org
@By_Right_Way	human
@TMYK_	human
@fawze22	human
@GaslampSF	org
@CouponDivaDes	human
@lookkling	human
@IkoTeng	human
@AnnaKat_Ze	human
@James_B_Smith	human
@lizzien28	human
@bilalalarabi	human
@my__villa	human
@NoliesPlace	human
@mpcPUBLIC	org
@GirlsOnStocks	human
@ShaquitaCHI	org
@juditbrea	human
@rakkapotts	human
@ayla_creed	human
@elaza78	human
@callmeChing1	unknown
@tourismwithme	org
@haywoodtavern	org
@tvxq_exo_smf	unknown
@David__Allen	human
@Lali77	human
@touhidul_tasin	human
@Jjeessiicaah	human
@ErbdyJockBREEZY	human
@gersonm82	unknown
@devilwearspuma	org
@b_elisaaa	human
@MagsJay	human
@BakmiGM	human
@Hannah_hanhan	human
@Jia_Foods	unknown
@Blackittyblack	human
@marhilary_	human
@HealthyHapSmart	org
@SashaMarie13	human
@Chimere904	org
@EraldoMaglara	human
@midwinterD	unknown
@mariko_arc	unknown
@archrestaurant	org
@nikkiiong	unknown
@SophieAnnaB	human
@aka_neirock	human
@MomsInAtlanta	human
@1neDom	human
@mariohz	human
@ratdogfreak	human
@EmiBiggs	human
@jebgavin	human
@PABSiLog	unknown
@FebyMayLoa	unknown
@AdasDesignInc	human
@MJPedone	human
@airathar	org
@AdairsWay	human
@julajulijulia	human
@JayCrook_LA	unknown
@Millhallfs	org
@BrookeLWard	human
@cjaeckle	human
@Playthislife	human
@Tupac_music	human
@BistrotTeatro	human
@stemeneses	human
@densanchez18	human
@marta_alcon	human
@epicurious	human
@Janey_Cotton	human
@2_IT_OnTheRoad	unknown
@kellyambereng	org
@markgransee	human
@HannahN_XO	human
@princessdynami	org
@annettegeneva	human
@congress_ICP	human
@MariaPeratopoul	human
@aynuraslanbasi	unknown
@tekilagz	org
@sunnshyne309	human
@papillesetM	org
@TheWolf1031	org
@zunsara	unknown
@ranOverdose	unknown
@kristajmclellan	human
@karacaradas	human
@nuttae	human
@SonyaVerny	human
@Angelynn_Kaira	human
@lose20lbsweight	org
@Thatsnotweird	human
@JoseDamiani	human
@MissyAliz	human
@MSIServicesInc	org
@PeachyDays_	unknown
@UnleyRoad	org
@KHOSINLO	org
@allatiara	human
@retereso	unknown
@Tatyana_Orozco	human
@cmcauliffe81	human
@Mike_Gomez	org
@tine_meichen	org
@danikaayzabel	unknown
@JUNIQEARTSHOP	human
@islandsmiracle	human
@robphillips28	unknown
@aburoays	unknown
@danyanais	org
@Krissynator	human
@bgb868881	unknown
@rikolicious	human
@MagdaJ_	human
@MA_riEtAGisele	human
@olddutch	human
@Archenbaldt	unknown
@LBLUK	org
@PocketTXP	unknown
@NikolaMcCloskey	human
@EconPanama	human
@AtelierChan	human
@JuwitaJamal	human
@G9eidhaa	human
@DjElizaMay	human
@MSVIVACIOUSCOM	human
@tiffanylynn84	unknown
@eloise_tan	human
@19861007_	human
@GOQiiLife	human
@KetchupSSide	org
@daxin_t	human
@chefbradspence	human
@anyamanplastik	org
@sekoyanatural	org
@tg_rhu	human
@pilartimpane	human
@Sanaa_Ijaz	human
@KT_HUTCH	human
@vicksan	human
@THEMissFoxy	human
@ruizsamson	human
@martitacjara	human
@OliveStreetCafe	org
@EllenBatist	human
@AllRealradio	human
@DogHausDogs	human
@Bitter_1216	human
@ourfulltable	unknown
@from_yamagata	human
@Maagra21	human
@breakfastaustin	human
@chinu000	human
@Kaaaaahl	human
@HeinzBabiesSG	org
@TurizmTourism	human
@NEMpls	org
@FrancescaOrsino	human
@micheyl0711	human
@JoorKitchen	human
@ivansiaw	human
@HelenCrayon	human
@goLadleAustin	human
@MrsOverby	human
@MarkJB86	human
@ZanyZoel	human
@Michael_Nyoto	unknown
@Oh_That_Shelly	human
@kaelside	human
@bertpeterse	human
@markjonesevents	human
@Stephlapinski	human
@Kaoriiith	unknown
@sistahvann	human
@ricard67	human
@Conserv_Report	human
@so_fairly	human
@zeppy_coffee	org
@MerMaurizio	human
@SimonMorykin	org
@GloriousClara	org
@PetawawaMFRC	org
@GraceGaz	unknown
@ChocolateJoolz	human
@engellig	human
@food4michaela	human
@RuthsDinerUtah	org
@kimoko123	human
@Rosmawar_Manaf	human
@ilaDMG	unknown
@RosalbaRuggier1	human
@MRissax7	human
@OCWeeklyFood	org
@erabramson	human
@NailsBy_RED	unknown
@jeanthebulag	human
@NuriaaCortes	human
@ShonaDoesFunny	human
@HyppoChan	human
@lazybabyz	human
@aussielucas	human
@finney_scott	unknown
@LuvsMyMunchkie	human
@spring0nion	unknown
@linaabbas78	human
@ToledoMoms	human
@MyArmyMe	human
@iSimply_Tweet	human
@JesusHelpers1	unknown
@gerbyerana	org
@BCookiesNYC	human
@awesomecelina	human
@dereksabs	human
@YoungTwizzle25	human
@velushomaz	human
@sasacascone88	org
@carnegiedeli	org
@interstatedraft	org
@gastromony	human
@iJulesdotcom	human
@autologei	human
@EyeAmNaJAH	org
@halal_mama	human
@madihah_ime	human
@seanlukethomson	human
@TiffanyHydeTRC	human
@sonalisj	human
@caffeinapura	human
@samefiresglow	human
@jAd0re87	org
@izu_26	human
@SteeeWorld	human
@estelleblogmode	human
@GoddessVT	human
@wisefoodie	human
@MILAN_ski	human
@ShowingElegance	human
@PhoenixMoms	human
@AlHudaBakery	org
@DiegoPR1	org
@aipeksenturk	human
@J_Biz_429	human
@coffeebeanqatar	human
@krinklett	human
@meyiii_mee	unknown
@alessiuccia_5	human
@Scotland_Style	org
@whatshelikesIN	human
@OrnaOR	human
@amicapubblicita	human
@DomesticatedWC	human
@KyleFerragamo	human
@anikurin	human
@cortonArt	human
@stephanierozak	human
@LakesideEncino	org
@JustLuxe	human
@campcoffee	human
@NYhealthyliving	org
@MyLoc_Tracker	org
@MakanTeruss	org
@misskatlady	human
@azuracasgrain	human
@MulderDSM	org
@therealvapete	human
@winnieho0818	human
@SayWellness25	org
@MichellePapas	human
@nannyheadhunter	human
@mondsonde	human
@SwallowsNestVI	org
@Johnny_B_81	unknown
@SritikaDhar	human
@oogami2003	human
@Ccrystaliciouss	human
@AnnArborMoms	human
@vixn36	human
@LSBclub	human
@KimmyHazelEyez	human
@kennethshorty	human
@AghaM7md	human
@BMM194	unknown
@subisubi	org
@foodpdxtv	human
@MahaloBudapest	human
@cal_EZ	human
@AfzalShakir	human
@Black_hair	human
@MisterBash	human
@Lissarette	human
@BudgetGourmetM	unknown
@MeridienPyramid	org
@ItsSeobia	org
@JensLifestyle	unknown
@sarahgk0312	human
@whiteburd09	human
@Erie_Ave	human
@MelltooMarket	org
@singersuchi	human
@pricaramires	human
@chikolove13	human
@PastrySchiff	human
@LloydMaunder	org
@MorganCoffey	unknown
@Table10Regina	org
@Chitta_Metz	human
@ilovemylaundry	org
@Tina_xp09	human
@xueCheryl	human
@Grillnshake	org
@hummingbird211	human
@Ucop_9W2YKK	unknown
@jesshhiikka	human
@Rickys_Grill	org
@MartinNguyenKMA	human
@july2k15	org
@JadeNorcross	unknown
@xxMissKirbzxx	human
@limho0622	human
@LifesA_Party	org
@zigzagzebrazz	org
@alice_updates	human
@takahirohirai	unknown
@liketosweet	human
@nachoperez	human
@antoinettepepe	human
@kaylasmuts	human
@jaymiie1992	human
@AndrewNorth5	human
@MissingLynxx	human
@huizhenl	unknown
@FINDitKC	human
@ginaeleescott	human
@greg_gerry	human
@gracefoods	org
@C1aRaDawn	human
@foodartbook	human
@PaellaBot	human
@MackdaddyMISA	human
@robertamorasco1	human
@LunaWM	human
@HandmadeHealthy	org
@hinayamane422	unknown
@Temi_Oma	human
@SwishasNMagnums	human
@LizFST	human
@ihamad9	human
@wehavewine	human
@ferdiyettPhD	unknown
@MichPainchaud	human
@BCBreakfastClub	org
@sweetsereniteee	human
@sybaritechick	org
@SurfInTheSun91	human
@Kitti_Kasshane	human
@cotono0703	human
@thedebsterruns2	unknown
@inJAMBIcity	org
@ViBE_ub_apple8	unknown
@Cook_Italian	human
@kaysbee	human
@AmyBakari	unknown
@mysskitn	human
@Sparkles_TIU	human
@miketinte	unknown
@adelinas_wine	org
@iiWorPocH	unknown
@OklahomaSentine	org
@mademoisielle	human
@Tuttlesbowling	org
@heindoardo	human
@TwentyPrincesSt	org
@maiak	unknown
@WheresSal	human
@realhentri91	human
@irina16d	unknown
@varyani_mahek	unknown
@Buatong_BTS	unknown
@blondielaland	human
@pioneerthinking	org
@ablackie	human
@benedictjeffry	human
@vinylgirl73	human
@kaechimuuu	unknown
@fichaspy	human
@cookwithariel	org
@Katy_Luce143	org
@GoEatGive	org
@robecta	org
@alle_05	unknown
@piercethebecca	human
@NicLJohnstx	human
@zoeesmith	human
@str1002	unknown
@mbentleybelle	human
@ReiJStrange	unknown
@Laura_Muscat	human
@Mz_Cali_Love	human
@LilithAnaCorpse	unknown
@Passiondelavie	human
@nicainsane	human
@missStaceyTan	human
@TheSaladClub	org
@bellachef19	human
@xBiBiAngelx	human
@TwoRiversNC	human
@CMatias_Mez	human
@4markiss3	human
@CaNdYFiT	unknown
@earlybirdkw	org
@VuyiDankieSan	unknown
@EasyPeasyOrganc	unknown
@cheftimbush	human
@mdjr1203	human
@robsrobs	human
@GIGI_MONTEIRO	human
@quirrow	human
@jelon_gmb	human
@PamHealthy	human
@analia_marecos	human
@TheAngelPub	org
@mikebabcock	human
@yunahlicious	human
@x_dum_ass_x	human
@Ferverferver	human
@TruongNguyen3	human
@MangoandBliss	org
@AwkwardGiraffe	human
@mllejj_etc	human
@aoomiie	org
@Erika_SFS	human
@MiamiRealtor4Me	human
@ferdie19	human
@tchyi2	human
@QGie	human
@TavernaOpaOrl	human
@EileenCCampos	human
@jennifer_vania	human
@ricciolino91	human
@SonyaParga	org
@balhumaidhi	human
@nudesandnether	unknown
@transounds	human
@aligiraffe	human
@LuthfiMuntashir	unknown
@monik_hrich	human
@lak125	human
@betterchildrens	human
@mandylynneats	org
@darkelf921	human
@fitriindah	human
@Cah_ree_nah	unknown
@cozmo13j	human
@MeynStay	human
@leighloftus	org
@CLTureFood	org
@MrsFlix	org
@TheFitDr	org
@socialcostamesa	org
@amplifier_mu	human
@AllSugarSpice	org
@the_cokiners	human
@gassigirl88	human
@tigressart	human
@supsup010	org
@HashtagAbdul	org
@FAST_VASS	human
@GreggioCom	human
@mystylediaryb	unknown
@max_strippoli77	human
@FavoredButtafly	human
@YolandaAshton	human
@GLVNews	human
@tonyahoward	human
@YvThtsME	human
@matteo_toffano	human
@sweetsavorycb	human
@nduindog	human
@sitoa	human
@KnipeRuth	human
@noseymuch	unknown
@fostercitynews	org
@SmallBizUtd	org
@CrownePlazaKW	org
@sonalimorjaria	human
@TunkLoveW27	org
@ReiversBarGrill	org
@LauraChoi16	human
@SAK11907	unknown
@kittyfashionist	human
@BadDogTavern	org
@sxegrl1	unknown
@angelmatriz17	human
@JeffRustia	human
@JamesBevarly	human
@vitamimihealth	human
@yoppy445_26	human
@HairSecretSalon	org
@gecko1505	human
@MissesFemme	human
@bec__morris	human
@kaathyperry	human
@NatashaKundi	human
@seldyloui	org
@zafirmawla	human
@GilmoreWifey	human
@CheapThrills76	human
@_Zanie	human
@lannhi2609	human
@iamDJ_Cato	human
@TravelingMurphy	human
@Curly0675	human
@rebeccabohl	human
@HanaBeny	unknown
@CookMate52	unknown
@thebraveandblue	org
@kimberlylace	human
@ThoughtOnBiebs	unknown
@nas_nat	human
@troublezzx	human
@CityFreudeBlog	org
@soemanta	human
@SolutionBB	org
@Saint_Got_Ghost	human
@Birgit_Chiensur	unknown
@MOnceuponatime	human
@smash1585	human
@CScrumptious	org
@larderbakingco	org
@Factor75	org
@VicParkGC	org
@dapperdangolf	org
@GoldenPalate	human
@AcropolisCenter	human
@itsmejaqperez	human
@QutrFerdouse	human
@Tales_ft_Thrift	human
@mllemash	human
@MuzikIs_MeVida	human
@PigSimYee	org
@s1eeeeep	unknown
@Gilly_Pickup	human
@CarolinaMeatCo	human
@PeterSoucie	unknown
@SteamWineBar	org
@ZaynaHamarneh	human
@TheCommons1	human
@MZTML1980	org
@CafeRougeTweet	org
@AmberChiuTW	human
@totalbristol	human
@NeuvooBocaRato	org
@mzmahadeo	org
@RMWLeith	org
@SewWhite	human
@louieorlina	human
@GreenLifeDinner	human
@asianfoodlab	human
@AnaLauraGall	human
@POTTERZ_KAGAWA	unknown
@gripenblom	human
@iamsheilfree	human
@PattiHakanson	org
@CremeCrepeCC	org
@bayourunners	human
@VirginiaRecipe	human
@foodista	human
@momojito	human
@claudiaemt	human
@ChalkHillCook	human
@MieletLavande	org
@MizzJ_Jae	human
@cortonafood	human
@Eatelish	org
@chefceddiebear	human
@Tai_sweet_chili	unknown
@ntlwomenshow	human
@foodmatters21st	human
@hlmachalak	unknown
@iamnaomi89	human
@Mei_Ling_Foo	org
@lyndonJmaddawat	human
@cheese_knight	human
@RolandoJVargas	unknown
@SewaraHQ	unknown
@MauNRou	org
@inhadewi	human
@atikahsamah	human
@yelphawaii	org
@tweetperth	org
@ArnettaTT	human
@County_Lines	org
@ClarenzeNixon	human
@j4cooks	unknown
@AlNoRy84	human
@x_xaiko0_0	human
@KlassikerKueche	unknown
@rida_shah	human
@Mars5884	human
@lolasfoodpics	human
@QT_KPOP	human
@russej10	unknown
@shadow62310	human
@MrGonzalezJose	human
@ShaunaMcGill	human
@JamesGGreen64	human
@zn2jcom	unknown
@ShannonSephra	human
@bigyfoods	org
@chat_away09	unknown
@BonfireMankato	org
@Juss_Dainjrus	human
@AnggiaSihombing	human
@noornk	human
@fratellis_pizza	org
@RRWFPizza	org
@NicHemmings96	unknown
@NicoleLayana	human
@2tunkins	org
@JLjoselu	org
@HeartY_rico	unknown
@100beers30days	org
@EstrellaNegra1	org
@5fitnessgirls	org
@DJDesignGuy	unknown
@itsashleeee_	human
@cimdrp	human
@mallorywitzig	org
@NotStepfordTess	org
@HeartbeatLady	human
@FinanZzii	human
@armando_llano	unknown
@jennyjennycrazy	human
@VeniceBeachMoms	human
@LizzMG	human
@ankitdmittal	human
@IMASFI_FATHIMA	human
@TheDepotBakery	org
@deeOHcee423	human
@mrburchcafe	org
@MomsInPortland	human
@taysmithent	human
@FeLoKbRe	org
@sohamolina	human
@jossiejimenez	human
@TiffyViffy	human
@lopezainat	human
@JustBarbarella	org
@PaulMartinsAG	human
@lovenab	human
@Lou_chan_	human
@Luinluland	human
@RobertosSouthpo	org
@GingerTapas	org
@Blairyroo	human
@cjstepney	human
@Sya_Salvatore	unknown
@CantStpDaFuture	unknown
@JocySkylar	org
@aguuustin	human
@brave_iam	org
@leticialidyaho	human
@mllayland	unknown
@josediazromero	human
@M3YCh13	unknown
@wilfundal	human
@OrderUp_PB	org
@meistumz	human
@Ambamlynn	human
@DannyResearch	human
@Alkaaddy	human
@tomy1224xoxo	human
@SGorchynski	org
@RDN_Mama	human
@L_ArtNinja	human
@spaziomusicapv	org
@agryne27	human
@myHealthyOC	human
@lulzsec501	human
@InnerEnl8tenmnt	human
@StefaNiall_	human
@kakumature	human
@Samantha_Jaikar	human
@DJSKYFALL69	org
@jannisescott	org
@nilushah	human
@Hbhm_Brick	human
@rowiro	org
@wiiLd_wOrLd	human
@johnphilippe	human
@elyamsye	human
@lashawnb	human
@INFOGRAZ	org
@Jarrahjungle	human
@jiromolina	human
@AlbertPasceri	human
@JenRoss604	unknown
@onestory151	human
@yok_pinkylapin	human
@RoniNoone	human
@JuaniitoB	unknown
@TheDer	human
@megunadi	human
@AbeerZaidi	human
@ChowOrNever	org
@LackingPattern	human
@TheDiaryIssue	human
@IamMissMcBeauty	human
@IngeMuchan	human
@chemicalcammy	human
@Will_and_Vics	org
@LuellaAndJune	human
@healthbyhill	unknown
@disquefoodie	human
@ChristaChmb2011	human
@hanycantik_	unknown
@whistleandbango	human
@emkapink	human
@anthonyremedy	human
@lohas_street	human
@AndreaWbffPro	unknown
@andy_war	org
@FeezahGeek	human
@vickivong	human
@rschaefer653	human
@timkour	human
@Kahvaltikulubu_	human
@therealholleywo	human
@designercottage	human
@MichaelSeymourX	human
@TenPennyPGH	org
@leavethemoney	human
@FGholson	human
@cem_luca	human
@lightcnd	org
@sarCASCAM90	human
@4nhq	human
@millai81	human
@brokenstrings	human
@Sieqa	human
@HarborViewMV	org
@twittacity	human
@jahanban	human
@faizal_mok	human
@OfficialRazDee	org
@themagicbullet	org
@filippogigante	human
@MomsInCharlotte	human
@justgotrob	unknown
@Good_Job_George	human
@ariel_sit	human
@Adeline807	human
@ElCortezLV	human
@ali991	human
@VIR_AN	org
@mojokitchenavl	human
@MomsInSeattle	human
@MomsInDC	human
@Croco4	human
@KOCODave	unknown
@PinkDelight1	human
@kate_re	human
@Frisky_Lemon	human
@BackBayBistroNB	org
@thelittledoorsm	org
@MoscaStudioLLC	human
@MrVer5e	human
@thariiverzogene	human
@MazapanToledo	human
@stefanogrande	human
@Omarcin1974	human
@NilsonTeacher	org
@s_canivet	human
@MsElleTee	human
@killah_kemst	human
@beaunjtb	human
@scottishgrocer	org
@VGSrestaurants	org
@DearEstephanie	human
@cafeconlechechi	human
@MeMeeMia407	human
@KVKeefe	human
@lilchichken	human
@ciboatlanta	org
@WindPixie	human
@ShugaPlum99	human
@Muckrachlodge	org
@un_de_plus	human
@nazrinajoosub	human
@VergilRuaro	human
@bahiacongress	human
@yogiepra_tama	human
@durgadasari	unknown
@crazy_lens	human
@MaryE2146147	human
@deSouflesse	human
@enterprisehotel	human
@jansen	human
@LesAssociesN8	org
@ToroToroMiami	org
@TopofWaikiki	org
@DreamBIGwME	human
@SharonNovak5	human
@bloggingmomof4	human
@SailsRestaurant	org
@saltwater_happy	unknown
@Elly_LinTang	human
@ffhpapot	unknown
@khirstelz	human
@rodog93	human
@Zah_z	human
@MumuNgui	org
@beccolquhoun	org
@fyeahmieko	unknown
@OldAgeBook	org
@AriGanguly	org
@AndreaReade	human
@CorreaFilhoES	human
@yoko7878	human
@JustPlainOl_E	human
@7030raw	unknown
@aLexXxMag	org
@MOBlunk	org
@CamiloArgenta	human
@ChinaAhPek	human
@DOG_CHIEFLOVER	human
@SCountryChaos	human
@Maya75010	unknown
@iamsancho99	human
@CurrentChicagoW	human
@Ana_Gomez_O	human
@FoodbytheChef	org
@CreepyAber	human
@curtisbrwong	unknown
@FiedlerNeil	org
@SimonTurts	human
@B0nb0n920	human
@tondacosta	human
@SirkMitja	unknown
@MorraRecordz	human
@THEGRIZZLYGRILL	org
@dogfishicu2	human
@fresasconchile	human
@mynimage	human
@WattsUpDan	human
@Manchesteriss	human
@celebrations	org
@FritosnFoie	human
@CindyHval	org
@slabya	human
@mklee936	human
@FoodMoodStories	org
@princessbclaire	human
@heatherlyxo	human
@henphilli	human
@lenafujii	human
@yillian_enid	human
@degren	org
@AnaCRivera	human
@GIR	org
@jayviemar	human
@SteffenBusch	human
@SayWellness22	org
@GoAnimalNSave	human
@InYourPantsRon	human
@HansenSatalin	human
@chip_tolentino	unknown
@MiTomatina	org
@EATNotDiet	human
@JaunitaCornell	human
@IAmAphroditeOz	human
@MeMoInteractive	human
@Mamako0	human
@kyuhyun_holic	human
@AnaTTMartins	human
@HendraHarianto	human
@Jazz__Mino	human
@FuaddYusof38	unknown
@missiondiner	unknown
@lucianaoff	human
@kyyykelly	human
@elfabuloso85	human
@Cha96Nisa	unknown
@YogaEatRun	human
@SilverPalm75	human
@KaraKJMiller	human
@Khiimfinity	unknown
@cherylnajafi	human
@thierrydehove	human
@FunFabDelish	human
@krystanBasselin	org
@cndytantan	human
@Jamie_Wesley_	unknown
@RoyCBiv	human
@KarlitaGeovana	human
@KimberleyAshton	human
@nadya_cyrus	unknown
@AussieDogCare	human
@FaizelMiniboy	human
@prinzezzcharmin	org
@tylerrotondo	human
@virginiamadrid1	human
@CityBizRT	org
@fedenika13	human
@Lextinks	human
@randolphgroup	unknown
@MightyMikeSA	org
@ClausenKeat	unknown
@Erickascarfino3	human
@katyfontanive	human
@writerscanvas	human
@LuvinglifeGFGF	unknown
@jessica_tyas	human
@SongwriterJAM	human
@Erngii	human
@kayleestier	human
@MomsinSanDiego	human
@mew_azama	human
@kreitlo	human
@Golden_Isles	org
@RajivTandon10	org
@barboru	org
@cRaphy88	human
@gileverest	human
@Elemil	human
@jouna68	human
@lindathome	human
@LoveJacCards	human
@ArkiJoelQuirino	human
@sawasawa0405	human
@MarianaSoaresss	human
@JanineBS	org
@SixtoyLucia	human
@LauraChlela	human
@JueLiang	human
@kickasspretty	human
@ferryxferry	human
@Alfie_19	human
@Meh_1391	org
@longhornlukeTX	human
@jimmy_jaxson	org
@LeBilboquetSP	human
@scottocarlo	human
@MariaChiaraPedo	human
@musingsfromme	org
@Kislings4wings	org
@Vanss472	human
@LeCreusetItalia	human
@ampersandmoi	human
@deeprestaurant	human
@TheReaLEdaluv	human
@douglasssteve	human
@Ali_Fareed	org
@RingMeUpToo	org
@Phil_561	human
@therawoasis123	org
@matejalicious	org
@christineavanti	human
@hungryadventur	human
@fgaileysnell	human
@RobinModeOn	human
@iAmUrmi	human
@PoorGrlRichLife	unknown
@SuburBeautY	human
@rev_7	human
@AnfalGsp89	human
@momstriedtested	human
@rackelo16	human
@Khakrongcheep	human
@chris_noland	human
@tkmoochan	human
@ATLBravesGrill	unknown
@LeDeniche	human
@tbag1402	human
@_aixinDIANA	human
@THarbourClub	human
@health_planners	human
@booowtiiie	human
@jwaldorfine	human
@ttwrite	human
@hommatamam	unknown
@5215Main	human
@rarxlarx0515	human
@vfreile	human
@YenlinAng3	human
@bencartwright83	human
@_Mugscafe_	org
@berninislajolla	org
@MissNovember777	human
@ZKopens	human
@gerwinvic	human
@tcfblogger	human
@WalterA_PintoC	human
@ItsME_JayeL	human
@LindmarksFinest	human
@mimi_machfud	human
@MarinaSamveljan	human
@CrunchMyWorld	unknown
@evemist	human
@sleepyhelen	human
@2day4u2mw4me	unknown
@epicureanedin	org
@TweetsNowIn	org
@BambiNoMuere	human
@frecklesxlace	org
@Ksu_MissK	human
@FramePretty	unknown
@theShiho	human
@Ediffied	human
@maisonpardon	human
@bigfrankjnr	human
@OptionsCoffee	org
@PuiPigaboy	human
@tjof	org
@DeathBuffon	human
@hotcafeyalgomas	human
@GanstarEventos	human
@wi11iamsmark	human
@scrdhrt	human
@personalmusse	human
@AjiezloveKing	human
@MassiveFoodie	unknown
@__risa1105	human
@janakhnayser	unknown
@WalterBishopFAN	human
@toyaLo	human
@CTCCrazyTill	human
@ldnrestaurants	org
@MrsT_07	human
@FairTradeFTAO	human
@t0rton	human
@allinadevi	human
@MrandMrsTplus3	human
@ChristineCarrUK	human
@kasiavermaire	unknown
@FitAlly	human
@LvNsSn	human
@Thrival_Orlando	org
@omoshiro_nQfs0	unknown
@SilencioHotels	org
@Roxacmu_	human
@CaiPalmiter	human
@RomanZolanski95	human
@MikiMikiKoo	human
@micanastafam	human
@Eullababydoll	human
@Practicalmedia	human
@texasgrillbh	org
@mjstack	human
@cremecafereno	human
@KikyHardiana	human
@ferdinandjuntak	human
@kuri_akb	unknown
@bakery_bingo	human
@Niki_Kesh	human
@Holdenscatering	org
@EvelynSaame	human
@huichingng	unknown
@AhlaAlamsyah	human
@EMiLY940812	human
@Belovedweirdo	org
@t0419_	org
@BeldenTaverna	org
@EatDressGo	human
@GiochidZucchero	human
@DressdLondon	org
@dianadaros81	human
@MThackerRealtor	human
@thebeautybloss	human
@ChichiandTofu	org
@travelpics_ml	human
@ElateMagazine	human
@juraganpongo	org
@CanterburyGhost	human
@_tamatm_	human
@joaojunqueira	org
@charmcarreon	human
@syazwanHairey	human
@Doi2210	human
@thebagelstore	human
@Barneysmiley	human
@FabWarriorMom	human
@Pinkgorilla1	human
@angadchabba	human
@MizVanezza	human
@AliaAlmoayed	human
@bakerbetty	org
@davidheat	human
@angelagpugliese	human
@MSDenmanStreet	org
@JJlChan	human
@StefaniaMarine4	human
@dstav1	human
@iamdanmichelle	human
@earthcandyarts	human
@Hamptons	human
@SavingThyme	org
@sorellasorella1	org
@DesireeMGray	human
@hynavian	unknown
@FailteFeirste	human
@CaliMspink	human
@VeryHungryTrav	org
@LeiAtley	human
@runozon	human
@TheEightHours	org
@NicolePercy3	unknown
@phileats1	human
@kyochon_KK	human
@tecnora	human
@TheBookOf_A	human
@kenchanFB	human
@Ttiaona	human
@arar789	org
@NomadHabibi	human
@just_sharyn	human
@KFC_AFRIDI	org
@transverseaxis	human
@RUPALIDEAN	human
@ms_mui	human
@Hakimbolism	human
@TheYogaCloud	org
@andrew_amiel	human
@EssenceComm	org
@shyuenmay	human
@MUUUBLANCO	human
@ARNELLtamayo	human
@RomneyParkHotel	org
@cowcrumbs	org
@BicentConcierge	human
@kichan515	human
@daneeyw	human
@VanCityRT	org
@GoldenPalaceHtl	org
@trustorybro	human
@SkinnySprinkles	org
@mmBubbleTea	human
@whocooksforyou	unknown
@dolcelounge	org
@AnjaYogini	org
@farman21	unknown
@IamAbongwe	human
@smile_rika0904	human
@Nikki198705	human
@SwatiBansalRao	human
@CHENCHO_LOPITOS	unknown
@EvaYummers	human
@ClovisChamber	org
@crazyholiday	human
@BoudoirGourmand	org
@SalinaShariff	human
@wildplanetfoods	org
@ashuragav	human
@DenissseTitong	unknown
@dyoungbigmouth	human
@SamSketches	human
@DCPAGirl	human
@tf_designer	human
@AmeliaaHermawan	human
@stevepanda	human
@RynNicMorse	human
@bistroaix	org
@_ross_	human
@msyensiew	org
@AshleyDlite	human
@RegineValora	human
@ansarbasha9866	human
@KOI_OFFICIAL	human
@lindstromphoto	human
@beth_harris4	unknown
@rodriroca	human
@darisholy	human
@a_march	human
@UniqueTrinkets	org
@craigmccune2	human
@XOVOamourx	unknown
@sylviehill	human
@cafe_route	org
@emoh	org
@CptFussybuckets	human
@alexandraowen84	unknown
@AiyoRach	unknown
@shannalynn_	human
@HuntsWeb	org
@mcella15	human
@Tarbouche_Cafe	org
@kristincaronna	human
@Gladys1226	human
@Jaymesbell	human
@Kits	human
@MarvyRieder	human
@alter_ego2101	human
@Irish_Guy78	human
@BlazeBurgers	org
@LoraJayneN	human
@hanaa_zaher	unknown
@noshfolio	org
@Dirty_Forty	human
@PablooCasla	unknown
@sulemareientu	org
@dedutch	org
@DeliciousSTL	org
@Dasshlee	human
@whatkellycooks	human
@MichelleMiki123	human
@harp181	unknown
@helenshin	human
@norielangelo	human
@VilleTurismo	human
@yosoyyosef	human
@nicoleescat28	unknown
@tasje64	human
@Aquariussc	org
@GetDownMoses	org
@egregiousfoul	human
@DrGtrombone	org
@TammySigond	human
@The_iphone_guy	human
@rmillard13	human
@SloverLibrary	human
@Derkgphoto	human
@DonnasBlogPosts	human
@enaena24	human
@Joannenyc5	unknown
@juliabrandon23	human
@CallmeMsThorne	unknown
@TocaHelsinki	org
@Earth_Balance	human
@esmarvict	human
@BigBreakfastBec	org
@Local_149	org
@aaataiko	human
@sickheart5	human
@Rouliberation	human
@WaxIllustration	org
@SOEPSHOP	org
@GlitterPants04	human
@ShuaylAlotaibi	human
@SamBobino	human
@Kimmy_EscMusic	human
@JenSSTID	human
@RanaDurham	human
@Boise4Lunch	org
@MarieNgn	human
@Tiger7sTrainer	unknown
@coraline_ch	human
@noe_eb	human
@dh2anjay	human
@filipina__love	human
@DeniseAustin_	human
@toastilkley	org
@lupinosdonno	org
@TOTNationDC	unknown
@tamara_cesar	human
@emmaasokbarte	human
@SugaryChic	human
@april_dcannon	human
@tinaleung	human
@bebeaznRSX	unknown
@vickycerqueira	human
@LoveJaneFlowers	human
@Slashwaterboy	human
@MrHavisham_	org
@Tu77le	org
@ElyPinktrotter	org
@senseiadrian	human
@aistonkoraka	human
@chrisam01	human
@JupiterFleet	human
@Helen_M_Designs	human
@FoodTruckJoni	human
@ErrickPT	org
@PDeeandra	human
@herbal_dewayne	human
@roelpascal	human
@melhayes1	human
@JoshChurcher1	human
@EbonyJLewis	human
@Sunnechind	human
@ascensioncoffee	org
@TinaTamale	human
@MerryGunawaty	human
@outbreak91	human
@ArdeeAquino	human
@Imstillwibo	human
@michaeljohngil	human
@inthewind81	human
@zanabenitez	human
@CezarsCafe	org
@NestleLaLechera	org
@tsuchirock	human
@CCSocialOnline	org
@myfriendslike	org
@GafferL	human
@chippychua	unknown
@Niveche	human
@LightbluePasta	human
@BarryEichner	human
@2CubanGirls	org
@BrownovoGibanje	human
@tylevision	human
@SwCatwalks	human
@PhoebeNaomiSM	human
@Cristian_Bric	human
@ClaraToneRecord	human
@frascamastro	human
@_ToniaStrong	org
@ZoesGlitzerwelt	human
@HussamAbdallah	human
@AndiamoItalia	human
@TheNObama	human
@Herba_Laur	human
@Cbellomarino	human
@EmpanadaGuy1	human
@adhilaxmi	human
@garyboi84	human
@colinjalepengos	human
@HHansel	human
@ShahSocialMedia	human
@BystroDubai	org
@WineandGlue	human
@MaNu3L01	unknown
@EXILE__news	unknown
@DannyDeux	human
@duetbakery	org
@BrookeBCox	unknown
@SylviasSparkles	human
@StefLyn29	unknown
@mcleangemma	human
@BellaJLtd	human
@Stayn2True	human
@logan_gina	human
@ellyguunz	unknown
@TraciLewis79	human
@AlexLoos	org
@JacqGobaco	unknown
@Week_end_Bot	human
@ShulaBurger	org
@Oh_THizGUY	human
@fairuznabylla	unknown
@GeorgeCely	human
@winelover_bot	human
@Nursecawthra	human
@itsjust_anna	human
@OhYeaItsSteph	human
@caleighPR	unknown
@NaturalDivalove	human
@CoventGdnTube	org
@Heather_McClees	human
@jack_son_five	human
@_sedayilmaz_	human
@3ShipIntercept	unknown
@sounddesigninc	human
@HotelBWSahil	human
@GiadaBrit	unknown
@mellowtoo_hype	human
@nikolkara	human
@Haziq_hisyam	human
@InvitingHome	org
@TortillaLand	org
@Sherkyboi	human
@littlestgator	human
@TO_foodie	human
@JamesInIraq	human
@Asking_K3lly	unknown
@shahrul_ikmal	human
@jspotnigarma	human
@loveboyfriend5	human
@lay_kevin	unknown
@61lang	human
@yogawithyana	org
@tugceeyazar	unknown
@BimbosF	org
@lorianafin	human
@zengrrl	human
@Xraggaamuffinx	human
@LiteratiCafe	org
@ERICgMORGAN	unknown
@anaawoods	human
@KellyLSharpe	human
@vinovinobistro	human
@RTWkatiedays	human
@CELEB_101	human
@MeMMontreal	org
@GoldenMalted	org
@justin_barnes	human
@theglamourist	human
@hollieprestonX	unknown
@boringfoodlog	unknown
@AlifaEglantineA	human
@BrummelBrot	human
@jessicaclairehu	human
@theycallmeCARRY	unknown
@AvilaElRanchito	org
@urfriendalberto	human
@dondinnematin	org
@HaysConstruct	org
@VERDE_lounge	org
@seina_tsunoda	human
@ShrimpNGritsCHS	org
@AcademiaBarilla	human
@framb00s	human
@angelasencio	human
@colettaandtyson	org
@liyanagany	human
@mixberries01	unknown
@TocHostels	org
@InVegeWeTrust	human
@IamGodofredo	human
@DirectorOA	human
@amby_bumble	human
@didijacobina	human
@BIOTIFUL_DAIRY	human
@FunkyKitschUK	human
@PlatingsPairing	human
@DiditDeeS	human
@NayibeDR	org
@HotelSavoyPRG	org
@jooleea1	human
@BrigataBuccino	human
@BbloggQc	human
@JadeHeleta	human
@hotchickarmy	org
@AtlasTrainers	human
@MR_radorii	unknown
@Vasiliana_x	human
@jbonz	human
@eagleradio	org
@Chrisbobfletch	human
@KauaiSA	org
@DJ_Dimez	org
@mvmking	org
@DanZwicker	org
@norbertjune	human
@Thidylicious	human
@ivyb3773	human
@saintjohnhotel	human
@JonathanJJudge	human
@l0la_G	human
@UKBridgeTeacher	human
@Ortega	org
@JamieJahnke	unknown
@abstraktnata	human
@RebeccaDaly94	human
@sarahisahipster	unknown
@Lkamau	human
@ncsulilwolf	human
@chicksca028	human
@yavuzhoca61	human
@SayWellness4	org
@BCTaste	org
@kasi_egu	unknown
@Domz008	unknown
@Emixxxe_vh	human
@MaebelleVarron	human
@hollyyannn	human
@ravenfiji	human
@WOBArlingtonva	human
@iMLiew___	human
@embellishmints_	human
@PrettyInPistach	human
@__s_h_a_d_o_w__	human
@SabinaSweetRice	human
@Date_Research	org
@DblELLEBakery	human
@Maureen_Suazo	human
@vixycarmichael	human
@jessyjesmin	unknown
@SocialCopy	unknown
@danreyesII	unknown
@Elmer9790222	unknown
@verseoogst	org
@jbarnofski	human
@Lay_kry	unknown
@lindasevans	human
@emeylie	human
@naaaaako87	human
@nanasgoreng_	human
@JumboboH	human
@ozcantu	human
@MomsInOrlando	human
@Crissy090191	human
@camilacervio	human
@GHETTOTVPT2	human
@PetiteTexas	unknown
@wetherbyhour	human
@tra2ce	human
@93Rachael	human
@Eugene_Okumu	human
@mariatere_10	human
@amnaholic	unknown
@heydriana	human
@MrsCashMommy	human
@FNightlife	human
@chiara_trilli	org
@DJ_KahLua	human
@Marl_o	human
@carlosdrinks	human
@thehealthfiend	human
@barbiborrajo	human
@AMG_SS_SRT	human
@sukibomb_	human
@MizYolz	human
@akhmadsy	human
@TasteofNS	org
@OkenwaJudge	human
@BCbrews	org
@delilahlola	human
@kiannadarling	human
@51monHarr15	org
@mihomu34	human
@ElevationUAE	org
@eileencdb22	human
@StevieColston	unknown
@BabyBlueOrion	human
@Jpaulsavvy	human
@GalsShopper	org
@JanaSpi	human
@love_belfast	human
@STOUTSeattle	org
@Whore_Beast	human
@yolandesaunders	human
@otelciyim	human
@loonyjuie	human
@beautybrite	human
@MyTabletCaseP	human
@luluhypr	org
@NinosPositano	unknown
@fredersenyeban	human
@PlayboyP	org
@FlipMode54	human
@effyzhang_1210	org
@KoyzinaKafe	org
@Club_SEGA	org
@modjoo_	human
@EatingNaplesFL	org
@blackhoneycake	human
@DarrylDwayne	human
@KLAMMFASHION	human
@spring_bee	human
@crimson_moon69	human
@stitchsarah	human
@black_s8	human
@bmaryb79	human
@Jacsonthe8th	human
@EarringDiscount	human
@Miss_T_Hill	human
@teamdog05	human
@vicky_yin	unknown
@1MermaidBabe	human
@livligahome	org
@brent_carvajal	org
@aefrosyni	human
@ChefJamieStone	human
@rosscathcart	human
@ka2i3	human
@CindyyAmelia	unknown
@heather_ogorman	human
@itantiques	org
@RiccAndrea	human
@karinadresses	human
@Morganism12	human
@Conshy_Stuff	human
@innertattoo	org
@ugurkiral	human
@LindaParigi	human
@marisol2821	unknown
@Alixday	human
@carlodgbiana	human
@J_Kilgallon	unknown
@daisyefthymiou	human
@_RetroGaming_	org
@ZiziLibarelli	human
@Blairful	human
@pinyapoenya	org
@Isaporidicasa	human
@fatloss_club	org
@christional627	org
@phnx_aficionado	human
@TAJIN_USA	unknown
@WalkersGrille	org
@oystersnpearls	human
@dalgoongjun	human
@TulungagungKini	human
@p3arld0ve	human
@AAsira392	human
@WiendaFirlida	human
@threewilliamsAU	human
@RosieeeeTan	human
@misssamee808	human
@NYCFoodGuy	org
@meow_eg	human
@milou1983	human
@manojpallai	human
@JanieTheresa	unknown
@UrbanButcher	org
@LauraGrevina	unknown
@michaelFranks23	human
@breadandwineIL	human
@Chabretsova	human
@dhavalvalda	human
@jaspacio	human
@stuckonsweet	human
@_TASTEMAG_	org
@FeeManon	human
@AaronF529	human
@LuckyPieLodo	org
@orquis21	human
@Noshbites	org
@FlashTrashMall	unknown
@Top_Nonprofits	human
@ayko_k	org
@gabriellekwang	human
@eejay	human
@valeriew272	human
@kuliahdijerman	unknown
@NutritiousNow	org
@EllieM5	human
@igobyjoesig	unknown
@Urban_Nick1	human
@CarloOrvieto	human
@bridgette__ann	human
@ChristalSJ	human
@nene_sparks6	unknown
@Legs826	unknown
@fayedyg	human
@lang2birrey	human
@daintypig	human
@StevenStuts	human
@xoDVF	org
@OmarMendozaUNT	human
@CandidKathryn	human
@netty_kawai	org
@marimmi33	human
@ExelbyFoods	org
@junejohnnie	unknown
@raneecute	org
@Bocca1981	human
@KawaiiHugz	human
@3giftsofheart	human
@Miss_Nanj	human
@loladealmeria	human
@annadaneau	org
@alwaysapache	human
@HappeningHarlem	org
@Angel_VieSlim	human
@AaZhaw	human
@SebEwaBeach	org
@ChrsLove	org
@Renat_Sky	human
@SDaneke	unknown
@Chiniriz	human
@purplefitness	human
@SoundSystemOne	human
@gerztwn	unknown
@GraybarCanada	human
@SincerelyBliss	human
@Meltgrilledchz	org
@adi_vasileva	human
@macchialina	org
@virgilkami	human
@catarinaa90	human
@eatmyselfslim	org
@sohoque	human
@chelmichellee	human
@pingprart	human
@whiskandheels	unknown
@__Yummy__	human
@Amy_Juiceplus8	unknown
@StephTaube	human
@paulaburton7	human
@tkenny46	org
@FurkanTurkay	human
@adfx	org
@LukeVillegas	human
@CSunshine94	human
@wiwinruslan	human
@lyft0ff	human
@handymacd	human
@MayedBH	human
@imasoradrill	human
@Parkside_Perk	human
@Tan_Ban_Bby	human
@glenibanez_	unknown
@FirdyAdkins	human
@ChristopherAmie	human
@acaigirl	org
@chefjamessmith	human
@ValeriaHastings	unknown
@Stylewka	human
@omstebeurt	human
@envtaino	human
@eclectica8	human
@lanziiieee	human
@AliciaGal7	human
@cluong4	human
@TheNomadScrolls	human
@BigSliceApples	org
@infinite_smiles	human
@FeedMeThat	org
@florencewijnen	human
@Kim_Nain	unknown
@errolljames	human
@Weightlosshour	org
@SvenStevens421	unknown
@Neurogistics	org
@ade_msidiq	human
@rinarishaa	human
@FoodCalorieism	unknown
@ConnectGFree	human
@MarcelaTeti	human
@MilesAndBandaid	human
@Hidayah860925	human
@WhereToEatSG	org
@egoasavakit	human
@rita_picarra	human
@GayLifeofVinVin	human
@dannavenutti	unknown
@LisaKerr68	human
@alex_durston	org
@shusse_uo	human
@befitDC	unknown
@lilfaerie	org
@YunHoo	human
@mario_kol	human
@Thegardengrille	org
@jindungs	human
@ChefSamanthaK	human
@RCRoseCamille	human
@LiveHolic_Ai62	human
@pfcsamoa	unknown
@shafielovesfood	org
@Megan__Martinez	human
@mytasantiago	unknown
@DemosAmor	unknown
@Beni_Bonnietta	unknown
@bradiversity	human
@OvinteJax	org
@BlightyCoffee	org
@ArzuUlubay	human
@TuanMario	org
@JerryCarrillo1	human
@Karzi_k	human
@Bursteardrum	human
@traces0fme	unknown
@GNCCanada	human
@inna1903gr	human
@FoodandFingrnls	human
@123broodjenl	human
@JessTappin	human
@boris3324	human
@aaaasako1203	org
@gorira_udo	human
@PaulJeffries4	human
@Decoraire	org
@BujeraHseUdai	human
@QueenTutsi	human
@andrewwywong	human
@AlexisElisa	human
@LunchBoxLDN	unknown
@JulianaYaz	human
@Minela_J_World	unknown
@htantweets	human
@zleepinghotels	human
@SeeSenyour	human
@NoAbbiamoWiFi	human
@Mar_Ghelz	human
@DrWarrenWilley	org
@nozawassance	human
@My_Mwikali	org
@Marilynzakhour	human
@JorgiyoGF	human
@daviosboston	human
@mmitro	human
@HinanuiParker	human
@_Angeli_Va	human
@SteaknShake	org
@BlackFinnGrille	unknown
@LA_SPINS	human
@BuddysNutButter	human
@GW_78	human
@CEEiAM	org
@it_yourself	human
@weluvnagaraya	org
@SebyMi94	org
@gtrejo1	org
@CPatrice	human
@Parrotchicbeach	org
@IglooFoodEquipm	org
@khankhronicles	human
@mynameisDadanT	human
@yodz25	human
@VirginieSZG	human
@richeats	human
@SawayaLovers	org
@hayleysellick	human
@JustSayinPage	human
@bakedchicago	org
@sarahedodd	org
@swaaggyx3	human
@tloinaz2015	unknown
@IBootstrap	human
@timecardexpress	org
@Panoocha	human
@adrianacesar	human
@Createh	human
@ChefchaconbayCA	org
@deblovesphotos	human
@TxBeef	org
@Americanafood	human
@CatharinasR	org
@Holly_GoGoGo	unknown
@EvaWines	human
@hellotofit	human
@PaulFagan	human
@cnsugrue	human
@Guheen	human
@LinZ_Diane	human
@crisAZF	human
@georgie_glass	org
@USPcrew	human
@HayleyBabiieBoo	unknown
@mafegomez	human
@Mr_Bros_	human
@AustLZ	unknown
@simpsons_rest	org
@yilingtitoo	unknown
@rajkamalaich	human
@TreeTopInc	org
@TracyMemoli	human
@3G1M	org
@rottenrage	human
@PBUNNIEP	human
@GodBlessMe__	unknown
@waughwaugh78	org
@veybitoy	human
@MarvinGiam	unknown
@ugur_ari	human
@BornLippie	org
@JasmineRabunal	human
@JuSzilagyi	org
@Smi926th	unknown
@shiwave	human
@Royalered	human
@tybraucht	human
@kyojeong1202	human
@EmEvanko	human
@JillFoodie	human
@Tonys_Studio_B	human
@Yolo_Restaurant	org
@m0llyt0belly	human
@Brickyard_Essex	org
@BaddJolie	human
@ChaiJovial	human
@xx94mu	human
@yeseulc	unknown
@alpierrot	unknown
@estef_bautista	org
@JASON_CHILDERS1	human
@KathyAlAbyad	human
@JujuDurham	org
@DomGeoghegan	unknown
@azreen_azizan	org
@elsychan	human
@TheLPCafe	org
@nimirova	human
@McD_HRVA	org
@aKalDream	org
@fohfolies	human
@GOaUSTEn	human
@Dread_Confusion	human
@teza_29	human
@BakeNbeMerry	human
@pollymagoo7	human
@AnArtsyAppetite	human
@Joaopmo96	human
@sarawrxo	human
@HadzrinII	unknown
@HelgaWolter	unknown
@designrock387	human
@HookahVixens	human
@djMASA_Y	human
@_Coco_Bella	human
@dvana_dva	org
@dendrolivanogr	human
@CalzoneNinja	human
@mlmoxy	org
@effjayhat	human
@tray_c_leung	human
@SandsHotelMarga	org
@dawcio930	human
@MJBank	human
@yogaclubbers328	human
@JokerzJinx	org
@TheBellatStow	org
@AmiraFoodsIndia	org
@EricaKirstin	human
@karissasalonga	human
@jenjenmon	human
@Juliemcpher	human
@_jweka	unknown
@riyasinghluv	human
@joanneku	human
@MaddieStamp	human
@CE_Couple	human
@gizemipar	unknown
@lisasamples	human
@Millebear	human
@justshirlay	human
@jelleyelle	human
@TNKidsFoodPorn	org
@martisanne	human
@EvanHennessey	human
@Me_AK13	human
@TinasChicCorner	human
@slavasolodkiy	human
@DDLJohanna_20	unknown
@LuckyPhat1	human
@WatermarkTO	org
@yancytrinidad	human
@AltoViva	human
@Divyeshh007	unknown
@LumosNox_sbr	unknown
@maromiki	human
@abw2	human
@dreyes_	human
@happy_moh	human
@nardioutdoor	org
@lisamerson	human
@expique	org
@TheBreweryNYC	org
@Jets0000795	unknown
@heartbeativy	unknown
@ACamanelli	org
@MadisonSkelsey	human
@fortstand	human
@ajcholeng	human
@kcsowriter	org
@alexpascual	human
@andre0id	unknown
@Bo5502	human
@Raffy_TAKEOFF	unknown
@DebraToddJordan	human
@CandiceShari	human
@DonMiyamoto	org
@msclemenza	human
@raniwibowo	human
@kei_EunHyuk	human
@EmWhitham	human
@Nia_Zamorita	human
@_Neeta__	human
@DelmonicosNYC	human
@estherooi1410	unknown
@FRWLx	human
@VeganSara	human
@HoneyHussh	org
@MgPenelope	human
@norecipes	org
@danvern	human
@ZonzoRestaurant	org
@lucertola_uno	human
@b_greeny	human
@manicindiana	human
@hwy199antique	human
@AmercEtAy	human
@haruka228	human
@Clark_Dawson	org
@drkayotica	human
@BarrelGrill	org
@MissOlivia22	human
@doanerfide	human
@SoulAberdeen	human
@amypie71	human
@Ririettte	human
@SLagaja	human
@TheStephGlover	human
@suryhern	unknown
@WRFN1025	human
@ATE_Street_Food	org
@tuffords	human
@TheSouthernSOS	human
@mzkittyox	human
@l0x666y	org
@IronHorseVyds	org
@MiaElodie	human
@mlle_alito	org
@queenkizzy585	human
@SandyHeadtke	human
@Hala_Magazine	human
@GateGuardian	human
@Cooking_Anthony	unknown
@JamesPunter	human
@Alazae713	human
@dvbgregory	human
@Tashamlb	human
@Kacymocha	human
@EatsPlaceDC	org
@europeancanteen	org
@nuky_puspa	human
@WorkplaceOne	human
@SilvaY1	human
@donnavdm	human
@DiscretionBrew	org
@deeniece88	org
@HoustonMoms	human
@heartsinmyoven	human
@Bentleys_london	org
@human2o	org
@counter_culture	org
@CammiHutton	human
@007Bnd007	human
@nadrojnamor	human
@GracePlastering	human
@ZureenJazlina	unknown
@kumquat8	human
@fabiokotinda	human
@Kleinstadtpoet	human
@fox_wa_kitsune	human
@BrittanyBrander	human
@trainersonsite	org
@HoneysSitNeat	human
@Chrisp_Street	org
@Sambazon	human
@AlfInchaustegui	human
@TagliataLondon	human
@JoseA_Collazos	unknown
@winlyemay	human
@marzacapistrano	org
@mtjmanalang	human
@shubham0987	human
@ACooksCanvas	human
@zaimokumachi18	human
@SOFRESHMARKETNG	human
@MattRichardsBMX	unknown
@kalymew	org
@MilBarrie	org
@adrian_r87	human
@taszoespresso	org
@LPNews1898	org
@JuraganTasKW	human
@BrittMiles87	human
@loveakogi1212	org
@SurbitonShops	org
@MartianDogfight	unknown
@staciemurtagh	human
@FlorentinaBL	human
@Cali_Reign	human
@FollowbackTorch	unknown
@YahoooMel	human
@SaffronKumquats	org
@WEARTOGOWTG	unknown
@s4mmi3x	human
@heysjaarda	unknown
@TheSilver_Sword	human
@G_Pull	unknown
@_CocoaBella_	human
@steveorenos	human
@KK__JJ	org
@greenwayhotel	org
@DiegoDomingo	human
@mizzkayz	human
@pelipeli	human
@donidp	human
@cheenyf	human
@Mandemvfood	org
@arancinacp	human
@cintaalexandria	human
@richardbflores	human
@Wow_MaIKo	unknown
@FamilyHungry	human
@rabbitscafe	human
@soryutwo	human
@JudithFronton	human
@TonyBerber_	human
@_TheGrill	org
@AmeYuda	human
@sergiosaro	org
@RLDeals	human
@AlexShihTW	human
@TabareOrtigia	org
@shireen9	org
@BSwanginWebster	human
@angelito9271	human
@NutritionAust	org
@theimmagno	unknown
@ThomasMaurer	human
@sibgatullina79	human
@tokyofros	human
@jajasofean	human
@IngoEKobe	human
@breadandbanjo	org
@MakeupViral	human
@ronferrer29	human
@dolls123	human
@simply_khumski	human
@paolaenergya	org
@francosaycon	human
@CoachJAJones	human
@MrBrianPaik	human
@gaborszakacs	human
@PattyChocMilk	human
@lloydcata	unknown
@mrCraveBistro	human
@jenessicalouise	human
@YasmineN	human
@ace_james69	unknown
@LaurenTLane	human
@NandWbar	org
@asashingo	unknown
@anam_xo	human
@delwell66	human
@DesMoinesMoms	human
@Hotel_Americano	org
@lshedmund	human
@KiirstinMarilyn	human
@P_kana_pi	unknown
@SeydaCASKURLU	human
@littleaprendiz	human
@orangekitchens	org
@gabyvasquezec	human
@cath_e_rine	human
@BrunchWithTosyn	human
@AdrianVilla77	human
@CopelandsNOLA	org
@sthpinkz	unknown
@insideandoutnl	human
@DressnessBlog	human
@LaGringaMadrid	org
@enguyen03	human
@EarthShake_	org
@gracemoments	human
@maha9866	human
@talk_my_self	human
@Fayeza_Aslam	human
@IAMvipD	human
@DreamsCaroline	human
@EatAtJohnsPlace	org
@Wandymainevent	unknown
@Sexy_latina38	human
@iamWanaPosner	human
@yaustar	human
@miamcafe	org
@baconandbaileys	human
@AmeriPrideFoods	org
@julianyap4	human
@unesp26	human
@thenoiseofboys	human
@Mattybangin	org
@roland_anderz	unknown
@anamildre14	human
@mnegrillo	human
@Florene_Blew	unknown
@jdpmiami	human
@erinkmcox	human
@GroupOf7Chefs	org
@IlVoloHawaii	org
@TitaniumBros	human
@GoChaChaCha	human
@BettyNueve	human
@MimieKhalif	unknown
@doodeesmommee	human
@tendenciastv	human
@pizzscotti	org
@lorenitalanus	human
@homeespresso_	human
@VikkeeT	org
@onlymecare	unknown
@harpoonhannah16	human
@saucingthemenu	human
@STYLEanthropy	human
@crazyhomemakers	human
@VIPMaryLiu	human
@romyrenaldy	human
@gmaefabregas	human
@Mry011	human
@TravisEats	unknown
@smcdesigninc	human
@miguelparana	human
@andrewaforbes	human
@cokkali	unknown
@Heartajack	human
@rincondeika	human
@SculleryGlasgow	org
@LaFayetteTR	human
@FreelanceSEOhlp	unknown
@35Slon	org
@Dream4Jordan	org
@fitcoaches1	human
@fourno_panini	org
@aLunaaxxx	human
@ritchie_dee	human
@Roit1990	human
@23Kipe	unknown
@unnnu	human
@mayacastelloz	human
@addictedtotae	unknown
@EraCharming	org
@SayWellness1	org
@dancmejia	human
@haru_rinco	unknown
@100GRANDRAN	org
@AnneValkyria	human
@Reksanita_cita	org
@TheAprilLynShow	human
@danidvo82	unknown
@merr_ice	org
@NinoSulaiman	unknown
@Hensfriend	human
@dieselelephants	human
@pat_mau	human
@hair_factory	org
@Brklynchica	org
@GreenRoot_	human
@phatgurllove	human
@FreddyWanKenobi	human
@RadioZombieSan	unknown
@melodi444	human
@mammy649	human
@MileHighBiltong	org
@tyrone302	human
@Avas_Porn	human
@LookCookAdoni	unknown
@gail_diwa	unknown
@All_The_Vs	unknown
@nyla115	org
@HannahLopeman	human
@Yuiiiimo	unknown
@fatfellar	org
@Ninnisop	org
@iLoveBoxing520	human
@Urbanmanbas	human
@KLNWriter	org
@IlkimAkcabelen	human
@CKPublicHealth	human
@Huda_Al_Ayyaf	human
@chardfong	org
@playlindasurfer	human
@HostallaSavina	human
@hopefuladdict	human
@espyexperience	human
@jody4president	unknown
@ryanjonesphoto	human
@PrestigeDuMonde	org
@sojuicynyc	human
@jus2keeltyme	human
@Samid_angel	human
@BoracayTOURIST	org
@MMADesigns	human
@PrinceDerrickSG	human
@VOILA_	org
@abbeymill1	org
@mikeladeras17	human
@ScarletOnTheGo	human
@SweetBlackguard	human
@BoboSocial	org
@deniapriegue	human
@krnries	human
@WalterRivera86	human
@katzenmuenster	human
@mucho919	org
@ayyappansrini	human
@CosmosHolidays	org
@JasmineDLowe	human
@3bernie2	human
@NoogaBrunches	org
@Busola440	human
@ZakharIvanovich	org
@ryan_conran	human
@DealsCollege	org
@Hollywood_216_	human
@fudatzkee_bot	human
@2001annabeth	human
@X_Annickje_X	human
@TopPeakHotels	org
@CouponAdventure	unknown
@LifeOfJits	human
@SherryZoulfikar	human
@Metz20	human
@BellaVitaWorld	human
@CadensMommaBear	human
@kidcrash	human
@Matilove24	human
@jack_mier1103	human
@bubblybeebs	unknown
@JenMadeUlook	human
@Rogues_Roost	org
@after_special	human
@akocdyuhlie	human
@Yoshen12	human
@tjrcuenca	human
@lhezthur	human
@eMazingDesPlain	human
@CosImCleva	human
@Koda6L	human
@ronlac_ph	unknown
@JKouzina	unknown
@bellita91	human
@MamasVegetarian	org
@CinquecentoBos	org
@SyEliza	human
@Tae_Nicole	human
@FashionReactor	human
@BridgeRdMelb	org
@CiccioWater	org
@Seconds4Shirley	human
@JessBennett97	human
@WAZU1228	human
@Samurhighsam	unknown
@fleetwoodclancy	human
@HungaryBuddha	human
@MariaKrystyna	human
@MomsinKnoxville	human
@TheTaster1	org
@0730Stephy	human
@crunchacolor	human
@_dini07	human
@Alimetria	human
@HuntersHealthyK	human
@mikloshvanEgan	human
@celinejingyo	human
@Kaptin_Hook	org
@Nico_Florenz	human
@zall1d77	human
@hackneyplough	org
@gusto_caffe	org
@alisonb65	human
@thebignoodle	org
@ribbensetc	org
@LyJ_10	human
@goldenbrownblog	human
@DanFrigolette	human
@gsolpr	human
@SheilaKennedy	human
@b0nn3tt	human
@gundamtech	human
@GenerationNKH	org
@7ACKattack	human
@EmilyLauren77	human
@robina_ko	human
@lb20131003bot	org
@BeezyKaffee	org
@4livinthedream	human
@swcary	human
@grillkasteeltje	human
@HoosierEagle66	org
@vash_martin	human
@charlie_gza_	human
@LeicesterLover	human
@theFakeAbi	human
@3mJax	org
@alyand18	human
@sofiamalia	human
@NickySummerMag	org
@robsonandres	human
@Marixee	unknown
@alexgyll	human
@tattysshoes	human
@iammatters	human
@saragiboney	human
@BeautysAddict	human
@emirakamal	human
@bmtanna	human
@Tugnonnette	human
@ckazevelyna	human
@__Ju_Ju__	human
@raycaryl	human
@apodosinovskiy	unknown
@JazAndrea23	human
@kaydien1	human
@lauralecouture	human
@TheLamwich	org
@Broff_x	unknown
@AKBoogie	human
@CoryK_yyc	human
@FarmBoy	org
@a33567	human
@Miko_no_Alex	human
@shafielovesiti	unknown
@CaptnPollyanna	human
@CultureTripBcn	org
@eatingzen	human
@Foodsitter	org
@lisarmalcolm	human
@hotelfelix	org
@SayWellness14	org
@DanielJohnLynch	human
@kbrooksie19	human
@bencade48	human
@MoralesGwen	human
@veganfamily	human
@KK0702_study	unknown
@CooperHannah	human
@EmBo613	human
@HollyBubbling	human
@MakeupModaVida	human
@theekevinfuller	human
@ohlookhelen	human
@Teddington_Town	human
@Kingblond91	org
@pi_snkz	unknown
@420MarySunshine	human
@yu_rararara	human
@Digz05	human
@x_audrey	human
@iruzsg	human
@MallauryB	human
@kmap2	unknown
@BiondoTiziana	human
@Pabluncho	human
@JaysonBrown_	human
@Dirtyboy08	human
@euneqkie	human
@surayajafarli	human
@iLUNCHi	human
@buhaybuhay	human
@xZombabe_	human
@ulrica_delamar	human
@DINOWELLS	human
@TheEnergyGrrl	org
@CoastLangley	org
@matmatmhaat	unknown
@AshBelieber_xo	unknown
@yutiyuth	org
@handemac	human
@Novijabarti	unknown
@sarahkaylee	human
@RiggioPaul	human
@bearstatecoffee	org
@cincristobal	unknown
@StarFish8989	unknown
@mattlindan	human
@MarieTDittmerRD	human
@ChatsMonroy	human
@AdyzyeraA	human
@sky_dreamszx	human
@HanadiAlSaqqaf	human
@ErninaJunita	unknown
@michiyodance	human
@BobbyGrubic	human
@Jacqueline_Fong	human
@IFRTIII	human
@Singlesjunktion	human
@m_auladi	human
@nicocolaianni	human
@cruz_photograph	human
@marmora_22	human
@samjwong	unknown
@heyvjmendoza	org
@FitnessForumTV	human
@nana_phan	human
@tracycopy	human
@e_connaisseur	org
@kerubinnie	unknown
@sarah_bianchi	human
@veniviccivici	human
@ALASKAMC	human
@Jenentecott	human
@jajashazam	unknown
@AbraResto	unknown
@WillettaWillma	human
@IvySotong	unknown
@Giraf79	org
@NURULIKHOD	human
@ArtHealing44	human
@raven_rainfall	org
@ivorynarcissuss	human
@latomatedc	org
@MikeMartinezDC	human
@Great_Gobs	human
@rachaelwhiteSTT	org
@GowerAli	unknown
@sena4hca	human
@Ericamay24	human
@eehecht	human
@Thelarder23	org
@Ciaanneee	human
@SayWellness29	org
@tspindle2008	unknown
@casernanetwork	human
@kristinecarolgo	human
@SandBySaya	human
@shearers_foods	org
@TheWindmillPub1	org
@MakeIt1M	human
@3GLOL	org
@miss_mong	human
@Peetu71	human
@VictoriaRosario	human
@LibertyLndnGirl	human
@aydilaputri8	human
@BodiedByGigi	human
@ukbusinessnet	human
@AnwarNutrition	org
@Floyd914	human
@discoversouthrn	human
@RosetteRedesign	human
@CaselliLorenzo	human
@MeyrickHotel	org
@ThatGirlOnDiet	org
@PR1JC	human
@bataglini_rick	human
@cesto	human
@jorinegal	unknown
@TOFFENUT	human
@Salle67	human
@FiaoBradley	unknown
@Baron4ways	human
@Mell0wSm00th	human
@heyreex	org
@chani135	human
@SueWu94	human
@BarryRoss2	human
@Acantiming70	human
@jtamayoshi	human
@ParkHillFriends	org
@Doppelganger520	human
@CaseyAllJones	human
@SherisseWoodley	human
@tomi_ek	org
@MAKIICHIRO	unknown
@xokammie	org
@Jeeeanne910	human
@Missy_Ked	org
@MomsInDenver	human
@MomAmongChaos	org
@tmk_ms	human
@bolambotjr	human
@ConGustoTweets	org
@santiagocorona7	human
@CultureTripNYC	org
@suritem	human
@hairycoders	unknown
@Serena_Xu	human
@damejack77	human
@agnes_2804	human
@NeuvooSaintLoui	org
@hubalfonsi	org
@MrsChunLi	human
@IamVinMeister	human
@KSUContinuingEd	org
@FWanderings	unknown
@nriske	org
@ilvolonelcuore	human
@Nancy_DOWN	human
@wenkaifong	human
@jen_luu	human
@SpaChocolat	unknown
@simply_willy28	human
@StylishKellie	unknown
@Kandy_Jo	human
@goodmorningsgn	human
@mandyFLD	human
@Cathy1847	human
@iamKarla_Lala	human
@joanamnc	human
@jayceedy85	org
@Althoww	human
@anna0988	human
@Grassroots5Pts	human
@maisarahhhhhh	human
@ViBE_ub_apple3	human
@HellsKitchenMN	org
@nakayoshimai_kt	human
@Fabulousperks	human
@ClonesNClowns	unknown
@Billy50984698	human
@ATLHollywoodKid	human
@geraldteoky	unknown
@coachsoats	human
@bugipogi	human
@MillBrnchCoffee	org
@PubBullseye	org
@Suthan95	human
@nobuu3	unknown
@JorAtita	human
@VictoriiaaAnn13	human
@lordkentkent	unknown
@Windgate6	human
@rariigo	human
@pathara	human
@kerrixx92	human
@MagpieCafeSacto	human
@BoutiqueBangkok	unknown
@AiGNERxo	human
@sihayasworld	human
@beanboy420	human
@alkazamdacute	human
@Soulseros	org
@1001nightsny	org
@SyaidatulNurul	org
@LesMascareignes	human
@nicolemiizuka	human
@ysadler	human
@yaegyr	human
@cocoakeke	human
@Barbraalmeida	human
@HIStokeonTrent	org
@haruka714	org
@techaafs	human
@ADyanW	unknown
@Kelsohomerryhil	human
@RichFM39517086	human
@cantiktanita	human
@CHEFCALLE	human
@room_iv	human
@deannammorris	human
@simplydarren	human
@AngelinaCaramel	human
@WFM_Louisiana	human
@er1ck_chavez	human
@vedatdemir_14	human
@StrangeMarco	human
@BIANCAFISHER	human
@SwimCharlieSwim	human
@saifmohd40	human
@angeladj93	human
@herefordhouse	human
@harryskitchens	human
@rahmaathifahh	human
@reThink_Israel	org
@yegSouthsidePCN	org
@maXrighi	human
@AndreaCalvin	human
@emannaguibs	human
@Yasuna_Aoyama	unknown
@BarMadrid_nl	unknown
@NylaVox	human
@OneArtsPlaza	human
@JukkaPietila	human
@nicky7902	human
@SCOTT_LASSETTER	human
@JackBremen	human
@MarkMcMillian29	human
@HauteBody	org
@mojappp	human
@heeynite	unknown
@irena_bozhilova	human
@JaneIsles	human
@teresawliao	human
@blisslogixIT	org
@i_Supp	unknown
@car_icar	human
@YIIIYRosy	unknown
@mik_1224	human
@Heenbob	human
@MSV2121	human
@ElenesKitchen	org
@whenuwerelittle	human
@DabizLegend	human
@foodandnews	org
@MorysFamily	human
@_LBarnard	human
@nyllawrence	human
@bazocc4	human
@Evaglamazon	human
@ridhisays	human
@PARKROYALdhbr	unknown
@Sean_Sky_	human
@Food_Travellers	human
@CHEFSCatalog	unknown
@TitoxLarriva	human
@emiex145	org
@KerryReeves11	human
@Unthoughty	unknown
@DileoFe	human
@Mondiall_SA	org
@Dalia_Felemban	human
@jahjajachay	human
@Unugamy	human
@MsYNHayes	org
@MuLaN15	human
@ArtsFF	human
@BeardyWanderers	org
@arg766	human
@sydneyweekender	org
@tiray91	unknown
@KateLoucks	human
@VintageDuygular	human
@fritzess	human
@Edwards1290	org
@Gaabethomas	human
@SurreyDownsMag	unknown
@JeyTan	human
@CourtneyPoulson	human
@chi_aria	human
@RainbowSteakH	org
@ChaptersHotel	human
@persecatering	org
@CristinasSteak	org
@JcoMalaysia	org
@RedRockUpton	org
@JaccyChew	human
@pashaselcuk	human
@its_javiersanc	human
@oldlondonnow	human
@Pulia	human
@QueB622	human
@Faiz_Rukia	human
@FeedSouls	human
@xxrst	unknown
@SpringMayglobe	human
@dcarmelitana	human
@Chovyco	unknown
@TH_Twi	human
@awkwrdsauce	org
@AmeraiIlFinale	human
@jehilor1	human
@veveliciousblog	human
@Sleepy_Genius_	human
@lacmagazine	org
@riichan_0330	human
@IndieMusicBot	human
@BarbaraRuffo	human
@x_shandi_x	human
@shawnzy1	human
@KirkAloha	human
@CharlesHyczy	human
@DanaHasan4	human
@majoriverac	unknown
@HelloEmiri	unknown
@ryutaflip	unknown
@walterweffer86	human
@itskima	unknown
@qzenmaeVIP	human
@reborn1975	human
@fashionandbn	human
@Eikaakaka	human
@LMAKFashion	human
@yukitsun_c	human
@Trending_style	org
@andrewswagpeper	human
@paleorunmomma	human
@AmandaJBayley	human
@iJasmineDenise	human
@FrenchfoodieinD	human
@jbelgica	human
@shelleykelowna	human
@YasmeenBari	human
@plateoffish	human
@OnkarParab619	org
@scoppetta87	human
@ChiaS88	human
@ZhanetaBella	human
@Malroy	unknown
@ExMrrk	human
@woonderwaaall	human
@nicoletteonate	human
@phantomriderDP	human
@PangsEka	human
@kiddcoffeemason	org
@makateggy	human
@GossipNews365	human
@MyRoadtoRN	human
@RestApplaus	org
@natasia_ayu	org
@mcaseyineurope	human
@ENGIMSanLuca	human
@nanitiki	human
@rickker_	human
@VinnimcHIJACK	human
@helloimchiara	human
@DaliaNewYork	human
@WahOnLee	human
@ITRTG	human
@KFNutrition	human
@eatatsimons	human
@louleyy	human
@VanlySteven	human
@LuongDick	human
@liviaclarance	human
@foodandwineblog	org
@tomazzl	human
@rheumatics	org
@LevineLoo	human
@MRiglione	human
@abieolivia	human
@xxxibjxn	human
@LorieZee	unknown
@BrionisItalian	human
@nataliaclavier	human
@simplymommiesg	human
@MoSambo	human
@Highlysaintly	human
@LuciasMpls	org
@jen_swelephant	unknown
@MetalfiendZERO	human
@jbean1976	unknown
@Taqado	org
@bunnydefuego	human
@AmandaSastiara	unknown
@cadburytreat	human
@attyanluv0710	human
@salesguru33	unknown
@miozinc	human
@lilroxiee	human
@Marco_Monsalve	human
@codyrodriguez	human
@Joseito_pr	human
@barbiemichiru	human
@lookman0392	human
@14thdoc	unknown
@Raythanks	human
@tobagoparadise	human
@Baoli_Cannes	human
@NeuvooSAntonio	org
@Jennaync79	human
@ItsMeKristof	human
@FaniFZSitompuL	human
@GERvsARG_Final	unknown
@aimeedegroff	human
@MERELYME2	human
@leau_bon	human
@sachie	human
@KickinKetchup	org
@SunnyToast	human
@NicePantsLtd	unknown
@markangliongto	human
@shiennyms	org
@HannahDando	human
@LinsHodges	human
@UNIRestaurant	org
@sabrilu80	human
@TheXboxMom	human
@ZESPRIkiwifruit	org
@Shinod0912	unknown
@Like_the_Nut	human
@TammyLynnMcNabb	human
@williamkovel	human
@CatchaDragonfly	human
@MattCKendall	human
@Bianca_BGorgis	human
@BRGRCOSOHO	unknown
@Momagoose5	human
@AyleenWolfe	human
@PaleoPartridge	human
@Chara617	unknown
@crown_goostrey	org
@restoranka	human
@Kideaz	org
@chef_adeline	human
@BBBSCenWellingt	human
@yukiboze	human
@NimsDin	org
@rhikooo	unknown
@JohnCummings16	human
@LucyDartfordPR	human
@1017_Records	human
@AUSTRALIAPETE	human
@ooohberlin	org
@iamdwalk	human
@BarbieMayaSofi	org
@ChillRadio365	org
@souvanny	human
@CStoreDecisions	org
@nicoleivy12	human
@thepulseblog	unknown
@mama_biscuit	org
@chuchuchuchuta	human
@etiburcak	unknown
@WarsandSawa	human
@AthenaStavrou	human
@SuperSexyWraps	unknown
@limabrown1	human
@ZekkRagnos	human
@amber_wallace75	human
@macristinabaez	unknown
@gianherbal	human
@allanaltera	human
@Futrickks	unknown
@Chef_KD_SNS	human
@Nikkitans	human
@JusPeachy_07	human
@Tim_C66	human
@TavernaAustin	human
@Nazichef	org
@JHSWine	human
@ichellmichelle	unknown
@UrbanFoodMaven	org
@KingStatus2012	unknown
@AsifSKhan	human
@TriciaRae66	human
@2homegirl2	human
@Lifestylosphere	org
@ForgeRestaurant	human
@SubwayKuwait	org
@zedhedge	human
@thomaspower	human
@TehLADailyNews	human
@jackychang91	human
@besplender	human
@PumuSadface	human
@yoda_bot_tweet	unknown
@Gracebird_	human
@Nigaya	human
@MOHKIMANI	human
@ykeisd	human
@kitlaserna	human
@RamenFox	human
@RitornoOakville	org
@yooko_k	human
@Raison18bute	org
@CBCRestaurant	org
@LCPizzaKit	human
@Bekka_Mejia	unknown
@shoppingscout	human
@SwtnSassySistrs	org
@NFBamboo	org
@jimdemet	human
@Bitchie_Brit	human
@stevetank19	unknown
@itsmeFatin	human
@sirfranzg	unknown
@JessicaMolstad	human
@ElixorResto	org
@MicahCabaysa	human
@Addis17th	org
@shirazathens	org
@sophiejoli	human
@iamjacQ	human
@WalterSilvaArt	human
@MagotoKonno	human
@SherylVedamani	human
@Potae_AugustZa	human
@fullyitalian	human
@VisitPortland	org
@str8cam	human
@chfdibari	human
@weenangeline	human
@TCUnPosticino	org
@NandomThoughts	unknown
@mhackyx	human
@xsarahspeaksx	human
@monilabruji	human
@crouton39	human
@Chianingly	human
@AllOffersHere	org
@UsagiRed	human
@siang_semua	org
@moca__yuka	human
@goodchild_mark	human
@ChicagoDish	org
@QuellheurestilM	org
@edokaitensushi	human
@9BAR_Official	org
@BodyRockPink	unknown
@hemgiles	human
@AgathaChocolats	human
@alazasalamode	human
@Tinylilyjess	human
@hypnoticdonuts	org
@SOHOGrill	org
@aininurhaliza	human
@360lifelover	human
@tudormihai6	human
@ShannonPalmer	human
@dilantekkilic	human
@AasthaRohella	human
@sugarplum1125	human
@AhmedBerardi	human
@Marydelis28	human
@MartaGiacalone	human
@TasteofRunway	human
@Santi_Martinezp	human
@PEEN1974	human
@NovotelHaLong	human
@HuiErFJS	human
@RadioGrooveFM	human
@BCDRestaurants	org
@ReenFozi	human
@SapioSexualSita	human
@sinxx__luv	human
@CityLodgeHotels	org
@leugeniomartins	human
@sukly373	human
@RanchesGolfClub	org
@CarlosFMelgar	human
@onetrack76	human
@mzimmerman321	human
@practicalmommy	human
@IGAStoresBC	org
@CupcakeQueenBee	human
@mizukiiiii10	human
@markleeforrest	human
@indohomemade	org
@Giadre	human
@stivencn	human
@yusa_xx	org
@irasipahutar	human
@TowsonHotBagels	human
@moviesweetie	human
@FragileSogno	human
@chooryan	human
@TendrilWines	human
@GraceMo42305185	human
@CeciliaOrOrtega	human
@xeugeniex	human
@rinakkuma0824	human
@jokpemejoseph	human
@KUgoProductions	org
@FoodHeartBlog	org
@sedwongjowo	human
@fabie83143	human
@irwanxshah	human
@monicaaweetuk	org
@Bloodywolfeh	human
@lovisalindstrom	human
@glavasyvr	human
@TrueToMind	human
@Moda_Shopping	org
@AubreyDollface	org
@DannyUF	human
@_SuchaFnLady_	human
@ninatasa1	human
@msyazwan_an	human
@chindigz	unknown
@GardenCafeFrome	org
@Ajer_Hearsa	org
@Danielagrav	human
@juergenklatzer	human
@rajhelsey	org
@Brianna__Loves	org
@mbaktiw	human
@luna_leaps	human
@CoachLiska	human
@x_tinalee05	human
@vickybvela	human
@RoseMcCulls	human
@theresa_hiu	human
@SAecomike1961	human
@Butterflysnj	human
@atalow13	human
@GenevaStanton	org
@IngridMrie	human
@GetItRipe	human
@Ian_W_Wright	human
@kkroner	human
@canalstmancs	org
@febriahabibi	human
@AyseGkbl	human
@wilhelmiinaiida	human
@junikun88	human
@justagirl05	human
@mony_105	unknown
@NatKringoudis	human
@yukkkkkini	human
@tommylandz	human
@TheGingerNerd	human
@brandibeauty26	unknown
@EatAtAnastasia	org
@0SuperKate0	human
@eduardosenoteca	org
@Hounddog_112	human
@shawacademy	org
@Lexayyyh	human
@bmhunter	human
@HappyMeCreative	human
@SFFoodGirl	human
@marishibbert	human
@Erik_Olson89	human
@owarek	human
@CCChien0926	org
@MEANIEjhuvy	unknown
@goldabanana	org
@Red_Matrioska	human
@NiallHorran4evr	human
@NVMG69	human
@1honGG	human
@psalvana	human
@Tendil_Lombardi	org
@kannakko	org
@bloggs	human
@kj_ashby	org
@nomadel_03	unknown
@GeorgRothLA	human
@Light_Sanctuary	org
@The_Steel_Trap	human
@princessswag14	org
@KatieB968	human
@juanbudiman	org
@subexyabhadel	human
@jmullsfitness	human
@SheyBerry	unknown
@Uut_M	human
@nite_wolfus	human
@BAblackXXXyui	human
@GerrBarrera	unknown
@christinerealm	human
@Remy_Me	human
@xmichellelaurie	human
@MusicCoop	human
@Golosinavisual	human
@SpringNashville	human
@AkronCrave	org
@CA30UK	org
@davidbordignon	human
@ExploreRegina	human
@NancyProvenzan1	human
@SkyB03	human
@amyrosenash	unknown
@ALFRED_PRESS2JR	human
@ChloeSolstice	human
@spiritual1995	unknown
@milkmykow	unknown
@OpenDoorLIC	org
@ChloeLouiseMee	human
@OdeLopez	human
@TravelNTaste4U	human
@WallerHouseInn	org
@battnee	unknown
@HouseBritannia	human
@fannybens	human
@MamaBear69	human
@LHaddadin	human
@justataste	org
@DaveMueller_F1	human
@Mariejanekay	unknown
@PopRewindOnline	org
@_mollusk_	human
@angelspirit1323	unknown
@RiverRacerX	human
@khalaf_Aline	human
@zychez	human
@edgarnievest	human
@carynfly	human
@DraMatik978	human
@DorkAdorable	human
@n_deleon	human
@MsPaulalala	human
@BulletBible	org
@Tre_D_WildBoy	unknown
@_getyourcrayon	human
@bubeee	human
@villadepatosus	human
@desyliliana	human
@TASSQ_Online	human
@meszter92	human
@mellygrant	unknown
@aude11360	human
@101healthandfit	unknown
@Albert1225	human
@MERIPNLBC	human
@KShj1988	human
@Lil_Lehmanz	human
@TadkaBoom	org
@NeuvooDartmouth	org
@janicesinclaire	human
@HimeKeshii	human
@TJ_GIT_FIT	human
@jjuyeonie	human
@JeremiahKhokhar	org
@mushmadlights	human
@pfinallyhere	human
@ShinyAndrea	human
@alexbullon	human
@JonAgCM	human
@AshleyNicole419	human
@AZIZ_XOXO	human
@ObesitySpeaks	unknown
@TessyMui	human
@BeckhamLankford	unknown
@thetwistedO	org
@maduro96	human
@CharleneMeng	org
@bbyducklings	unknown
@soniyanavlani	human
@BabyMagnus	human
@Tiger_Jet_m	human
@yuji207	human
@LAFoodMarketing	human
@BrasaDeBrazil	org
@ImperialSugar	org
@gunnac111	human
@616RelloDaDon	human
@bigpblue	human
@PammySab	human
@xarejuvenation	org
@Tinkertam31	human
@mommyrunsit	human
@BetitoMarina	human
@SherryWernicke	human
@thefunkybeans	org
@mikktan	human
@Jamal_Crooks	human
@amanda2punkD	human
@MissCocoC	human
@WorkerEcho	human
@qdb2900	human
@caitfitz6	human
@tiyaputriamalia	human
@iowtomatoes	org
@BelindaCHL	human
@Michelle_Radio	human
@Gina_Caro	human
@That1chickuknow	org
@freedom_cafe	org
@FreshKitchenTPA	unknown
@mariaplanbee	human
@SBSMFoundation	human
@I_am_Anaisa	human
@Steffie__D	human
@JP_Broadgate	org
@AntiquesTJ	org
@massielperla11	unknown
@ExpatHealthInfo	org
@alisonyuen	human
@pantanalshop	org
@Tameramuller4	human
@gdingleviii	unknown
@heatandstir	unknown
@IMPASTO_MTL	unknown
@WellnessScout	human
@tania_sit	human
@bpolsky	human
@SuzanneRHolt	human
@GolfHarmonyFL	human
@naruho_	human
@planetorganicuk	org
@chloesway	human
@onewildrosie	human
@KAREN_GRABER	human
@AlmandineSky	unknown
@kualitylife	org
@osagechan_24	unknown
@Tuah_Alwi	human
@PhyliciaSP	org
@pittigetante01	human
@socosyhotels	human
@GomokIpoh	human
@VailLifts	org
@BeautifullyBway	unknown
@she_ng86	human
@DJAcolyte	human
@chefgarylawson	unknown
@_km331	human
@SandyPembroke	human
@FlipmodeJP	human
@blogbysusana	human
@AnnaSances	human
@SayWellness23	org
@ViBE_ub_grape9	human
@Fat_Foodie_	unknown
@torigray07	human
@NellieHayden45	unknown
@teej929	human
@CarolyneLW	unknown
@mauplayacar	org
@99Only	human
@elencantohotel	org
@danielle_twits	human
@BergeronJodyA	org
@shinelianna	human
@adrianavenue	human
@thehungryguest	org
@Aliend15	human
@dptodelacomida	human
@HomePlaceBlog	human
@TuxRecomienda	human
@iamhannah	human
@ArielleAllouche	human
@jeffthomas84	human
@Klausstrofobia_	human
@_Collins7_	human
@YesItsDot	human
@XplorioConnect	org
@luis_armstrongg	human
@GulfNewsGUIDES	human
@CorriganSays	human
@boutbtealunch	human
@samuelaraki	human
@MarkMino	human
@HTLHotels	org
@crazymissmyers	human
@orsopolis	human
@CharlotteRyanNZ	human
@yohannyperalta	human
@yrroundhomeschl	human
@cenitrol	org
@madelinemccarty	human
@DespicableEddie	unknown
@nikkaalmazan	human
@xuet1ng	human
@jess_nichols13	human
@Apachephotog	human
@kat__22	org
@TamaraPayne2	human
@ms_roxx	human
@Zzzinful	org
@CaHa_Da	human
@greedymizdee	human
@TheLocalHouse	org
@CraftyHope	human
@CambNetwork	org
@Djoeroemasak1	human
@jib_najib	human
@hitesh_sharma	human
@Lightscap3s	org
@djnatazu	unknown
@Suleiry	human
@VeraGoundry	human
@lcclaw007	human
@umpaloo	human
@meljespinosa	human
@rannekuhl	human
@Sweetcraftiness	human
@SassoolCafe	org
@Masaki_pon_pon	human
@tashy_83	human
@137bargrill	org
@HamptonSocialCH	org
@GastronomyBlog	human
@hngrycrmdgn	human
@Miz_Palou	human
@DixieNicola	org
@AnneVDM0519	human
@WeiZhen1020	human
@sjperdomo1	human
@ZeydAzi	human
@AnthonyJohns0n	human
@BaddestJoanna	human
@help_me_fat	human
@_hrdk	unknown
@BESPOKEVENT	org
@NurArshiEral	org
@khnayser	unknown
@em_chambers	human
@fullyfueledlife	unknown
@LiaoYingHan	unknown
@muratovich77	human
@Rover281	human
@CatfDIVA	unknown
@3squaresMN	human
@ocogara	org
@GemRayMedia	human
@rebecamaccise	human
@GreatNorthernH	human
@shereestrange	human
@Zizikis	org
@MaritaPerroni	human
@hirominak	human
@advanceURstyle	human
@lucidillusions_	human
@awoods1972	human
@Helga_hlg	human
@TillyMaeBeauty	human
@PurpleBalancetm	org
@fitfoodieeats	human
@Jonathan_H233	unknown
@leopardliving	human
@BaristaBatgirl	human
@ShahlaaTahira	human
@noelfaust	human
@SheratonAUH	org
@omarelbarbary	human
@andante111	human
@royalavell	human
@gedlinghour	human
@ridyllic	human
@hmurphy15	human
@CarlyDeBurger	human
@LindaKartika	human
@bogosaveratl	org
@SandraNoSekai	human
@mickymistral	org
@zeynepcerenalp	unknown
@Tilde_S	human
@ilkinozc	human
@miscastdice	org
@Julietsbb	unknown
@BrunettiCaffe	org
@evitaskourleti	human
@DrSagers	human
@Poppy_ROGUE	unknown
@LMothershaw	org
@FullertonsBooks	unknown
@JulianoHuertas	human
@DwaunSellers	org
@LauschJack	human
@Stellar247	human
@backalley10neko	human
@rouget1977	human
@simaj	human
@fumeelee	human
@dvbvq	unknown
@LuCSky	human
@brand_emile	unknown
@ChicknFriedSoul	org
@Miwak25	human
@Sammy464	human
@3dprgirl	human
@TheColorfulChef	human
@BrandlBelmar	human
@MuazAlRashid	unknown
@hotelgelato	org
@rockbar99	org
@zanajasmine	unknown
@ishii_0321	human
@ChantalBorch	human
@robertusdanny	human
@MissLove2Blog	org
@cakeandloaf	org
@mrsdannytorres	human
@Meryl_Pexton	org
@michelle25490	human
@ProphecyEnt	org
@sjh4444	human
@biancadama7	human
@mumsmakelists	human
@fashionloverett	human
@iotattack	unknown
@juliehawaii	human
@RafaWhore	unknown
@Chef_Jost	org
@jaedoni	human
@GoodDinnerClub	org
@warrenkurtiss	human
@Brandie_Bentley	human
@ryindini_a	human
@jaweamerica	human
@BMwatsi	unknown
@GCTLosAngeles	org
@GH_Serbelloni	org
@atikakoh	human
@TasteSavant	org
@MollyKhanna	human
@DavidCodyAllen	org
@MyChaos	human
@devitailhami	human
@sloppyjohny	unknown
@CharbelCAK	human
@xng21	org
@KingsFineFood	human
@reneeb1980	human
@starlight10	human
@docajayjohnson	human
@KhadijahsPV128	human
@tniver	human
@_SaraJaz	human
@AngelicaLeeds	human
@Souda_27	human
@_cninggg	human
@DML2451	human
@tyggerlilly	human
@_Nkateko	human
@ammainhouston	human
@ildescojax	human
@skinandbonesTO	org
@LaBaleineUS	human
@RadissonUdaipur	org
@FolloBrodalumab	human
@ipafm	org
@avonwings	org
@HumairaMahmood	human
@rjaimes63	human
@AntiaHanoz	human
@CornwallHour	human
@AleppoLuis	human
@fattoincasawp	human
@talldoll0501	unknown
@JamesEApplebaum	human
@ERICSCOTPHOTO	human
@LianYoungMUA	human
@catherinebarr	org
@Milestones5237	org
@MadeFrmPnterest	org
@chjata87	human
@WModel	human
@Mind_MD_	human
@Helios_19	human
@Midtwn_Village	org
@JRMoala	human
@RentalLiving	human
@shrubshutter336	org
@aileenkflores	unknown
@ninatendo	human
@WestSydUVCBL	human
@OzevDonerSalonu	human
@cerinade	human
@_BloodyHope	org
@teru28go	human
@laborders2000	human
@kayleighrose92	human
@QmkhqA	unknown
@CeramicaJp	human
@KaruhunJAWA	human
@DovileFashion	human
@CourtneyTerror	human
@Sunnyfen	unknown
@The_Duchess25	human
@CIZKAGULTOM	human
@Kohai41	org
@wabagrill	org
@Mwafreeka	human
@SpizzicoBarnet	org
@lorabooh	human
@SouthWaterCHI	human
@FootFancier	human
@farahsedefoglu	human
@mara_qu33n	human
@RoldanOcampo	human
@justfalafel	org
@G0rj3sssssss__	unknown
@FolkestoneRT	org
@Naneki86	human
@SAMELIAsWORLD	human
@ErlindaShen	human
@DIAMONDNFURS	human
@SayWellness38	org
@TweetKrystalO	org
@DJ_K_Japan	org
@rose790511	human
@ElenaKale	human
@jasonsheardown	human
@RocketsTweets	org
@sha_sha_v	org
@dangalvan92	unknown
@LuxeEnFrance	human
@HumphryMarch1	unknown
@McHughsWineDine	org
@cico238	human
@ThirdPromotion	unknown
@NCTavernBowl	org
@MissaVeggie	human
@MCusms	human
@StrG8ZeR	human
@manonfirenow	human
@CikJuju_	human
@miiladepaula	human
@Johanes_JP	human
@saranfood	human
@TinaMariexxx	human
@VSVBlog	human
@happpy06	org
@Petalo23	human
@skiddle	org
@Walli1313	human
@RebeccaChui	human
@ponyboi_84	human
@edalduga	human
@Mike_J_Pistol	human
@flipphilli	human
@Cosmopink21	human
@Tam2Blessed	unknown
@swrtyjon	org
@Fucktronics	human
@enigmatically99	unknown
@tee_thr3	human
@HATE_YP	human
@denderland	human
@blueprincessrha	unknown
@Estherbatlery	unknown
@reethibeachres	org
@MrsCherriT	human
@mine__ma	unknown
@thecamlinnyc	org
@Es_Ka_	unknown
@UKHashtags	org
@A_Paniagua	human
@BecomingBKLYN	human
@fraeuleinlara	org
@DressToEat	unknown
@KahrenAK06	unknown
@cinthia4apple	human
@theaaholic	unknown
@ByronTJr	human
@DanChamb3rs	human
@cucinarustica1	unknown
@andrea_montori	human
@eatseesee	human
@Jleigh1391	human
@juzmarc	unknown
@guaycurahotel	org
@BokuWaYoru	human
@MrPoohCyber	human
@HBANY	human
@paolapaulo75	human
@actron	human
@GilbertoTCC	human
@bhp6761	org
@Lilfoxyli	unknown
@lischerrybomb	unknown
@WestSydUVHWK	human
@mrbankvocalist	human
@iitspatty	unknown
@AlresfordBear	human
@PenangRaceWalke	unknown
@Maroobella	human
@GiadaWeekly	human
@citestecevrei	human
@xFirexFairyx	human
@Barbara102006	human
@Melz_8	unknown
@the_blitzer	org
@Metalfifa	unknown
@NoahNate	org
@georgesmixes	org
@LeighLopez	human
@Thrilla_dondada	human
@dr_yummy	human
@Michelley_Elle	human
@DimSuonoRoma	org
@DenvrConsistory	human
@GodOfTweets63	human
@HerbalifeDude	human
@mrmr830mrmr	human
@RR579UZ	human
@mc_0313	human
@Petra_ke	human
@ufallome	human
@LilianaSnchez9	human
@blkvelveteen20	human
@RoyChan1	human
@kwfdgrs24	human
@Crudoco	org
@BrockberryGrill	org
@LynYusoff	human
@Tanavit23	org
@CulinaryTravels	org
@kyao_kaorin	human
@CindyCindyresha	human
@ahzul05	human
@pickdeath	org
@CNWFamily	org
@Broham25	org
@blondie1483	org
@rheapaigeclark	unknown
@d_rosengarten	human
@Glandless	human
@noriko_style	human
@siArianneyan	human
@Mark_Haagen	human
@rebelhouse_ca	org
@CoreFxFitness	org
@Mambo_Leo	unknown
@4_CoinsduMonde	org
@Almz15	human
@PittsbgPirate	org
@avitalc	human
@PapaRatzi83	human
@FebrianaJason	human
@SpinneysLebanon	org
@kasia_kawczak	human
@Lizzi4real	human
@hannahhausen	unknown
@sheskym	unknown
@Dumbbell_Boy	human
@TheCopperBarDub	org
@MHResto	unknown
@Ladymermaid	human
@amirulalhafiz	human
@clarenswolf	human
@Popular_Drinks	human
@WhiteCastle	org
@stephanieyfc	unknown
@overacupofmilkT	human
@dogleaves	human
@StineKenneth	human
@cazacioc	org
@mhald_tha06	human
@BierMarktEsplan	human
@mimaYlrej	human
@jonesjr876	human
@TUI_kiev	human
@tifa2276	human
@HdV_Cheltenham	org
@ViennaGray	human
@WagenersMeat	org
@MONIQUEIAM	human
@TheLondonWeHo	org
@katkins1982	human
@MrRellBrown	org
@dailyelfs	unknown
@alexisvert	human
@IAMMartinit	human
@brownface78	human
@FireandIceME	org
@gabybaquerizo	human
@nathaliacamilla	human
@wenqian77	human
@TengOnly	human
@KGBBistro	org
@gmajpmdj	human
@SarahBorisky	human
@CJoella	human
@AnaCaroMartinez	human
@AuroreDonguy	human
@SimplyAlbert	human
@joshuacahn	human
@Yvonne_Yau	human
@LEcoleMem	human
@mikefolden	human
@tina_30901	human
@Dawnlantero	human
@MyGOMOM	human
@pennyandrusty	human
@Enkeria	org
@LondonByThames	unknown
@InstaAlushta	human
@CornerPub_Grill	org
@TheprincessSK	org
@KatEstipona	unknown
@syazwantahir	human
@merchantsqevent	org
@BODILLOIS	human
@lisyin_pri	human
@SerranoRamses	org
@Gerosimov	human
@amsuperMCfordan	human
@SagesEpiphany	human
@FrancoisGeurds	human
@CalistonJ	human
@theunswsmuts	org
@lilichaniago	unknown
@maddytalksto	human
@SierraJ117	human
@Kyriee_93	unknown
@kristin0825	human
@Meiyan2009	human
@niceykels	human
@My931Vegas	unknown
@lovebylizee	human
@Ellinad09	human
@benzeetme	human
@chopshopseattle	org
@APBPAYROLL	org
@Amy_mi	unknown
@JessikaGotti	human
@brendacouture	human
@aiiuMinho	human
@Shineshka	org
@TheBeatChef	human
@klang_JJ	org
@Emporio86	human
@the_foodiegirls	org
@ozgetopdemirr	human
@StKittsTourism	human
@nangtravel	human
@WritesonMUSIC	unknown
@geeceedakidd	human
@Kassay	unknown
@Curvily	human
@lindikonoso	human
@shion1313	human
@TheTrendOven	org
@brunaphilippson	human
@PilotAthletic	org
@AshevilleBlog	org
@mackpijewski	human
@akane19881230	unknown
@Zhiruma	human
@deathwizard57	human
@herfashpassion	human
@ericpj12	human
@VintageReinvent	human
@IronChefEmmitt	unknown
@ANabilahTayyib	org
@JasmineACasana	unknown
@nicktolo	human
@MegaMem3	human
@hattiewest	human
@Princessjade514	human
@LaVoguettebyAC	org
@_SalilaS_	org
@jesscoakley	human
@MoneywiseMoms	human
@richierichv	human
@ErnestRaymond	human
@AmpnnRosa	unknown
@WOGOAMAGAZINE	org
@jsher10193	human
@BellalovesBear	human
@BourbonRaw	org
@EmoSalvatore	human
@cassandra_5479	human
@enniopugli	human
@RoseliaSchwebac	human
@gofamintmushin	org
@mushieduskie	human
@lord_rodan	human
@GeeDavies1	org
@macario_jimenez	human
@GUCCYUAN	unknown
@emilyrunfree	unknown
@blk_orchidmiami	org
@Lidiaa_98	human
@downtotheup	unknown
@BikeorBarRob	human
@hhairunisahamiz	human
@AtelierMadrigal	human
@01mac0223	org
@az4490	human
@SkyyLyfe	human
@jocooks_com	org
@maestar2000	human
@Katyboo82x	human
@FashionRetweetd	org
@mediahubb	org
@vegan_lovers	human
@callmeROVI	human
@martijnn_mm	human
@BelleDameFolle	human
@Retdsquid	human
@TheGlamBoi	org
@Layla52362515	human
@zeusmannj	human
@SandiNYFoodie	human
@JonasRosengren	human
@silversaisky	human
@FannezhaFord	human
@HdDiner50s	org
@TheKtAnomaly	human
@FleurEast	human
@leahkuhne	human
@Sandsenmivian	human
@AsiadeCubaUK	org
@judithphillips	human
@GourmetEssenz	human
@PingHui92	human
@MartinMoralesJr	human
@RACHELPG79	human
@CarmiEscueta	human
@XxWeirdPersonXx	human
@Doestaxxx	human
@FirdausShafawi	human
@GlazaromdMary	human
@FiveFootPhotog	human
@LivelyVivian	human
@CaaroSantellan	unknown
@Xquisitely_Meen	human
@OurHappyHouses	org
@lynnd0720	human
@Daliza_Sanchez	human
@Lifesum	human
@GoodEatsMD	unknown
@iMOMSi	human
@Brittany_Geneva	human
@maerygoround	human
@MissyB_Live	human
@collegeunder	human
@Fearless__Women	human
@soapyyme	org
@Tukyonlyme	human
@mjcabuhat	unknown
@FinePosh	human
@chrissytees	human
@DevonRVA	unknown
@FurrowNL	org
@IbrahimHBK	unknown
@tigerinadrugstr	human
@jlrossal	unknown
@xHashtagPH	unknown
@100tables	org
@ilse_g	human
@HottyToddyNews	org
@hernameiskim_	human
@jesssmithphotog	unknown
@AndinosBistro	human
@E52BEATS	human
@KingJavii_	org
@MaisonCF	human
@hrzmnkyr	human
@youvirginia	human
@AllWomenStalk	human
@CathyMartin	human
@coverdncandy	unknown
@desertlilly	human
@HKP2012	human
@NaturallyMe35	unknown
@EnjoyMargarine	org
@SeattleiteLeo	human
@SpicySugary	human
@ShortFuse	human
@3hotel	human
@FlintKaty	human
@7alces	human
@alizorganic	unknown
@MrsCullen611	unknown
@THEjustink	human
@Summersnowdrops	human
@ChefDonie	human
@MarielitaF	unknown
@remaja_jaja	org
@annnn_es	unknown
@Mspvtr	human
@WaveeeyB	human
@Chalicekow	human
@FINCACORTESIN	org
@ayshebalci	human
@iamrixana	org
@HWBLAW	human
@drsarahlist	human
@laxsamana_sunan	human
@enjoyableja	human
@The16BitChef	human
@_SteFunny_	human
@sue0218moeka	unknown
@Cunphotography	human
@hryasjack	human
@shelbyvanhorn	human
@GayleCraik	org
@Telemanmusic	org
@beYoutifulMode	org
@FitnesTips	human
@SolGirimonte	org
@DAVIDJCASTILL0	unknown
@TravelBySan	human
@JimmyZWynwood	org
@reny_nps	human
@HERBSK8	org
@puddin847	human
@JyreekEllerbe	human
@ElFrancesderosa	human
@SofitelLA	human
@NielsGoethals	human
@south2southwest	human
@Au_Comptoir	org
@adpike19	human
@MarekZeman91	human
@mmserrano83	human
@Benjijohansen	human
@Ou_Ou	human
@Carolina_Rodz	human
@RoxyChan15	human
@zamakeupartist	human
@TanyaManalang	human
@bbutlerstyles	human
@KelseyHouseBR3	org
@RWJeddah	human
@pirabhut_	human
@MarlynnLane	human
@Sandys_Beach	human
@artOFdelving	human
@Pseudohazard	human
@eggsrockland	human
@krmengloriaaa	human
@TuckRes	human
@gimt1162	human
@MiamiNewTimes	org
@Am1cus	human
@SuziSlimWorld	org
@JessiSlovakia20	human
@eroomns	human
@ConsolacionH	org
@CatBoogie89	org
@saritaisabelle	human
@ZinhleMqadi1	org
@chemabedmar	human
@SocialMisfitATL	org
@delijah3	human
@SalStammetti	human
@BullocksAuto	org
@arnm542	human
@jilllllbert	human
@IMVoyager	human
@TSMMAGLENDALE	human
@BateauxLondon	org
@sherrybracy	human
@LocalsecretsUK	org
@ThArtofStryTlln	org
@OliveNRuby	human
@FITstoryteller	human
@LittleDuvel	org
@Ms_kLaiRe	human
@Food4Lyfe	org
@wjnit	human
@zacharysung	unknown
@AntonRG	human
@DeenaMcsween	human
@tbrck	human
@BoaAbuDhabi	org
@TTAfood	human
@CoreyMc89	human
@Bella100pizza	human
@Cami_Techera	human
@LucyFarrugia85	human
@OnSheGlows	human
@mailarest	human
@Miss_Montoya_	org
@unappetite	unknown
@kulturkervaniIr	human
@garuggi	human
@LennarColorado	org
@dariom_85	human
@KellyNReeser	org
@LisanneRose	human
@PattyBBoyd	human
@KehaulaniKyle	human
@martalino	human
@Nacho_Uve	human
@smileyhawk	human
@CoachDanielleH	human
@mimsimplythai	human
@Hot_96Kenya	org
@HappyMamaAustin	human
@NorainOsman	unknown
@AuroraSoho	org
@ely_squid	human
@rylescatering	org
@Lumea_	human
@ringole	human
@AndrianaO	human
@_Sebs_	human
@Hola_Hef_Fito	human
@warningitsfredd	human
@MYNIOO	unknown
@ThePembrokeDub	org
@JeffRadford	human
@mohdikmal92	human
@Just_Colwell	human
@ladyduncs11	human
@redridinghoodl	org
@ashes2ashesbski	human
@FuelBandSE	org
@Nihilas21	human
@lisatse	human
@SimpThriftSavvy	human
@VillageDeliNY	human
@damnelf	human
@stephendc915	human
@SNOWMOULA	human
@JuanaHyland	unknown
@Hidden_Art_Shop	human
@ImDefAnASSHOLE	unknown
@Zola_77	human
@626drift	human
@villycivneva	human
@EtenbijWerelds	org
@thisislovemade	human
@asyrafazizi89	human
@SteMeneses	human
@AYPeoplMagazine	human
@therikix	human
@omnoshedidnt	human
@wenere	human
@zhen09681011	human
@Emmmmama54	human
@DusitThaniMV	human
@Oveeelha	human
@NickySamano	unknown
@WikiBooksGuides	human
@TikeTiana	human
@Radisson	org
@fionafasha	human
@aepdesigndiva	human
@Stacie_Jayne_M	human
@sarahokada	human
@ktinndalala	human
@B3dge	unknown
@MartinisSlipper	human
@Candlemom3	human
@blogfoodfitness	human
@imQhairy	unknown
@MaricelMunin	unknown
@i_am_yula	unknown
@VittyBrizuela	human
@MrEflor	human
@meektochic	human
@Phokingawesome2	org
@sephCZ	human
@ChitaCollazo1	org
@chelsea_od	human
@KyatShotta	human
@ArisaEmiBlack	org
@VeraFine	human
@Benlong10	org
@Deli_Nene	org
@SamuelGlife	human
@ryanaldaba	human
@shandiijossa	human
@nazcek22	human
@ogjaygee	human
@helloPAUPAU	human
@em_HU4L	org
@Seapointrest	org
@JinjuuLDN	org
@Rizky_Poppy	human
@TechyTee	human
@mdewidt	unknown
@MarilyNsClosetB	human
@pazmariar	human
@drexelcruz	human
@DJ_SOARISE	human
@anagallego009	human
@FashionAddictsU	human
@dbwlgy	human
@DeGraciaAgustin	human
@RyeBrookHH	org
@EverydayVeggie	org
@Brookey1827	human
@RadissonBluDMC	org
@jerrydsimons	org
@StylisiMon	human
@butterfly_sc1	human
@takashiaaty	org
@aoa191	unknown
@willamber	human
@KristineCataldo	human
@shonab7	human
@BaronsAlpine	human
@MrBrownMty	human
@jkai_ooi	human
@OnlineFootfall	human
@DonHawks2012	human
@DJ_DaCosta	human
@bellyfullnyc	human
@simplyxclassic	human
@bmking72	human
@annkeizel	human
@MsJueJuita	unknown
@groovin1974	human
@VEEisCool3	unknown
@rubin21	human
@CaaaroOrtiz	human
@SanCarlo_Bham	org
@Nastyhulk_21	unknown
@AncaEllenbeck	human
@hendersonbakes	org
@n0427ao	unknown
@EccolaBar	org
@Catawiiina	human
@pccagalawan	human
@nDuk_28	human
@HydeGlasgow	org
@thefoxgekkocool	human
@acc977	org
@ArteSanoVGccs	human
@CityWineryNapa	human
@theGOODSdept	org
@YumVillage	human
@imatifster	human
@siborotti	org
@ridhokhan	org
@piggypops123	human
@serkantav	org
@djbabzy	human
@HeidiGreen9	human
@RockwoodHealth	human
@auralanae	human
@idris_isa	human
@Keizer_Aquino	org
@JacksonsNash	org
@NikkoNation	human
@disneytravel1	org
@byarja	human
@TheBunchSE1	org
@helloimsus	human
@Loributler5	human
@mk10runrun	human
@StreetsTO	org
@SugarBarBA	org
@Nikki_Marsha	human
@valentinazulian	human
@todaylifecom	org
@redchcick19	human
@TheDayfarer	human
@eric_thamcs	human
@XxX_mery	human
@FontanaFederica	human
@theaterdear	human
@WhiteLionRoad	org
@raynanyap13	org
@MaiYashAhir	human
@Waan_naka	human
@martinrogers92	human
@Heartswilldie	human
@grfxchic	human
@Lapao78	human
@RandPitt	human
@ManakaLand	unknown
@g3or_93	human
@vicky_pravita	human
@MasonCash_UK	org
@AY_106	unknown
@eca81uk	human
@Belle925	human
@MarinMPLS	org
@dmanuhate96	human
@danielle2sp	human
@B1A4_elipunt	human
@h_tgc	unknown
@numbphoto	unknown
@Decapolispanama	human
@rin01271227	human
@table_matters	human
@Sarah_GFS	human
@cheenaagha	human
@esimon1980	human
@thislady27	human
@FoodMattersNYC	org
@pv1312	human
@MetohiKindelis	human
@ModelKimmy	human
@DaKidIAmEnglish	human
@wafflerica	human
@DeadNDrippin	human
@viona_maylinda	human
@KIKEromerobravo	human
@KristaTGilbert	human
@kamogusu	unknown
@FoxedGlove	human
@AjiPeruvianLB	org
@qixpoet	human
@Mell0710	human
@shfoodalchemy	org
@Mario1387	human
@DavidGriffen	human
@LoreleiPalmore	unknown
@Brindisa	org
@Amanda_Hall	human
@niamhiee95	human
@to_mi1224	human
@wak1722	human
@LittleSoya	org
@StavrosZito	human
@krispykrunchy	human
@LazyMusician10	human
@RabezzanaLondon	org
@NotableCalgary	human
@BeingBoycie	human
@MzN2Hair	unknown
@anaees	human
@MaieAttar	human
@wingmass110	human
@farmnuts_nueces	org
@ChatKitchen	org
@GranillaBar	org
@miraclemiledeli	org
@sauceloves	org
@ConfidentDiva	human
@ShannonJade22	human
@DevaSvn	human
@KatieHoban1	unknown
@smashbangdollop	org
@kofdisgdsa	human
@Catermatch	org
@dairymarquiroz	unknown
@DreddyTennis	human
@saladcreations3	unknown
@MignonetteMIA	org
@quattromiami	org
@RubinaRovini	org
@graceoswald	human
@ryanzleech	unknown
@morehousegroup	human
@cozycafes	human
@LabelsShopping	org
@lyndam42	human
@DFGrilleStamfrd	org
@palladiumhotel	human
@SBNWorldwide	human
@ualperyilmaz	human
@XLBeachClub	unknown
@AliBabaFood	org
@alchornea	unknown
@braderunna	human
@aska1214	human
@DickySumarsono	human
@raja_omer	human
@StellarVintage	org
@olvrchrstphr	human
@hendsans	org
@tokutya_akhi	human
@x_coeur_x	human
@DanielsDeidra	unknown
@VellaFilani1	human
@Butt_Hutt	org
@RegularVince	human
@chloeCHR	human
@JetSetTourism	human
@Blackberry_muz	human
@stars2p	human
@paulmartin1107	human
@yennywen	org
@johnklass	human
@ChampCharlieGY	human
@danaegarcia89	human
@suzannecooks	org
@OneAppleMonaco	org
@Rihsbest	org
@sskariah	human
@EDGEsteakhouse	human
@JeniR14	human
@Shan_Z_tie	human
@bonnieandkat	unknown
@sussexliving	org
@KarenKingham	human
@JadeStaley	unknown
@rosecoloredsun	human
@psychostronaut	human
@GreedySpaniard	human
@Nikoletas2Hot	human
@NieshaErisna	human
@pepperstormedia	human
@ericleong94	human
@FrancisLozano7	org
@nutunit7	human
@Elenista	human
@rayjendiane03	human
@bernardeschi	human
@coachkev10	human
@KeepDotCa	human
@m30111982	human
@JohnathonTT	human
@mhawke	human
@sarahpearson80	human
@diamondcityswag	human
@ilovedayami	human
@DonnaNadine	human
@SusyTVRD	human
@jazzy0218	org
@CoachingW	human
@erkhalsa	human
@napolimade	org
@girl_onthego	human
@TJRPayne	org
@mrsaa1	human
@TheBakedApple	human
@Emlarr	human
@RachaelRaymag	org
@SarahLCook	human
@kla_613	human
@FonderieRoubaix	org
@bellscabin	human
@MELONCARNIVAL	unknown
