@fitchj14	human
@TieyHarith	org
@corinnehaan	human
@JimmyCruisin	human
@PHONIK4REAL	org
@MontrelNation	human
@Fatima_ZE	human
@LeDandyMars	human
@Porasbrand	org
@xcarbonell	human
@topshelfaz	org
@saraudentia	human
@ChristyTyler	human
@4EverAWife	human
@a_bakulka	human
@MariaHarefa	human
@TalBerkovich1	human
@BrightiLand	human
@CuraLau	human
@cookingwitherin	human
@Chandra_Sev	human
@endawia	human
@TinaLoves2Tweet	human
@KatieGulleyMUA	human
@millennvj11	unknown
@uvintertrade	org
@LaDietaMed	human
@Granny_Cheryl	unknown
@canlasrocel	human
@cheesecakeyeg	org
@iamlesterjoseph	human
@sristygabriel	human
@fmsantos93	human
@T_UrFavBartendr	human
@jushassler	human
@jadediningoutsd	human
@rrvs1990	human
@GamerGirlBooty	human
@Heatlex	unknown
@IoOrtiz	human
@WestfieldPD	org
@DarrinBradley	human
@MistaJuly	human
@IamJeffyLee	human
@bodyism	human
@phyllgerry	org
@mariskamakmud	human
@2013ginpi	human
@Veg2Paleo	org
@n_erea	human
@TraciKBaez	unknown
@americansmut	unknown
@FamilyOdd	human
@ChuZeorLuZe	unknown
@ArcoSW1	org
@DonaldDDiva	human
@BigFeedAU	org
@FahmiHazizan	human
@PMInMIn	human
@KaranWahiFans	human
@cha_tterbox	org
@kikimojo	human
@RYCOM1976	human
@HannahhLea	org
@AnabellePync	human
@dayandabid	human
@kogfidsgdsfs	human
@dunxs78	human
@CSteinhovden	human
@MariaaYasminee	human
@SaboresDF	human
@kyrcn	human
@ErikSarni1	human
@ANP_Pub	human
@SchreibsHotDish	human
@T_Dawson_87	human
@AllisonEnkeRD	org
@crazyshort12	human
@guraffiy13	unknown
@ECGraphicArts	org
@xmillyxu	human
@nyluxevents	human
@pokoke_maknyus	unknown
@jeffyan87	human
@ColorfulHarvest	unknown
@FamousFodder	org
@8407	org
@m_r_ne	human
@RailLineDiner	org
@mr_delovely	human
@ayruz516	human
@HEARTRetail	human
@Caroldemp91	unknown
@JG_Tokyo	human
@IsabeauLeonie	human
@brittanybrowers	unknown
@BrittanysPantry	org
@LeonesZia	human
@midnight_ame	unknown
@vemmakeup	org
@elibeeortega	human
@The_PerfectDiet	human
@BiscuitJill	human
@paddycummins	human
@Cookwithalocal	human
@gosia78	human
@neerav	human
@mmgermanbakery	human
@NadiaHilmey	human
@AgArielguevara	human
@modelivylee	human
@StepanBubak	human
@HoMBurgerChef	unknown
@StewartVanessa	human
@FVCKYOUKAHSAGAD	human
@Grazy_me	human
@EdazenUSA	human
@Ajithspeaks	human
@VoodooCantina	human
@lozza_LJ	human
@RisaAFelix	human
@mplay08	org
@vearanka48	unknown
@BoSSMaCC55	unknown
@SteveLobel	human
@smcw2005	org
@Michelle315678	unknown
@TweetsTheTable	human
@annieandevery	human
@NaomiPluym	human
@maricaborracha	human
@BRANB954	human
@ZZZainalZin	human
@GlamSquadShop	org
@dipzblue	org
@MagicalWishes77	unknown
@CioMike	human
@ninamnam	human
@AinH_Casper	unknown
@XdaleLipit	unknown
@Rat_thakarn	human
@nour_313	org
@RealTalkDior	org
@theBuzzzwithBri	human
@73_maru	human
@beachwoodhotels	human
@Jetsfan101290	human
@MzPSA	human
@David_Cap10	human
@iamRIELISTIC	human
@aeropuertoGYE	human
@PAIGEE_CONLINN	human
@RickyChozai	org
@Mudam	org
@ArjuneMark	unknown
@Dopecurls_Tina	human
@oldwhitelionN2	org
@carolyneegg	human
@Catchycork	org
@mynd4life	unknown
@AuraNash	org
@DrumlinFmGuelph	org
@Jesatronic	human
@The_OrganicDiva	org
@arindaloverock	unknown
@MissAineON	human
@Copolovici	human
@3_parts_beauty	human
@J_airomine	unknown
@Nicole_Pedrick	unknown
@ix3cheesecake	unknown
@DreaArtist	human
@AlfieJones22	human
@MulryanSorcha	human
@choonhaw	human
@aidarapr	human
@Chouxchouxbedoo	org
@Aspire_Wellness	human
@lovingnorthpole	org
@SamoneSays	human
@packmylunchbox	human
@JokerEvil1611	human
@renai_G5tgs	unknown
@iHafezz	human
@IngaKravetz	unknown
@ashrafabrahams	human
@EssenceAllure	org
@dsgnfreak	human
@jikou222keisatu	human
@brightonfood	org
@marimogranger	human
@aimee_caba	human
@IsmaNadzman	human
@MontanasAncast	human
@Susann_Chapman	human
@kristykubis	human
@ExoticNik	unknown
@ChitraQueen24	org
@lifesnotvanilla	org
@ShesA_BigDeal	human
@Velox167	human
@Siyeon0214	org
@djraetotheworld	unknown
@dilla_farid	org
@SFCpdx	human
@miichan0626	unknown
@WestEndHoffbrau	org
@carla_battisti	human
@kCBossLady1	human
@ChArLoTtErOsE66	human
@AlyssaJolt	human
@minamichan48	human
@KaylaMelissaa	human
@vashz	human
@Piccolino_Chest	human
@Marc_C_Bayliss	human
@Gabrie_Iva	human
@_chellby	human
@coriwestphal	human
@WorlWindWriting	human
@haroldjames83	unknown
@CupcakeColter	human
@beth_the_emu	human
@MileSweetDiary	org
@easykidsrecipes	human
@ongkeet	human
@McD_NorthTexas	human
@Shessolovelyxo	human
@MarniPrice1	org
@MyFitnessGate	human
@rigb	human
@jowjow01	human
@ImSuqi	unknown
@lilly_orlov	human
@r5bani	unknown
@macncheeseegy	unknown
@xkurox_y	human
@edenL05	org
@cup1023	human
@Desy_Mago	human
@Haru429	human
@The_Egg_Boy	human
@_karenmiller	human
@mypawsitivepet	human
@DCFoodieMom	org
@emiiha	human
@Aan_Silantoro	human
@egidiocarlino	unknown
@MaJoseMena	org
@TheProjectMaria	human
@Frank_TheBarber	human
@alieyaellisyaa	org
@laceywilliams08	human
@FlyGuy87	human
@diasdelili	human
@nagiisangpipol	human
@bdkDESIGN	human
@cindyhko	human
@abmayuge	human
@Halley_parr0t	human
@StarklintPR	human
@Bee_nantawan	human
@cliffjody_3008	unknown
@GabrielaDeleanu	human
@londonerbh	human
@carolific	human
@_OFSM	human
@kisanyans2	human
@leanbody4her	human
@rainingcakeblog	human
@BmSenger	human
@kimhonan	human
@HungryRadar	human
@isabella_mav	human
@lostluna	human
@Olof_Lagerkvist	human
@aldrinejuwell	human
@soniykris_mila	human
@weltkopfunter	org
@bitzofglitz	human
@qimphanerr	human
@Graceleu76	human
@vroomingonheels	unknown
@charlesjmusic	human
@Carlaingjuarez	human
@Vaneesa_Sade1	human
@leaniecg	human
@mcdonaldcade	human
@justinatwood3	human
@CQfluency	org
@Liazusa	human
@LorenzoDesimon6	unknown
@ashleyaang	human
@bigbrolic	human
@GreenlifeAVL	org
@sachieeex2780	human
@Runnin_The_Show	org
@TC__Photography	human
@vancityboi604	human
@dawnro1101	unknown
@radiohartlepool	human
@MandyCataldo	human
@Fivetopfive	org
@exo_1234_xoxo	human
@PlantoHappy	org
@RockyMtnSavings	org
@NutellaGlobal	org
@TiniHasyim	human
@TikiLoo_Bishes	org
@JuicingWA	human
@Orchid212B2	human
@ulilitem	unknown
@Sincerely_Beby	human
@QuothTheNOC	human
@sultryfoxiii	unknown
@katestylepetite	human
@giuliaelettrago	human
@TheDmvKING	unknown
@exfuzeevent	human
@alliegee319	human
@StreetFoodDubai	human
@fitnessinstyle	human
@kellym86	human
@monicaadianntan	unknown
@faithofhere	unknown
@MuhdFirdauz91	human
@AyyFcknBabyy	human
@maharanimas	unknown
@andrewhalverson	human
@doodledip4soup	human
@icklebuttongift	org
@IowaEggCouncil	org
@LovelyHorte	human
@pastorsgonewild	human
@Idealgoalweight	unknown
@linariyana10	human
@haycellel	org
@SpookiBelle	human
@IntegraJewels	human
@MacKensieG	human
@Karen_oxo	unknown
@Emmhhhaaa	unknown
@darthycdious	human
@ShangriLaShard	org
@kissa1022	human
@DelicatezzaUK	human
@KimberlyMonical	human
@OxAndAngela	org
@mikechai998	human
@carensababy	human
@Hiibaa_AR	unknown
@GriffinPubHx	unknown
@agnesagrifany	human
@iTomHarness	human
@FitnatKhara	org
@annsom	org
@chevysfreshmex	org
@ottoroman	human
@TravelEater	human
@Leah_Cevoli	human
@BangerMashChat	org
@GMoralesLozano	human
@nicapamela	human
@HuseyinGok6	human
@CollingwoodArms	org
@george_nadia	human
@MaryBrown55	human
@thephilishere	human
@carlo_gibertini	human
@ELPblog	human
@craigblize	human
@StirMarket	org
@HattyBeth	human
@DennisBogart	human
@ike_a2	human
@JudyTJP	human
@AnnaPeterTz	human
@KeepNk	human
@MuggyCupcakes	human
@sandy_sirikan	human
@starburstjewels	human
@Linetteg	human
@acgelai	human
@_aleeduran	org
@al921233	human
@host_bar	org
@mattgogal	human
@VILLABloorWest	human
@FollowbackJoker	unknown
@Cocina214	human
@Mihokuwano	human
@snitch1958	human
@marlniko	human
@iamsheanaB	human
@ArihyaZolanski	human
@kelseycombe	human
@azature	human
@euroatheart	human
@SouthDakotaBeef	human
@2sistascookin	human
@Iam_AwaisJamali	human
@freshgardenlive	org
@FreezeIntl	org
@herznah_	unknown
@WorkiLondonGirl	unknown
@drifterandgypsy	unknown
@DPDCA	org
@AyaTheAngel	human
@body_energy	org
@lynndseymour	human
@Chelsea_OToole	human
@LusciousVida	human
@RoLlops	human
@Embassy_es	human
@PastaBoyPeter	human
@Aqumi	human
@solarmanasia	org
@amda007	human
@HanaPurple_	unknown
@Chef_Madewell	human
@steens_ellen	human
@Wurth_Skidder	human
@xulfii	human
@YeeniiG	human
@melissaalbo	unknown
@TheBigGeek	org
@DavidBeylis	human
@jcjorn22	org
@chynadoll1178	org
@matthew1hickman	unknown
@MasterOfRimjobs	org
@ProperProtein	org
@KIMPITBULL123	human
@missYassyG	human
@_astoldbyginger	human
@iammitchdatuin	human
@Ofdamoda	human
@mr_foxi	human
@wiruutami	org
@barneyswife68	human
@lizafoxmusic	human
@alyssarimmer	human
@Maluxma	unknown
@katioli82	human
@jobloggs	unknown
@LisaMcCorrie	human
@central4858	human
@GlutenFreeBear	human
@gayguyfitness	unknown
@jralaire	human
@RougeWarrior	unknown
@snowted	unknown
@Malec89	human
@danniferkitchen	human
@Kat30x3	human
@oscar10bcn	org
@imdjencore	human
@JacLira22	human
@TinaViitala	human
@VinnyGuzgler	human
@Cat_Foley	human
@DeShonsCatering	human
@sengloh	org
@KathrynScuba	human
@bettymerry	org
@VovoteloDurban	org
@scorringrithoug	human
@co_oyaji	human
@iamrezzie	unknown
@sadiedoesit	human
@MaziNwoke	org
@FanAdriFonseca	human
@ClutchPR	org
@AniLidaa13	human
@Mechelle_Renee	org
@italiangirl_18	unknown
@ShutterBrugs	human
@camprockgracie	human
@N5Jess	human
@chefinter	human
@Idawatidarma	human
@ZuhairRosli	org
@harrenegade	org
@lorlee_mee	unknown
@Oriental_Lilly	org
@TheUAEobesity	human
@JustAGigoloCJ	human
@TressieLajoie	org
@ga6rielgan	human
@Adelientan	human
@raisagoBOOM	org
@areyouswedish	org
@RockinChris	human
@mpopat	human
@manel_chebbi20	human
@SubsoloSydney	org
@Dillon_Chong	human
@brouwertje	org
@bun_appetit	human
@corneliastcafe	org
@Code2Works	human
@PamPammyjean	human
@ctaicastle	human
@kumichop55	human
@uSEDNAb	unknown
@TLepianka	human
@EllenLevittEL	human
@Atlantalivejazz	human
@SproutedJourney	org
@KraseyFitBeauty	human
@william_rainer	human
@rakantani	human
@gieeharyadi	human
@chefseth43	human
@AnneBrownell	human
@pagkalaagan	human
@cathwoman27	unknown
@totheupside	human
@FoodGirlRobyn	org
@christmondbiano	human
@ReneNieuw	human
@poojou	human
@AzahelyC	human
@DeSmaakboutique	human
@thenewsroomhk	unknown
@subadoobadoo	human
@missssYgBrackin	human
@sanasultanpk	human
@Verona2490000	org
@NeuvooAustin	org
@mybagonline	org
@RougeTomateNYC	org
@patchworkdoll5	unknown
@GarconsFoulards	human
@AliJaneNYC	unknown
@SyazmirSaleh	unknown
@mallyk13	human
@lyansantiago	human
@alexisClissa	unknown
@Krystelabiassi	org
@BuntingJo	human
@mc859078	unknown
@kundayiaudrey	human
@JacintaJames	human
@willtk	human
@delano_jacobs	human
@monzie	unknown
@My_Sweet_Treats	unknown
@Kay_94_	human
@ClaireRohan	human
@JDCultour	unknown
@shaikhaLhawwal	human
@qielaira	human
@DWattMusic	human
@coffeeculture	org
@MarthaGr2011	human
@AwwkwardPenguin	human
@GlennAdhi	human
@ezrakrisna	org
@delphinite	human
@Valentin_Baez	human
@ZuzanavSchlippe	human
@IrlandeRussie	org
@LawrenceMoore	human
@jess_soundchick	human
@natnattkv	human
@JustRachel32	human
@MaxwellsNYC	org
@BeEnviedEnt	org
@MirandaatEB	org
@LasAngelesTimes	org
@itsmeSHARD	human
@KirbyTheodora	human
@sally0645	unknown
@Kondisyonum	human
@ALM3	human
@laura_valle	human
@CorinaCervant13	org
@tvxqxiah79123	unknown
@juanigaravaglia	human
@DarthShada	human
@helxne_	human
@missmaesen	human
@KINGPHILS	human
@monkeyboyzmum	human
@LucreziaMaggio	human
@EmilyARicher	human
@koo_0629	human
@VaishieD723	human
@OVO_Feeqah	unknown
@mayraelisam	human
@cheapwinecurius	human
@rlee13	org
@BlazesBeans	org
@sifumauro	human
@Spears91800	human
@xchulet	human
@haaaru38	human
@foodweneedfood	human
@dutchpancakesca	human
@infinitexsummer	human
@ECPictures	human
@MrPellizzoni	org
@I_LUV_HARMONIES	unknown
@ReverendSkulls	human
@rrussellauthor	human
@ABanera	human
@local_food	org
@AmandaDaniel	human
@xMissyy__	unknown
@KhamalMurray	human
@CassieKeefer	org
@ChaynesSW	human
@ViaJaneHong	human
@Serlini	org
@ato_warai	unknown
@sannexus	human
@WhiteCrossPub	org
@FirstPProvision	org
@healthyminders	org
@WhichNight	human
@TomHall	human
@Lunardiosa1	human
@LosKitchen	org
@stuffednstarved	human
@JohnnySurfDoggy	human
@fitria_airtif	org
@Farzaanah_R	human
@Edgarrodriguez5	human
@Tiffyluvs2sing	human
@tomesan329	human
@AlbertoQuintero	human
@tippfood	human
@monica_rahme	human
@SweetT16K	unknown
@_malibu_barbie	human
@SanAntonioMag	org
@EightyMPHMom	org
@HounslowChamCEO	human
@MeeshOneLove	human
@ShellebelleM	human
@moranhillel	human
@PaleoInPumps	org
@LisbethScharBay	unknown
@primokush	human
@serjie22	human
@GraftonCheese	org
@JaseSaltybeats	org
@Joshua_Morris20	human
@miyuuu1009	unknown
@CL711	human
@freshpicklondon	human
@suwondotriyanto	human
@Efendy_Balmain	org
@rodialskincare	org
@4r3v3r	human
@bunnydolly916	human
@Fannyladel97	human
@ViViLaChipie	human
@yhinchliffe	human
@shfaii3424	human
@p1s4	human
@TheLarderat36	human
@PauFlorencia	human
@_941010m	unknown
@angelynnsxt	human
@KarineDelage	org
@patoaya	human
@jolanigeria	human
@rturning	human
@SpinToneSweat	org
@fead_me	human
@LolalitaSV	human
@tomominakagawa	human
@MustSeeIran_Tr	human
@silly_old_sod	org
@formersize6	org
@jemscragg	org
@TelepanLocal	unknown
@GoldilocksSocks	org
@dyesebelita	human
@beautybygaby	human
@simoneink	human
@cckchengkai	unknown
@JohnnyValda	human
@Vevarude	unknown
@AmberKetchumRD	org
@Kathryn67	human
@regininhast	org
@mcrankchef	human
@bahar7791	human
@jodwats	human
@ujunkz	human
@Gypsy_Jellybean	human
@kxxs_x_sxx	unknown
@mamat555	human
@Its_MelPrado	human
@sexxyyROMe	human
@MobileNom	org
@magicrodmanzw	org
@RicardoNunes	human
@AkbarSeptian48	human
@jarvansalo	human
@goodlar	human
@TourTravelindo	human
@robo102	human
@hisaemomo	human
@LILLY_SPICE	human
@DANY1991	human
@theminnie	human
@StevenagePlus	org
@choppielovesher	org
@BeYouMissAlisha	human
@Swim_Gymwear	human
@LittleBabe84	human
@manualvarezto	human
@1WORLDWINE	human
@princessmisia	human
@ConnorPoole	human
@rousemaycordero	human
@meganewr	human
@LelandCK	human
@Januarygirl69	human
@kettlynp	unknown
@miss_niclou1	human
@idazzle	human
@haraheri_seijin	human
@modanapraticaa	human
@AlexandKateRTW	org
@Closeupdiary	human
@amktraining	human
@cutiefrance08	unknown
@IchigoOtaku	human
@iamRonaldDC	human
@baysabra	unknown
@SamuelNorinder	human
@humobar	org
@susanjzach	human
@andiDP24	human
@10Fitch	org
@laurita3180	org
@Debora_DM	human
@Kate_BagelNagle	human
@always_az	human
@stonybrookhouse	org
@Sugi_Rgopal	org
@ehvs_	human
@LannyMardono	org
@VIBE_ub_orange9	human
@PETER_SZETO	human
@TrinityWhitby	org
@DasLokal	human
@Kgam866	human
@ChefHaroldMoore	human
@tzeeck	human
@josekrlo	human
@TaraFougner	human
@TheLane15	org
@africafwl	org
@vij_nutjob	human
@OlgaVivenzio	human
@autumnlarryleaf	unknown
@WhatJoannaAte	human
@GoodallsKitchen	org
@RobertoEDelgado	human
@hart_marissa	human
@siMameiAko	human
@SchaepdryverB	human
@sarasuamaria	human
@BistroLiaison	org
@DianaSternberg	human
@LA7712	human
@raffygcanare	org
@bysarahh	human
@AshleyBever2	human
@SkippyMesirow	org
@SimplyNatalyy	unknown
@MarloCCalma	human
@Stacey1Smith	human
@carefreeorg	org
@CorOfTheSUN	human
@LorraineReiid	human
@LadyD_rdz	human
@LornaMcRae1	human
@RS_5150	human
@PorkandCo	org
@charmisgodsgift	human
@piratesfoodbalt	human
@theoc_life	org
@AMA_Honda	human
@Shellycom1	human
@NeuvooWestmins	unknown
@nienymuyashie	human
@841_chann	human
@DenizIzbul	human
@OkiSushiPa	org
@HeelenaHelena	human
@afarkhany	unknown
@dimstwit	human
@clodinJean16	unknown
@Julekha	human
@fullerdada	human
@Tyler_Sarry	human
@jayceethenerd	human
@Randy_Allmann	human
@omoshiro_Jf4MH	unknown
@mikkidelroio	human
@Chefmichou	org
@MaggieeMoonbeam	human
@VBEmeril	unknown
@MusulungoSosa	human
@Cinbeth4	human
@reika517	human
@conanwho	human
@Amberrpyott	unknown
@thegoddesscher	human
@bradleystovessu	human
@LeisurePerfect	org
@heyvincee	human
@lisalika	human
@titajessmd	human
@tenaj81	human
@Peileeloo	human
@MrBennyYau	human
@rihannapv	human
@MorningRoseCafe	human
@OfficialObeid	unknown
@WhatnotsAndFanc	human
@phepbu	org
@JaishreeSharad	org
@earvin_comora	human
@_atiya	unknown
@FrSeed2Stomach	human
@maritease	unknown
@mrstuartjames	human
@ianstevenong	human
@HZQzick	unknown
@AlleghSandwShop	org
@biggsdem	human
@TBCSHfield	org
@marshwigglegoth	human
@LStrengthStyle	human
@SimpleBirdie	org
@_no_name	human
@Lisa_Tuek92	human
@TSTB_blog	human
@lequeos3	human
@pagejeter	human
@EddieLovejoy	unknown
@BPRsocial	human
@denise_mb	human
@xxxtruong1	human
@WhoreDolls	org
@mugueto	human
@SnackOutLoud	org
@GudStufPhoto	human
@zaroob247	org
@10tiffany04	human
@RIGMUSICDREAM	org
@zibiru	org
@classicrouge	human
@BNI_Bridgewater	org
@AlishaAndChris1	human
@JordanAFarhart	human
@crafty_baking	human
@NoraHamsan	human
@Edlidza	unknown
@Best_Cooking	human
@magzink	human
@denizbalkin	org
@MiilaJuulia	human
@BookyMm	human
@AbsoluteAbsin	unknown
@praowproud	human
@SalvadoranPride	human
@Vancity_gossip	org
@JAjmnz	human
@Irazmi	human
@rebeccajubb	human
@DeniseLHeigl84	human
@TastePV	org
@NuuNokk	human
@tokitan_da_wan	human
@BernieDiaz921	human
@TrimmingsNdLace	org
@leandromulki	human
@LilHppyThoughtz	human
@LayneLovesTV	human
@MrLuvMrLuv	human
@vieviesilvie	human
@HONkenneth	human
@bastillebarva	org
@katiepinningt0n	unknown
@ALEXMOGTADERI	org
@wellsbones	human
@Prefeita	human
@meono81	human
@LuisSandovalJr	human
@BaronHotelsEgy	org
@malenadisapo	unknown
@miaaa_official	org
@OrganicRanchers	org
@ladienueda	unknown
@beckerliving	human
@ortensiadeloren	org
@clockingoff	unknown
@bellanguyen1191	human
@VoltFamilyMeal	org
@lawsonpriscill3	org
@Local_Cooking	org
@maryannerodis	human
@Annamariayo	human
@Candlewood	org
@boobearLOUIShyn	unknown
@RVAmag	human
@bastaschipoco	human
@Majimaboys	human
@green_eggplant	org
@btypes	human
@GetInkPR	org
@haokian	unknown
@___RealTedBundy	unknown
@SyranJohnHair	human
@SanFranPlaces	human
@Lisatochi	human
@Mllegima	org
@Sunset1Richmond	org
@missfrancesto	human
@AND_i_WANDER	human
@candyandink	human
@H2O_1STE	human
@mynamedany87	human
@Djoelj	human
@supriyasodhi	human
@dicktionary10	human
@dogtwittz	org
@missNormaJane	human
@DifusionGourmet	org
@LucaPery	org
@Delon82Marco	human
@BrendaLee713	human
@IAmArwinV	human
@dagrosso	unknown
@hippofede	human
@divi1401	org
@Melly_Herendic	unknown
@rbrtmcrthr	human
@spunky_ginger	human
@themisswblog	human
@BethanyDarr	unknown
@AnaiFdz	human
@chatthefat	org
@Sarah_Weeksey	human
@EmaliaNights	human
@ImYaBos	human
@mazyort	human
@andricksmandric	org
@RoderoChantelle	human
@Megan_A_Taylor	human
@jessica90088294	human
@FyreStarterz	human
@lingchef	human
@SashaSayazakura	human
@ralphysutton	unknown
@1_RedFridayLady	human
@naidoodenise	human
@JennaElizabethT	human
@missyblurkit	human
@IamtheEmpress	human
@bbcubico	human
@KatlegoMaboe	human
@Mera160982Mera	human
@meals_carnaby	org
@PolinaParty	human
@TheBalancingMom	human
@JPDelrosarioII	unknown
@xtinesone	human
@Darden_News	unknown
@DerbyOnPark	org
@MooteuyWhiz	human
@LaPetiteAussie	org
@Jennyy_08	unknown
@jayschuerman	human
@MJman01	human
@localnjfoods	org
@NadolnaWiktoria	human
@CShezza	human
@millieandmeg	human
@DokterBonny	org
@OrtegaChefboyrE	human
@bones_hki	org
@izzy1818t	human
@plhgirl2277	human
@RaykerBulan	human
@myquick_weight	unknown
@Nomdemode	human
@sassandsun	human
@Marcii_Avalos	human
@cuzzyofalot	org
@EdwinChiew26	unknown
@runwaysme	human
@marvision	human
@31Sutton	org
@itsmerackiebaby	human
@backstagedream	unknown
@906Taka	human
@Arigato_Sushi	org
@TradCookSchool	org
@FoodGasmHtown	org
@n4cer	human
@KakeExpectation	unknown
@VividCherubic	unknown
@kayleyguy94	human
@lulubritty	human
@EldyBartowski	human
@ly431994	human
@moxamedsaid2	human
@missmarinicole_	human
@wisatabaliyuk	human
@allyferns	human
@sondang920	human
@IconGH	human
@hahavibin	human
@miss_aliice	unknown
@HB_Asset	unknown
@Juli_174	human
@lexsixstrings	human
@MyriamDjelouat	org
@stephberryumyum	human
@tanhuiyi	human
@BleedingTeal	human
@AlixElizabethG	unknown
@NivenKunz	org
@ByAshleyMarie	human
@KikiMiyars	human
@ais_dreamz	human
@Herzensdiva	human
@bin1301	org
@_Sammy_Jay_	human
@Sarah_Mjs	human
@falcolieschkesk	human
@killaine	human
@dog78124	human
@TB3Omaha	org
@BlindPlatypus1	unknown
@kitchenplaygrnd	org
@madoka_aus	unknown
@MyCookingSecret	org
@bohemian_me	human
@paulskidac	unknown
@NaomiZLevey	human
@MikeLoBurgio	org
@barisduzgoren	human
@BwareOfKoko	human
@Farina_Samsudin	unknown
@jillyscupcake	org
@macykins1	human
@tanatwin_reo	human
@chy_ntia	human
@DAN_COL	human
@JoshuaLeoCobb	human
@selinaphy94	unknown
@ringconexrarea1	unknown
@juanapt	human
@amandarrom	human
@ooleen	human
@Six_Seven	org
@_selinmelin	human
@eibhlin_munster	human
@EmmaLouise28x	human
@TheRealH3r	unknown
@sayakahiruma	human
@diyiviai	human
@ViBE_ub_apple7	human
@mintelf137	human
@laplayeraN1	human
@ninoska_cp	human
@YukoGen	human
@CountryRoads35	human
@healthekabim	org
@xaylinx3	human
@AbelArana	human
@SarahTait9	human
@Rine0513	human
@rudi_nopriadi	human
@SmokinHerbz1	human
@julzbrooklyn	unknown
@kelvincruzn	human
@NSH_Joden	human
@Rosiee_Thomas	human
@theblackcape	human
@aim2bhuman	human
@putriviranti	human
@TheJetPackMoves	human
@kurohera	human
@ddavis317	org
@Yanita_99	human
@GeorginaTDC	human
@DChirilco	human
@souk_voraphet	human
@ZakirUddinAhmed	human
@Charddd	human
@HebaaKarim	org
@amynelson013	human
@catarinafrancoo	human
@Lwolf79	human
@work_hard247	human
@HerbertPaul2	human
@agelovesiopao	human
@raynavihuela	human
@_yes2life	human
@1goebel	human
@WholeFoodsABQ	org
@jrgamotin	unknown
@Willia11	human
@kylepjennings	human
@PECO439	human
@NickiSabatino	human
@Zanmif	human
@gords2004	human
@Oggis_MValley	org
@vanessaNortiz	human
@tvntweets	unknown
@WingKiLam	human
@_Skrill	unknown
@cencensuburban	unknown
@sceavola	unknown
@choose901	human
@RebeccaArnesen	human
@Quinoatogo	org
@RussellHobbsFra	human
@Chloe_novelli	human
@SammyWrites	human
@RandyMeiro	unknown
@Billies_TongUK	org
@iamshahrule	human
@SpanishMarker	human
@jevieestrada	human
@WaterLibertyRC	org
@keniaryne	unknown
@ryuscrap	human
@pstephens26	org
@ACorporateChef	human
@SG_Lin	human
@SocialBarLounge	org
@littlewhitecafe	human
@KaariineeMK	org
@i_magene	human
@FoodieEshe	human
@HallieSalmi	human
@NeuvooMedford	org
@jfunk78	human
@CrazyChanese	human
@dgraaff87	human
@Littletissimo	org
@TVDPoland	org
@savethecatx	org
@katiemae_beader	org
@skinnywrapsAsh	human
@misstiur	human
@UnicaHijaG	human
@HotelNikkoSF	human
@JuicyTastyMeat	human
@lemonpressack	org
@picnic_la	org
@RoofTopHHI	org
@uamumagoya	unknown
@Beckyj89	human
@rodzajowo	human
@FreezeAlmighty_	human
@LeylaBrunton	human
@ex0120yuli	human
@cwpabon002	org
@BruhLuuhMusic	human
@asmidarmat	human
@StirItUpStAug	human
@OSMAN_M	human
@IamAPacifist	org
@WyndhamWestward	org
@RefractReflect	org
@CHRISTABELS_	human
@sammi_jo110	human
@ondejeune	human
@TwinRLee	human
@HillaryofTroy	human
@KristinApple24	human
@Pei_Hsien	human
@xinhonglee	unknown
@Reteresa	human
@hinakosato	human
@ceylancelikk	unknown
@radiokitchentw	human
@IlkkaUtari	unknown
@ElaEsBella100	unknown
@KeniaWriter	unknown
@25ghee	unknown
@foodspirationNL	org
@Carmelinadeals	human
@JuanMaOP	human
@brycewiatrak	human
@triplepx3	human
@wifibd	org
@arcadiahomecare	org
@SayaCrazy	human
@hanabefgkd	unknown
@WahleeahSW6	org
@Mkr1117	org
@lovfoodlovitaly	org
@itsjustd_	human
@SyafiqChipmunk	unknown
@yoniiix	human
@KitTayyem	human
@lulucreates	human
@infinebalance	human
@ROSEinthePARK	human
@nakimouri	human
@timsolshop	human
@TenBellsMeri	human
@MancBarGuide	org
@JaciWalker	human
@Teni_Meranti	human
@ARainbowGirl	human
@KELLEYandPING	org
@LaBelleCarte	human
@daty_slopez	human
@ashinator88	human
@Oven_Pride	unknown
@MADa4n2a0	human
@frfxd	unknown
@poseidon_ashore	human
@CorriMcFadden	org
@sharmachic	unknown
@rinachan0414	org
@I_wine_ALOT	unknown
@JCAdlef	org
@Gena_Tan	human
@250SquareCoffee	human
@shitxbullshit	unknown
@scarlett_burton	human
@Kstrobel92	human
@czicardi6	unknown
@zhamil87	human
@KING_Jyu	human
@Hustle_123	human
@kanettkaa	human
@coffeemeow	human
@LotusSchool	human
@apartment_bar	org
@YellowMachinePR	org
@OnePerySquare	human
@ontellmimilolo	human
@RichardNDiA	human
@FreresBistro	org
@fahmimadjid	human
@Kuryach	human
@lkwtsrongtsnlas	org
@FollowWIN	human
@dyingforkyumin	org
@Cyrhiza	human
@NeuvooLakewood	org
@AnnaRever	human
@MaemaeGumban	human
@Pom_suwandee	human
@ayyeitsmaark	human
@titanmusic09	unknown
@360Burger	human
@Agustinacacers	human
@Bantanamo_bay	human
@041494rai	human
@NicoleMicallef6	human
@aska523	human
@imaginativejess	human
@wendyleeherman	human
@DolceLuna1981	human
@boenga_lily	org
@ilovelili	human
@NeuvooHorsham	org
@foodiehoon	human
@tamasbocsi	human
@cocopaglieri	human
@MealsKidsLove	org
@shikhalamode	human
@rubyso	human
@NoelleWiley	human
@jovadou	human
@ChadwickHalse	human
@martin_GZ	human
@Alliss0nA	human
@Ntrendsic	human
@aknnn_	human
@andrigunaw	human
@chris_human	human
@bubbleskp18	human
@wease1	human
@Havi_Official	human
@TamaraParry	human
@XOXOPIMPIMXOXO	human
@thebradleyhall	human
@StayFitMomBlog	human
@VanessaGurtler	human
@thebraeburn	org
@FinnL_	unknown
@ThePixelAgent	org
@TheQueenAidita	org
@chocfullokat	human
@SmokeHouseNG	org
@jamesrichardong	human
@HerbalifeCoachM	unknown
@Livetradingnews	org
@Swamper60	human
@DrJames_007	org
@PhyMendez	human
@NutriNeRD	human
@mrgunplastudio	org
@rebuzzme	org
@ChaneleBarbieR	human
@rzc2007	human
@donvts	human
@tymarwildtree	human
@Silanstudio	org
@MontalesLemon	human
@DineHard	human
@TheCitizenWorld	org
@eltalchelo	human
@zackylive	human
@DaNewYorkTimes	human
@JoannaMSvard	human
@nomotivphoto	human
@GustavoAbraham	human
@MommyinMKE	human
@JohnMasiulionis	human
@tjlammoor	human
@HenkCoZz	human
@LuiePink	human
@NichoNick	human
@GoKuPoP017	human
@histography	human
@xavierPintoG	human
@Michigc_	human
@CafeBarcola	unknown
@AndreaWyland	human
@AndreiaTristao	human
@HeatherParker01	human
@Goezt_BaekHo	unknown
@TeamTDiddy	human
@luda_shevchenko	human
@days_healthiest	human
@kris18u_	human
@InspiresMi	human
@raquelsmadrid	human
@MikeyDaRoza	org
@sherrelljia45	org
@StacyMonacelli	org
@froudza2108	human
@ChapterSC	human
@Foodee_TO	org
@utmarketers	human
@Fashion_Tailor	human
@MilaMiloo12	human
@phillboda	human
@mikemothafuckah	human
@kalin_le	org
@CookShopsa	human
@BodhiFit	human
@plasticgrasp	human
@pinkybaby_jade	human
@knit_tea	human
@cynthiawidjajaa	human
@RonaldTannur1	human
@iowhistoryguy	human
@Keith_McPherson	human
@5280Meat	human
@eatlastminute	unknown
@SkinnyMeAlive	human
@Ikuma_Taste	human
@ITYIYBMAB	human
@xrahmathekiehlx	org
@CharmeSilkiner	human
@zfei83	human
@TrendsnHealth	org
@jwanslow	org
@GlamoliciousAU	human
@meekflora	human
@DecoratingDork	human
@buurmeisjekookt	human
@foodieindublin	human
@healthdesigns	org
@Y_Wong	unknown
@NatsuNiimura	human
@dajekevin	human
@lupita_alvarado	human
@AyannaOliva	human
@TatiOnYourRadio	org
@FizzleDollas	human
@BBNOttawa	org
@_y0826y	human
@Manith_Ransara	unknown
@CarmenaFreiha	human
@LevDebra	human
@Kaylaaa_Jean	unknown
@qw_156	unknown
@HarmonsDoll	unknown
@mhapriso	human
@PM_coto	unknown
@albamandujano55	human
@MissLJBeauty	human
@whatscookinglov	org
@OleanGoodTimes	org
@EDPimages	human
@DariusJBrown	human
@PedrOrmazabal	human
@FoodFamFitness	human
@wilderabbit	human
@CantinaAustin	human
@vitin_fs	human
@brianc0z	unknown
@Fienra	unknown
@thelovelyfoodco	human
@Tiffany_DODO	human
@starnite87	human
@BeaCreativeBex	human
@kimdeoncom	human
@friendlife4	human
@Azzah72	human
@AnnalenaG97	human
@meetPHL	org
@eugeneraetaiyae	unknown
@StyleMyParty	human
@melthousebistro	org
@abobbers	org
@tuyidee	human
@toshei	human
@thelearnjourney	human
@xin1611	human
@adbachmann	human
@erlizanuzuliar	unknown
@sniperwong	human
@payahyah_	human
@ItsArki	org
@MainLineToday	human
@drenredfox	human
@HisDaughter	human
@eatrightPA	human
@1sexNdrugs	human
@hayleymusson92	human
@Marcellonator	org
@JustSnacksAU	human
@engineermataRAI	human
@hazelcih	human
@andys2140	human
@TheShirazine	human
@JessicaS_Gold	human
@LAnisimov	human
@dprihodko	human
@Allyson_gibson	human
@RickyKellogg	human
@xladyofsorrowx	unknown
@slinnitt40fit	human
@IaraAbrilSoldat	human
@DrMoriole	human
@Blue_Mesa_Grill	org
@YoffieLife	human
@evinschmevin	human
@anfavoris	human
@askinnyproject	unknown
@BestinManila	org
@_ChloePoynton	org
@Vtk1234	org
@_reiiina_	unknown
@Kikitrish_	unknown
@MegTucker1	human
@PalmaTeaHome	unknown
@lash__love	unknown
@jackietopolRD	org
@volutology	unknown
@valentine_annie	human
@DotyRandal	unknown
@semi_vegetarian	human
@JuRondan	org
@michka1	human
@Twitbulk	org
@PennaeForchetta	human
@dancinginblack	human
@Andi_Roo91	unknown
@SyasyaWilly	human
@MarycelyV	human
@mylifecookbook	human
@uLheanovyta	org
@morning_squeeze	org
@DonnaBrrooks	human
@MyRumorist	org
@sacolando	human
@ellieshrampt	human
@peterjwu	human
@waleed_yacoob	human
@kristitrolinger	human
@MadelinC	human
@BeverleyRyles	org
@miyachanroom	human
@TheRealMissH	human
@VeggyKart	org
@AbyMalykesFA	human
@johnnyday76	human
@agurbani	human
@HalidaRahmilla	unknown
@leish823	human
@old_n_high	human
@LouRetroWife	unknown
@cheddar_and_co	org
@ceaciliangela	unknown
@joehartbags	human
@TheWillDon	human
@itsellenramos	human
@goldndawn	org
@Flyyour	human
@DelonghiSA	org
@chem_575	unknown
@fireandshine	org
@foodat52	org
@thestyland	org
@BrasserieCassis	org
@Cajundog3	human
@adzizi	human
@roslynhernandez	org
@chriizee	unknown
@KnysnaTravel	org
@mbrown_beauty	human
@hagglane	human
@FoodLoversDlite	org
@Benny_C	human
@We_Are_Aspire	org
@airytweet	org
@mehmetskorhan	human
@SocialSecretUK	human
@beachbaby1528	human
@pravinaldo	human
@just_anothermom	unknown
@Fierce_Blogs	org
@ottpak	human
@HeatHotSauce	org
@Pasta_Felicetti	org
@MariMarJ_aw	human
@bforbsheffield	org
@JoParker0203	human
@Lunarsupplies	human
@christinatv	human
@UNKLELOOP	human
@Aneiszka	human
@PreawTon	human
@Toni1777	org
@HertsChamber	human
@gymbunnytweets	human
@KelseN217	human
@abceypril	human
@buzzincebu	org
@azevaperth	human
@Bryan_MarqueeLV	human
@astcarolanne	human
@PolarMarketingO	human
@ChefCityCorp	human
@yk_melo_13	unknown
@NikG_is_Me	unknown
@CindyClaireTan	unknown
@nitrisofficial	human
@nathanmanderson	human
@The_Nicole_Chiu	unknown
@apw1975	human
@fruit_fibres	org
@ctsalizaadnan	human
@EricaAYGem	human
@guilleglezwilly	human
@KristelMad	human
@Natitaxo	human
@Grasshoper83	human
@OnigiriSocietyE	org
@ScopeStream	org
@BroodjeMeppel	org
@PatrickLeung666	human
@julievelife	unknown
@victoria_thomp	human
@aliahilyana	human
@thisisshazz	human
@LMRfit	human
@FernandaZorzal	human
@rastalope1876	human
@DJ_Enygma	human
@nurdzanahrisa	human
@jennzia	human
@C0NT4B0T	human
@BarbSRI	human
@Farid_adjah	human
@erinmaynie	human
@_paulina92	human
@MaritaPena	human
@aiiiii0811	human
@shanksterz	org
@Mucon19	unknown
@nilesite	human
@stephanie_Foley	human
@GlidingTheLily	human
@rolypolypcola	org
@d_r_e_v	human
@reconWarehouse	human
@RiiaIW	org
@91X	human
@Hanson8046	human
@garyxujiayuan	human
@BRXVNGLSTXYZ	org
@funnyloveblog	human
@gaigreengirl	human
@Donya_Mullins	human
@sophiereeves1	human
@Gerrupta	org
@JacQueenT	human
@justmeyesnikis	human
@SandraCohen_	human
@leagron_	human
@TTTashia1	human
@missgo2girl	human
@ReneeLHK	human
@CafeAllAngolo	org
@MasterPrint266	human
@paxxman	human
@phonphokkun	human
@tcm007	human
@_sheena	org
@mindofkennedy	human
@hungryhiba	human
@zatsugaku_warai	unknown
@Andrew4ever32	human
@working_chix	human
@CarloRandall	human
@NisasMommy_2010	unknown
@glinfymc	org
@ModianiKitchens	human
@Mexxbear	human
@JhonVilchez9	unknown
@Kanokomi	human
@crumbs_curds	human
@BS_Isabelle	human
@welovencl	human
@tablelocal	org
@0226Minori	unknown
@dcanoli	human
@keichan0513	human
@PBarone_mundial	human
@sarahyoga	human
@Jhe1015	human
@DongBangShinhwa	human
@RamblersBeekman	org
@entwellbeing	org
@MarkAChilders	human
@BreakfastBig	org
@doughallrdh	human
@ViBE_ub_apple10	human
@PirerMercado	human
@TFCFan	human
@chocoladdict	org
@IAMZAYCOUSINS	unknown
@Cathedral_73	org
@laurakate21	human
@Finna_DFlov	org
@mountsomersetGM	human
@thejuliakitchen	human
@arisachan0902	human
@mo_ri_wosagase	human
@yullippe	human
@HesperiaResorts	org
@YouBabyMeMummy	human
@lushiouseats	unknown
@cuisinefarfadet	org
@Andycantuc	human
@TIESTICKNYC	org
@GabrielleStone	human
@andreagaranto	human
@MelWakeman2	human
@Mass_Mashitah	unknown
@great_sisca	unknown
@GroveRoadCafe	org
@jackchad	human
@aybanhiro	human
@mloar5	human
@miora_Xmas	unknown
@TheFoodHe	unknown
@Ivna_Cunha	unknown
@SocialAdderNet	org
@ChefShaneP	human
@sandyanesz	human
@ryria3mama	human
@ElizabethRyba	human
@kim_soohwa	human
@yokolmemaybe	human
@Skye_Mahoney	human
@HitZol	human
@donaldsng	unknown
@MadamSamary	human
@carltonjones212	human
@SafiyahBasir	human
@anzuko217	unknown
@magnoliawraps	unknown
@bethtia28	unknown
@MauroMast	org
@perliis	human
@StephNettyPrice	human
@gregorygomez2	human
@loredanarigato	human
@chezzalau	human
@spitsnpiecesAU	org
@neclakaraova	human
@jieha_91	human
@BieberQuotweets	unknown
@dhobbies30	org
@schuhPR	org
@HogaoBistro	org
@Jordanfan215	human
@yana23654552	human
@madamexicaras	human
@FolkArtAtlanta	org
@ToniSabStyle	human
@VmpAnna	human
@StefJonesPR	org
@wave105radio	org
@eden_levine	human
@jonhanlan	org
@relishdress	human
@gabycambero	human
@Frazers_STL	unknown
@tinagiana	human
@florrync1808	human
@LunaticMomma1	human
@garickgoh	human
@chamrestaurants	org
@bernardtzing	human
@mehv33n	unknown
@Ananty_Maya	human
@lailpimada	human
@VJupdates	org
@kevinatawr	human
@FoodCarlisle	org
@franklinyeahh_	human
@friarsclub	human
@chloe6elizabeth	unknown
@Anjaneve81	human
@JezamaryM	human
@viva_la_prawnio	human
@puripuri123456	unknown
@noonaLintang	unknown
@dozfy	human
@vibrantveg	org
@Kartsi76	human
@nori_358	human
@amibradja	human
@cadencealexx	human
@ONTHEBORDERSD	org
@rhenzoaxel25	unknown
@EpochDining	unknown
@Scally1804	human
@sanaijo	org
@LizeeAngel	human
@Tuptus_Charlie	human
@kingoftroy011	human
@SunnyGreenBfam	human
@TBritophile	unknown
@winnysvd	human
@raythedesigner	human
@antony_fuentes	org
@mskeecole	unknown
@BlogCarrieOn	human
@mizuho133	human
@leanonlamb	org
@ttkvenice	org
@chabasobakery	human
@vrundachotalia	human
@PizzeriaSerio	human
@MatildaEkwall	human
@tamanraudah	org
@HardRockHotelLV	human
@monika_kamila	human
@cherivoce	human
@FafahHalifah	human
@SantiagoArana22	org
@Louis_JV	human
@pmhodg	org
@lemongddss	human
@thevegasindex	human
@malpyooon	human
@Silvito0	human
@Milestones5208	human
@tmmaihg	human
@MiaZatiey	unknown
@crystalleecious	human
@IchongiriBC	human
@kevwhartman	human
@PaulaSkyesA	human
@_e_l_y_s_i_u_m_	unknown
@SOPERALISHA	human
@JaniceBissex	human
@BedrockRES	org
@evitamins	org
@LokiMonroe	human
@cookingforkeeps	human
@meohmy005	human
@bernieharwood	human
@echa_shalom	human
@Jing_Lyj	unknown
@louizeeeeee	unknown
@PurpEverything	unknown
@That_Whisky_Guy	human
@Mhaey03	human
@spice_cadet	unknown
@bounty_2006	human
@chrisroe	human
@NoVaCk_3893	human
@FelixxxGerardoo	unknown
@AmyPaulussen	human
@ItsNikkiBelle	human
@uedomaro	human
@Jonesy843	org
@spilledout	human
@dehchoapaulo	human
@Chika935	org
@DiurnoMadrid	org
@WFMBradburn	org
@GranvilleMoores	human
@TKinStyle	org
@LoungeDeco	human
@supermau1418	human
@Figue_Sardine	human
@CheapRecipeBlog	org
@IoannaSka	human
@itsreegsbitch	human
@puredigitalmaui	human
@LoveJAYAMuch	human
@eL_iCy24	human
@cuppakeQueen	human
@maikoolet	human
@Teedot_ca	unknown
@smartservehpl	org
@Ard_dhie	human
@Ali_Mel96	unknown
@avavaaaa	human
@roielle007	human
@Bellevue_Philly	unknown
@REVFOODS	human
@Mx2rawr	unknown
@KaliChocolatay	human
@Generous_George	human
@Only1Summer	human
@SheaFresh84	human
@redheadplease	human
@MofireMMA	human
@KatyG_unit	human
@colintants	human
@BrigitteWhoa	org
@Miller_Time79	human
@TheNYWino	human
@p_nadiia	human
@Stephanie_Rand	unknown
@cabeludoaraujo	human
@Olevolos	human
@daffneemichelle	human
@testaproduceinc	human
@kucukmutfaksir	unknown
@Vinrgy	org
@goyqks65lb43	unknown
@JerJerryl	unknown
@iqbalhareez	org
@saritablume	unknown
@HeyBethBentley	unknown
@alingles	unknown
@MeyAlways	human
@OlinskiSnyders	unknown
@IainSBeattie	human
@taste_tempting	org
@SavorDallasTX	org
@globalnewyorker	human
@Vicky7787	unknown
@MauColCh	unknown
@Devon_Hour	human
@PuiFaiKtn	human
@SarahNicoleHill	human
@EDInteractive89	human
@nanakoma77	human
@missjaneinhk	human
@danielaceravolo	human
@SicaPermata	human
@howelibrary	org
@HertsHour	org
@CookWithAmber	human
@bot49055778	unknown
@allergicgirl	human
@CrazyGooseBar	human
@BarceloPV	human
@wisebarbecue	org
@DarcHawkins	human
@freefromfusion	human
@Emmahumfrey	org
@FarmersFridge	human
@HuiChiChin	human
@trailboss_	human
@danielace95	human
@AlyssaBeattiexx	human
@DeepSouthDish	human
@NikkiNormal	human
@MaroBradshaw	human
@derek_leung	human
@MeLadyLuna	human
@LesleyFitz24	unknown
@chefscollab	org
@nemuminebula	human
@annikaanchor	human
@blogciaotutti	org
@yantii_yan	human
@hardzy_bfg	unknown
@kevangelina	unknown
@AsyikinMF	unknown
@jaemsoto	human
@julessulls	human
@pocbooks	human
@CPriyadarshini	human
@Bakebydayhk	org
@Moin7601	human
@ChopeHK	human
@Care4MyToddlers	human
@Rb_fitnessclub	human
@maereemae	human
@janepfrank	human
@TheCleanMethod	org
@ViBiOh	human
@mustardwench21	human
@SiriNYC	human
@RADskillZ	human
@Mayji_tangmay	human
@LAFitness	org
@Niinaame	human
@RioBarEssex	org
@slSakurako	org
@Natanaelmona	org
@TramVu12	human
@chefscatoris	human
@truhistory	human
@JaKapsalis	human
@AlexandraMC4706	org
@_FitRiss	unknown
@EdwardChenMusic	human
@Johnnyontheroxx	human
@marylyne89	human
@yeungisaac	human
@JCimock	human
@nouman1988	human
@TheDiMarcoActor	human
@dhaniearie	human
@dilema_A	unknown
@RussellHobbsSA	org
@Menteanah	human
@forkmylifechi	human
@arielleksy	unknown
@ADG_IQ	human
@Simooo03	unknown
@KareemTooReal	human
@urichan16	unknown
@Edgar_GoldenBoy	human
@EahmYu	human
@Not_YO_Averagee	human
@janwarhamid	unknown
@Elenita_Corazon	human
@InnoCordero	unknown
@ThePerezCuisine	human
@tuscandreamwed	org
@lee_Bluee	human
@anatorrescruz	human
@vicusgalaico	human
@khariharan1234	human
@mine_momsen	org
@MardeCavaBCN	org
@ImAbigaillynn	human
@maryminx_blog	unknown
@RdBluBoulogne	human
@rilectro	human
@nicacomandao	unknown
@victorhaldana	human
@donlauwhincky	human
@karen_ruffle	human
@hicamphoto	human
@HeleneOrr	human
@mystagetips	org
@SugarHutCafe	org
@TastrzClub	human
@BurtonAlison	org
@kyoran_chii	unknown
@icampayno	human
@KaneeYuu	human
@sariajb	human
@GP_WildBoar	human
@JurajRecky	human
@snuggleytime	human
@MajesticArjaan	org
@jackwhite2015	human
@syafilahnain	human
@DoreenLamoureux	human
@ThePlantBase	org
@VinlandMaine	org
@emersonlopz	human
@mikkibenaglia	human
@JessJesVin	unknown
@mallorycanteven	human
@TheyLoveHerShey	human
@alicia_carvalh0	human
@GoProGirlMiami	human
@GiaKaren	human
@BazohShabalala	human
@FW_Warehousing	org
@JuliaenlaOrilla	human
@OfficialMaleeka	human
@HotelQueensGate	human
@GiorgiaBurighel	human
@isutave	human
@Beckhy_Ridwan	human
@JadeRapsey	human
@vonwienen	human
@bramschristian	human
@LPT5	org
@L_chelsea_T	human
@GoogleNoodles	human
@other_R1u3Y	unknown
@bogdanborza	human
@AlisonColdridge	human
@nika011	human
@kuhreeng	unknown
@CeeDotKaay	human
@hartslief	unknown
@meshaseville	human
@SALancaster	human
@Desmond8839	human
@ryantologyz	human
@Dashkita	human
@cookieDOnyc	human
@missyJDev	unknown
@lifewithheidig	human
@FabriMontemagno	human
@JUSTKISSIT	human
@erinanastacia	human
@sandralbutler	human
@PB_and_Jaleh	human
@BeccaFeher	human
@LoveSweatBeers	unknown
@MiggyBangs	unknown
@VillaMahal	human
@PlatinumHousewi	human
@reikapi	human
@yanihamdan	human
@Kiankunn	unknown
@ixlr8a67	human
@_Pushthelimit	unknown
@Prevagen	org
@tequila_anejo	human
@_LynnT_	human
@PrettyRumour	human
@Iejasajjer	unknown
@sorayismo	human
@faviavongal	unknown
@SuzasuSuu	human
@cockyone	human
@dhonskhie29	org
@kiyomin	org
@GlasgowBaker	org
@CBGoode_	unknown
@SuperMajHilario	human
@Flipside_PR	human
@rui_kotobuki	human
@Roxanne_Barton	human
@rumi_72	human
@queensheadhp10	org
@LAXSmallBiz	human
@CercoSocioIT	org
@guillembaches	human
@livingtuner	human
@essentialnice	human
@famousladyv	unknown
@MalSannie	human
@nessaussie	org
@venusqinz	human
@EatMoreOfIt	org
@babberly	org
@statepix	org
@RunnelsDaphney	human
@ltparty	human
@ForkstoFeet	human
@chibiliciousMe	human
@untilnxttime	org
@AnabelaBartolo	human
@Gottara	human
@KyleWilliams923	human
@JempsonSMT	human
@Jr_Roc_Chila	human
@noopurke	human
@CraigBradbery	org
@mara_dy	human
@PinkPrincess	human
@YousraMokadem	human
@VillaCoraHotel	human
@itsjasonsantos	human
@TheJasonHodge	human
@VipCondensed	org
@ElDoradoSonoma	org
@MissScubaru	human
@geeemwhizz	human
@yunussuyanto	human
@chloesfruit	org
@jenniferwalsh9	human
@Dopdops	human
@WeCanBegin2Feed	org
@PODandSEED	human
@bearoxshott	org
@cinemusiques	human
@aina_lim	human
@pinchandswirl	org
@connieyaoyao	human
@ChableLetty	unknown
@300914_	unknown
@oria77	org
@BriscoKimmyJr	human
@QpidRox	human
@siriusbintang	human
@ilLambrusco	org
@Rosalyn_Vincent	human
@James_Barley	human
@kaloymanlapus	unknown
@ria2895	human
@SohoHypeLondon	org
@loveshoppingg	human
@powerpuffkmo	unknown
@LucasKnows	human
@dicoupey	human
@BoltsVoltage	human
@Brenuloza	human
@PhoetiqueInc	org
@mimieizwanie	unknown
@pebbles0017	human
@zain_zera	human
@YoukoLi	human
@GoodFoodguyd	unknown
@sarah_ryder	human
@hkel	human
@RatihNingtyas	unknown
@Torecittaro	human
@sweatlife_nyc	human
@Herbert_Oh	human
@inloveinlovexo	unknown
@JimmyPlayground	human
@rohaanmohanty	human
@PalaisMed	human
@biscuits_pieces	human
@BOSSKaaaye	unknown
@Rachel_Yesicca	human
@MiniMallKids	human
@slimanetirera	human
@asnanid	human
@tanyawastaken	human
@kokidao	human
@kikeguadarismo	human
@bobbysburgerpal	org
@valemartino016	human
@JohnnyAbdallah	org
@Elisa_defi15	human
@super_adz	human
@WhyJalil	unknown
@PilyHearts	human
@RyanKitto	human
@Julie_Ent	human
@bhatta_sarita	human
@SaoirseKennelly	human
@GrocerandGrind	human
@LaughsnLollies	human
@HamZaPsha	human
@14andhudson	org
@ScorpianQueen24	human
@HeatherHomaXo	human
@ClaudiaTaganas	human
@haandldhaoi	unknown
@KaderBennacer	human
@graciiermha	human
@PattyLobert	unknown
@StacyFequiere	human
@EmShergy	human
@paulamascaros	unknown
@tlc_sta8ments	human
@KatysBeauty87	human
@eDithGalaG	human
@francislourona	human
@rosiesuz	human
@tnaks10	human
@bakingbluenoser	human
@farahbaba	human
@alexlefa04	human
@E_Money_Otaku	human
@paulapereiratv	human
@chloecharlet	human
@christelelliott	human
@AidensCuisine	org
@foodrecipe1on1	org
@nyaan03	human
@wicked_clay	human
@AZIAN_P_PRODZ	unknown
@bluebirdtrini	human
@CantinaBoulder	human
@Shut0chan	human
@TheRealSaraM	unknown
@paulwellen	human
@_MJWood_	org
@daegeunlee	human
@eye_am_me	human
@pershingsquare1	org
@mycoopwestheath	human
@BillPosters101	human
@style4lunch	human
@foodfindrUK	org
@myxtine	human
@JaoJuico11	human
@FrankSpedooch	human
@AndreaNimchuk	human
@CHAN3L5	human
@jar7166	human
@ultimatevofme	human
@ShoeDaydreams	human
@jaimerenealmagu	human
@flykoreanhoney	human
@Hot_Dog_Carts	human
@CajunInATruck	org
@ChefPeterAng	human
@senrigan0515	org
@DiaaRivera	human
@lovenicebeach	human
@MamaLoloCooks	org
@samkriswan	human
@PHOBIAtheDON	human
@Beaa_Beltran	human
@thekarihoshi	human
@devyavj	org
@snappylifestyle	org
@LadyChefM	unknown
@V_Shubayeva	human
@cswils85	human
@PrincessNibz	unknown
@maxfiumajunior	human
@TeresaVining	human
@DancinginLife	human
@Park_Panchalee	human
@bigTssanjose	human
@floralmouse67	human
@kouchoutama	human
@Amberlicious_xo	human
@Darv3352	human
@NtombelaB	org
@h24_lindsey	human
@Linda_Loebiez	human
@JadeProbitts	human
@luncherito	human
@ThickFineLibra	human
@RawliciousTribe	org
@myinnershakti	org
@avadakedagron	human
@ebhiebuncidtt	unknown
@NadielEllis	org
@redbaron2358	unknown
@seaningrum	org
@cate1612	human
@Ella_Bussey	human
@FlorenceVanM	human
@SDeVoretz	human
@yumi133727	human
@firatdgn	human
@einstrxx	human
@loveme_art	unknown
@GenCervero	human
@bakinaccountnt	org
@winadajcie	human
@firmas_s	human
@silviaz80	human
@Kasie__K	org
@HalpinEmily	human
@JudyRector2	unknown
@AGINNYC	unknown
@andrewnbagman	human
@lindyloo79	human
@olwoodsy	human
@Lizzie_Mackay	human
@BrookBakeryLtd	org
@fairyblue62	human
@MireilleChester	human
@benhamslc	human
@ilseheutink	human
@JBLover95xxx	human
@Ame_Gijs	org
@RODCAFX	human
@QldChoiceMeats	org
@Raaiye	human
@alextoshie	unknown
@FourPointsBali	org
@OnAirJordan	org
@shane_tetsu	human
@shamdeity	human
@DhindzTiamzon	human
@paleoplan	org
@volinda93	human
@ricksdhillon	human
@where_is_shie	human
@SaraZakhour	unknown
@yuhimaruGT	unknown
@AaronChowXin	human
@ethicalgourmet	human
@carlossolari	human
@BedoCorleone	human
@AHA_Wichita	unknown
@Aareiyah	human
@fromrotoyou	human
@Telugu_Hope	human
@dessi005	org
@cheery_sunshine	unknown
@MeteoLeBourget	org
@danniimarsden1	human
@trueibelivestar	human
@greatkudscruz	human
@MademoiselleH_	human
@JericoJose	human
@xjuicydiamondsx	human
@EdnaSantt	human
@HortonsFitness	org
@RaderFoodsInc	org
@chabellacollect	human
@alhydrtrgy	unknown
@BlackSwanBK	org
@DestTips	human
@pepe_gue	org
@Jaime_micthy	human
@VegetarianIndia	org
@TLDWrestling	human
@couplevacation	human
@TheCocinerosSA	org
@Polly_Gregory	human
@Chiscosl	human
@purcell219	human
@miramiyamin	unknown
@KyokoHJewelry	org
@Steveo112562	human
@ismail_ogutlu	human
@Tash_Lindsey	unknown
@Dhilalaland	unknown
@momochin_alan2	unknown
@Luciana_Capo	human
@texasgypsy05	human
@thedailylady	human
@SuzyMarS_ART	human
@asiffoodmatters	unknown
@lucreziavillani	human
@TaiL_Fox	unknown
@CreatingFitMe	human
@nobzbk	human
@Burritosblues	org
@hanwalfit	human
@jessicaheckel12	human
@bakersandco	org
@ThaClassicStar	unknown
@air_man1	human
@SChasse49	org
@Phoebepokesyouz	human
@biefilan	human
@tselenyksl	human
@TracycakesCafe	org
@elisabethmandu1	human
@sush_princess	human
@CheekyFoodCo	org
@dinatasiaka22	human
@22DaysNutrition	human
@RLBANKZ	human
@princesskitin	human
@OFlowYoga	org
@AshleyBeach8	org
@bevsbestdeals	human
@SalimaTamdi	human
@myscribblings	human
@willbakeforshoe	human
@xia0da85	human
@Gabi_Bafo	human
@bongskieee	human
@megratu	human
@chefbern55	human
@ZackShiky	human
@wingston	org
@CityLifeEats	human
@gagduck	human
@mkukreja1988	org
@angeldeclercq	org
@ManuelDeMeo	human
@kfortierxO	human
@sexyti929	human
@s2iqz8_xo	unknown
@smooth9records	human
@FucxWitTheBest	human
@genius91	unknown
@CorinthiaPRG	org
@JEANAYOONG	human
@leejiahq	human
@BalanceTheChaos	human
@JohaLira	human
@loriaconway	human
@GianmarcoMain	human
@KIMSANTYY	human
@cftml	unknown
@chiwai_tang	human
@makNcheese87	human
@coachdanas	unknown
@rachelljanine	human
@WellyRealAle	human
@virginiasmakeup	human
@VivirenMiami	human
@PapaLou702	human
@ManwitPURPOSE50	human
@Tracey_callahan	human
@SiciliaKo	human
@iogocanada	human
@CEJ4JLS_Cheryl	org
@CrumpetsDickens	org
@Jeessc	human
@Noemie__Taylor	human
@ash_cutler_kay	human
@_fifiFiona_	human
@Lloieh	human
@KakaAzraffTeam	human
@audeliacleta	human
@beckykbarnes	human
@SoultonHall	org
@kudetabali	human
@dalejung	human
@solisjonathanDG	human
@officiallobezn	org
@AmazingWomen	human
@jeremieannho	human
@Girl__Next_Door	human
@ambhenToT	org
@cfaschertz	org
@alylalaland	unknown
@RI_JoeyB	unknown
@connie_fh	human
@noviaretnosari	org
@beamwallet	org
@Beacanactive	human
@Dano400	human
@evaratnayunita	human
@MyPoshJournal	human
@LallaneAnne	human
@turbo__fleur	human
@bebylucass	human
@catarinatania	human
@VeganDrunkard	human
@SeattleTopPicks	org
@Phaon	human
@FlowerPatchFarm	unknown
@stopwatchheart	unknown
@drjoshjor	human
@zoeida69	human
@EmmaParish906	human
@sodyzee	human
@lolo_hauoli	unknown
@anitasi99	human
@DetoxEating	human
@iLordMichael	human
@Mads_Collective	human
@Chef_Bevan	human
@mverheij	human
@ashmsnyder	human
@mhbaerga	human
@YaniLbs	human
@nicoleklaverty	human
@__MARiE07__	human
@Alex_Relaxx	unknown
@sumofresh	org
@onehappyyogini	human
@50tastesofKent	org
@Carmela_DAscoli	human
@Sushiteisby	org
@iamlizard08	unknown
@ibztrouble	org
@DelaFuente_Vzla	human
@amstel89	human
@FitMomTraining	unknown
@Alexisspartan2	human
@ViBE_ub_berry1	human
@Eleonora_	human
@Ti_nounou	human
@PoplarStreetPub	org
@fieldingsgrill	org
@TheGoatsBeard	org
@SaraHmrani	human
@KJMediaDarling	human
@mrsznaboya	human
@aketza_	org
@KissKrissers	human
@paulm844	human
@GF0	human
@TatjanaSunshine	human
@MalinMatson	human
@LoweCarlos	human
@dblack5252	human
@MissNatiaa	human
@Vishal_kt	unknown
@PhysiqueWildCrd	human
@bosworth1963	unknown
@SerrMonika	unknown
@anizaRia	human
@d3bsings	human
@iamaristo	unknown
@padlocklove93	human
@mystwts	org
@GLENszabo	human
@msellemalcolm	human
@SaddleClubNQ	org
@tinybazaar	org
@dj_techhub	org
@NNoeiii	human
@StefStaffieri	human
@stjamescorner	human
@myadamayanti	human
@seoulphia	unknown
@riverfront_bfi	human
@jsunnyo	human
@silffida	human
@_pattypie	human
@Blackgoldynasty	human
@SmokinMosChico	human
@AdriHasan	human
@afifahnahary	org
@GrtLakesCheese	org
@RandymSpencer	human
@sjt_winchester	org
@sesjephiey	human
@numeg6	human
@RayW78	human
@cafehidamari8	unknown
@ramatasyaa	human
@MindofIris	human
@tanpopochan	human
@ibenzba	human
@kelli_owen	human
@frezkotacospot	human
@BitsNBobsUK	org
@BeppeGallo	human
@Abira2011	human
@naughtypwee04	human
@CheCheWagan	human
@angelNennaP	org
@Z4ckHong	human
@RMBeades	unknown
@jeanieschmaltz	human
@melodychamlee	unknown
@chryxi28	human
@sofia_amc3	unknown
@lina1975	human
@BBYmandarh	human
@YUHYU_DOLL	unknown
@M9A9R9T9I9N	human
@salizamerican	human
@thoughtsofsonia	unknown
@EnggiESRH	human
@ppholicx	human
@amberdawnharvey	human
@charliesangelkt	human
@ezgi_ileli	human
@ACupFullofSass	human
@Bookatable	org
@mkhlovelife	unknown
@CupOfConfusion	human
@_CH3T	human
@LeCollectionist	org
@thebestofbath	org
@Bethunn	human
@heiditaly	human
@JaxFineDining	org
@Spinny18	human
@LYDiAROCKz	human
@lola_se79	human
@mysteriousjijie	human
@Arleniezi	human
@But75211m	human
@mr_ffunky	human
@Pizza_Marg	org
@RaEnergyFoods	org
@tomokoimade	unknown
@SAFOODBITES	human
@Ocladgetaan	human
@Faweightloss	org
@_yvonnetann	human
@evieheart	human
@TinaSchrijver	human
@AndreaGambadoro	human
@lknothe	org
@JSlavutsky	human
@sanai_kurita	unknown
@rhealist12	human
@FitnessbyRachel	human
@Styleismything	human
@platosycopas	org
@ChefSammyDavis	human
@danielepanigada	human
@kimberleyPeele	human
@HashanMadz	unknown
@fordhallfarm	human
@tfaisal	human
@CTPackageStore	org
@rajudeoal	human
@PeonyandBlue	org
@beckmitch64	human
@Carapelli	human
@Megan_Sarah14	human
@CreeganKirsty	human
@dLaughingHyena	unknown
@blacknsmith86	unknown
@KocaineKhoki	org
@SatapornSuriyap	human
@zwezwel13	unknown
@GerardStephanie	human
@rouifaelnar	human
@kazukojoy615	human
@chazer2009	org
@ana_cocinitas	human
@TulkoffFoods	org
@par_lor	human
@SarrParks	human
@shortbread707	human
@nicolenejati	human
@allaboutmissy	human
@Carlos_Fung29	human
@CareemDOH	unknown
@DanyaelKristoff	org
@MasonTavern	human
@bornDigItaly	human
@SouthCathFood	unknown
@PandPfoodblog	org
@tina_svilena	unknown
@KitchenCmty	org
@morningbrew_tea	human
@ImZuliahIzzati	human
@mustafaseryan	unknown
@JessieWAhmad	unknown
@BossMoms	human
@TheSpencerIFSC	org
@prasut	org
@shiu_xx	unknown
@kissmarky	human
@AniseApoth	human
@gfbestfriends	unknown
@asyrafnajibb	human
@PulpNYC	unknown
@key5947	unknown
@momtools	human
@sophielq	human
@DanDanWine	human
@handmadecardsll	human
@popgourmet	org
@fi_magee	unknown
@KatyfromItaly	human
@mariatralalalaa	human
@26_shio	human
@Nwr_iraq	unknown
@KarinaHaraburda	human
@slodiabetes	org
@healthydiet_ID	human
@SZGCityTours	human
@cuppa_teags	human
@WilkieMolly	human
@suehatje	human
@sherekadunston	human
@Seoulgrub	org
@Phatcatlilgutta	org
@SFGconnected	org
@NeuvooITTampa	org
@MsTeeElise	human
@Bharatsinh_food	unknown
@tomdoorley	org
@yammy_roll	human
@WonderWhoaMom	human
@kwishie2012_UN	human
@thelondonskybar	org
@AlvaroPionSalas	human
@KimberllyScott	human
@xxLucyRogersxx	human
@syazrilhasnol	human
@UnnY_Unn	human
@sammyg_tg	unknown
@fireislandbeer	human
@AnaisCrt	unknown
@ArizonaBiltmore	org
@bfmanzano	human
@arryaz	org
@SelanderMaria	human
@WineSociety1946	org
@nelifarhati	human
@LENA725	unknown
@renadawn	human
@ranasilvia63	human
@Railcation	org
@AltaPineForest	org
@MomItForward	org
@victor_alpha1	human
@nesyaaa08	human
@MindYourFeedNL	human
@lamtorres9	unknown
@cynthiafogoe	human
@K_Gallaher	human
@CeriaAyat	org
@JeffAWard	human
@hidesax	human
@CommittedPig	org
@Nerdzncocoa	org
@bodyglowonline	org
@DiogoSeverino7	human
@cafe53_tetbury	org
@getjuiceinme	human
@CuisineCeline	human
@kirkfranklin	human
@OrupaSalem	human
@zrider_	unknown
@JamesEDuckett	unknown
@VennyChen2493	human
@MitchKornfeld	human
@ATherapyCentre	org
@RGHOSuffolkCnty	human
@MayNguyen5031	human
@actionchan	human
@WEIRDCHRISTMAS	human
@SevenBarKitchen	org
@Ozaeta13	human
@ReadersDigestCA	human
@Rotana_Hotels	org
@msmary1962	human
@debbinadilla	org
@vintedge448	org
@Nany_rosadita	human
@2418baseball	human
@GoodGalMikka	human
@Chloe_Galley	org
@muni903	human
@InnsofPEI	org
@Franduerto	human
@LifeotSide	human
@KLiichow	human
@marqpmusiq	human
@Lukrecjusz	human
@uEnVyMe1280	human
@kuruma_ikasu	unknown
@spyridonkagkas	human
@cassiizging	human
@ananfang	human
@Sivyaleah	human
@bloggerconnect	org
@BecauseShesStar	human
@Reni_Skye	human
@aishwar66897239	human
@BlushingBetta	human
@kssael	human
@FlammenVejle	human
@RyanTrabuco	human
@MomsInNYC	human
@designstudios	unknown
@ice_wolfghost	human
@MartaPozzan	human
@iPox5	unknown
@400DegreesHC	org
@kawakishi	human
@rawwdrigoo	human
@Its_mattv	unknown
@Nurul_Freako	human
@shotgunsimmons	human
@nenyish	human
@EStreetBagel	org
@ChilamBalamChi	org
@emilyxstella	unknown
@kimkirkham29	human
@PatriotIndiana	human
@JESSL_B	human
@raesiao	human
@lanammsouza	human
@Jema_triana	human
@irisvaniiz	human
@3dot_life	human
@makiodx	human
@Finelychopped	human
@BernaLOKKO	human
@Mojcica83	human
@Anja_Fit	human
@MartyCorradetti	human
@cassandra_photo	human
@JODPT	unknown
@grabyourkicks	human
@sonicgrill	unknown
@tinysmallshort	unknown
@azwankamarudin	human
@AlaskanaKitchen	org
@BeachinBrews	human
@KLEANLA	org
@angel990227	human
@meee_shel	human
@afoodiesaffair	human
@Scherrie19	org
@AmayaNagore	human
@MelissaArrrgh	human
@dismaa	human
@SpoonieFoodie	human
@Rubrys	human
@JackyAngel4	human
@thateestigirl	human
@America_Toronto	human
@AuszAlimin	human
@nidianinoche	human
@jcapers	human
@clintonw6969	human
@GoundySkyzOo	human
@clooneysgal	human
@CoRvAxCISNEROS	human
@findpndnce	unknown
@amazingly_lily	human
@mrsninajewett	human
@Rk24Rina	human
@travelby_me	human
@princezchen	unknown
@RealityOffends	human
@SilvermistWine	human
@NPMainStreet	org
@ItyBtyBalebusta	org
@Lynn88Mr_suju	human
@Amy75Moyer	org
@gercek88	human
@is_a_bella_m	human
@el_j_of_rva	human
@lauraweavis	human
@godfrina	org
@mHie13jOy	unknown
@kengen03	human
@AnnDysfun	human
@cinnamonsoho	org
@saznaz93	human
@LuFerRiC4	unknown
@AWRFmarkd	human
@eckhwan	human
@ANK818	human
@OrioPia	human
@Mr_Gene	org
@pumpkinn_	human
@keromaia	human
@InglesDietitian	human
@GoddessofFilm	unknown
@LateNightLeanne	human
@SwAG_Mollie	unknown
@XssDo	unknown
@puddinpie2345	org
@Matrimoincucina	human
@annadebartolo2	human
@lisamodonoghue	human
@grammypennyann	human
@adrenalin_bakso	human
@GreenvaleFarm	org
@DamaChiara	human
@JaLoRican	human
@RandallFitness	human
@GRRitsAmy	human
@ChefMarySonnier	human
@TeacherMe2	org
@Princessgift	org
@LiveWellLabs	human
@EmceRelic	human
@MutalibRaof	unknown
@JuninhoTIMBeta_	unknown
@about_taste	human
@AishahAlhabshi	human
@Tymperleys	org
@brandleadership	human
@Paulahcosta	human
@Basha1294	human
@thranduilion	org
@souperdupersoup	org
@VarelaJulia	human
@Ane_Urkidi	human
@SUGASLICK	human
@BHanagriff	human
@missFebbyGea	human
@dootah	human
@gerald1921	human
@imj_almodjel	human
@RevMelanieNOLA	human
@19sushilkumar88	human
@afya_fr	org
@kitawny24	human
@RakaiDimas	human
@recipe_lab_app	human
@cctheauthor	human
@atorres210	human
@Saifullah_MK	org
@TFXNonStick	org
@EstevezAnnabel	human
@momodiaz	org
@myfavesjournal	human
@BIG209	human
@cikLehaaa	org
@jaizzacabuay	human
@HavanaBeachCafe	org
@Naiskitchen	org
@thebueller	human
@RumpStrut	unknown
@MexwayUK	unknown
@BrigittesStore	human
@EugenaWoodson	human
@HACCIVic	human
@madfashiondream	human
@benjaminjaney	human
@AmaliaSetiawati	human
@GyanduBaba	unknown
@ObliviousD_	human
@UnwinedSW17	org
@TheUrbanOven	org
@e_polina_p	unknown
@xoxoamandakiss	human
@Rockbluenyan22s	human
@SuEnOng83	human
@DianitzPeniche	human
@yuktiwat	human
@Dinni_Ramitaa	human
@singh03shruti	human
@cuddlesandrage	human
@Sweet_Potato_B	human
@mscindyhunting	unknown
@winzies	org
@Hunibunch5	unknown
@GetFrostedCakes	org
@ScarFair	org
@Gene_Ramsay	human
@rosiecorriette	human
@mdedenhotels	org
@OglesbyFerguson	unknown
@Justrealfood	human
@SofitelSF	org
@divinestar1030	human
@PHATRoyalCentre	human
@Caami_Bailat	human
@EllCompadre	unknown
@Isabella_Back	human
@teamomo7	human
@Greattweets2go	org
@Mul_Hana	human
@Natoro5	org
@JULORDJUI	human
@EasyEasycooking	human
@PixyExpress	human
@lasbombachas	human
@IdylwoodGrill	org
@Lady_Crunk	human
@GustavsPDX	org
@prokick	human
@FeistyPisces220	org
@MrShaunGCassidy	human
@madebyf	human
@EatCookSmile	org
@ppopp45	human
@ne_sang	human
@akaridisney	human
@Imperticus	human
@kthubbs	human
@emzebaby	human
@SeaIslandShrimp	org
@yum_gluten_free	human
@yourcloud	human
@CalandraBond	human
@VivaCadet	unknown
@emiljaranilla	human
@StirItUpbyTreph	human
@Christi48526882	human
@KindandInspired	unknown
@mskeira	human
@augustastatz	human
@LUCASYASHERE	org
@normankaui	human
@3littlethinkers	human
@Sakiyu87	human
@BeauTfulove	unknown
@purplesaga	human
@Okihcahkoki	human
@DaFitnessJunkie	human
@nusretsirin	org
@ElmNursery	org
@lieze_van	human
@StephieAnne_DM	human
@DesIsland	human
@118alison	unknown
@MEMEMEMikaela	human
@Silvia_Giron	human
@NoWisdomTeeth	human
@CMLobsterVEGAS	org
@beatrizf3rreira	human
@iamjulzclaramon	human
@ZeloLovesAoi	human
@facelifetweets	human
@NuningWidowati	human
@colourmoo	human
@LeRelaisLDN	org
@medicgirl22	human
@NoxMarauder	org
@FennyKurniawat1	human
@Elizabethnews12	human
@HMichelangelo	org
@SAXwdc	org
@oliviabrown1992	human
@psicodelialoves	human
@5buble	human
@jecalma	human
@GOLDCOLLAGEN	org
@stirmobile	human
@naturalgourmet	org
@GDeLaurentiis	human
@veggieyummy	org
@Vlogaboo	human
@thisisaby	human
@AnnieWa96955274	human
@mini2254360	org
@chefruss79	human
@silnfinaqqdyck1	human
@BackyardBebekoy	human
@PRundler	unknown
@claraemilyssdf	human
@Fernstaa	human
@qucay	org
@jandsknitts	org
@floraisabelle	unknown
@miqiita	human
@BigCuzLive	human
@CMoran143	human
@LigonNatalie	unknown
@youldash	human
@doordash_LA	unknown
@ArushKakkar	org
@kyoutohyougo	human
@elephantsdeli	org
@FIGandOLIVE_USA	org
@Lindaadie	unknown
@habibahatjah	human
@loriannelee67	human
@MalibuMamaLoves	org
@FriendsEAT	org
@scofro14	human
@jaq1979_jacqui	human
@CoastalRunsAA	org
@EVITBistro13	org
@americainefrenc	human
@inles	human
@sarahSAlias	human
@YuucoItou	human
@ForkinRecipes	org
@pinksmokeee	org
@DeeGeeVeeBee	human
@tanchoonkai	human
@BoxonCollins	human
@alluregrace1	human
@GrantyGrant	human
@AlbertaRetweet	human
@thejacksonbull	human
@FoodFamilyFinds	unknown
@a_edithia	human
@Telugu_Voice	human
@Chalei	unknown
@TheDAOldTown	org
@helloStudioWeek	human
@athriftymom	org
@go_jacksonville	org
@veronicaegidi	human
@itsMarcu	human
@theresiapauls	human
@damianruizdiaz	human
@LeenaaXO	human
@pbi08	human
@TeethClaws	org
@angelosalatino	human
@umyeahyeah	human
@sharlosp	org
@itsJustineGrace	human
@StanfordGrill	org
@watdope	human
@RymDrici	human
@komu_0427	human
@EmmmaGorman	human
@PiquisPiquis	human
@happy_dementor	human
@tatianapyper	human
@blvdtavernkc	human
@IamHeavenD_76	unknown
@Welchs	org
@susan_nancy	unknown
@BookBunnyPR	org
@syibet	human
@shanissaa	human
@Lagouache	human
@ilovetemplebar	org
@LukeCoutinho17	human
@Redhooklobster	org
@thaumaturgicone	human
@Roc_RCDG	unknown
@ruth60167333	human
@SheChoseHealth	unknown
@Rosanne417	unknown
@Pinkdrop	human
@dag00dag	human
@poshmia	human
@UncannyDinky	human
@SavouryMilonga	org
@eriwonders	human
@jenahface	human
@NickforNewYork	human
@krazykewl1981	org
@TomsRestaurant	org
@ariesbabyxox	human
@fruzsina_varga	human
@misscesibaby	human
@TwiceDailyFresh	org
@drtcates	org
@BupphaOfficial	human
@Quality_HotelSJ	org
@CAZ_FEA	human
@_MichelleMae_	human
@beautyring520	human
@ReviversOxford	human
@kiaxiongs	human
@CIJC	org
@zeppy_tmnt	human
@Felise7en	human
@figsinablanket	human
@TheChameleon777	human
@StBridesTavern	org
@Aurasoulband	human
@mikimiki23	human
@stretch08807	human
@AlbertaFoodGeek	org
@mafercornejoA	human
@MooleyOfficial	unknown
@MaMoosie	human
@amandalaine82	human
@vincenzofrisoli	human
@MartaBoscolo1	human
@marquezcag	human
@PaanCj	human
@diadori	unknown
@GuerlineGillot	human
@Wendy_229	human
@donnatalie	org
@monica_6681	human
@Jenbeez	human
@Despheria	human
@CuexxLana	human
@IamVashy	human
@FulStopCatering	org
@GreenwichWOT	org
@meadowsweetnyc	human
@rjzulueta104	human
@Am_aMAYSing	human
@stevensgirlxoxo	human
@vaske	org
@VeretQ	unknown
@MarcoClerici94	human
@JenSoares73	human
@yunhalonee95	unknown
@LetsTalkLiveDC	human
@locusttunghok	human
@HeartbeatNosh	human
@MonicaKarroum	human
@dimitriarroba	human
@LIUSHIHHUANG	org
@RaeSheilaTM	human
@First1000Days	human
@Entrustable	human
@allieskimopie	human
@CoalaMark	human
@nhayase	human
@t3to86	human
@nika7k	human
@susjcrusher	org
@RosemaryMarotta	human
@Pinkyinthesky13	human
@cldem	human
@ms__simple	unknown
@LinaaaaA5555	unknown
@cocyzysyvuqi	human
@AlixPineau	human
@Ollyf81	human
@paupoljr	human
@Cartier08	org
@selatheresa	human
@deestiv	human
@InsonytyFitness	human
@StephanieDevia	human
@LemonadeLA	org
@rositagarado	human
@VA_Chrissy	unknown
@mattcarroll1650	human
@kaminahito	human
@KellyLeBrock	human
@yayansmum	human
@taco_blitz	org
@HIF2016	org
@BestofBaltimore	org
@dieanners	human
@RHILLHOTEL	org
@GideonAmosNo1	human
@Exotic_n_easy	human
@HarbourCafeLooe	org
@CharliWhat	human
@CharlesTerryJr	human
@ipowded	human
@1337invisible	org
@nickdjb	human
@lizerbes	human
@INBuenosAires	human
@uMadddt	org
@CityofSantaFe	org
@JulzOnTheGO	org
@ItsMeMarilynn	human
@MarriottsCR	unknown
@iLoveJMV	human
@Stephanie_05sum	human
@desawn1	human
@newyork_rican	human
@mevsthebulge	unknown
@thewhiteoakcoo	org
@CallumIsTomlin	human
@summermanas	human
@Hguer1	unknown
@centralyogis	org
@MinieMindy	org
@SaraSmillie7	org
@click_fyra	human
@italianbestfood	org
@TheMistleyThorn	org
@chimu841	human
@citawidyasti	human
@Holly0910	org
@MrYouKnow919	human
@HeidiNYBO	human
@adiraathika	human
@majo_chsm	human
@SumoSteaks	human
@VergaraJuan1	unknown
@corinaish	org
@0302yes	unknown
@AnnaKoFeldman	human
@syahrinabdullah	human
@Kay_The_Tequila	human
@desnucao	human
@kyanon0402	unknown
@deecrater	human
@llaurener	human
@JieMiko	human
@pasha76	human
@tjbyfield	human
@eobpr	human
@datskewll	org
@rmk314	unknown
@DeLaMel	human
@MommyUpgrade	human
@ChicanaEspanola	unknown
@kdpapadopoulos	human
@sianuth	human
@Uncroquisdemode	human
@305KingNeptune	human
@seaviewhotel	org
@nottinghilldady	human
@PierA_NYC	org
@umatillaridah	human
@latte_lib_86	human
@cmdfernandes	human
@HireStudios	org
@nilmamma	human
@J_Sko	human
@acacia_uk	human
@DenDen148	human
@abbie_griffith	human
@dizzybeekitchen	org
@pepitoocuhh	unknown
@bpg91	unknown
@mutsumi_numasa	human
@miiamej	unknown
@SpecialKUS	org
@MilanoBurgerBar	org
@jembonhere	org
@FashionisaQuest	human
@charlietous	human
@MissCelineee	org
@sironyalove	unknown
@GusMartinPT	human
@pem2x	org
@twinklestarzz	human
@widiaDwiU	org
@BodeClubKing	unknown
@Candycritic	human
@feelJoke	human
@TaylorCole93	org
@hristi___12	unknown
@Corporatebaby	human
@Cookanista	human
@marceloceviches	human
@DohertyAleHouse	unknown
@wmapple75	human
@TaelxrMattox	unknown
@feastrestaurant	org
@Trip405	human
@SashaJames2	human
@narcissistickit	unknown
@RichardBaldric	unknown
@OnasisOdelmo	org
@milesz	human
@HudsonsSeafood	org
@Caffeine_Bliss	human
@AmySKiernan	human
@yui_717	unknown
@sundae_mcflurry	human
@SmishyDot	unknown
@pink_travelblog	human
@erindooleyy	human
@DayanaCV	org
@smeccyboo	human
@LaBelleNegresse	human
@SarahLaiLabel	human
@CraftLA	org
@acooknotmad	org
@tarheel_foodie	org
@WomanFreebiesUS	unknown
@AndresTmpk	human
@katie_katekate	human
@sw9teen	human
@BigReege	human
@TavernSqSalem	unknown
@AndrewCreepers	human
@CyDanielita	human
@albertus_adi	human
@mousymoo	human
@SharonTepper	human
@kogidgfdsaf	human
@janvwingerden	org
@_3ZIO_	unknown
@linnasama	unknown
@umechiku	human
@2istz33	human
@Luv2Dream36	unknown
@seantabatabai	org
@FitJamApp	org
@aomkod__sj	human
@manizz88	human
@michaelsat	human
@das_heffries	human
@Tsuvuuutan	unknown
@TheRealFoodClub	org
@SeasonsInQEPark	org
@eeerriinn	human
@MaicoCapitale	human
@PinkLights	human
@ThePackMomma	human
@BagBoyDad	org
@JTSchmidsBrewCo	org
@mariatrains	unknown
@TarenFerroni	org
@wellingcatering	human
@dekyingPutin	human
@RandyLoth	human
@EvaMasyita	human
@sohumstudios	human
@FerdinandNgo	human
@Tapeandojaen	human
@alicesortijas	human
@EducateKateBlog	unknown
@TheMonsterlnMe	human
@G_FILOGRASSO	human
@FoodLoverLnd	unknown
@CulturaBellezza	human
@Essocov	unknown
@MelissaHarkerRi	human
@rebeccabrittle	human
@PontisIK	org
@FatBoyTreats	unknown
@CantinaGrpvine	human
@TheACM01	human
@darrellcortez	human
@SkinnyWrapsInc	human
@boylovesfashion	human
@KashifWajid	human
@aprilvixaysack	human
@Yess_FierceNess	human
@Hercat_	human
@canisgallicus	human
@Mia_Darling	org
@cubansoldier	unknown
@Chef_Shellaaay	human
@gobbleoff	human
@RealityEating	org
@gulsennmli	human
@garnet0102	org
@OOMPCAMP_RUDYRU	human
@Joyeuseffff	unknown
@trendy_things	human
@mariacomparetto	human
@maroc_o_phile	human
@Shana_Was_Here	human
@AAltmimi	human
@LVBlondes	human
@DeniseAustin	human
@heldy_fortune	org
@bellalucia	human
@kazukazu2011311	human
@JohnyFp	human
@MACPAT83	org
@issykjewels	unknown
@lizthechef	org
@Danitzaa	human
@gunrina0307	human
@BierMarktMTL	human
@nicoleyi19	human
@hollie_dee	human
@Yardii	human
@janclp	human
@FoodieBoys	org
@andiechrislo	human
@merbenwoo	org
@arribaslosada	human
@ItsJayyxo	human
@CleanEatingGodd	human
@PlusNj	human
@DeathIsntBlonde	human
@ash_ross23	human
@TheOneKaila	human
@fithealthyfood1	human
@NUSpoonMag	human
@MommyLovesIcy	human
@hasselku	unknown
@_NatalieEve	human
@ethioscmyk	org
@FreshFoodz	human
@QueenSheba_SEA	org
@the_wine_club	human
@voitajasuolaa	human
@odj8890	human
@hohneker	human
@eiwyra	human
@Jandherlipstick	human
@tem_pavlovich	org
@JosephAdelantar	human
@ysm_n_1024	human
@RubyTemptations	human
@esok03	human
@Jade_GP	human
@citizenbakerpdx	org
@keepitbeautifu1	human
@FGPropertyM	org
@labulka3	human
@StoyanAngelov	human
@NaomiBeirne	human
@HotelNuenen	human
@EHSaunders89	human
@MCupCake22	human
@mysportsdiet	org
@PrettyBrownNita	org
@lilmikeamastami	human
@DreyLockRB	org
@sanxsimon	human
@murnishu	human
@melissabarcafe	human
@beatrixbudhiadi	human
@SocialMVMT	org
@vc_stylist	unknown
@Chadisfunny	human
@sushicebiches	human
@SCDSB_Wellness	human
@l0vezae	org
@citraayuw	human
@LongIslandDQ	org
@linaaaxo	human
@CharTinker	unknown
@sbeezyxo	human
@claudiamutti67	human
@yummy_dutch	org
@ShaunaMann9	human
@asiannyy	human
@Twittisin	human
@susanscookn	human
@AlCowsert	org
@Oscar25907299	human
@askfor_janice	human
@tone_ring	human
@Downtown_Rocks	human
@CMLobsterDALLAS	org
@veganbun	unknown
@InstaLugansk	human
@jpagravante	org
@ZackZaidi78	human
@JamesDuigan	human
@Nicolas_dennis	unknown
@ScoutologyRVA	org
@Lexuspark	human
@vitorfoxFR	human
@PitaCafe	unknown
@SimpleCrew	org
@jzampz	org
@ElviraRomanchik	human
@31_17fitness	human
@reviewsbycouple	human
@uniqueleered	human
@tenovid	human
@lyricsoflife_22	unknown
@kanoooon0618	unknown
@jomarisi	human
@SkinnyBuddhaNY	org
@SaucyQueen	human
@djeddygonzalez	human
@alexkortland	human
@Gussalazar09	human
@Gina_D760	human
@RachelleMiu	human
@19Lars53	human
@DaisyCakesNC	human
@TheHungryDogg	human
@Jolyine	unknown
@btsunoda	org
@Acik_Cda	human
@Teigenallen	human
@QuicksilverMail	org
@chaos_garden	human
@NadiaA_N_JELL	unknown
@aangelraamirez	human
@PujashreeSharma	org
@Alex_Jo9	human
@ToTourism	org
@thelovebirdcafe	org
@SSabolenko	human
@jessicaswander	human
@mama_andii	human
@kelzroxit	human
@imanangel04	human
@francesca_93	unknown
@henlez92	human
@AlisaJaa	human
@fatesilenzio	human
@akina19840619	human
@TheNickyDare	org
@TwinsFromRussia	human
@jmpakele	human
@aaronjmarch	human
@smuennix	human
@celesteatkin	human
@mariajoanna69	human
@lakersbsk15	human
@rienayumi	human
@SadieSomethin	org
@jesseblueribbon	human
@ChingLee930	human
@t2k_t2	unknown
@DaviaGThaHBIC	human
@Limericksyyc	org
@jubolondon	org
@BigalChef	human
@Sae_HOMEYS	human
@Shaun_Liddle	human
@KrystleCupcakes	unknown
@wandernosh	human
@libelula_latina	unknown
@EntreeKitchen	human
@GuapitaTondita	human
@GrassMaven	org
@vkrumnino	human
@daIbyang	human
@maher_afif	human
@HairByJachelle	org
@CAMabisSociety	human
@AllanAllanbm20	human
@David_Rd2	org
@LiriaDS	human
@SteelCity_JP	human
@amyfriedland	org
@LyliaRose	human
@LureFishbar	org
@YangHoff	human
@karenc2103	human
@noni_noni91	human
@breadandwineFH	org
@Parmalv	human
@marinatv_	human
@sofizamolo	human
@openticketravel	human
@FLNutritionUK	human
@davidsprahran	org
@19980323kysy	unknown
@Batom_Cinderela	human
@HedeenJenny	human
@Venditoredifumo	human
@misasajovic	human
@DeeBoscoe	human
@MarriottHoteles	unknown
@insightsmedia	human
@BanjoPatty	human
@GTIllustrisimo	human
@oeofbag	human
@PrincessLynz83	org
@RizkyTriSlstwn	human
@dinahrp	human
@SallyYogini	human
@scoobyroobydoo	unknown
@christyisabell1	human
@nolant23	human
@GFBdoralicious	unknown
@pixelski	human
@ShayStibelman	human
@john221991	human
@pastrydiane	human
@MC_MOGGYY	human
@KatiaCortelli	human
@BrewBistroKenya	human
@Brassneckbrew	human
@MarcoSoares19	human
@CynthiaKKim	unknown
@BuzzinToday	human
@dobirmiah	human
@CharisseMills	human
@MiaBertilsson	human
@food4theseoulLA	human
@TheOrangeCrate1	org
@samanthahughey	human
@talinkpink	human
@portalfleureast	human
@joelalfonsofilm	human
@_Just_Jamie_	org
@DebbieParcesepe	human
@monmarocguide	org
@NazishBari	unknown
@Cheoffrey	human
@Hotel_Shalimar	human
@Porkyaskew	org
@jean_noonan	human
@OrangeChuck	human
@roratarek	human
@YankeeInnkeeper	org
@fishashish	human
@sil_bubble	human
@zkhaku	human
@xcrap	human
@granlund_	human
@JulianH89	human
@thefoodjoy	human
@rurodriguez85	human
@ericstamps	human
@UsmanBasitSh	org
@srslytheshow	unknown
@CRACYGIRL	human
@spidfyre	unknown
@nathanaelthiry	human
@Richardm1960	human
@EmperorMikko	human
@GGsWaterfront	org
@ShaunPendergras	unknown
@Ikaa_301197	unknown
@gabriellaxious	human
@sammidooley	unknown
@dfroehlich23	human
@theatriumHRC	org
@LyssaRenn	human
@DeniWida_	unknown
@JoshGellers	human
@BeckyKlitgaard	unknown
@smitha_r	human
@mosamahussain	human
@Gui_crema	human
@jennyjenjenz	human
@GuidanceGirlEm	human
@IamLinya	human
@JCruzoo	human
@giselaandzoe	human
@RossetButlers	org
@achicooooo	human
@juancarlos5893	human
@beaconholidayin	human
@erwandamahal	unknown
@chillibbz	human
@cavenderm	human
@kalinamarg	human
@Lugo_Fitness	human
@Foxy797	human
@legit_jhoone	human
@evonneching_	unknown
@annettelamMUA	human
@relishponte	org
@XFactorer	human
@megabowman	human
@DearSandyCheeks	human
@coachkristijean	human
@ahmedmo18297879	human
@GeorgiaRoberrts	human
@fabbbulous89	human
@bobbycrash	human
@SyazlynnIdrisII	unknown
@cikant	human
@dianadomo	human
@CompanyPrtyGirl	human
@sucirramadhani	human
@LebnaniSnack	org
@therandomrhys	unknown
@CompassroseDC	org
@cesarmartinez21	human
@ShopSewFlo	org
@iyut_rya	human
@MemoryMorsels	org
@nandaportella	human
@LunchBoxOttawa	human
@alyssampowers	human
@suuchan314	human
@VegeOnTheTable	human
@JeffKawakami	human
@MsConcession	human
@snowballid	human
@MelodieMikeNg	human
@Urbanapie	human
@air1987yuya	org
@FarmsteadTable	human
@jashmeenthakre1	human
@nicki_bride	human
@MuhdNajhan	human
@ChiantiVillage	org
@bellybuttongirl	human
@ureyes51	human
@xiomy_cast	human
@GOTH_XP	unknown
@Asparklingspark	human
@FitBegins	unknown
@yopheztee	human
@cazharrison	human
@UrHostSashaSkye	human
@PhillipBrowntv	human
@Swieeeee	human
@Pete_S_King	human
@JulieZwing	human
@SpiffyNZ	human
@julia69xxxx	human
@Suckmyswa99	human
@LOVEcandlesUK	human
@Ney1524	human
@t_r_a_n_	human
@slprncess2392	unknown
@telmasofia17	human
@mellisayohana	human
@CarmeliaRay	human
@Cat__francisca	human
@QueenOfPoland	human
@Gypsy_Savant	human
@milkcrownkain	human
@FLORENCEYAP	human
@VeganCosplayer	human
@MRTWOTONE718	human
@moiftwx	unknown
@MiriamvdGroen	human
@SheeyamS	org
@rougewriting	org
@JonahJamesCafe	unknown
@cwindley	human
@sportsalert24	org
@TammyWongNomNom	human
@NottinghamLover	human
@essexwineschool	org
@ChefShikany	human
@kewyn15	org
@pooreskimoboy	human
@itsrubvck	unknown
@ZhangShanLing	human
@rangrez_london	org
@ShelleyDTerrell	human
@Avila1031	unknown
@Djnadjor	human
@JosbellAdrian_1	human
@syaheerasaiful	unknown
@notesfromanomad	human
@HappynHealthyRD	human
@benborj	human
@Lisa_Kieklak	human
@mikegee_93	human
@jamescs1404	human
@Vitussss	human
@neymartinj	human
@bexxc	unknown
@BurgerBar1	org
@SecreteEmotions	org
@morgankwyatt	org
@ashmac49	unknown
@CandGirlHaynes	human
@JUSTINkingofU	human
@AwaMokhtar	org
@marianawihardja	human
@T_QRON	human
@ckmok86	human
@maxxpowerss8	unknown
@sonitag24	human
@_FreeBitCoins	unknown
@ScarlettPixl	human
@Holly_Love2	human
@luisferni23	human
@RicardosMed	human
@cristyristy	human
@matcha_maiden	human
@Brent_Lee_Baker	human
@auscapitolgrill	org
@mjs_shaklee_way	unknown
@dane3williams	human
@SullyDee	human
@frugalfortune	org
@MissJology	human
@roads9708	human
@RestaurantInt	org
@fashiongirly6	human
@Olivia_CA95	human
@theveggieside	org
@RussDeGuzman	org
@cooksense	unknown
@elishalicious18	human
@SabaterDiana	unknown
@NYC_Info	org
@MapleLeafAussie	human
@PiselLoupatty	human
@iamdwaynemoore	unknown
@Cocos_Mad	human
@shesaywhatever	unknown
@Vina_Nta	human
@flutterby1068	human
@vesnabliss	human
@jesmonddenehous	human
@GlennSoucy1	human
@donaldkks	human
@kellygrothe	org
@felixyonathans	human
@ArbynC	human
@nozonni	org
@haltiy	unknown
@I__am__carEleSs	human
@syasyabam	human
@Drifter_Local	unknown
@MagnumMonday	unknown
@vivaciousVAR	human
@DoreenHDickson	human
@SaharHabboub	human
@RealTayChaTLC	org
@Apocalyptica	human
@wjaldiss	org
@whatnataliedid7	human
@donmarcofoodco	human
@thewilkescafe	org
@MGiannaros	human
@michesdishes	human
@ogawamomoe	unknown
@DJKracbaby	human
@JumeirahMB	org
@erico1127	human
@SECONDCITYRADIO	org
@smileclaire	human
@MeganRGallagher	human
@DalzielLtd	org
@LauraCYMFT	human
@mviniciux	human
@GarlicUK	org
@Stacey0389	human
@HodaMallone	human
@RedDevil09	human
@Sxa_proof	human
@katiemcclung33	human
@EMRAHDEAN	human
@jfoong	human
@earlybirds_ie	human
@Chicksue	human
@d_chat	human
@ludovicosdeli	org
@Kiya_aThick_Mom	human
@Jenw0114	human
@LarryGriffie	human
@drigs	org
@ABinHindi	human
@NYCOfficeSuites	org
@handefesan	human
@krissi2323	human
@Vikar08	unknown
@NyaaKrystal	human
@julicancinos	org
@Chelssie	human
@donnabellee	human
@patriciahidris	human
@RecipeFavorites	human
@gentlemansb	human
@XavierMonteroo	human
@superpattee	human
@kelvincheer	human
@FDoficial	human
@nazhlita	human
@Flip_jo	org
@SharneeFenwick	org
@VitaUnivers	human
@TheJGillen	human
@azwanannuar	unknown
@sara20chi	human
@Kimber081968	human
@scratchmadeLBC	unknown
@elmenuvirtual	human
@chocolateri117	human
@ShineBoulder	org
@lottammy	human
@LiindaJackson	human
@_Maximosh	human
@Amore_Cafe	org
@momoUtters	human
@artemwee	unknown
@kathliz5	unknown
@AFCSoyFoods	org
@GirlGoneMom	human
@puregoddess	human
@HourWaiter	human
@Brittny_Traeger	org
@NOLApicks	org
@Zoerie	human
@scottsfishnchip	org
@ttanttaamaya	human
@hanoinoi	human
@iamNajidah	human
@aslyana_ab	human
@wiwin193	human
@clynn090394	human
@DARTQuan	human
@Gina_T_Frasca	human
@imasrikar	human
@DeirdreAdam	unknown
@PeonyJade	human
@TomCookery	org
@People_In_Paris	org
@NadetteEats	human
@mycoopharrison	org
@mariela_photo	human
@Marbear_8	unknown
@B_VillJC	human
@filipdjpozitiv	human
@TFKitchen	org
@HealthyFellow	human
@Chu_akina_avex	human
@Giugy_88	org
@WhitneyMarieC	human
@BettySergent	human
@smsm_abdullah	human
@Dwi_Kuniarsa	human
@xMissMoulex	human
@deviijaf	org
@harrynicholas	human
@ThisPrettyGyrl	unknown
@trekaroo	org
@isWatching	human
@nicolehollyking	human
@CarloA15	human
@suffragettecine	human
@LumaQaqish	human
@regarfield	human
@CreativeRoyalty	human
@taniguchi5920	human
@mgoconnor1	human
@Weekech	org
@bebadiaz03	human
@Taras_Table	human
@tecompany	org
@mickey4324	unknown
@Hanz25	human
@chiquibabyLA	org
@alepicci	human
@ForeverSimplyM3	unknown
@Steph_Vanessa	human
@Emisapunkrocker	human
@picwals	unknown
@heyitsmejoy	human
@catnathannathan	human
@VLutes	human
@KalishaBlair	org
@ctgirlonthego	human
@MrsMinarik	unknown
@angelinemjh54	human
@Ku_PeneDuffy	org
@ladyzir	human
@BJBGirl	org
@jlauphillips	human
@TTHMaidstone	org
@zsnassani	human
@DayuumNilo13	unknown
@MandieDeLeon	human
@jonathanuhas	human
@syouen0713	human
@RuddyIndian	human
@whiskeyamerican	human
@RD2beKaylaB	human
@armie_navy	unknown
@HampersFoodWine	org
@kutsusita_maoh	unknown
@Vesper1931	org
@lindsayzubay	human
@LRRcoffeebar	org
@KyngKG	human
@TermePreistoric	human
@VanoverMaurice	unknown
@VoucherMine	org
@blog_sunrise	human
@EndOfAllDays90	human
@YolandieWessels	human
@Lounge_Kitchen	org
@hangsan84	human
@MarthaMartika	human
@riri_andriani	unknown
@circus_boi	human
@OnlyOnePatron	human
@DavidGarayDAG	human
@praline_doosje	human
@Ms_Virgo981	human
@SlimVegan	human
@osservarte	human
@BurgerHeavenNYC	org
@tbsprouts	org
@Gweetjo	org
@maroayu1021	human
@caffebeano	unknown
@stefanieoliviaa	human
@ViBE_ub_berry4	human
@karlacrespo	human
@LizNunan	human
@twaynev	human
@SelenaPai	human
@AShimaneko321	human
@q2han	human
@LisaNutrition	human
@AdrianoomellO	human
@oopheliach	human
@liveafrugallife	human
@Jen_Robinson_89	human
@nourhangouhary	human
@lifeissweet2328	human
@maryegilmore	human
@LentDVM	human
@manonxx94	human
@ricey_boy	human
@mizaaaaaa88	human
@coquitlamcentre	org
@KK_maineee	human
@TheBullTeam	org
@michan_910	human
@rainbownan	human
@Smowbray90	org
@kushiinstitute	org
@qumbySH_KH	human
@coastag	unknown
@perreyhsu	unknown
@vis8	org
@MillenniumForum	human
@NewYorkDad	human
@jonaspenguin	org
@LatteAE	org
@HomeGoodFood	human
@MrNoTorious69	human
@maratanga	human
@JoanaParada	human
@cheapasprints	org
@naomicheung	human
@BBlancL	org
@AlexMals	human
@antosgc	human
@madame1205	human
@nadii15	human
@PabloMEspinoza	human
@sotto0823	human
@shamutsha	human
@Silvia_Bianco	human
@ancillalubrano	human
@ChefCrystal_M	org
@sweetdreamsfe	unknown
@MsAshaMarshall	human
@Yallitsmando	human
@hbabi	human
@Rolau27	human
@SnarfHappens	org
@Maple_Tavern	org
@PressBrothers	org
@BPustiak	human
@chipicipoy	human
@m00nbloom	human
@airlandseaspace	human
@BluewaterCafe1	human
@LizAutmen	human
@MissFitree	human
@RayDigmi	human
@mh_s8e24	unknown
@EcoBabyMamaDram	human
@Balweshh	human
@PaigeBethley95	human
@courtlux	human
@keiratobin84	human
@EmmaJean_Queen	unknown
@Mark_Naidoo007	unknown
@fetchmemylolly	human
@GGirlGGreen	human
@JacksonBoogieJ	human
@indealsUK	org
@petiteflowerone	human
@_p_yuqi_	human
@JUSTICE_BODAN	org
@tipsydiaries	org
@laborganic	org
@pastrygirl1701	human
@JouwWeekmenu	human
@HmtwnHrvst	org
@roserqmokhtar	human
@WeHeartBread	org
@NikkiRSharp	org
@diewithoutshoes	human
@RosemontGeneral	org
@NaoCarleton	human
@babablackwell	org
@brittanybolt	human
@miccan01	human
@lafleuryvonne	human
@Jenny_Buijs	human
@MLPBrony1978	unknown
@mzlynn760	unknown
@sweetpotatosoul	org
@noelcastro_acg	human
@sabrina_jackson	human
@hassantutu	human
@PlageBeauRivage	org
@TheseDrinks	human
@Mbotyy	unknown
@blacktravelSNOB	human
@bellamoir	human
@BryceBussell	unknown
@woodenflamingo	org
@Terence_Carley	human
@tinapiebaby	human
@SanyaJeet	human
@haruka0708	org
@schulze_kerstin	human
@LauraleeSwor	human
@ChronNicPain	human
@cyndi_tvxq	unknown
@JOSER4UL	unknown
@katrina_lising	human
@clairecares	human
@cristal_Sotelo	human
@AHateem2007	human
@reenie_rocks	human
@macromarinelli	human
@writersblock15	human
@saifulrohmannn	human
@AmyBalmer	human
@wajinator	human
@bettinaskitchen	human
@KimBeatriceLLC	unknown
@ValeriaPalieri	human
@AllaTimas	unknown
@daniel7489	human
@maak0331	unknown
@ctmgalwayslucky	org
@310Sunshine310	human
@LiRanDee	org
@Lins_xoxx	human
@JoshSConner	unknown
@MairlynSmith	org
@Spawn2023	unknown
@AnQiBistro	org
@joaukc	human
@ulswat2	unknown
@Begooommm	org
@MeatMarketSW	org
@Mermoz1	human
@sunnyli	human
@livingsunnylife	org
@LaBibliotecaNYC	human
@This_isAwkward	org
@jpgmaker	org
@kimosimpliciano	human
@eddiecpt333	human
@SpiritShoppeCT	org
@moonwaterlodge	org
@bubbledogsuk	org
@KellyNguyen	human
@iddlepeeps	human
@Tech_Truth	human
@cmoneyspinner	human
@snackbutton	human
@415Mauricio	human
@UltimateDesires	human
@Oliver_Reyno	unknown
@MannytheGreek	human
@STREATMcKillop	unknown
@YxMinaxY	human
@MonicaGeorge13	human
@LesCreadeMarie	human
@highsocxxx	human
@mellysaastuti	org
@MujerBalance	human
@scordarmidime	human
@ayehzamri	human
@SimmonsKindra	human
@do_davide	human
@p3nnie	human
@zilazulkifli	human
@pekoka	human
@LoveLittleMe	human
@lisa_vipond	org
@Mariam_Carmona	human
@TruTableFoods	org
@DivemexBells	human
@kclarke21	unknown
@jamekalee	human
@garrettholmes	human
@teddy6c	human
@PearLBho	human
@AFrancis_DJ	human
@HiddenEngland	org
@IAmCongo	org
@Infusedoptions	human
@CYN_Offers	unknown
@CalvinTsu	human
@Randy__Jones	human
@Mobility_Doc	org
@TumbleweedsMex	human
@has_yusuff	human
@GGrommon	human
@dhina_arg	human
@AvantiGarde	human
@ploy_bodyslam	human
@7LittleSara	human
@tshepom67	human
@HakkasanIndia	org
@FairmontPacific	org
@akky_breaky	human
@LowerEastDG	human
@Skingodmother	unknown
@musicandchants	human
@faridahmccaul	unknown
@dannu66	human
@BrownChrissie	human
@jindivik	human
@nelfyfaithullah	human
@Mary__Twilight	human
@_bythegoddess	unknown
@CleanLivingLndn	human
@AnnaMarieAsha	human
@ttt6993	human
@_GorgeousShae	human
@bosstetelaflare	human
@Mixuca09	unknown
@MrMikeStreet	org
@ozcanilke	human
@shopmeridian	org
@hubert_quach	human
@corynmaher	human
@suso_ki	human
@spore88deal	org
@raloarca	human
@HealthyAssFood	org
@happychefuk51	org
@MiandMeLondon	org
@saveone83	unknown
@SanofiUS	org
@mgza	human
@KimmieD2010	human
@KumiRooooock	human
@jmghouston	human
@fuzuco	human
@BigTomAjax	org
@gaminecat	unknown
@Amays_Beats	human
@Brandiwine29	unknown
@beanoor	human
@CityOysterDB	org
@StevenWijangco	human
@Alexander_N_A_B	human
@candice46670711	unknown
@825_mzk	unknown
@idildeligoz	human
@kanacot14	unknown
@cristobal_ig	human
@elanapermutt	org
@hitomiaka	human
@lynncitaaa	human
@InkAndElm	org
@quigley_claire	human
@LishaJin	human
@HalimAnthony	human
@BrewAndBakeHQ	org
@PrettiPeculiar1	human
@roligm	human
@CoachBrielleRN	human
@TheGroverPub	human
@ChinaGateR	org
@rhhouse	human
@dhita_yosephine	unknown
@KarlaAmezola	human
@BnyZ_	human
@NanaLaNuit	human
@_laurensampson_	human
@ammajune	human
@lily_taay	human
@Angelamb09	human
@YM_Corey	human
@yuriexileee	org
@LisyWrites	org
@PeacockDiner	org
@Mariela_Garriga	human
@GreatEscapeBC	org
@akstyagi	human
@branapeles	org
@brendanking11	human
@AdoringOpal	human
@_QueenKIM_	human
@clubnobbie	human
@Basquiet	human
@thaunattainabLe	human
@MIKESTANKO1	human
@benlimisella	human
@AllisonRhee	org
@___kymu	human
@FreeLancer_ID	human
@WorldInstaPics	human
@VHetal	human
@KellyMartellFit	human
@AzzurroCoffee	org
@Purely_Chic	human
@snehcook	human
@ryancarlmercer	human
@amandasoled	human
@Rosettejlo	human
@glasspirations	org
@amazingkaleburg	human
@fedickfelizardo	human
@heyitspham	unknown
@SvenMauch	human
@CloudberryB	org
@dezwhitehead	human
@FrammyKan	human
@YuluIshii	org
@Curlydana	human
@cclawson	human
@twinkleg0ne	human
@IPorticiHotelBo	org
@samanthargreene	human
@Jospitrepart2	human
@StelyBelly	org
@sandrajhons4	unknown
@LTTravelConnect	human
@keeleyryland	human
@Johanna_Cho	human
@iamchristianaa	unknown
@Live5brands	org
@leigh_land	human
@sibudaktecik	unknown
@theblissfulrun	human
@bennybilac	human
@EmiPerezB	org
@ShaneandShawn	human
@TillenFarms	human
@Cristhy87	human
@bklynbabie	human
@kbairokeeffe	org
@Michael_Vasanth	human
@ThisIsExile	human
@sue_broad	human
@chantewl	unknown
@GaryMackay82	human
@Dewyy__	human
@FGmakinggood	human
@daniber72	org
@MartellMarvin	unknown
@TigerPowerUST	human
@19thSPRING	unknown
@nirmalatrisna	human
@ShakeysUSA	org
@littlelysaght	human
@Vinicio_Rotelli	human
@zinpalmsprings	human
@JoseManuel1602	human
@MilenaDeVivo	human
@Schmaltz08	human
@lilmaniscalco	human
@RAMEF6301	org
@DFW_ALERTS	org
@reaction_radio	human
@gurms	org
@whatfreddiewear	human
@fanii_jenny	human
@1DEurovisionGag	human
@IvonneKinser	human
@sxika1224	unknown
@Ankitg18	human
@Zupastar	human
@LJComps	human
@srslysheska	human
@oluisribeiro	unknown
@DJFIRSTCHOICE	human
@ocmomdining	human
@letsfluc	org
@J_anggraini	human
@daveybx	human
@123selfie	human
@TykerGiselle	unknown
@silvia_lablonde	human
@anto872	human
@williamodhE	org
@titoperoni	org
@RissNori	human
@shokoran14	human
@rahnaaron	human
@1alhashemi	human
@FoolproofLiving	org
@cprimesteak	org
@yoriapriori	org
@inoostmetmik	org
@PPlatinni	human
@LydiaGirges	human
@christinaschu	human
@stephanvdwulp	human
@SarahFVohra	human
@christy_julia	human
@EnglanE	human
@LyneRobi	human
@Thaakipooh	human
@_CristinaSV	human
@englislearner	human
@mizajmclean	human
@PizzaBitePK	org
@NicheforDesign	org
@PastorKarli	human
@RadissonBluPera	org
@darren_fink	human
@iambourlon	human
@GURL_IN_FOCUS	human
@badgalmosley	unknown
@MrMYBOB	human
@Oilnt	human
@PortovinoResto	org
@greatwesternarc	org
@VballDzags	unknown
@TheMummyToolbox	human
@_mikinosuke_	unknown
@JAzorinchan	human
@_GoodGirl_Gone	human
@KiloGladiator	unknown
@DOMSantos09	human
@chab92	human
@ieka_hashim	human
@emilybratkovich	human
@Snotnosterbol	human
@EleonoraGalasso	human
@allthingspearly	human
@DFarrer74	org
@ElaineWanyi	human
@AdnefMDFKR2	human
@JavierJamaika	human
@gmarionsanchez	unknown
@ericfebdian	human
@pipstopsmoothie	org
@CJCruz1995	human
@vanepillado	human
@Notashopaholic	human
@Mustbegood_blog	org
@MissKitten18	human
@Chicca_D_L	human
@CrlssDlgdd	human
@aricyong	org
@KVictoria_92	human
@sergiodelolmo	org
@SophieDonya	human
@HerCampus	human
@rixoskonya	human
@buecherkaffee	human
@RxWiki	org
@Aquarian_Soule	human
@muganlee	human
@aizav06	unknown
@Wayne_Harris7	unknown
@LuiSays	human
@Sarah___Lee	human
@tbkkappel	human
@ayami_1028	human
@banjobiol	human
@IN_Deals	org
@hancs_i	human
@fuegosgrill	human
@knk4142	human
@Naomi_SFB	human
@LeedsATW	org
@DataJobSP	human
@becki74mcleish	unknown
@barbygal	human
@RockandBrewsES	org
@hunnybzz	human
@GirlyInterests	unknown
@flittychick	human
@NeuvooAlexandUS	org
@SisillaRiann	human
@stepfspencer	human
@triHeadLLC	org
@jonllamaman	org
@BeckyShockMay	human
@jerseydude21	human
@MarinaLouis2	human
@GraceHdzJ	human
@dobbies	org
@Xchile	human
@MauiElise	human
@HilltopBistro	org
@grafitgra	human
@matildaprall312	human
@everyday_meal	human
@Myss_Meka	human
@SaudagarKopi	org
@veltimera91	unknown
@wedgewoodbdman	human
@edyndut	org
@DulciaBakery	unknown
@glennvicente	human
@Khethzana	human
@ggchiquitinbb	org
@DrHarryLime	human
@hysmiri	human
@moniiislibra	org
@uchennaji_OUCH	human
@sambeii	human
@padnoshkee	human
@mscherrylou	human
@MDMatteis	human
@_nicoletz	human
@LickMySpoon	human
@eled1406	human
@avgeekretweeter	org
@HoyBarKitchen	org
@mayorofbeertown	human
@ThursdaysMtl	human
@Bee_Kpr	human
@Annexsolutions	org
@Jenpotten	org
@s_4040m	human
@AlexJohnsonFood	human
@TheShaylaBlack	org
@pattywoo3	human
@anapriha	human
@yana_koval	human
@EeWaun	human
@funnytee	human
@PatzDelaCruz	human
@welvin_iguna	human
@karimgamal9	human
@sugarsweetbesje	unknown
@TheTasteVenture	unknown
@godfathertwit	human
@kogdigdsaff	human
@chyiien_qe	human
@DimasWahyu_	human
@sexypartyanimal	human
@iheartfoodvb	human
@BryceRicketts	human
@lucky7canteen	org
@Ryan804VA	human
@akuri_miura	human
@BevMo	human
@DevonFoodLovers	org
@TAK_APU	human
@MagofParadise	org
@dora_etha	human
@danilandia	human
@Qtravels	human
@RestoClubdes5	human
@tobiasperanza	human
@camarleigh	human
@RenaissanceMum	org
@malcolmmw	human
@VANFV	human
@CarrdiganButton	human
@guilhermeale	human
@ilariatomasso	human
@georgyishere	unknown
@LuluBell25	human
@forever__chuck	unknown
@BurakAliKasap	human
@lokyee_0119	org
@gusvagyok	human
@ELIZAGMUSIC	human
@jozifoodwhore	human
@alyssa_swi	human
@ShowcaseNYC	human
@LibbiMorris	human
@biiibiiin	human
@jetebete	human
@lisamary01	human
@Ain_Munchkin	unknown
@MINANGDurman	human
@orthokindyork	human
@claudzbulboa	human
@KhalisaMK	unknown
@coreybankz1800	human
@Nick_Haby	unknown
@Daeminium	org
@davidgray13	org
@gopickelo	org
@elly_75	human
@kharen_1027	org
@Monaliakurniana	human
@TGBSurat	human
@snowdalala	human
@elcatacaldos	human
@simbabobo	human
@nuruladdiec	human
@dewinurinaw	human
@DiabeticPicks	org
@iamkiwie	human
@ATweets_	human
@kylienicotine	human
@moonforest	human
@riski_rauf	human
@riskilicius	human
@mks_cookingclub	org
@Xp3erynce	human
@jmha90	human
@kelsnation	unknown
@PlazaFoodHall	unknown
@canvas_yyc	org
@ICMarseille	org
@Noy8293	unknown
@jtloov	org
@rubylips1221	human
@zuoten1	human
@EastCoastMama	human
@DJTec19	unknown
@pratimann	human
@YayaMassacre_A	unknown
@UnitypharmacyFF	human
@radcouch	human
@feariinz	human
@irfanadiguna	human
@InstaMansion	human
@SandwichSwami	human
@damoncarter10	human
@ryannvillamater	human
@moses_says	human
@Bowflex	org
@YanneFriedrich	human
@Ted_Schmidt	org
@stickerevi	human
@SXYBALLINDIVA	human
@HayleyAnne97	human
@ForeverFlyJesus	human
@angelicswan	human
@Schlafly	human
@TONGUEFUMASTER2	human
@MSSeafood	org
@m3alima	human
@WhiteRoseInfo	org
@MarinaFiesta	org
@MadinatJumeirah	org
@DaleHaywood	unknown
@coffeebowdon	org
@ChefTrenise	human
@nurshameem92	human
@TheRealJess_85	unknown
@VanessaCarby	human
@6Figure_Shawty	human
@getLista	unknown
@32shea	org
@PassionateRadio	org
@seldalondon	human
@littledickybird	human
@HonestCookingIT	org
@Sandhya_Roy4	unknown
@BaRsInSyDnEy	org
@lovefooddrink	org
@VSMOOTH1	human
@M_Schuddinck	unknown
@L3iDeeNa	human
@troycap	human
@011202	human
@xKarolinax	human
@fanderson_david	human
@Silka_Spectre	human
@Seosockenbart	human
@swithess	human
@MrsBristolxox	human
@chyntialiem	human
@koichi_nat	human
@smokeoutkid	human
@antoneitte23	human
@davnavarro	human
@muenchen_hotel	org
@FlorCondor	human
@OhNoItsBex	human
@nastiasorokina1	human
@Psycho_Les	human
@Albertw2	unknown
@BluefishLuciano	human
@GirlVsSweets	human
@BossyItalWife	human
@Loay_Saleh	human
@elvina_santoso	human
@BlakeABoy	human
@trinitastreat	org
@_prateekj	human
@Madamecaramel	human
@umiekeysha	org
@monotaro56513	unknown
@ho_hocc	human
@nurtazin92	human
@ItzyBellababy	human
@AndheriJam	human
@PalpitedeLuxo	human
@brenology	human
@LarissaMAziz	human
@nadiamishchanka	human
@HouseCuomo	human
@susie_parker	human
@petikool	org
@ClaridgesHotel	org
@confeXioncc	human
@BambiNido	human
@paesHimuRa	unknown
@badtastefatboy	human
@Tommy_A_Koepp	unknown
@SchmidtMommy	human
@MISS_MORENUK	human
@CoachBashford	org
@Samuel_Mrc_Mdn	human
@CharlieChance01	human
@LuuSunset	human
@AlanRodolph	human
@kokodakecom	human
@Run_Mummy_Run	org
@cherhpy	unknown
@RandomOenophile	org
@juantomates	human
@mowenranger	human
@JMakJeans	human
@pararimpimip	unknown
@DassyDuzIt	human
@marcuspang	human
@df1hx	human
@WStreetcafebar	human
@giftandloyalty	org
@hoshi_falling	human
@swooshkidjm	human
@PurgoTeatox	org
@chrisxherrera	human
@kotodama89	human
@_LickMyIcing_	unknown
@louisevonge	human
@gkentertainmen	human
@Gyiwen	human
@Glamummy_	unknown
@ayyebrendah	unknown
@MarionWininger	org
@Nichomac10	human
@AFRestaurant	org
@amyelakiz	unknown
@bjf29t	unknown
@HerdadeFozdaRep	human
@Reneenakagomi	human
@RobinGlasser1	human
@jhen_latorre	human
@JetChefs	org
@widhiadeangelo	human
@natatascha	human
@Squash_Banana	org
@joeynikejo	human
@CraigsCookies	org
@ashembot	unknown
@edaGriani90	unknown
@CantinaBranson	human
@DORKRIP123	unknown
@BakeSale4NKH	org
@asyuraniel	human
@esojcandido	human
@match65nyc	human
@Frenelism	human
@kreshabajaj	human
@billfredwynne	human
@GloriousDmc	human
@Vanessa_vivich	human
@MaiMaiDelRey	human
@ViviiCheung	human
@Mangekyounokage	human
@OMFGitsMEL	human
@sevtapyvz	human
@JazzyFe31	unknown
@inalunetta	unknown
@RNCrisostomoCon	human
@CallMe_Bel	human
@Annydaya	human
@OriginalKabob	org
@mmmoan	human
@iamsalik	human
@Doveye	human
@murphyashley13	unknown
@iammooghar	org
@dagienkz	human
@Manuelceronte	human
@stephfashion	human
@EmilyDavis28	human
@AmuseBouffe	org
@TowYardBrewing	org
@QualitySocial	org
@DustinSoper	human
@msleford_g	human
@Fernandinho_G11	unknown
@VinConservatory	org
@prust04	human
@mama2lmcjd	org
@Phitthayasenee	unknown
@xxruhazziqxx	human
@lenebajamunde	human
@JuicyJules04	human
@missemily_jane	human
@mzdannielynn	human
@SWFL_Angelina	human
@hassanarazaa	human
@JustYenCaBS	human
@MARAGUSS	human
@IngeWidy	human
@GraceyChill	human
@FlavorofItaly	human
@AngelGaill	human
@GrubBoxSnacks	org
@bakerzinjkt	org
@laurie_mypotl	unknown
@Selvaggia81	human
@DisneyLostgirl8	human
@Hernaan_Garcia	unknown
@LeanneAnthonyx	human
@nanaypadron	human
@KWEST1995	human
@Cecy_Haro	human
@spikeonthewater	org
@Beth_Lazarou	unknown
@koriem_mohamed	human
@bennyfitz	human
@medixsteve	human
@Tastynsnacks	human
@tik_wilasinee	human
@UrbanEatery	org
@defiled_forest	human
@nithinankam	human
@ELLDRID	human
@rainedictator	org
@HellLion	human
@doingthemost247	human
@rasyaik	org
@april_ruth401	human
@MoormanGrantham	unknown
@mammafelice	org
@BrazilRetweets	human
@cclammoor	human
@Boredombaking	human
@acvbuttons	unknown
@stljs1	human
@theikid	org
@ConfusedBawarch	human
@Foodblogbyfede	human
@dweddinghawaii	org
@Sticky_Beaks	org
@CakesInReverse	human
@evadelvillar97	human
@AudaciousArshad	org
@kiri_hirokawa	unknown
@AngieInProgress	human
@daikinmanman12	unknown
@VixenMadness666	unknown
@claraelmo	human
@qazifabiahoq	human
@MeH_GirLz	human
@Tranquil_Dragon	human
@malenuchas	human
@SimpsonDave	human
@ElisaDiStefano	human
@NgugiMuthoni	human
@MisiakMarta	human
@LeClandesJules	human
@WinnieChou_	human
@UdithaAnu	human
@noregretz45	human
@StarStruckNYC	human
@redmotman	human
@0804_reo	human
@vika_sweet	human
@DjFulvio81	human
@UmaSharandon	human
@syallyn916	human
@WorldGymDesert	org
@Aripriantoni	human
@TropicZones	unknown
@diptishishir	org
@munozy1	human
@MRashidiR	unknown
@putripurple666	human
@LeNewtown	org
@Red_HeadedB	human
@katie_m_kelly	human
@kantinalondon	unknown
@GnarlyJargon	org
@Quoco07	org
@Littlebrewyn	unknown
@districtsocial	org
@KimDeLasAlas	human
@Ale_Winophy	unknown
@Jessicaology	human
@fatinadzirah	human
@TheEbookDen	org
@thetomatosnob	unknown
@ajaypadama	unknown
@shellrazali	human
@Sharon_bees	unknown
@EsLanCip	unknown
@SilkandScissors	human
@LeahRosanna1	unknown
@retepjoe	human
@LilEves	human
@cryslewis	human
@CGhotsauce	org
@cHaYAYaH	unknown
@KopiCatz1981	human
@shutterjira	human
@gpysees	unknown
@candacecorner	human
@AnnieRraoet	unknown
@KSpacePrincess	human
@zoulamry	human
@mtmt_moe	human
@elementpizzabar	unknown
@haprababe	org
@starlance08	human
@MyIndyMcDonalds	human
@PEFiona	human
@crazycheekyfoo1	human
@DapurCemil	org
@PressRoomBistro	org
@matryma	human
@Ifa_Muchenk	human
@humblemonkey	org
@jazziestyle	human
@fastfletch	human
@beiiaareyes	unknown
@sawanomika	human
@Bistro1847	org
@MINALIAS	org
@MelRiveira	human
@nanieztnanul	human
@dougridley	human
@petincco	org
@Flyer_thanu2	human
@MaichuTKD	human
@Fuferson	human
@milk3g	unknown
@TheMsJFox	human
@DJFATFINGAZNYC	human
@jonestrainer	human
@drinkchik	human
@duncaninla	human
@hughmann2	human
@7soulseven	human
@Im_RichBoi	org
@Desire_Cantero	human
@secretgardenhom	human
@pinnk_monster	human
@em_irene_ann	human
@MSInessa	human
@ViBE_ub_grape7	human
@RealMiguelg2	human
@mrvakalin	unknown
@TamOndevilla	human
@sandra_tamaela	human
@fullmoonboston	org
@ballet_stylist	human
@abidabido	human
@bmeckie	human
@operatcam	unknown
@tomonoff17	human
@marthaatphilips	human
@HealthyEatsLDN	human
@Beagle234	human
@Bmarchai	human
@BrianR2	human
@miltonf11	human
@HillCountryBBQ	human
@shyhae	human
@frizzling_fizzy	human
@macha_mpagne	human
@cyclingevans	human
@leroydlf	human
@laneige_412	human
@PDCACornwall	org
@Yulyyea	human
@FoodieMD	human
@AprilTadena	human
@Afro_Doms	human
@Girlproblem11	human
@eppisan08	org
@CoachEliz	human
@MandyjoWalker	human
@FashionAsILove	human
@OliveLiverpool	org
@E_ATzikis	human
@susankonny	human
@miabbklausnerb1	human
@Sharon_Cureton	human
@youbfit	human
@Woddee_devART	human
@weejockmaley	human
@ChesterLoverUK	human
@HoneyzMohd	human
@mamabeeCindy	human
@ewee	org
@dbyramboutique	org
@shailjas	human
@LaModernaRoma	human
@spicypeach	human
@vbangz	human
@paxnegro	human
@imsweetlemonade	human
@TheDrinkTank	org
@ariezeL	human
@benji3191	human
@angel_incarnate	human
@saturdayartisan	org
@lynned1111	human
@SymplyFressh	org
@castellana98	human
@express864	unknown
@fLofUmA	human
@pensandpieces	unknown
@davidjmunday	human
@VBODYPOWERFIT	human
@mc_namaraa	human
@sportvestinews	unknown
@OnlineSkor	unknown
@thesneakydees	human
@felapol	human
@CandyRose1209	human
@BerryhillBaja	org
@tigerlilybubu	human
@LynWeir	org
@Sama_Em	unknown
@cahal_pech	org
@DaisyFrenchie	org
@Cricrajeshpk	human
@0605ayy	human
@farabieberlouis	unknown
@Ateronon	unknown
@AmandaRoseZamp	human
@Harrys_HotStuff	org
@BarRiverBar	org
@nosoyadriel	org
@freddiesampang	human
@khayekhaye14	human
@peterandmawar	human
@schuaribitch	unknown
@bearlim0615	human
@flyersman19	human
@kidkoolit_ian18	human
@ActorKyleJames	human
@Gulnus	human
@mmaccapani	human
@babyweishin	unknown
@nepalplanettrek	human
@CiCi504	org
@Lauraford08	human
@AllThingsJen	human
@Prince_Raaj	human
@makih3	human
@LeaveittousTO	human
@janietsaica	human
@FemmeDomestique	human
@fitzroviajrnl	org
@angiegoldn	unknown
@tayDOPE_	human
@TamaraMezzo	human
@Carmen_Quiroga	human
@Peque_Detalles	human
@Hwang_iP	unknown
@CPKMiddleEast	org
@SayakaYm1	human
@Syura_Zulkiply	human
@JediSchmoo	human
@Paola072	human
@HolySpiritPA	org
@NYCocktail	human
@feastnetwork	org
@chusnulbing	human
@Bazophil	human
@zvathletics	unknown
@CocktailsandCaz	unknown
@lunchboxbunch	org
@BossyNyc	human
@itsmeKisstin	human
@PhenomenalMama	human
@Spout_	org
@LoveMe1921	unknown
@juliefoodface	human
@papersnobhill	org
@Wear2go_com	org
@Jenn_Soto	org
@CleverVintage	org
@SRCarolina	unknown
@hoyjolios	human
@Raouls	human
@andymitchell24	human
@KatieRhames	human
@HermanMowoka	human
@ICHIGOMILK_0222	unknown
@rannisaddap	human
@Foodielosophy	human
@LoveSnackly	org
@MobileCakesTT	org
@MDfineart	human
@wishmastersissi	human
@AnggaPradiptha	human
@leilafrugone	human
@anjuselfies	human
@Eddie255	human
@MargoBarbieOC	human
@Itlovesthelife	org
@lintonme	human
@JWSahar	org
@StephKeenanFit	unknown
@aprileveryday	human
@Adnan_Daughter	human
@Stylespersonal	org
@hiharu86	human
@nyan48_erika	unknown
@HealthHungarian	human
@TONIGHT_BTV	human
@CatShellMusic	org
@carldmarshall	human
@shahira0331	human
@DarrinChung	human
@kaleandcaramel	human
@bbpgolf	org
@drfcdevon	human
@PipoyPoypi	unknown
@Dave_Barreto	human
@ryzatazzjay	unknown
@joshua_clf	human
@Littlemisschoco	org
@SissiTv	org
@ChinSadava	unknown
@Kly1971	human
@ysmnkui	human
@vzafir	human
@brinton1964	human
@NunaaBie	human
@KARIMECHEQUER	human
@DY8Bray	human
@LindaMathieu	human
@LangPicardo	human
@iLady_B	human
@djgshock	org
@edyzai	human
@CRAFTParkhurst	human
@mizraim14	human
@bkkggrl	human
@jellyt0tss	human
@CindyClarissaA	human
@_HORTUS	org
@IbizaRetweets	human
@chinis8a	human
@JasminConner	human
@porksterr	human
@annisa_spa	human
@Capacitea	human
@DeeJayMac10	human
@Shunammite_Move	human
@HeyCharde	human
@Uriyya	human
@Manya_chan	human
@violettetilley	human
@JohnnysBmore	org
@juliogaggia	human
@9gogoTe	human
@emmel13	unknown
@RBogatell	human
@tinayums	human
@ayashinki7	human
@SaulBHP	human
@sherylhir16	human
@nex_piranah	human
@Talia_Stylist	human
@OHBrita	human
@arinMJputri	human
@Tdb34r	human
@Th33B3autifull1	unknown
@JaneLuminous	unknown
@cstylemagazine	org
@raziDj	org
@ryanjbolger	human
@naho_madara	human
@ezfitnesslife	org
@akaneslum	human
@GirlTua	human
@thatgirlrei	org
@mytenida	human
@bovajo	human
@HGalot	human
@JaredGartner	human
@lafs730	human
@graceirenewu	human
@OldTomsBar	org
@tekomaiko	unknown
@BananaGangster	human
@PaulineVerstr	human
@SoccerKid83	human
@HeimisheVillas	org
@AmylienaM	human
@drleasure	human
@ROCO	human
@Robert_Krioski	human
@Fit4Africa	org
@Segmedina_	human
@loriamjavier	human
@Trendlovers_	org
@TinyDealFrance	org
@CerroniR	human
@birmingham_in	human
@nicolasfabre	human
@Dale_Renes	human
@_Magwoj	human
@biasd12	human
@LeblancLucy	unknown
@ayahrhey	unknown
@momentummedia	human
@McCabestavern	human
@LennyKhouw	human
@MillenniumAUH	human
@Sexbasstian	human
@Vanessa_1017	human
@theextremebean	human
@fashion_galore	org
@AshleyLovesx	org
@pesan1977	unknown
@juanitacruz105	human
@GymCraftLaundry	human
@Rocstarr478	human
@MaxiRiedel	human
@Tokyo__Sushi	human
@bumbleananda	human
@chasingPB	org
@jcfenol25	human
@blognaturgesetz	human
@school_neta	unknown
@lauraimrolli	human
@AnnaVieBrand	human
@SabrenSOll	unknown
@yurixo93	unknown
@TBBRestaurant	org
@Mschocolet	human
@la_natalii	human
@AlyshaWilliams1	human
@moderngentsk	human
@ThNourishAffect	org
@xoxo_sav	human
@MissyAmorette	org
@BrooklynHilary	human
@elizabethdamiis	human
@wereRichardStay	unknown
@kincowHQ	org
@CStancy	human
@KhrystynaBee	org
@radnam	human
@louielouie723	human
@RayyanBlake	human
@CMLobsterORL	org
@lastkurts	unknown
@luckyrebecca23	human
@AudiMidtown	org
@campbellru24	org
@ShellyEdibleHI	org
@BornAdvertising	human
@vathees	human
@aussieasians	human
@AnchorTintern	org
@Ryo_sparrow	human
@ReserveerDirect	org
@CarolinaMLeitao	human
@derek_shane	human
@MariSayavedra	human
@MillyCookbook	human
@dhebbie2t	human
@FCoconutRecipes	org
@BISTRO22ROMA	human
@girlby_thelake	human
@tnttaqueria	org
@Alien_Wch	unknown
@NinaPuslar	human
@kiyomilk	org
@KassieinTX	human
@LincolnNYC_65th	human
@RIA_Inc	human
@mongolian_wloo	org
@annousa_mela	human
@ReLovePlanet	human
@BaguetteButter	human
@mardigrey	unknown
@lisadefazioMSRD	human
@sirJeff46	unknown
@Dol2	human
@rafaymughal95	human
@LadyZeeParis	human
@Oums92Diaoune	human
@dana_tay	human
@3renko	unknown
@HarbYara	human
@thatssodivamua	human
@8310955	human
@FitFlyMamasNWR	unknown
@IcoCondecido	human
@AGH_BnB	human
@NeighbourhdLink	human
@FitnessJoanne	human
@Mamethoo	human
@BobPetUK	human
@SandyJPOCE	unknown
@The7uffster	human
@BajaniC	org
@EE_Apple	human
@MelanieBODY	human
@mudcrab_wb	org
@_melior_	human
@WrigleyFielder	human
@lovethephotoo	unknown
@LauGalve	human
@YuriaKushido	human
@AkashdipMitra	human
@ross_707	human
@ArulDJabbar	unknown
@lostboyblue	human
@DreaJ5	human
@stuartwebster	human
@TonyUmana	human
@Afdhal_Fadzly	human
@SSY_V2	human
@BonggakaDong	human
@ardyan_fahrezi2	human
@kaisakallio	human
@VeronicaCaputo	human
@Colse	human
@KitchenNYC	org
@ritinhac7	human
@boldimagery	org
@dulacetduparc	human
@EnzoNeri1971	human
@MariSanchez0409	human
@RMuelstroh	human
@bsanta101	human
@stephaniesastar	human
@LittleNinjaEmma	human
@pokiedotie	human
@AlexNash18	human
@LanaLeesVoer	human
@anggunwahyuti2	human
@MissMollie_x	org
@Nami_0519	org
@FitGirlATX	human
@novarinadina	human
@daVidaRestauran	unknown
@pammyooi	human
@DIVALICIOUS1118	human
@monikadubska	unknown
@uprun4life	human
@WillyBMum	human
@WallaboutBK	human
@ROCKAFLOCKARAY	human
@Luiis_Maria	unknown
@YunhuminM	human
@informer_xxx	unknown
@SJWagstaff	human
@LaLaLovesChic	human
@eggsmart164	org
@alyah_z	human
@DJSydVicious	org
@goenmatcha	org
@kathy_aldana	human
@chris__warwick	human
@bkkmenu	org
@mikeberlinriga	human
@arantxasdiary	human
@CornKroky	org
@jubelproling	human
@TFranky	human
@saucyseattleite	org
@AProbaRD	human
@meiseibahrain	human
@jayneliou	org
@johnalby09	human
@MRC1981	human
@TashaAlyssa	human
@Lamaisondelmode	unknown
@StLouis_Picks	org
@DJKatrinaLim	unknown
@riceandbeansla	org
@JustVinaG	unknown
@dtgiii	human
@kjvillados	unknown
@DieMontillo	human
@MyGGGF	human
@heyyyitsnaomi	human
@CarolynDeverson	human
@OffshoreFashion	org
@CotswoldCreate	human
@jazzzzwu	human
@kennedyyanko	human
@LaetitiaZ	org
@flyingapsara	human
@ChikoLoCo18	human
@MysteryRecipe	human
@charliehorz	unknown
@BravoFrancoPGH	org
@gasalmito	human
@mummyjilly	human
@chigusa1992	human
@ervin_diesel	human
@emiri_nishino	org
@JBNetworkers	org
@TheHungryDonkey	org
@sumie_ram	human
@EMBiOs	unknown
@Pebblepip	org
@IndulgenceSlim	human
@TheSupperClub	org
@roberandy	human
@Duaaboutique	human
@_ashdee27_	org
@LidyaDecliana	human
@BarnabysAston	human
@peter1550	human
@bierbatteredNJ	unknown
@Dalmatiansoap	human
@upallsummer	human
@geedeeochida	unknown
@Jbrengc	unknown
@katchkats	org
@workingmumy	human
@MissBEVxox	human
@DavinaLeeann87	human
@SteamWorldWide	human
@HostelROOM	org
@elitacolantonio	human
@Victoriaeaves	human
@i_maimi11	unknown
@edmund_77	human
@darriuschism	human
@MPsilakis	human
@mztoya_baybee	unknown
@ogoknessy	org
@JansenYang	human
@Adhemarsoriask8	human
@jacojvanr	human
@brokensoul22	human
@HDOsw	org
@BarjeelGH	human
@GACCColorado	org
@_chloedavies	human
@foodcoop	org
@beerhunter2	org
@Jugdar	human
@FaveSouthern	org
@sweets_cc	human
@MitchGWilliams	org
@cakeduchess	unknown
@paul_kania	human
@jlnhaddad	human
@McGettigansPub	org
@n_sylwia	human
@OneLeicesterSt	org
@HappyHourPal	org
@joannajoeee	human
@egagaramram	org
@AbbotCookPub	org
@Daichi_1105	human
@Danskchef	human
@mybakingandmore	human
@lennesimoblog	org
@Lilapud	human
@Saskia4	human
@Lexhitlist	human
@shipley90	org
@b_odko	human
@ErricoPhotograp	org
@videocache	org
@trisevanswifey	human
@amandacjh	unknown
@abigailsw1D	human
@gabrielleyc	unknown
@SkogCarla	human
@VidaFoodie	human
@quirksph	org
@dhaliwalmk	human
@Arthursmumldn	human
@zoilaguerrero	org
@RoxyBallRoom	org
@Cubana_luv	human
@Ciliegina85	human
@yinger81	org
@CouponSavinDad	unknown
@dukes_92	org
@HunterAHomistek	human
@Lukas_henrique_	human
@KayTahRing	org
@hammiedos	unknown
@Rocky_Nash	org
@indraxie	org
@CDueholm	human
@nisaefrizal	unknown
@C_vietnamita	unknown
@Babebuymethis	human
@KathSwinbourne	human
@PeteZeed	org
@oneandonlymeeka	org
@married2food	human
@superfoodtea	org
@R3publicano	human
@philmywayne	human
@DOUBLEBAY35	human
@PALANAKALI	human
@suzedoo1	human
@supernova518	human
@GlisteningSheen	human
@PxyCynthia	human
@STREAMTriLogy	unknown
@ChiltonChun	human
@bucephalus79	human
@JacksRestaurant	human
@hyelisahello	human
@XieLi	org
@sellywhite	human
@Woodstockdoll	human
@ilbaronerossocr	human
@mcough	human
@piiaaa88	human
@16thStMALL	human
@kb2184	human
@Mavhicsandy_mpp	human
@fruchips	org
@_fitandhealthy1	human
@chefshannon313	human
@KermieM	human
@byAsco	human
@xs30527	human
@HaabNYC	org
@metalita	human
@emilyfetcho	human
@artrulez	human
@bal_erie	human
@countrygirlem83	human
@Glo_Vig	human
@rasavg	human
@FollowGoodStuff	human
@amit_jha2008	human
@Gaby_Cox	human
@dennicoleah	human
@Ndhym	human
@DCvisions	human
@THEMhylowh	unknown
@EatCraftPizza	org
@sming7655	human
@nmatsuba	human
@ernie0627	human
@Shurypuff	human
@shiro450214	human
@_anko_	unknown
@showta0311	human
@piazbox	human
@meli_orti	human
@emshealthdiary	unknown
@Nugus_Bottomley	human
@_ToniTones_	org
@rjf84	human
@DanyRuiz	human
@thefoodgypsy	human
@AgencyTurkey	unknown
@marionfasel	human
@MatiasKris	human
@EyesTrekking	human
@TheFatApple	org
@iammelissaruth	human
@ChickThatClicks	human
@yugoroyd	human
@Babaroma2014	human
@rmattwill	human
@athenachen0126	human
@PepeYacaman	human
@ChefYanni	human
@OrientEatsLA	unknown
@ilanterrell	human
@gastown	org
@FARAI_BAHATI	unknown
@andrea_giola	human
@delovelyest	org
@lyricsborn	human
@Gracielicious1	human
@cupcake_422	human
@longdudi	human
@bombaybruxelles	human
@7thSoana	org
@BrownsCambridge	org
@TheJackfruitCo	org
@DarARCMA2	human
@KrisHublerArt	human
@StonerIrma	unknown
@TwistedRoseAZ	org
@RizzoliFighter9	human
@SeaSh3lly	human
@GorgeousChaos04	human
@Fitnationmag	org
@CalEgan18	human
@Suzanne_Gamble	human
@GreenBoxFoods	unknown
@RebeccaBullon	human
@xyzaspeaks	human
@pamelaOscos	human
@gbudfitness	human
@iamsusettttte	human
@RuannChwah	human
@selflovebabe	human
@TonyMandolas	org
@MirandaTCS	human
@zuleimabgarcia	human
@AwayJay	human
@lingmuuu	human
@titaniumfairy	human
@jaccjaccc	org
@BloorAnnexBIA	human
@ocho_carrillo	human
@Huxleyandcox	org
@renai_aTFiM	unknown
@louie_bully	unknown
@chaaachin8	human
@Juanesky	human
@MrBenKlein	human
@JoshWhitelam	unknown
@mikeekaii	org
@Akb48gIs2	human
@cristian_cib	human
@part_spartan	human
@ckz21	org
@JunjiReyes	human
@alexthezang	human
@abusaadd	unknown
@wanderlustwell	unknown
@GUPPY_BUBBLES	human
@SELI_ei	human
@Doransonthepier	human
@origami_x	unknown
@designerboi9985	human
@AfsarArda	human
@houseleisureSA	human
@_TrippiJ_	human
@LadyTwilightXO	human
@itshowiwish	human
@bcnprincess	org
@utterly_argel	unknown
@kimhenry124	human
@Harrogatehour	human
@LilBittyCity1	human
@FrancoFChaves	human
@143BlueRose	human
@joeltemgoua	human
@186Aokooooo	human
@Anthea__T	human
@KatieRyan4	human
@funtime7777	human
@brunchinnyc	human
@polishd4pennies	human
@SiyaKhula	human
@SofiaCantey	unknown
@rhinomediaza	human
@TarjinRahman2	org
@MACH1981	human
@keepwalkinghere	human
@Pascal_Appel	org
@joannelim20	human
@CrownDaGawd	human
@daylelanae	human
@QCafeAbuja	human
@irissolaja	human
@theonlyaiya	human
@sabyera	human
@smurfette_i	unknown
@ChunLi_i	unknown
@generousari	human
@Gem_tld	org
@MiqaaChediac	human
@bigvote2016	unknown
@Corentin_W	human
@GeorgeDeep3DX	human
@julietanner07	unknown
@djstretchnyc	org
@CaptainTim	org
@navimumfoodies	human
@bostoncommag	human
@isaguevarant	human
@TVChaz	org
@benhillgrill	human
@Ms_Bonafide23	human
@fastHaziq	unknown
@JudyTinker3	unknown
@103HOPEFM	human
@Perrottis_TCU	org
@lasaeta	org
@BlueRainbowUK	human
@ashrules24	human
@BleuBarnBistro	org
@GencogluGnc	human
@theswellcafe	unknown
@PeteKnott1	human
@VivizhenZhen	human
@paullovestea	human
@Ranjuanne_Prim	human
@jwschow	human
@WalrusBBQ_CT	human
@EatAtPerkinsKS	org
@sugasaiting	human
@Bellpurple0119	human
@EnigmaNetxx	human
@foodiecology_	human
@juanjoich	human
@NomWah	org
@ApinchOfItaly	unknown
@christengowan	human
@SugarSweetHomes	human
@EvelynHowarth	human
@DenverPizzaCo	human
@RobinLavender53	human
@wilsonchiabm	human
@MistressKofOs	human
@kakachelFTW	human
@eli_baga	human
@gravityx9	human
@DomAng810	human
@AshleighJewels	human
@meri_pop_pins	human
@szgbsl	human
@jennassumner1	human
@ShootnDownCupid	human
@xjosiebabiix	org
@VikinoDaily	human
@BeGlamrs	human
@Magnus_Cson	human
@Techeytim	org
@thefrgalcottage	human
@ianv2008	human
@mchedela	human
@bitchybhel	human
@arikayulia	human
@VQLeeds	org
@JamisonDErnest	human
@thechicityvegan	human
@AntonNacion	human
@keelybshannon	human
@ibrahimajamson	human
@adro49	human
@WenakaSelene29	human
@JMarts99	human
@nekodaisuki1130	human
@seraj_alhadrami	human
@Akekawat_s	human
@knoxkeith	human
@Tirrnanogirl	human
@haliliein	unknown
@LeeLera	human
@jemimahblu	human
@TolkienLibrary	human
@cheesecaveRB	org
@Rafael415	org
@GinaZhenya	org
@MissChantel1989	human
@cheftheinrich	human
@p_saya417	human
@Ozemutha75	human
@EmmaPayne89	unknown
@irerr	human
@sodazin	human
@happy_food	human
@CafeBastille	org
@delectable_doll	unknown
@maxckoch	human
@onelifelivingit	human
@TheOat	human
@loavesnleaves	human
@ElizzabethK	human
@JudyYang_atfc	human
@zilboutique	org
@MustBeTheMilk	human
@lilmeady	human
@wanluv36	human
@MrBenCollier	human
@lepetitebonheur	human
@100PCT	org
@tommi_zhang	human
@MyPlantBasedFam	human
@nataliastevens	human
@MAKANDMEY	human
@LyssaWelch	human
@TheGreatExhibit	org
@ms_dorasmith	unknown
@Gerartru	human
@flaviventurini	org
@amitasososo	human
@themakeupjar_c	human
@JDennisM	human
@danieltri93	human
@YIWEN_HAN	unknown
@TheBachelorChef	org
@sandrayluo	human
@BelvinAngeo	human
@missLC89	human
@_theteenyone	human
@masamisae	unknown
@WorldTravelMom	human
@Baltax_333	human
@ben_keough	human
@pavii_	unknown
@jenn_pilgrim	human
@quyee	human
@michmcgregor	human
@coach_resimius	human
@badchilly1999	human
@RootsCafeWC	org
@el_fondue	org
@funchomp	org
@con21simeon	human
@StillrgnChamber	human
@Jamesshepperton	human
@doinakappe	human
@chefjaymorjaria	org
@ShiviRamoutar	human
@WHEYTOOGOOD	org
@WieleHungry	human
@darwinsm	human
@AimeeElizMars	human
@TanMariaMega95	human
@VisitFortWorth	org
@tazkhan	org
@FANTASTICRADIOO	human
@stanestreet	human
@djetergirl2	human
@Rolling_HillsCC	human
@OTFRichmondHill	human
@imsandees	human
@mariaabras	human
@YeelingW	unknown
@ZinthyaCy	unknown
@PRTandem	org
@begumsky	human
@CoyaMiami	org
@EricaAmericaOnZ	unknown
@Karibu_SADining	human
@Twittpiece	human
@zeppy_england	human
@chefscenter	org
@pikorinn3	human
@Thromizzll3	human
@PacCatchCOO	org
@beehive_bdg	human
@carlesanagustin	human
@nadiamancini84	human
@sundialgirl	human
@marthafawcett	human
@OpusHotel	org
@ReboundersRock	human
@CurlyChaun	human
@clarateddy	human
@missbdwalsh	human
@Bilishbob	human
@SaraMesaBueno	human
@RealWodkaVodka	unknown
@_realgoodgrub	org
@the_8th	human
@BecomingSule	org
@higuma8810	human
@cari_fowler	unknown
@a_good_foodie	human
@YengPLUGGEDin	human
@emmacooke88	human
@Andera905	human
@SdeSebas	human
@shanisahamid	human
@fahrer_amanda	human
@faizdatoazman	human
@eatlightright	human
@suhailahchiah	unknown
@risarisaaa06	human
@dilek_sel	human
@AlenaLenna	human
@Street_Food_UK	org
@vegasmom728	human
@Kellybrarian	human
@CalandraMartin	human
@MicrophoneJones	human
@Anadevin	human
@kaliaxiong13	human
@TheFieldsW5	org
@CutiePatroller	org
@TherealHannahC	unknown
@broomancexo	unknown
@irich_m	human
@willexploreph	human
@alicexxpink	unknown
@ElfNDragon	human
@quiquelunar	human
@aculjourney	org
@judkrub	human
@son_cek	human
@LUCKYNORMAJEAN	human
@YadriAlwi77	unknown
@FRNTR0W	human
@vivadsm	human
@baristacafebar	org
@FranBlackburn	human
@beelovemac	human
@AtelierParis_	human
@Amy_Katherine3	human
@Mellisebasan	org
@ippe94	human
@MistralKDawn	human
@OCWatchCompany	human
@Suzuki__55	human
@LuCaldironi	human
@Getrealbeats	org
@Vaibhav_SMO	unknown
@blestbutstrest	human
@TrokayInc	org
@nobiinu_x	human
@m3th4mp	human
@menswrmenswr	human
@azli_razali	unknown
@RoseVereecke	human
@CCHoldingsInc	org
@thrashedroadfur	human
@JJprjune	human
@oneworldwill	org
@CafeFauveParis	org
@angiechristie1	unknown
@TLauxo	human
@nxnwbrew	org
@smarteggsja	org
@IndianMakeup	human
@Erin_Ells	human
@aliceoneone_	unknown
@clarachn	human
@ONEBananas	org
@thejoyformation	human
@GundaW	org
@bobdelima	human
@journosarah	human
@ranmanila	human
@iratialkorta97	org
@nadianidnud	human
@tparkey830	human
@jesuischerry	human
@cafeorimo	org
@pinoy_1987	unknown
@NeilBNealy	unknown
@Heather_i85	human
@yoveelicious	human
@UmerSharif_	org
@AWyand311	human
@Setyadi_Roma	org
@kandiwilde	human
@keennethlee	unknown
@FLOGUY2014	human
@longhornbrit	human
@GodsOfa	human
@KarenWirima	human
@InstantWellness	human
@MemoriesByJenny	human
@FacundoAscona	unknown
@fadlunrahman	org
@spunkyfitjunky	unknown
@mssohollywood	human
@POPNashville	org
@taelonv	human
@CKdestinations	human
@BREEZ210MUSIC	org
@giselleavenido	human
@Rebii1	org
@aliceelinborg	human
@JackieRoseTv	human
@HRWright	org
@nubody1	org
@InstantanesKloe	human
@theellingtonny	human
@TheDreamCafe	org
@IndustryVantage	human
@O_So_SweetKiwii	human
@bas059250636	unknown
@Cynncho	human
@Mias_Kitchen	org
@daviglesias	human
@kpopmalesnaps	human
@marianitapop82	human
@chris2401	human
@CptnK8	human
@_japaneseusagi_	human
@AnyTots	human
@hahazique	human
@GeorgeWinsdk	human
@AngllCbraa	human
@devilishlygreat	human
@Falimhelmet	human
@morgan_b_pink	human
@wakapaipai4	unknown
@thetribeway	org
@irisherself	human
@pienkychin	human
@IGianFrancoI	human
@RanceePG	human
@bobobsunway	human
@TopLaFood	org
@KhengzAnthony	human
@iamnanztuden	org
@kbriannaxo	human
@ClauFerrero	human
@pagigenic	unknown
@Wan_Li_	unknown
@mzt0ky0	unknown
@NeuvooPortland	org
@abhimac	human
@pcskigal	human
@rah_dv	human
@PSYCHOGAMING93	org
@ALL4Q	org
@ivan2266	human
@joliecantina	human
@BTSTanya	unknown
@SaintsBarNun	org
@muhdphirdaus	human
@sTcRuncH	human
@MissLacito	human
@anggelina_ester	unknown
@AnnieGulliver	human
@zeppy_vintage	human
@BachelorTrek	human
@Kenfronds08	human
@stacyroby	org
@CamiiBayo7	human
@TalaToTo	org
@bhabyhaze20	human
@Michelle_pMayz	human
@dorimt	org
@etweetval	org
@we_fetch	org
@LivVsLon	human
@marcomarriott	human
@JenJen2712	human
@jncjmghs	unknown
@Angelchap	unknown
@marylougoyer	human
@Sauce_NYC	org
@koreanmutt	unknown
@Arwind_K	human
@Yhonghong	human
@mrwillw	human
@CentCaps	human
@mtlfoodthatiluv	org
@CaptainChristel	human
@AdhilaR7	human
@ryansaplan	human
@Fitriana_L	human
@FaridaKaizar	human
@kristiannprobst	human
@lawrenoktania__	human
@SofiaGHerrera	org
@snwch002	human
@nazaj4ever	unknown
@Liez_G	human
@Coconoil	human
@Hilaltsnn	unknown
@el_buenprovecho	org
@MeridienJkt	human
@MiddleStMinis	human
@dreamercri	human
@KillAMP	unknown
@MotiMahalUS	human
@UhmRene	human
@prettyyyCarl	human
@PicklesBBQ	org
@crackbrained	unknown
@kitty__softpaws	human
@MummaAve	human
@struinvOgel024	human
@Nathanoutlaw	human
@MissDestinyDoll	human
@Andreana_L	human
@koenvenekamp	org
@Nosirrah_EEl	human
@EleonoraMarino	human
@ajaizamri	human
@JuneKnight	human
@bmopositive	human
@LoveAnayia	org
@Yellowpotplant	human
@bjcaptain	human
@MadhungryLSQ	human
@Gluelessscr4pbk	human
@FadeStSocial	org
@wholesomefoodie	unknown
@fleurofthecity	human
@LetySuperstar	human
@phalanxifor_	human
@MizzGalvez	human
@PLovlie	human
@QdobaWI	org
@darealchief	human
@jennyvi1221	human
@DaisyandSausage	human
@stickyrice9093	human
@sassybrinaa	human
@cutlngpo87	org
@ManaVidyalankar	human
@findingvictoria	human
@apmurph	human
@sondriaWRITES	human
@camivanni123	human
@Dz_y75	unknown
@Blankitana	human
@LikeItsOurJ_O_B	human
@meroyalprincess	human
@HulkySmashSmash	human
@JulesHabana	human
@copyright1972	org
@Cangurosguarda	human
@VIBE_ub_peach4	human
@cgraceabrams	human
@syarefacamelia	human
@Dony_suratman	human
@rhiview	unknown
@MTLState	org
@Mumma_Cat	human
@latestsouthport	human
@m_istikhori	unknown
@MrTramueL	human
@papelonbistro	human
@kasma	unknown
@mrsgracelee	human
@Ver_on_ica123	human
@itsmekristytan	human
@renai_Mclf3	unknown
@Sarah_Lawson	human
@LisaPSUMOM	human
@marielacenteno9	human
@prityasprincess	human
@preggie_app	org
@ily5686	human
@LiveLaughhLovee	human
@MssOliver	human
@Fredyn85	human
@DebGress2	human
@SVanBurkleo	unknown
@claudiayamell	human
@FloydSoRandom	human
@JakTechUp	unknown
@petegilb2	human
@OoohNaNaNa	org
@GlenandJamie	human
@NazaninNour	human
@Akihiro031126	human
@jude_magee	human
@MariellaSimons	human
@kalei8carr	human
@LuluKimbio	human
@LiLMsMayShine	human
@chefanwar_	org
@ronald_Vzla18	human
@damanda8351	human
@theguycornernyc	human
@UrbanPlum	human
@marmadman	unknown
@pyros755	human
@banyupadmatangi	human
@ninau	human
@jnnyrvn	human
@MonicaBarbosa87	human
@MrMikeRamos	human
@LocalBanya	org
@MrsRoxas	human
@ha_yap	org
@thekissbandit	human
@NamYeungNam	human
@MolisanaImports	org
@CloserAliAli	unknown
@DJEFFECTLMP	human
@DPDAnthony	human
@Alia_Raman	human
@cvaughan64	human
@hendry6591	human
@JPAutoGroup	org
@Asherina1808	human
@AnnellyaT	human
@iamliamsfairy	human
@GeloMorelos	unknown
@meli_cahas	human
@fleursdumalmal	human
@CanDanceNicHole	human
@LilyIsis	human
@a2aca	human
@Susy_pazza	human
@assiretenob	unknown
@adagioboy	human
@JonWayneM	human
@ChixDC	org
@BeauSillage	org
@leopardmartini	human
@lookandchic	human
@ladykcat	human
@Giada_boo	unknown
@IndigoSmiles	human
@oandbrestaurant	org
@kellyribble	unknown
@HendricksonNews	org
@Ezyshine	human
@Theodora_Nan	unknown
@nuraffendy	unknown
@ViCKiKi_	human
@CreatingBetter	human
@BreakfastCanada	org
@BellaNYCMag	human
@CandiceChantel	human
@sacredhearthosp	human
@Hera7Noor	human
@ants516	human
@QueenCityJewel	human
@yogasupperclub	human
@tohtohchan	unknown
@RAZZ_DA_GOTTUSO	human
@cdoyle713	human
@mylittlebaklava	human
@arttebcn	human
@HVillasMiramar	org
@Daiveeed	human
@cdmtx65	org
@Diane_Edwards26	human
@Ikhwanprasetiya	human
@cesar_pareja	org
@prettycrissy12	unknown
@_YrLee	org
@IsDanielle	human
@annavonzansen	human
@CJ_II	human
@luciannita	human
@AmandaLiRD	human
@DoubleSixSeminy	org
@ZagatAustin	org
@tozels	human
@Owen_Daniel	human
@PubLePourvoyeur	org
@PropellerComms	human
@dinnerdateitv	org
@dancinggoatinn	unknown
@CACHETLIFESTYLE	human
@maddie_mart	human
@mizzberry101	human
@julycocoon	org
@RAWofaLioness	human
@radhikahamlai	human
@ChiaraPedichini	human
@ThursdayThirst	unknown
@becca_smerkerud	human
@FriarsPride	human
@sophieclark_	human
@iVishu_Gujju	unknown
@Timo_Brecht	human
@LiamPhotog775	org
@Hexeyfood	org
@sabinekadyss	human
@arief_onos	unknown
@eveychua	human
@Mr_Mochey	human
@anjmeowski	unknown
@cravewholistic	human
@pashionmagazine	human
@20silw	org
@louis_charden	human
@Getback_Records	human
@valtteri1102	org
@_LeslieEli	human
@TheSouthernAvl	org
@BennettsBistro	human
@BionitaFreeFrom	org
@keziyajones	human
@4StarAutoBody	org
@4leafclover409	human
@wulaand	human
@randombybrigida	human
@SophiaHanz	human
@bbrodricalde	human
@UpperCrust_uk	org
@AlaLokuta	human
@Jackiekovacs	human
@CheckAContract	human
@RugDoctor	human
@CrosbyVillage	org
@JeanneSay	human
@bimbaylaurablog	human
@Roman_Meal	org
@CULTURE_RIOT_	human
@7amoOodAlawadhi	human
@InaAlcantar	unknown
@vegankia	human
@Sayid_Potter	human
@OttawaFarmMkt	org
@ZOnDgirlz	org
@14chubby	human
@BlueAndOrange	human
@YoungApron	unknown
@MissLola328	human
@JGibsonDem	human
@Vita_Sunshine	human
@ColdBathRoad	org
@Chiquitapop86	human
@pooomy	human
@TheDonStroke	human
@dadayakg0105a	human
@kariem8e8	human
@nourishedblog	human
@middleholly	human
@SHRTampa	human
@Nicky_Rizzles	human
@LydiaMarcelaWJ	human
@GloucesterQuays	human
@aannaamaariee	human
@SweetDoughBoi	unknown
@Senorgrubbys	org
@Pamela90210	unknown
@tresia03	human
@RockonShop	unknown
@MaxineCatalina	human
@HRLXV	human
@Switchboard168	human
@stuntmanraf	human
@larettadm	human
@Arthur23us	human
@Akinfe	human
@andyc1100	human
@PaleOh_	human
@Mandalina87	human
@SkyHighAnderson	human
@WhitleyJosh	org
@Emmy_Colon	human
@NearAndFarNY	org
@OriTheSmall	human
@KearJacob	human
@thefashionfuse	human
@sales_iris2	human
@TheRestaurantSM	human
@GraceMaierGM	human
@rabbitlol666	human
@LansdowneResort	org
@follow_mda	org
@HayleyScottie	human
@Monkipan	human
@Herlustre2	human
@JanePlanUK	org
@andreh190479	human
@rowing_and_co	human
@Amellliaaaaaa	unknown
@NY_ChinaDoll_VA	human
@KuteKurvy	human
@photorator1	org
@Hikarux33	human
@iaremmerai	unknown
@toyomi	human
@AstisBubbles	unknown
@RaintreePC	org
@BillySimsBBQ	human
@CaleshJR	org
@suzieshehab	org
@Amano_Foods	org
@KLinnemann	unknown
@PacificPreK	org
@thenameschuck	human
@IamLeonardT	human
@ChikakoHONJO	human
@pesawah_padi	human
@goatboy91587	human
@EzamSulaiman	human
@AnneYoonVS	human
@Sazzlicious17	human
@Piumm	human
@loudiloo	human
@yuuchimu124	human
@KaLu06	human
@yzaraif	human
@melina1887	human
@Oxy_bot_Fr	unknown
@_VivianCarvalho	human
@WalterWalter112	human
@AMFM661	human
@s2_cas	unknown
@CassidyGladney	unknown
@eatrightiowa	human
@Un4getabldiva	org
@PerioDPointBlnk	human
@weihongchan1999	unknown
@amleann_	human
@pipnbling	human
@cinemaqueen75	human
@LiviaGlobal	org
@cindylinsf	human
@PoshPair	org
@SexyCarf	human
@amiangel	human
@elizdriscoll	human
@makirin079	unknown
@ASPreciado	human
@ritagirl20	human
@AzizKhouildiii	unknown
@AkGLanPgm	unknown
@HeatherSmithAU	human
@WhippetWhere	org
@ToucheStudios	human
@wilsonchia2u	human
@ThisIsKCcom	human
@Syawal_Adhna	human
@BeatrizLrio	human
@mondanitenet	org
@fargerberg	org
@rubenspiccionne	human
@MaggieBezerra	unknown
@PROPERCORN	org
@otoriyosemiyaza	unknown
@RickSmith	human
@tanyaleen	unknown
@jessicalauree24	human
@davyboi1151	human
@LaraHouseBend	org
@beautybitestyle	human
@SummerTencza	human
@Robb_Holder	org
@GoldenTouchLA	org
@Feeed_Me	org
@AntLiberti	human
@gelatomojo	human
@WeAreNewDelhi	org
@konceptfilms	org
@eatusrice	unknown
@southy_girl	human
@learnalifestyle	human
@solbreadwestend	org
@iauanmkt	human
@michelemclean	human
@sophieantonini	human
@aputcedatcedot	human
@foodismyfun	human
@SiobhanHowardx	human
@lauradextermua	human
@BobandBerts	human
@lymcrest	human
@ST_LifeTweets	human
@JesusIReyes	human
@kamatamizuki	human
@Dani4321	human
@stevecullenPT	human
@AnisBidin	unknown
@gregfoodie	human
@wholesome_fft	org
@tyronea	human
@K_waitforit_ME	unknown
@MaryHTorres	human
@Ebite	human
@MiiLeAb	unknown
@HerbaBombshell	human
@sp_idk	human
@Thrifty_Groove	human
@TunkuHarun	human
@bluistgirl	human
@enirdnec	human
@MajorieKriete	human
@AhmadKaisKamal	human
@AnneMultimedia	human
@JasonVettese	human
@FlyingRhinoCafe	org
@BartendHER	human
@saachin20	human
@mariovianney	human
@lauralscott	human
@YoninahC	unknown
@PIC_pgh	org
@YouthWreck	human
@Mandyshops	human
@beatriiizrocha	human
@thejoshhhh	human
@ainegal1	human
@Karin_Kristel	human
@DeLunchjuf	org
@On_Southend	org
@gofooda	org
@Chris_Chinnery	org
@susan1375	human
@mrscmd27	human
@RyC_shutterbug	org
@yrlocalmarkets	org
@merlynnparkjkt	org
@dev713	human
@PremoliClaudia	human
@rendy_keren	human
@sparkymews	human
@julliocardia	human
@ImPoperoMamon	human
@MomHippie	human
@ClickaFarm	org
@ChickswKnives	org
@alienaarcher	human
@jessica_moloney	human
@ConaWest	org
@poiOjef	unknown
@PriscillaMartha	human
@jemmyhill	unknown
@NaturesHabit	org
@Lishy721	human
@XimenaJimenezRD	org
@myslimquick	org
@Elnenemurua	human
@iolandarubio	human
@Ohad_aviv	human
@twitt580	unknown
@mandii1979	human
@Ribka_Monica	human
@carolynleanne	human
@MKTalk1	org
@RunnerChicWC	human
@QuestforCalm	human
@NuttyBMclovin	human
@alexis_morrell	human
@vkj73	human
@mogmog_birdie	unknown
@TheNikkiYoung1	unknown
@JervoisSteakNZ	org
@CaseysBrampton	org
@princessdi702	human
@slimlancaster	human
@yanaruseva	human
@denisealondra	human
@RGriscti	human
@FoodShuttle	org
@kehayson	human
@romer_linda	human
@bryeeegayon	human
@larafield	human
@Karls_143	org
@carlness	human
@FoodieGdl	human
@HollyMarieez	human
@NicoleDeSantis2	human
@MezeeMijot	org
@desy31	human
@crushice28	human
@USMadagascar	human
@TanSuoTravel	org
@Seluz_Fahik	human
@mrbravo2000	unknown
@TheHarlsz	human
@AlessandroMilly	unknown
@ameliae8819	human
@BrandonWest	human
@controlfreak316	human
@TSFCponsonby	human
@kmacca6060	human
@TrippyFood	human
@itszroekiddz	human
@IndyMomsBlog	human
@Ezgidogan3	unknown
@roelmoises	org
@vancitydrinks	human
@supercooldani	human
@wei_jun23	human
@BellamieClothes	human
@RevolvePizza	org
@kopinthai	org
@Student_CookX	human
@itknurd	org
@notsomodernblog	human
@LeSirenuseHotel	org
@ChihongZhang	human
@MomentsofColor2	human
@missriiina	human
@lifeasyouimagin	human
@AlterKristie	human
@Mya_Lwin	human
@CountryandTown	org
@filanastasia	human
@janscrisps	human
@Iffahtulmunirah	unknown
@RmkoSchippers	org
@MayDuganCenter	org
@LILROMANXD	org
@DanielAudi	human
@dandydujour	human
@yesileyes	unknown
@Foxyma2k9	human
@MaxBagelsNY	org
@gerommc	human
@sprkle1218	human
@kevinpurefokus	org
@Locomojo30	human
@FABmanchester	org
@CRAFTbeeryeg	org
@EventsArmstrong	unknown
@sergiofimiani	human
@leaflondonette	unknown
@mtdempsey1	human
@okik03	unknown
@meitech	human
@Crepe_Delicious	human
@mhaya23	org
@KetelOne	org
@PRhotelcipriani	unknown
@V_Brown_eyes	org
@justjhico	org
@Taisa_Veras	human
@CalleOchoNYC	org
@djharrylotay	human
@CRsRestaurant	org
@soya03	org
@chrislovesvioli	human
@wanderingkitch	org
@Chawykendi	human
@Sym93	unknown
@melanieliow	human
@Clemmy4444	human
@ollybars	org
@YoHobbyNY	org
@LoveAndLaugh01	human
@h_e_n_j_i_n	unknown
@ParadoxicSavior	org
@VaughnMyLove	human
@elementalaromas	human
@sydchan	human
@cindy_tuiran	human
@applepenuliar	unknown
@dimitry1970	human
@Sammy_Morrison_	human
@Sweetie37492	human
@NeilsonAndriake	org
@GlowPotential	human
@SaraiBurch	human
@toodlestothenoo	human
@BeATallPoppy	human
@roosterpisces	human
@DairamK	human
@MrWorldsfinest	org
@johannenriquez	human
@lilgreenhabits	org
@myinelegantlove	org
@hollowaylife	org
@EmmaMayB	human
@BushwickDaily	human
@TripleHQ	org
@LinzeBrandon	human
@Moonles16	human
@MeeraAmirZada	human
@luisgonzalez196	human
@whatseatingharl	human
@printer_sira	human
@OhChelsey24	unknown
@quenchbytidings	unknown
@DrSamuelAzer	human
@mbsspr	human
@YemenTags	human
@tien_khadijah	human
@shinyaofficial	human
@omegamovement	human
@faye2117	human
@mizy_sue	human
@KirstenBermanGF	unknown
@richmondasian	unknown
@Pete90Ch	human
@izozulia	human
@Eleanora1712	unknown
@MissKatieJordan	human
@cocotanka	human
@eypriljoy	human
@BayanJargon	unknown
@six_182	human
@CherryMissie	human
@szeeilan	unknown
@iamreylynne	human
@Make_up_Blush	unknown
@mazevedo04m	human
@DecadentMinis	org
@The_Combe_Mhead	org
@PutrinaADINDA	unknown
@DA_peruvian	human
@burcher2	human
@JackieWitzke	human
@HubbubEats	org
@Kevinthornton5	human
@rogerbipolar	human
@KRS47	human
@kponthemic927	human
@Taatiiii18	human
@yolandateskou1	human
@GrowthRinger	human
@jasintaervina	human
@IanSeanJohn	human
@MasterofMomInc	human
@bektypronto	unknown
@RosalieZom	human
@BakeZone	human
@IncasCafe	org
@marianela616	human
@TasteofBurl	org
@13canis13	human
@KKhankluay	human
@lovethosecakes	human
@SabrosoTaqueria	org
@AngelToInfinity	human
@itsmikehyl	unknown
@Mommy2JAM	unknown
@FullFoundry	human
@bottlenotes	org
@shafiqulhasan81	human
@grandinncomeh	human
@GlorPow	human
@nextbee	human
@CantinaHallndle	human
@GiftCards_com	org
@f_ckkkkk	unknown
@thea_nolan	human
@Arisa_Chow	human
@4theYoutubers	org
@KPSCALnews	org
@GeraldineTay	human
@Devins_Dove	human
@austria63amy	human
@Rickyturo	human
@priscillahgreen	human
@fooming	human
@eltiposinnombre	human
@LaydenRobinson	human
@Sanisha_28	human
@lissms1	human
@mufidahayati	human
@CBDTailor	org
@piiiii5	human
@EsplanadeResort	org
@imanol_ferro	org
@chainchat	human
@sneakyvegblog	human
@Laura_Aseijas98	org
@itslukeyall	human
@LaFemmeduChef	human
@StuffedSuitcase	human
@HamdaanSaleh	human
@dijeis321	org
@forluminousskin	human
@NorthStarEaling	human
@Kesha_Mkaay	human
@EspressinoTrav	human
@janbelingon	human
@ryba_karolina	human
@ManagementJames	human
@WellWithJoanna	human
@ci_maylissa	org
@BaraSvobodov	human
@4NOxshireSouth	human
@Conservatory659	human
@goodgrlgoneblog	human
@sstef34	human
@GP_Acupuncture	org
@DrRandyGreg	human
@talilambare	unknown
@JaxTruckies	org
@Justlinda23	human
@xsimsalx	human
@nikki_079	human
@QDGourmands	human
@Telugu_Blog	human
@p__hm	org
@CentralBklynCSA	org
@AddaPinch	human
@useTray	org
@Hunee_Munee	human
@janKEVIN_	human
@ChardonnayChefs	unknown
@ParisBienert	org
@DavidReveron	human
@jaswantskitchen	human
@FatsAndBird	org
@7Syvenn7	org
@steviecapone	human
@champodelux	human
@namiiberry	org
@MisterSchmidt	human
@kelseylin22	human
@CobbleKitchen	org
@Looksthor	human
@ElTriLopez	human
@taniaferdi	unknown
@afterDRK	human
@MammieYu	human
@boggyfresh	human
@chefcalum	org
@LucyTerriCook	human
@VictorNunezJr	human
@Charissa_Fay	human
@sagesociety	human
@q1rq1r0	human
@Mike_Tan96	human
@Igor111Banovic	human
@chloekhalua	human
@fylome	org
@Damnlovable	human
@Georgia_Bazioni	human
@StogieFarts	human
@ILoveManitou	org
@PeaceLoveSaving	human
@thismamatweets	human
@LittleMissMelbn	human
@lafourmiele	human
@RockseesS	human
@placesieatbtn	org
@saintmickmars	human
@mirjamlingen	human
@GautamArcot	human
@victor_williams	org
@angelaperdon	human
@iStacyOliver	unknown
@Eyla_Ismail	human
@BTUMIA	human
@Itty_BittyNikki	human
@KENGO_PHOENIX	unknown
@FrancisBerrie	human
@tapaslunchco	org
@CCKnokke	unknown
@drlnornelas	human
@cancerguion	human
@JGItchon	human
@niibrasa	human
@yaidunohannji	org
@superANT_OG	human
@Kwinxo	org
@nanachi775	human
@csbollema	human
@OnyxPrince	human
@jackglasser	human
@cliofast	human
@ninaonthemoon	human
@jon_hyland	human
@Balibrasserie	org
@reiko__takagaki	human
@ceru_	human
@BrawlinBetty99	org
@rafika9	unknown
@beautybrunchmx	org
@SusanneBender26	unknown
@CruiserByHeart	human
@dayahanhar	unknown
@PrettySafie	unknown
@Kathy918Adams	human
@DeeAthena	human
@nick83i	human
@ChefSandra2015	human
@kaseyskitchen	human
@NinetteOsei	org
@APCmtyEvents	org
@celebratedco	human
@eat_cleanDE	human
@lina__xo	human
@SageAppliances	org
@MeaghanTuffy	human
@ChelePlushie	human
@E_Fit5	human
@eddiecohn	human
@kanyui	human
@93ta_ta	human
@DaryllHew	human
@PilatesWHanneke	human
@Lkash20	human
@Mitchell2712	human
@Quicklylocal	human
@OneSq	org
@mall0ryfm	unknown
@billyontwitwit	org
@meliy09	human
@richesonmaria1	human
@somchartlee	human
@ceciliastromber	human
@BAD_MEDIA_karma	unknown
@ehoqtemprahj	human
@tety_afriyan	human
@ChatrinNura	human
@CynthiaSass	human
@uglyrooster4U	human
@ayaphoyo	unknown
@habibahmohamad	human
@DaniPonche	unknown
@kkrader	org
@BeitaDinamita16	human
@PizzaHutIN	org
@CitraTDZ	human
@pote1123	human
@Raymiel2412	human
@debazexydisy	unknown
@honeyandharvey	org
@JE_Uncorked	human
@harizkasin	unknown
@ellawikstrom	human
@magz216	human
@GrainsLegumesNC	org
@PinchOfNutmegs	human
@jeromeajones21	human
@WILLTPNLIE	human
@tonicasta	org
@maeyamanatsuha	human
@odettagli	org
@AnaAvy510	human
@722_hr	unknown
@iLoveMyLife3223	unknown
@KelliDienhoff	human
@KARIMAMUSIC	org
@MsSmittenKitten	human
@envystudios11	human
@amorlupi	human
@DinnerTwist	org
@JASchuermann	human
@JulioCheyparr	human
@misselinaariate	unknown
@_tuplacer_	human
@alinaconst	unknown
@MamalDiane	human
@KamanRyan	human
@HelenBranquinho	human
@Vanilla_yukina	unknown
@deankw	human
@Nico_NLY	human
@timdug	org
@CafeBlueChair	org
@stefiedrew	human
@gbucelli	human
@HectorGwar	unknown
@MarkPhelpSA	human
@SusanMcNeill	human
@DerbyStShoppes	org
@Babygirllina31	human
@SadieWeinstein	human
@Egdiel	unknown
@ciellavanille	human
@sashaghaff	human
@omoshiro_mDWbU	unknown
@simplyrizado	human
@RocioSaltenas	org
@magicoven	human
@FoodRockLove	org
@nicholeas	human
@GraficaBella	human
@GemmaTrattoria	human
@leonell_aroca	human
@RickyPopmeron	human
@luckylady140	human
@GezondheidB	human
@JillysCupcakes	human
@quornflour	human
@OteroManoli	human
@oliverdamian	human
@faryfredy	human
@paullnguyen	unknown
@FDLakeMary	org
@pnkheelspnktrk	human
@kanazoo	human
@LawmanMerrick	unknown
@GuerillaMcGavin	human
@DylonJones	human
@cityscapebliss	human
@NickoleRaddler	human
@dheath3180	human
@StPaulsBNI	org
@leeselby126	human
@lindsay_lauren	org
@LevinHorowitz	unknown
@NovaCooks	org
@jason_lay5	human
@craftiestcouple	org
@DominosPizzaAC	org
@jacquiefenske	human
@qftyabie	org
@EatnMingle	org
@focr06	human
@therandomguy07	human
@mikeshier	unknown
@zroxyz	human
@__VDS__	human
@TegannJadee	human
@stevejunjieneo	human
@BrickwoodLDN	org
@1iLove	human
@AnnBrampton	human
@TuTAlive	human
@CMVanek	human
@Hiltonhotelfans	org
@HullStreetBlues	human
@HollyBritish	human
@jveuxtoutgouter	human
@kazoodiver	human
@EricaRhone	human
@wlconcierge	human
@coachhousebooks	human
@BlueberryJane	human
@hungryhouse	org
@scrappydoo6	human
@_Full_Throttle	human
@Hawt_Asian_Mess	human
@HandiMan112582	human
@kariniwiii7	human
@NourDouma	human
@JasmineSendar	human
@RobynPaigeUK	human
@BrunchGirls	human
@jojofrench22	human
@MissNanylg	human
@caiovfsouza	human
@cookingwithmani	human
@Jasmine_B1A4	human
@MaurooAngst	human
@donnyv12_	human
@Chopstick67	org
@wondereight	org
@julesgr59	human
@rodsoutherland	human
@O_Zuca	unknown
@JOKER1112	org
@wantoinktoink	org
@pfeeto	human
@ire_nillaa	human
@Bemyalways	human
@glimmergirlxxx	human
@nashlacc	human
@beaberenguer	human
@immaDIVA_duh	human
@PedroPhtSantos	human
@PKHumanityFirst	org
@moni_0802	human
@InstagramFeet	org
@BarrhavenBIA	org
@gbdavis1	unknown
@MoveEat	human
@oceanview1969	org
@hida_kanako	human
@ChefCWies	human
@theparcdeli	human
@LiveSTRONG212	human
@ilsevkollenburg	human
@sands_catering	human
@rolls_mania	org
@B_Leddy	human
@BeatrizCavaco10	unknown
@out_of_ligh	unknown
@posysufazov	human
@AshleeJ_1	unknown
@HolidayguruIE	org
@Catchfiftytwo	human
@JessicaRoseM	human
@JeTaraS	org
@Chanel_Paige	human
@charityanna	human
@hannyyyy	human
@Aiicha_94	unknown
@Kalliojen	unknown
@pilates4pros	human
@luvleee	human
@EuricoChaves	human
@lkooli	human
@VeschaSwann	human
@jarsiny	human
@pearlynpeiyi	human
@CityLimitsWP	org
@Anyuta21	human
@ainsyasyahirah	human
@vittovito10	org
@Juparto	human
@fredytoduran	human
@thetwittaziner	org
@tiawanawana	human
@tamsinlang	human
@Isissin	unknown
@firdaus_h	org
@itsnowsamV	human
@sandyman19	human
@JessicaAten	human
@Shei_jay	human
@Rashp29	human
@djmconline	human
@HeyitsmeMicko	unknown
@FEEL_866	human
@EmirhanKRD	human
@MakiRest	org
@activ8health15	human
@5aaae	human
@myrtlebeach	human
@tatakbanana0401	human
@Esposito_jerryy	human
@CantinaItaliaIT	human
@feliciaevita	human
@BrassTapPines	human
@SaltsCure	org
@daranny24	human
@Chef_mbaker	human
@vrai_magfood	org
@cijah	human
@RobertCheeke	human
@DCHomos	org
@Marveluxeworld	human
@mZelleCupCakEs	org
@miichelleMg	unknown
@KelleherDelphia	unknown
@silvianjoki	human
@louise_anita	human
@y_o_k_o_	human
@NomadCook	org
@OkkeTheresia	org
@TkZW46	human
@Eatin_Happiness	human
@Hana_ni_nare	human
@blues8karen	human
@SD_Foodie	unknown
@HyattHouston	org
@AnBhialann	human
@nonnon6521r	unknown
@HRHJourney	unknown
@allaboutcharms	human
@bshallenberger	human
@yohaneskwan	unknown
@Greggyie	human
@CcileBriand	human
@suemclelland1	human
@JAKrist2	human
@backslapperbart	human
@m_z_o_	unknown
@Lundenwic	org
@Annie_Warhall	human
@PrincessTayL	human
@FarajaAdelaide	unknown
@HelloNokie	org
@ClikitMedia	human
@melaniebiehle	human
@RollysGuitars	human
@BeldaOzturk	human
@littleliamsdad	human
@bennettchin	human
@DJKrypton1k	human
@PXYD0P3	human
@Yummy_Paleo	org
@WhereToEatCork	org
@ATXBeauty	human
@Chi2xT	human
@colix_i	human
@amber_pates	unknown
@designerskin	human
@mybaby_love00	human
@garryfgrant	human
@ghie1978	human
@SANDRABRUNE	human
@Ken_Cotter	human
@LesleyJOng	org
@GillianA_P	human
@kenmacaraig	human
@GrillBarrelMag	org
@BrkNews365	human
@s00pagirl	human
@JohannaCure	human
@rachellopez28	unknown
@daverhiwlas	human
@sunnygiftsone	human
@x_shenksx	human
@FussyPots199	org
@swimmyokinawa	human
@IszPutera	unknown
@EdwynnYeap	human
@sjnightout	org
@ilchara92	unknown
@jennapilant	human
@friskyswanson	unknown
@ashleemdavis	human
@avery_bp	unknown
@deShasCincy	org
@LaQuercia	human
@GFWellness	unknown
@CallieBundy	human
@IlliasM	human
@dxbheidi	human
@DormeuilUSA	org
@medAbarghaz	human
@2FashionStrikes	org
@carobiel	human
@KK26OC	human
@RickBison	org
@HlebiLale	human
@MillaPinch	org
@VeganRebecca	human
@MasqCrew	human
@immarialuna	human
@thefussyfork	org
@rinatyxx	org
@SeptembersSong9	org
@DJ_Moloko	human
@voggesong	unknown
@VinceArvinDM	org
@AazaadPanchi	human
@NdumisoM07	human
@Lavitha_Tan	unknown
@RosscoBossco1	human
@ABChealthonline	org
@lee_allea	human
@Annabellainla	human
@TravisMakesTV	unknown
@miss_bee_xoxo	human
@urbanpeopleco	human
@JordansSexiMofo	human
@bigxjcat	unknown
@keechae	human
@ayachii93	human
@shiho0526	human
@mayraguzman1	org
@plasmadice2	human
@nenianggraeni	human
@Nyaar	unknown
@ArdaYsn	human
@gvladi727	human
@LukeStreet1980	human
@Huacatach	human
@AyeshaSky	human
@Clara_Rose2	unknown
@NordicCookBook	org
@nomnomanimefood	org
@JulianLeaver	human
@flabfitfab	human
@gegirlicious	human
@bambicco	human
@Chef_Klein	org
@psyduckieeee	human
@korn0506n	human
@kekerobusto	human
@zoominearth	human
@Markettower	human
@TheFlourWorks	org
@DisneyDivaGal	org
@pritam212	human
@iremmyuksell	human
@KrislinQuotes	unknown
@Bakmi_Idola	unknown
@AretskysPatroon	human
@iamiaey	human
@aimee146	unknown
@weeteck	org
@aaronamaya	human
@barrospizza	org
@theviennesegirl	human
@SoulKitchenStgo	human
@miamiquacks	human
@Koko637	human
@graeae3	unknown
@KatieGraceMarie	human
@abby_jb_xxx	org
@joiistone	human
@mrsdonnigan	human
@JasmineAlvarez_	human
@Qdoba_Graceland	org
@GLuglug326	human
@marianelaed	unknown
@ClaudC2014	org
@thielebenjamin	human
@teamhappyngood	org
@eugelaine	human
@LaDonuteria	human
@RunningWithRach	org
@AlForbiddenRose	human
@MIKESAVLATORE	human
@BasicRecipes	unknown
@ybashley4u	unknown
@Mlle_Lna	human
@intanAutami	human
@TexasFamilyFit	human
@sohodinerLDN	unknown
@nkjshr	unknown
@healthymount	human
@fun9ypan	human
@deerediary	org
@exetinaMA	human
@_TehreemOlakh	human
@debbieyogiwod	human
@guckenheimerUSA	human
@RuthieeL	human
@waepen	human
@LeiCasans	human
@PamperedAngie	human
@MartinsHotels	human
@kathyyyyy28	human
@foodonyourshirt	org
@jason655360	unknown
@giorgia77	human
@cexxyoriginal	human
@kiley_mcc	human
@sayaxxo	org
@NewYorkChica	human
@KatherineFrelon	human
@Sazon_MX	human
@LatinoHeritage_	org
@HeatLifer13	unknown
@VirgilSolis	human
@uliliumm	human
@FamilyPromiseCO	org
@angad_panesar	human
@lauraswelt	human
@CFCAngieCFC	org
@Faga__L	human
@marbooks	org
@Disscertainty	human
@SQUiSHYMcFLY	org
@AngelaRepcsik	human
@OSHIDOL_48	human
@Oomphlove	human
@TOPNCRYSTAL	human
@SalesDiscountUK	org
@ChrisHachikoo	human
@andhyfirmansyah	unknown
@AUSTRALIAMIKE	human
@Joserojasart	human
@arsmex	unknown
@sarahrachel_PR	human
@Fairyhill_Hotel	org
@sj0628	human
@KarleenCortes	human
@askjoeygarr	human
@URBNAnalysis	human
@IamMicholeTan	human
@DetoxFilmsSC	org
@krisadora	human
@bcnugget	human
@Flytg2000	human
@TransformMeals	org
@MioRestaurant	org
@dboed	human
@chewsylovers	org
@KatieHall00	human
@ccfontes	human
@mashedpotatosan	human
@uneebslogic	org
@sareeraya	org
@imtrishaquino	unknown
@GoVoskos	org
@progunbobby	unknown
@Shaun_Best24	unknown
@Vicho_avichuela	human
@KeyifliSofram	human
@chhchh	org
@arasso_exe	human
@GarciaPaella	org
@RoseByAmo	human
@VeronicaAgapova	human
@khaiyagirl	human
@Wok_A_Toque	org
@ekule_le	human
@LolyRusso	human
@Lukwi	human
@rreveronpojan	org
@alpa46	human
@mashmystories	org
@giuliapagnin	human
@WillDietrich1	human
@Greensurre	org
@vnilesfitness	org
@hamizah	human
@ericanovianti	unknown
@KDalde	unknown
@jptrevino	human
@Firavununtohumu	human
@hailie_p	human
@_KellyMcGill	human
@qg1973	human
@sexiim	unknown
@SisiliaLambert	human
@spabettie	human
@henrybanks07	human
@cddiangson	unknown
@blak_cloud	org
@bbmisctweets	unknown
@ailsalouise	human
@HeyImAnita	human
@HaidiDeltaSwagg	human
@GarretHutchens	human
@fewwehks28	org
@LatvalaPiia	org
@avexdesigns	human
@DjTranz	human
@1gamer_princess	human
@iluvdona_arceno	human
@figgfm	human
@kaylakittty	human
@DallasMomsBlog	org
@PoemTrees	human
@HousemateMusic	human
@SamuelFullwood	human
@SJNews9	org
@dustinMijares	unknown
@ini_friska	human
@SquareTwoBlog	human
@KittensBulge	unknown
@vixvixkennedy	unknown
@llei_cute06	human
@Wibisana0048	human
@vllgehideaway	org
@AshleyWESC	human
@Cayde_Stone	human
@yousignedup	human
@BaByCaKeS8o8	human
@WFMNewtonville	human
@m1_yan	human
@HuberHank	human
@hanabi_8	human
@FamilyFun	org
@thenewperth	human
@bizzilizzi50	human
@helenadurko	unknown
@JohanaVarelaH	human
@ashley_rayray_	human
@arohammer	human
@TheDarienite	human
@Paulagarod	human
@ZuzVystrcilova	human
@pacaokhaw	human
@Irmunchis	human
@LISA_WILK2007	human
@OrangeGroveInfo	human
@citychickenstl	human
@GlassHair	human
@Paul_Avila	human
@Womens_Mktg	org
@TeamRuckusLtd	org
@PonyDiningGroup	human
@elizabeth5363	human
@joelene2009	human
@MlleCupccake	org
@RachelMarieT21	human
@hotlyspiced	org
@evelyn_twitches	human
@adhahelmy	org
@Kristinson	unknown
@WalkingLunches	org
@gregorsdressing	org
@anjoooooyyy	human
@Montiblu2	human
@ROCKINGeventS	human
@LakesRegionCoC	org
@Barbayar	human
@TonyVat	human
@wadai_pon	unknown
@gEnio_euge	human
@JOSHDOVEN	human
@KarinaShiratori	human
@paleoontheRD	human
@bloodyrippa	human
@djmilitante	human
@anniedoogs	human
@HipstahhPleasee	unknown
@Pimisbuecher	human
@m4riannelee	human
@uguralparslan14	human
@ALEXccastillo	human
@earthmomma82	human
@RetroChalet	human
@linogua	human
@GiovanniRanaUSA	org
@ed_larderbistro	org
@Wika_Wolska	human
@lynnlovesdbsk	unknown
@Blendcafe401	org
@lawestmedia	human
@lepetitverseau	human
@murray1606	human
@BoatgirlTM	org
@TheRealKyleBas	human
@DerKeeks	human
@ks_2zxx	unknown
@X___Claire___X	unknown
@pjayployjaii	human
@livejew1	human
@heyitzshangg	human
@Orthology_inc	org
@SDRTraining	org
@_NeNe11	human
@tererecetas	human
@NIZUC_Resort	org
@OhJamesBBY	unknown
@Kwame_T_Hall	human
@koneko_neko_h	human
@PAAO_Andrei	unknown
@theveronicablog	human
@chai_medel	human
@betayeshazamry	human
@pacosantamaria	human
@Beaufood	org
@Jinie_Beans	human
@SawahBieber	unknown
@undercover_a	human
@lamarinamartino	human
@rssdesigns	human
@KWilliamsAuthor	human
@RotherhamsHour	human
@MO_PRAGUE	org
@13thStPubGrill	org
@missnaliaka	human
@ThereseTaylor12	org
@MsKatrinaLim	human
@NWDCScoop	org
@krystha_tweets	human
@105Hotfm	human
@promsi_twt	human
@HungryTexas	human
@zeppy_apple	org
@bridlingtoneye	org
@McGinnis_London	org
@CrazyJokerXx	org
@Di9it8	human
@YolyGalaz	human
@NeNov10	human
@Fog_CitySF	org
@juliancruz78	human
@honeytch	human
@Build__Muscle	human
@ThaisSher	human
@TheAlanHequibal	human
@hannah_friendly	human
@ndrewLie	human
@amirocks	human
@Aliamonster	org
@tomo0909_Kiss	unknown
@Andontowillow	human
@GamaConsumer	human
@BChowpatty	org
@Hardy__98	unknown
@ZueMrsEffendy	human
@TheCoffeeTrade	human
@KingdomOfDreams	org
@74ISTANBUL	human
@vixhiltonPT	org
@Nathy_Lei	human
@BoardwalkJazz	human
@sbczk	org
@NotParisienne	human
@annaritab72	human
@PROEDGEBIKER	human
@Evalyn501	human
@FennysWorld	human
@ClaudisTweet	human
@NotoriousJNR	unknown
@drachristiansm	human
@nadsvonrich	human
@anjeeprants	human
@aimeekitty84	human
@CharlineFoxFire	human
@dizBe_ken	human
@ClotildeRoux	human
@sarahbhairo	unknown
@3lynLoh	human
@1Up_AT	human
@debbydevina_	org
@CentreForWomen	org
@SofiaVoloWine	org
@twigchic	unknown
@arlenerogers17	unknown
@ATWNetworking	human
@zahrudinharis	human
@solarisx	human
@gejascafe	org
@iffa_afiffah	human
@sweetsaltynutty	human
@mashspienks	unknown
@jamespgalbraith	human
@wandagautami	human
@Cristuska	org
@AltafIshak	unknown
@FitForFun	human
@JoanQueeren	human
@HiAmyitis	human
@njmike731	human
@StickyWalnut	human
@Shifkey	human
@MySuitcaseDiary	human
@OneGirlCookies	org
@GarbyBrando	human
@poohbearcware	human
@aniedeee	human
@MarleyBalt6	unknown
@33jazzygirl	human
@CourtneyKuhlman	human
@BNICoombeWood	human
@SleepReaper88	human
@_BLACKK_BARBIE	human
@beelu13	human
@MinsooKay	human
@ninoskasua	org
@WiriyaW	human
@StyleOnV	unknown
@JesssiePerry	human
@dave1943home	unknown
@AndreCoulson	human
@hewella1	human
@dayandnightlife	org
@NandaWibowo_	unknown
@benjiebels	human
@KoriRileyLee	unknown
@ramonearthurs	human
@Djonix_id	org
@prashantwosti	human
@0Lenalee0	human
@ditullioluigi	human
@iamtroybonono	human
@rjespanto	human
@tophersuwita	human
@dagapodgorska	unknown
@JAoceanview	org
@gaooo_o	human
@KIN4LIFE	org
@MohamedBuhari	human
@JustOmelettes	org
@RevBhoyNJ	human
@Basilsinger	human
@d2balways	unknown
@MIroadtrips	unknown
@cheriembraden	human
@ivredeteslevres	unknown
@SarahQuan	human
@VHoulgreave	human
@Juliusthechef1	human
@3rdon3rd	org
@Lionheartola	human
@EricaPerezPR	human
@sweetliferunner	human
@maggielizeida	unknown
@Cafe_21	org
@ideaalert	human
@asimplerdesign	human
@adriangoh92	human
@AkankshaMaurya_	org
@cazij	human
@kenitoken	human
@MrAlSouth	human
@maxlrose23	human
@afreemanevents	human
@abbyjerky	human
@MyLifeAsCeleste	human
@cotswoldfayre	org
@Vixy88	human
@araphaxdeep	human
@Zepporah	human
@CelestSuar	unknown
@RanchoMirageRA	unknown
@StellaGorgeous	human
@xiannxy	human
@MattinBerlin	human
@15KYUMMA07	human
@EvaSabuco	human
@hayleyj11	human
@TasteofTennis	org
@BucksCompete	human
@flunch123	org
@chris_crash	human
@TripmeMichele	human
@sprinkles_spice	human
@brie422	human
@Holla005	human
@iamMadJones	human
@djonradio	human
@umountmycock	unknown
@gabriel197287	unknown
@wernerkeil	human
@andylevey	human
@bigdsgrub	org
@uae4kidz	human
@MuhanizaMuhamad	human
@wazzy1989	human
@eva_labas	human
@MarikatheDay	human
@fatfranz	human
@CannedTime	human
@BRANDEDSALOON	org
@silly_momo	human
@radee_rd	human
@SoofrineG	human
@daniiosaurus	human
@Earth2Ashley	human
@TaenieBear	human
@Yayaa_chan	unknown
@_sachiko	human
@Risa_amor	human
@KaramLDC	org
@zeppy_holiday	human
@h4n5t4n	human
@les_charlots	human
@antonellaprimo	org
@LizaRoblesG	human
@SarahlouDavis	unknown
@ZaraKettler	org
@visitCCW	human
@cutetothecoreuk	human
@jenniferchui	human
@stacylynne	org
@Mariposita79	human
@EstefaniaLuv	human
@NiceP_	org
@Joanna_DG	human
@tyyashin	human
@giokartolari	org
@Michael_Bell__	unknown
@NewbornTHAkidd	unknown
@HogandRocks	org
@pbregman	human
@understairbambi	human
@ChefGilo	unknown
@Raniah367	org
@MarcusLake31	human
@Juven80	human
@antigua	human
@MsDevonVictoria	human
@geeron831	human
@Novice_Cooks_TV	unknown
@TheJimLanahan	human
@fredslape	human
@begirls_akane	human
@VanhornOates	unknown
@esthermalan	human
@DJNickLo	org
@SharinaJulien	human
@jea1007	human
@ogatolarpeiro	human
@buffgeekymoose	org
@Telugu_Heart	human
@RColliland	human
@sweethandicraft	human
@monnadamaso	unknown
@Zach_lubbers	human
@BehrendtElen	unknown
@MissThickness60	human
@Greeneyez5	human
@loriannmd	human
@HungryTrek	human
@modacadisi	human
@rogerioalvesdiz	human
@Madeleine_Walk	human
@yourecooking	org
@karhutova	human
@IAM_CHINPHANG	unknown
@BradleyScott1	human
@qadrybasri	human
@romibites	human
@EVANGELIST4GOD	human
@catalva	human
@PreKPages	human
@MaisonLaduree	human
@CasamanilaCa	org
@maahijaanu18	human
@AlfGuitar	human
@Cavakia	org
@TheCoffeeHouse5	org
@cupidrop	human
@disclosuretweet	org
@FerchichiMarwa	human
@Simply_Potatoes	org
@HappyArielle	human
@Y2K8theGrrrrrr8	human
@Ch0ppingBlock	human
@AndreaDini_	human
@okta_three	human
@kolesiyiz	human
@imyvonne82	human
@ashleynunnlol	human
@DymeataB	human
@asu_1018	human
@2periodicocafe	human
@itsurfriend	org
@CuccioPatina	org
@tsunderellaa	human
@swagperfect654	unknown
@SugarSpiceMkt	org
@mariotulastrais	human
@Qdoba_Grandview	org
@rekanagy20	human
@Cecy_Paredes	unknown
@mrsdriverman	human
@imECKAclemente	human
@camilaaaacu	unknown
@HLY_chicve	human
@lookslikelara	unknown
@winxloo	human
@__lovatosheart	unknown
@MRJayWin	human
@roligaurvashist	human
@Raphael_Dudler	human
@SarahHPlus	org
@aima89ain	human
@DinnerWithLiam	org
@kieraliberati	human
@armieeeynavy	unknown
@GeraldoThomazin	human
@ashley11scott	human
@mehendb	human
@dadaaaaa2o	human
@Noah_Vinova	human
@BagiArtikel	human
@GonzaBS	human
@joyceespeaks	human
@MFakherdin	human
@cadreWEAR	human
@PrincessRosyRue	human
@DebbraHornish	unknown
@kurokona	human
@jumjumouano	human
@KimOptana	human
@rubenlicera	unknown
@IrfanHasnol	unknown
@DarkMysticNight	human
@AlexisBrath	human
@accrosscollege	human
@SamyValero	human
@Zealth_London	unknown
@PrincessAlana	human
@dailymomtivity	org
@OrangeCupcake_	human
@itsmechamalou	unknown
@pedersensrental	org
@Ash_Nose	org
@hcomatt22	human
@nixinne	human
@CJanes122	unknown
@LeumasHon	human
@bartines	human
@BarrowDavis	human
@Sta_Vinchester_	human
@SuzanneRico	human
@lizzztweet	human
@cheflaner	human
@CY_EXOtic	unknown
@mooncake421	human
@StephNLieb	human
@SophieLandes1	unknown
@______mone	org
@szafa56	human
@chopchopmag	org
@jeparisation	human
@JhooeMtz1	human
@TheIsaacReid	human
@MBroemmel	human
@PenelopeCafe	org
@my3rdeye	human
@JoshNY21	org
@Damian_s_p	human
@nifferhall	human
@LucaP6	human
@Stijn_vegan	human
@Kuskus_Ruiz	human
@thefriedparsley	org
@Alex_Halford	human
@biggrovetavern	org
@Bibita89	human
@BlinkLondon	org
@OfficialRichman	human
@_MichelleDay	human
@BarryWhyte85	human
@DJRAOLIN	unknown
@mistaTwiz	human
@RedCatSarah	human
@EllyWimer	human
@missoliviablack	human
@danisia_pw	human
@whitneyjdelong	human
@SinginSeanDavid	human
@TheManNamedRyan	human
@DJSAKIGH	human
@angela_sims1	human
@bjbcruz	human
@gymexile	human
@joedowdellnyc	human
@johannes_march	human
@michicolondon	human
@BeckieWood1	human
@ZouBisouCafe	org
@desertnovamugs	human
@Nicolejean28	unknown
@ScarlettDubai	human
@BellAndGray	unknown
@megastassia	human
@Catz797	human
@BartenderRSVPia	org
@WaltWhit3e	human
@chefkime	human
@StylingChaos	org
@PAOLINGFORU13	human
@LaurenJadeATX	human
@Jutomusic	human
@BeckyHirst1	human
@mskimisfierce	human
@robredo11	human
@wkoepkejr	org
@chriscieri	human
@VisitWorcester	org
@Laulovesclothes	human
@JaydeStaveley	human
@miyoungCm	unknown
@raraavisdelhi	org
@elliekathleen93	human
@maliciousnerd	unknown
@janessayeux	human
@ComunicacionLoL	human
@AlbertPostel	human
@sabrina_b10	human
@djvernoncarver	human
@PrettySanta1	human
@Tigina_	human
@auntiecharley	human
@Makderw	human
@SpringhillSuite	org
@ArttuKesanto	human
@yayasdmrz	human
@BostonBeehive	org
@jonathonkemp419	unknown
@CHOW	org
@YepJeeway	org
@gianrufin	human
@rachelspatch	human
@monicanimoo	human
@foolermy	human
@viviennelion	human
@skylight_lounge	org
@noonrize	human
@GrovewoodTavern	human
@Sen_EggLdn	org
@Haponesa10	human
@cherrybombpinup	human
@WallaWallaBread	org
@flipchickmomof2	human
@yrsgym75	human
@AnthonySCasey1	human
@jeanfrancis	human
@captureee	human
@HelwisAlison	human
@pukupukushop	human
@ganjagirl671	human
@vanillablack1	org
@Mia_from_Mars	unknown
@MrGwej	unknown
@SFEgirl	human
@specialforkdave	org
@cheezcarl	org
@jehmiebarrick	human
@bittertwitch	org
@Grawrbriel	org
@MrHillermann	human
@NB_Photog	unknown
@My_Easy_Recipes	human
@MissDecentGirl	human
@Tastad	human
@cwallen2	human
@TheNYBreadMan	human
@olivesfordinner	human
@iudsgdsag	human
@MforMICHAL	human
@thatguyChris12	unknown
@roztaste	org
@saimenbakery	org
@TappersCafe	human
@emily_inspires	human
@yh1202jk916	human
@azboogie	human
@ivichicprojects	human
@365Sabados	org
@IamAvin	human
@ma_ke23	human
@LifeTasteSoGood	unknown
@MahyuniErna	unknown
@JohnDiazYoga	human
@michelexavier71	unknown
@Funktryboy	human
@MimiB_Blazin	unknown
@molaudioinc	human
@LIGUCIS84	human
@DaisyTheMouse	human
@bayeraCo	human
@christine_wewon	human
@solomonsolis	human
@dcdeye	human
@deenhuis	human
@HarryHallsPT1	human
@gummybellie	human
@djLyNTeK816	human
@RapunzelNuruL	unknown
@mbymarcus	human
@Khairizayzk	human
@DaveyHolly	human
@miniDMmag	human
@Orwith	human
@AranaNola	org
@JLethabo	human
@Mybakersdozen	human
@lvgurl85	human
@MeynardPaulo13	human
@TraceTV	human
@OKDiner	org
@Nina_Oink	human
@cuterowena	human
@traitor_nico	human
@G_Rees99	human
@xmitchelxedge	human
@NeuvooBroomfie	org
@ticlinetravel	human
@ThornleysNF	org
@KekeMaramisII	human
@MVarietyShop	human
@rocknroler_girl	human
@shaylafitness	human
@TotallyFlab	org
@_Ella_Enchanted	human
@danredz	human
@SupaMike718	human
@ikkousha_ramen	human
@Ladyjennif3r	human
@thefinickylady	human
@MamaTU_SUPREME	human
@MBKSolihull	org
@JDW_MooiLeven	human
@lele2erqi	human
@GreenTomatoOC	org
@jackbullock	human
@depyKay	human
@131TheProm	org
@AquagrillNYC	org
@mssdaisy1	human
@aisling	human
@okkazaldi	human
@carolemartin610	human
@officialJart	human
@Xculpture	human
@RaleighOnTheAir	human
@WJP48	unknown
@DynamicAffinity	unknown
@DrbyCtyStranglr	human
@FerraraKaren	human
@vpgootee	human
@BmorrD	human
@katt2609	human
@agalbraith0618	human
@woifim	human
@thesoulofjapan	org
@BbJing23	human
@TFS_TotalFood	human
@TatianaElaeva	unknown
@koas8grtg	human
@visualsenseie	human
@lovethykitchen	unknown
@ricoyphoto	human
@ThePPP	human
@StellaDavis	human
@beecyin	human
@MyWhistlingDuck	org
@CloBlades	unknown
@chloejohnson3	human
@EllenaXue	human
@frankmarr7	human
@UhdatzBeedoeDuh	unknown
@TastyEdge	human
@yinRoot	human
@elisaday	human
@ganqiganqi	human
@Blutarsky_	human
@CragusMaximus	human
@IntermtnMedCtr	human
@Dreamstime	org
@hyzhenry	human
@MAMIEBOUDE	human
@OhSnapItsElala	unknown
@nnaaoommii0305	human
@cafebimelek	human
@gbespresso	org
@OttoGrG	human
@Angrybairdit	human
@Velarte_ES	human
@journal_style	human
@MandaInMotion	unknown
@SashasBakingCo	org
@bergles18	human
@MyKitchenNY	human
@ATastyPlate	org
@FatimaAl_Ali	human
@LeeSchaaZuey	human
@shinov141	human
@subhanat76	human
@L_Efemie_MCFC	human
@LocandaLeggera	human
@O1O1sayataro	unknown
@rhezanovianto	human
@imagineinkprint	human
@thegreenhead	org
@elinbrissie	unknown
@LowerMarshMrkt	org
@CrystleLampitt	org
@Daan_Fernandes	human
@NorFaTiHaH94	unknown
@amandamkeefer	org
@doidavin	human
@Rocca_Lexington	org
@Ms_Clairey_d	human
@desmondchris	human
@Food2Vous	org
@pejalkira	unknown
@AmericaIndienne	human
@denisenicolepop	human
@salcombedairy	org
@toplay4ever	human
@roselselot	human
@sumire1120x	human
@ma_torro	human
@JennaArtography	human
@iC5world	human
@beckityler	human
@biancaadriana20	human
@barleans	human
@lengsee5	human
@CarlynPamela	human
@NeuvooColumbus	org
@kyayi	org
@KataRocks	human
@mililnerd	org
@SergioGraziano1	human
@Maruchisays	human
@snowfish101	unknown
@Esther_Artist	human
@ozzgurL	human
@Ines_DeSuarez	human
@CindyCheng93	human
@Walestweetbot	org
@Millaneko	human
@aidamollenkamp	human
@edyskawaheID	human
@ImAeris	human
@megumi_0313	unknown
@Wan_ERA	human
@leisamayb	human
@cipatat27	unknown
@nicki_davey	human
@Lea___Smith	human
@andrushka_k	unknown
@economino	human
@feebi_fox	human
@VegasHungryGirl	human
@EurestUK	org
@ernestomartelli	human
@DJ_Kroft	org
@imiimace	human
@LinMarie_T	human
@Ryan_Summit	human
@Mandi_Chillii	human
@thevincenthotel	org
@djmarvel	human
@chefharper293	human
@Nathan_Luo_	human
@BarbieSania	human
@JuliusMcflylike	human
@samjobacon	unknown
@StrassFeed	human
@HAUTEbyDaniCee	human
@aaralynism	human
@nickydcooks	human
@RaphalYem	human
@grandplazaUK	org
@a__no__	human
@Bobsled_otaku	unknown
@MARineSuccessio	unknown
@mardhiahiftiah	human
@KarizEspena	unknown
@dance11holic	human
@mintyfusion	org
@WeedyBieleber	human
@planetayurveda2	unknown
@ZaraWoodsen	human
@revantonion	human
@andz17	org
@iamdiorlicious	human
@moorespencer13	human
@amgidynska	human
@MelroseArch	human
@AdelaideSeoSA	org
@purplelide	human
@justthewayilike	human
@moniqueangelyn	human
@LifeTimeLaguna	human
@awefome	human
@JryCgy	human
@imi0413	human
@LewisGTaylor	human
@acelholic	org
@myu_sherbets33	human
@DariaCimoroni	human
@ShirishBhakta	unknown
@GpeLupitaRuiz	human
@uncagedcuisine	org
@MissyDaLook	human
@youCEEme	unknown
@TastingQueens	human
@KathleenRuiiz	human
@NicholeA_says	unknown
@LindsayMMichael	human
@TwosomeStudio	human
@marasnave	unknown
@AbdelAlaoui2011	human
@inge_loker	human
@Salumeria104	human
@milcahllamas	human
@RajaNadia	human
@cmkish0w	human
@tran_vee	human
@Nazfiaa	unknown
@SCSpizz	unknown
@tsidideeh17	org
@IamKanal	human
@triprdp	org
@iananthonywadem	human
@jalafaci	human
@WarriorBetsy	human
@WiltDaCEO	human
@bmxergamer9999	unknown
@GSFKitchen	org
@Kyla4788	human
@Sticky_Panties	unknown
@LivingMySomeday	human
@MesVoyagesParis	human
@dyovoleta	unknown
@DaRealestWoman	human
@sipsandbitesnyc	org
@SannieSanford	human
@JaceyBirch	org
@MissBusyD	org
@karla24	org
@bsjunior1	human
@vina_viona	org
@josettehsm87	org
@metalheadjs	human
@senna2603	org
@sugarcubehouse	human
@CoreySeeger	human
@SteelbirdGocek	org
@FreakyBoomBox	human
@dbrklyn355	human
@daniela_chaya	human
@nataliecantell	human
@lizwilsonyoga	human
@ayjuri	human
@VisitLB	org
@Raphelle_SM	human
@RVNantwich	human
@LilianMoore13	human
@abbottemma	human
@sa7arfarooq	human
@chubby0318	human
@TheCabanaGrill	unknown
@jamondeaver	human
@BeautyForRunner	human
@BeingSmooth	human
@Powermanium	human
@LaurenceDenhez	human
@aelohomora17	human
@koreansamurai0	human
@siophal	human
@HandH_Ealing	human
@loupedro	unknown
@duaneheslop	unknown
@DanaKamote	human
@EHAMY	human
@vpyp	human
@teruaco	human
@borjedad	unknown
@BrittanyMahnke	human
@theguildagency	human
@PrimaPerform	org
@foodvalstyle	human
@PowerFm997	unknown
@Peggy_0817	human
@therambristol	org
@CC072	human
@YazzyBabyyy	org
@lloydsteahouse	org
@monsterchxw	human
@KristySimonova	human
@DannyHobbs92	human
@bubbyroses	human
@Alvaro_Martinz	human
@ninoyume	human
@nadianovember	human
@dawn_samantha18	human
@johntae_ivory	human
@PetritHusenaj	human
@RogiOlletob	human
@bondioli_luca	human
@MelisErek	unknown
@Jujukal77	human
@melstan95	human
@ChiangmaiUA	human
@kitgabucan	human
@Jose_Antonio_Ar	human
@ma1110me	unknown
@thepleasantdays	human
@GirasoleWorld	org
@QuanLegendary	human
@alliieethefall	human
@AnneNightingale	human
@apham17	human
@Yo_Wazzup04	human
@mike_angeles27	human
@Pretty_Southern	org
@theretropenguin	org
@emgrillos	human
@ImJoshGo	human
@UnstoppableJEFF	human
@jlfine21	human
@BOB808music	human
@DonnaKirkPeters	human
@aprileebhy	human
@jaejr	org
@DIY_CleanLiving	org
@CaiaMatheson	human
@atamamaruusume	human
@kheizkhie_04	human
@APDMiami	org
@hannyangels	human
@amandanzalone	human
@jacksinmyheart	org
@XhrisMaben	human
@tweetCapeTown	org
@baby424tiger	human
@624Ching	unknown
@VixenVBoutique	org
@SkyFoodie	human
@StefanusFK	human
@roxeedj	human
@topjongin	unknown
@jeremyqmartinez	human
@MarthaPattz	unknown
@GzmErenay	human
@Lycrawidow	human
@FreeWerkt	human
@AimanAmiruddin	unknown
@NurLiyana_MY	human
@GreySword	human
@mcrhodes82	unknown
@iamthemanansala	human
@LUXBelleMare	human
@proofpizza	org
@eriwinkle08	unknown
@Arielutin	human
@blowfishbbq	org
@yinyin95jini	human
@UrbanFoodFest	org
@clayovenlondon	org
@mandycbrown_	human
@HFCSingapore	org
@mrchipmunk214	org
@chelseyahrens	human
@CitySaladsUK	org
@_uarefab	human
@LaBibu	human
@CzarneckiD	human
@momoktomok	unknown
@iStashley	human
@Saffronflowers	human
@PintsnPlates	org
@justafluffyday	unknown
@VMilek	human
@rafaelasuarez	human
@Creeny_de	human
@SugarFactory	org
@jazzcafemv	human
@Huimin_Taiwan	unknown
@Montez2333	org
@lesbren	org
@fabistuffed	human
@hqaddomi	human
@SkylandClt	human
@ResumeBOTio	human
@KissTheRunner	human
@Mindy_Hart	human
@brunothenner	human
@MaiDashLee	human
@mariska_fani	human
@UptownCle	org
@dnicoletti87	human
@thepavlovsdog	org
@OoJiChOkZ	human
@ROCKsama14	human
@TMB0914	unknown
@whatevertickle1	human
@4JuicyLiving	human
@arumiinisa	human
@CeolaB	org
@milapisoni	human
@onelfitri	human
@ciciasskicker	human
@misssglad	human
@Rumika_100	human
@nuurinreal	human
@35535mer	human
@Couvfooddude	org
@why_do_i_care	human
@JennaThompson	human
@AatifAzio	org
@laceybakker1	human
@TheGalAboutTown	human
@CorinaGorrin	org
@CoffeeCakessc	human
@SalomeTintack	unknown
@quattroottobre	human
@thank_tank	human
@minnatheskier	unknown
@LordKimchi	human
@jura768900574	human
@MeKajcy	human
@Shakeintoshape	unknown
@Garris2	unknown
@DanyolJaye	human
@FelicieSalinas	human
@RoweBeck	human
@CupsandChairs	org
@ghurairrayhaan	org
@AmyHarber	human
@RobertHughes05	human
@IndustryBrokers	human
@yuliinickyarce	human
@punkyjakey	human
@JowalJones	human
@Timber_	unknown
@PassoniFabiana	human
@DNutrition	org
@michokaaa0205	human
@LiYaSan	human
@edenlye	human
@ivyytran	human
@nilechunky	human
@DJPIPENYC	human
@brisicles18	org
@ShellyWester	human
@wickan123	human
@brittanydcosta	human
@MZsoars	unknown
@NeuvooStPeters	unknown
@dessy_destria	human
@fotolica	human
@allenlandscaper	human
@HdV_Birmingham	org
@doctordshafir	human
@JungMinKevin	unknown
@Florencedut	human
@VeintisieteAlba	human
@GrownWithLove	org
@karlieburken	human
@1971ra	human
@ChrisSweetumsD	human
@FabioTameni	human
@akaJECK01	human
@OR_01140508	human
@MICHELLE_DINDIO	human
@iamvada	human
@batsivad	human
@haxbybaker	human
@MrCaruccio	human
@TheGalleryNW6	org
@FalynConners	human
@1993Isla	human
@BostonMoxley	human
@RogerWoodFoods	human
@HyattBellevue	human
@Aistuk	human
@Miss67C	human
@Pyrokinetic_Cat	unknown
@SocaSaySo	human
@mfbosteo	org
@cheewwyy	human
@davbai24	unknown
@DinnerPartyChgo	human
@jodeanhead	human
@sunnyxlove	unknown
@inGEEKTOWN	human
@lemamurphy	org
@SeanPatrickLear	human
@seacap240_hs	human
@JesssJustine	human
@feedyourcamera	human
@NOMADS_RULE	human
@47KingStWest	org
@calmaladam2	human
@FSDallas	org
@freedaf	unknown
@PartyIdeas4u	unknown
@YourBoyGarvin	human
@Mazerati_Marcuz	human
@jenmacphee	human
@JohnPHoke	human
@C15espresso	org
@LimoLivery	human
@Marianna2190	unknown
@Brooklandshotel	org
@pusspa_sarii	human
@JozefObuch	human
@RavenCherokee	human
@5starSteve	human
@farm_cafe	org
@reelSNOB	unknown
@IvanLevy1	human
@rupertbontigao	human
@emiliaevelynn	human
@nanduin	human
@j_vramos84	human
@ericdelosantos	human
@bernadettemiss	org
@emilycooksretro	human
@moniseverywhere	human
@TDUB_919	org
@savierboy	human
@MikaelaCornejo1	human
@DannielleCrisp	human
@alllifefocus	org
@Theboxandbarber	human
@natizun	human
@swaych	human
@ErlNotEarl	human
@WT_Magazine	human
@JayRnYce	org
@keziasarah	unknown
@CrazyWiseWoman	human
@Vhusukic	human
@QuelPerez	human
@izzatighafur	human
@tortuewaii	human
@PrincessHaylo1	unknown
@Queen_B_4eva	unknown
@MACCMUSIKENT	human
@redtopaz610	org
@MissSiobhanHM	org
@EgLDHsuki	human
@coolpams	human
@cmoney42	human
@ini_taree	org
@mandywine	unknown
@callmedhen	human
@imrheynnielle	human
@greathoteliers	human
@ex__aika	human
@nelianagp	human
@hadehoplah	human
@SanAntoniosBest	org
@Radnayurikochan	human
@a_Guu21	human
@YourboyDonell	human
@MaryAmyx	human
@luckyBgirl	human
@_Angelyn_	human
@younusakmogral	human
@Janiseywong	org
@bodytechfitmama	human
@goodfoodcast	org
@kndssd	unknown
@RosaOliva10	human
@bon4820	human
@PilarYamila	human
@CabritoGoatMeat	org
@BlytheJarrell	human
@maximumboy	human
@innapackham	human
@sjuab	human
@Charlottepugh27	human
@TheGazettE_Red	org
@djdmaxxx20	human
@mslie	human
@anderroom	unknown
@drakatiger	human
@DerekWongKuowei	human
@balletmaiballet	unknown
@TheJadeHare	human
@vicious0smile	human
@RadissonBluDkr	org
@Jaggsta007	human
@Jesse_cn	human
@IamTootoomoo	org
@myFabulousDiary	human
@oOhrYan	human
@bea955i	human
@renoster78	human
@NabilArabia	org
@nallysss	human
@ruanaway	org
@_Lauren_Grigg_	human
@pegster00	human
@2Real4Mos	human
@abeworno	human
@DemiCassiani	human
@AaronDonline	human
@Elizabe32305183	human
@RichardLinares	human
@MarilitaG	human
@musadocampbell	human
@francopenalver	unknown
@pamelayyj	human
@Nightdyne	human
@PureBrownSugar	human
@MarcellaSella_	human
@Myfreekitchen	human
@RadenCupuy	human
@RestMarruzella	human
@StuartDunlop1	human
@HOPE_nl	human
@strippedCHIC	unknown
@MillCreekMM	human
@PreciousPins	human
@kotoritte	unknown
@Cashflow247365	human
@99788Bud	human
@myrontmoore	org
@HealthyChefNYC	human
@neee_kooo	org
@KozmetikPasaji	human
@HqahAmin	unknown
@precint13	human
@EFlamerick	human
@CoButcherNash	human
@babesandkids	human
@MohdHuszaini	human
@PinkChroma	human
@redeyesjana	human
@natbalda	org
@Carpentergirl23	human
@itsmazzzz	human
@vimags21	human
@Pigkaju	org
@FOX26Caitilin	human
@eve429	human
@amyus85	unknown
@Hannah0313	human
@tomothy23	human
@EmoGaGa	human
@HayleyMMorris	human
@smokehouse21	org
@Merda_Chen	human
@caroline	human
@kcramer501	human
@ATLGAUSA	human
@kusineronggill	human
@starpolarx	unknown
@imanne4gettable	unknown
@Sancho_Pistolas	org
@gracemarinii	unknown
@ScottyG1616	org
@migoism	human
@AikMay	human
@roseledgefarm	org
@OrganicEating1	unknown
@wallacetsoi	human
@azredlizard	human
@PatrikBosen	org
@Aryo_Ardan	human
@TheAuburnGirl	human
@YDalesRealFood	unknown
@sasha_arana	unknown
@Rrusita	human
@KFQ85	human
@BezKawyUmieram	human
@a_marts	org
@FardinazFadzil	unknown
@gonzalo_ad10	unknown
@veggielovingmom	unknown
@itsNicolesz	human
@GabrieleLou	human
@LeithMatthews	human
@hookahplace	human
@GardinerMan	unknown
@mayawardanis	human
@mariko_arch	unknown
@dedybudaarsana	human
@Sarah33Mitchell	human
@wineandgoodfood	human
@Daltonn_M	unknown
@Lisha_YeXiaELF	human
@BandirmaLii	org
@LarissaSchucht	human
@Yello_Cocaine	human
@AnAngrySnatch	human
@cahyaintann	unknown
@RamirezzAshley	human
@Manal_Official	human
@rawrindiebabe	human
@Mitch_JRansley	unknown
@andreiapblog	human
@bodybuildingw	unknown
@taniagbonini	human
@dandL1on	org
@shzlynhalil	human
@PL4cey	human
@lovedeguzman	human
@zeppy_america	human
@Kamps1910	org
@brainybrowngirl	human
@jeffmocini	human
@TheHummusapien	human
@ForceBrands	org
@DrinksDoctor	human
@lauraRC94	human
@juliusjulian22	human
@yBfstanlee	human
@Rumi_ia	unknown
@cyruszlee	human
@abbytriniborn	human
@thenorthernduck	org
@DJsMakeUp	unknown
@IamDMobe	org
@Celebrity_Flash	human
@ivansanlopez	human
@Cenafood	human
@mukzpux	human
@Sldrsaki_	unknown
@mikotomiyazawa	human
@Hailme377	human
@Latenightblock	human
@HalanaCapitanio	human
@sweet15magazine	human
@aishaladon	human
@RadhikasTeas	org
@Selling_Coffee	human
@smmease	human
@fatimadaoud	human
@dellazai	unknown
@SimplyBee86	unknown
@vsbhojwani	org
@barispandir	human
@Georgiporgie00	human
@rownita	human
@WalterSarnoi	human
@660SSdjsatoshi	human
@NewInZurich	human
@Jayyy_714	human
@visithra	human
@abbiestone13	human
@dan06501960	human
@CatchingUpWKate	unknown
@flexAW	unknown
@likeadad	human
@ChloeLeos	human
@Ja76	human
@AmyToronto1	org
@caesarcognac	unknown
@6eventi	human
@ae_jones	org
@theroamingbelly	human
@elle_noire	human
@Hii_its_Jacky	human
@RobynDope	human
@SPG4EVER	unknown
@TiffanyLieeee	human
@PenelopeVB22	human
@Drayroc	human
@thebigfelaAde	human
@globaldish	human
@heymelindadaily	human
@jiccups	unknown
@showsuzanne	unknown
@macao0821	human
@DECOuvrir_deco	human
@withtheluggs	unknown
@dewidira	human
@JRDACLAG	human
@YukaE28	human
@lauralhughes	unknown
@VintageCSB	unknown
@JustinTuscano	human
@Crowdmuncher	org
@NehalRoys	human
@BrasserieJoel	org
@Nutelluhh	human
@TheMarramGrass	org
@mingxiwoo	unknown
@EuroKids	org
@luispalacioslp	human
@lmjbrichards	human
@LeysaUK	human
@haley_polk	human
@deli2dinners	human
@craftysarahp	human
@RomainSantoni	human
@IHOPQro	org
@ChildFund	org
@cynthy_a	unknown
@hobokenshelter	org
@MyRawesomeLife	unknown
@sayaelena	human
@jen_hewett	human
@priyapatel131	human
@ArtsMusicMovies	human
@Hawk_Cui	human
@designdigger823	human
@CarlWDisque	human
@ma_turcios	unknown
@AtylaYusff	human
@TaoPanAsian	human
@Jessie_Melendez	human
@Sexy_Model	human
@vvdofficial	human
@tomnordmann	human
@marijuanamusic4	human
@Ebr3him	human
@JenNeider	human
@athaPCAP	human
@elroyg1	human
@chitomor	org
@JWMumbai	unknown
@Imlisapaige	human
@LucyAnneChurch	human
@c_gutta	unknown
@Matt_yeung	human
@SheIsTheeMRS85	human
@xImaginarylight	unknown
@eatcake4dinner	human
@croberts422	human
@CisfourCasey	human
@SetoElKahfi	human
@veravesta_	human
@rayza_deathgurL	human
@sandieroyparis	human
@claux0430	human
@JeromeAldeza	human
@taylor23oam	human
@SubUrbanTrading	org
@Championology	unknown
@idkputwhat_	unknown
@gemstone158	human
@StreetFoodG	org
@geraldrflores	human
@CahAngelus03	org
@__hannahrae	human
@aevicted	unknown
@EdwinHauris	human
@iripomko	human
@Fromhightolow	human
@jettiemeister	human
@planbread	org
@8thWonderSpice	org
@Fedhislayer	human
@jloucrawford	org
@me_goodperson07	human
@nqp003	human
@yas_marilyn	human
@fairwaysCampsB	org
@AhunnaStacks	human
@Jemxia	unknown
@yummymummyfl	human
@lunchboxgr	org
@LIFEnextDOOR_	human
@DiscoverNorCal	org
@CoBaiiN	human
@jo_dubai	org
@ReclaimedPrep	org
@LA_Cali_Bitch	human
@MuttMan72	human
@smokiesinlondon	org
@IngeVernooyPhi	human
@nikkiesparzabaa	human
@Live_toBhealthy	human
@GPinckneyII	human
@CSNewsOnline	org
@javhamre	human
@MurilloItzel	human
@itslareina	human
@hizkiapah	human
@Olseeen	org
@BallDePaul	human
@aika_0920_	human
@nicolealycefit	human
@nkirasuke	human
@DatSexZDiva85	human
@TheIgnacioM	unknown
@IoanaMartin	human
@wiffiprincess	unknown
@LaLa_Dayna	human
@SarahShireen	human
@blushingnoir	human
@amfares9955	unknown
@simplyveg777	human
@mailamps	human
@msmonroe30	human
@Mandyola	human
@Lanvinskaya	human
@Rjtheragingazn	human
@AGBeautyBlog	human
@PjayRN	human
@lilicos1844	org
@iamchinitakathh	unknown
@jomart263	human
@S_Guin	human
@HUGOBERREONDO	human
@ShahRukhKhan00	human
@Monstermellow	org
@StefanBowers	human
@exile__saishin	unknown
@sank91	unknown
@marticovelli	human
@WeAreLove17	human
@sempreCOOP	org
@nannadukesjacky	human
@EdinsNottingham	human
@kenmilk0802	human
@nanastella90	human
@Laurance_Xiu	human
@UrbanKweenBrand	human
@CourtyardMP	org
@KristinaHitler	human
@lidszx_3	human
@akophil	human
@tizutyan	human
@DoubleNRich	unknown
@ihappi	human
@CoOwness	human
@FeedmeCJ	human
@adnanyusuf	human
@CestLeVinRVA	org
@_SkiJumping01	unknown
@CupidDidMeWrong	human
@Just1Sina	human
@JulesBistro	org
@thaiguy123	human
@BluestemSF	org
@TayB4NonProfit	human
@ArborpointWS	org
@kookoomonster	human
@choschos_jb	human
@mpascua	human
@thisabode	human
@marchingangels	human
@Tracie_Rose	human
@etylyeung	human
@PetitCotillion	human
@Annrin2	human
@mrskathrie	unknown
@2elementsdjs	unknown
@tinkertink2010	human
@CoachOnnie	human
@jessiecamacho	human
@Justin_St_Clair	human
@corrineemata	human
@JoMElston	human
@SaruMouli	human
@KelleyCabbana	human
@GraziaTardo	human
@stevosrs	human
@aghnii	human
@sproutsmommy14	human
@C_Cunningtubby	human
@VallettaVerezen	human
@JamesRTullio	human
@CWolfePhoto	unknown
@crryystaall	unknown
@therealdamianb	human
@Lillian52305187	human
@DreMC10	human
@RhonaFox	human
@MeHerHeSirYo	human
@mrstusk	human
@mleignadier	human
@Dweber54David	unknown
@francescasfl	org
@karentakatoriii	human
@happenstance013	human
@deraapasha	human
@nytimesopinion	unknown
@JohnGintyRealty	human
@steebri12	human
@Tasya_Langi	human
@WWU_Dining	org
@geowhoa	human
@MigTorres314	org
@NiniModa	org
@rebeccastreasur	human
@ReyccaNanda	human
@sotisotto21	human
@ChefSteps	org
@mimibayb14	human
@LailaYafi	human
@LiveLikeBritt	human
@Agnesporn	human
@siewlee1806	human
@MatiMorgan	human
@YelpBrussels	human
@kulturezdotcom	unknown
@ValeriaVanfiori	human
@pietrinooo	human
@dhiggins53	human
@nathalieadeline	unknown
@lisavirgin	human
@jxradxoor	human
@gcampbellstyle	human
@BusinessMoney	human
@AngeLxLoveR	human
@FarrahYaacoub	human
@Carol_Doughty	human
@tbollekeresto	unknown
@martinlepage	human
@bigolgreek	human
@kamalasu	human
@7evinAteNine	human
@thomystrass	org
@San4fun	human
@hetinyrecyxi	unknown
@StayGroundedCBC	human
@MissOaks	org
@ciaInka	human
@WASaphrodite	human
@Indry_Karen_	human
@MrsLeafyGreens	human
@GARDENIASORRENT	human
@CogginsRalphs	unknown
@iksretep	org
@VQKezia	unknown
@shannong704	human
@BytheWayTO	human
@theKONGLIST	human
@valemaldonadd	human
@MartaTheBest	human
@SaveurMaroc	org
@elfelit	human
@GardeningTags	org
@bhh59775	human
@slaurens23	unknown
@foodmadewithlov	org
@WatfordMarket	org
@Akla_KIKI	human
@215Foodie	org
@TMRMrsNotso	human
@JulieWest96	unknown
@iamrobertsen	human
@bakasid92	unknown
@pathong410	human
@TucsonNightOut	unknown
@prototype3224	human
@goddessrosemar1	human
@RohanVangal	unknown
@jrshotyou	human
@islamheshamy	unknown
@aldrich_b	human
@jeunk_dewie	human
@MrsBeaudette	human
@MissDomoniqueJ	human
@Lynees	human
@MyNutritionPlan	org
@chanM0323	org
@EllyMenger	unknown
@AlmaCocinaBmore	human
@emirlyy	unknown
@LuluxKris	human
@Pac0u	human
@ypdine	org
@MotherWouldKnow	org
@Rthemise_	human
@Changingplate	human
@acchi	human
@SportsRDExpert	human
@agnitadamaria	human
@richie3royal	unknown
@masslivenews	org
@napolionking	human
@JenBroyles1	human
@themarkwootton	human
@_jnf	human
@NurryMz	human
@pilyanghauswife	human
@ZiGGyBarFlY	human
@imass_81	unknown
@flowerskt	human
@andscreaming	human
@HOODZION	human
@I2aNdaLL	human
@tapiamba	human
@lynkensam	human
@briancyork	human
@ciparent	org
@AnuRiikka1	unknown
@Telugu_Mind	human
@SofitelDXBDownT	org
@marijune17	human
@_Lady_Digital_	human
@candidJerry1	unknown
@Archiesnotebook	human
@266Painters	human
@RochelleLeeD	unknown
@bethasmara	human
@HAROLDLUXFORMEN	human
@BabyKennKenn	human
@nataliatanahara	human
@intan_nayoan	org
@EmilMacaranas	human
@massappealdl	human
@peterem04897913	human
@Lets_B_Real	org
@ShareStrengthDC	org
@GordyCamp	human
@bieleib	human
@MalenieAragan	unknown
@KimMoShow	human
@erichibi27	unknown
@KalenBlayke	unknown
@iampaigeparker	human
@jeffboi87	org
@SassyKittKat	human
@EsperantoBr	human
@0509_rika	human
@vaaa_lentina	human
@PrettyLittleJam	unknown
@MindyKayRay	human
@sebas62971	unknown
@PeterSpurs	human
@18__PHOTOS__18	unknown
@T_Square_PS	unknown
@Nachurodriguez	human
@KOYUMARUCHAN	unknown
@mf711766	human
@moniortegag	human
@tattoo55	human
@THEDAILYREGIMEN	human
@marbingham23	human
@Gl_U_v	human
@carolinesther30	unknown
@BagelShoppe	human
@AnaPiliCM	org
@OneandonlyKijai	human
@incisionn	unknown
@teenybod	human
@iamachampionne	org
@ghoshneha	human
@trayrific	human
@coconutbenefit1	org
@OhSoVane	org
@JustAManXXX	human
@pinkcrayon7	human
@imagewords	human
@Sprinkl_Food	unknown
@153154SiO2	human
@CordeiroRick	human
@lorenjaifreeman	human
@fitriafebrianto	unknown
@nnhotels	org
@Purvikins	human
@MakeupbyMakalo	human
@elico917	human
@thonybucket	human
@Rich_Rick_Trus	human
@xxxxo6l3	unknown
@jamiewilliams99	human
@PispiAndMau	human
@DbosWingsNMore	org
@FanDeLaSanchez	org
@ShannonCuttingx	human
@seemplyjaja	human
@georgianbath	human
@potinue	human
@ajblackshear	unknown
@NancyPantsDV	human
@antochesini	human
@ShonuffArt	org
@vee_visha	human
@BlaiseInFitness	human
@MyYellowBells	human
@SofiaMiller0	human
@augusrodri	org
@greencardmonkey	human
@lovemyclifford	unknown
@MissCharlyMae	human
@manulele81	human
@moneta628	unknown
@boegrasias	human
@honeystores	human
@RUWandering	human
@cinemadna	human
@mrscrimbles	org
@PlaceOnTheBay	org
@yemaiia	human
@BothwellCheese	org
@willkidsmusic	unknown
@CharlieLima79	human
@HallyuBack	human
@dark_angelik	human
@iamsupermc	human
@urbanindia_SA	human
@_Vi_ki_	human
@La_BellaCupcake	human
@2knowu2	unknown
@PATrickstaarrr_	org
@Azhaziel	human
@KelliBMiller	human
@postelled	human
@AlekGorg	human
@itsmeicoy	human
@Hitchhika21	org
@Mercadoel100	human
@LOUCHAUD	human
@jennitavb	human
@sergiocorbia13	human
@NurMaisaraaaah	unknown
@Cole_McFarlane	human
@dyanlittleblog	human
@Zocalo_Sactown	org
@Trivento	org
@nickontheradio	human
@CappysCappys	org
@bitsmithshubh	human
@Littlebluealex	human
@ChewDigital	org
@Xiiu92	unknown
@awadhnyc	org
@nenita_miranda	unknown
@HENRYsNYC	org
@RominaEsc	human
@emiliaginestet	org
@ettalidwina	human
@nikosmykoniaths	human
@gulsahtanote	unknown
@emilyh1234_	human
@SupaNova_Key	human
@FireflyKeyWest	org
@Josh_Hopkins91	unknown
@RickyTsaiWu	human
@MARIAKAMIYAMA	human
@Hem_bitch	human
@kayenalimagno	human
@gratiocafe	org
@intrippytationn	human
@xmisskatielynn	human
@twirlmycurls	human
@bar_starz	org
@LaurenAlisabeth	human
@ShannonDuffyx	human
@DavideLastrina	human
@OssimoroMoro	human
@iamblu020	unknown
@RadegastHallBK	human
@aikochoo	human
@CutieKylie	human
@GrahamBlus_Rvmp	unknown
@KuroseKurose	human
@CleverHousewife	human
@samantha_keenan	human
@george_wiliam88	unknown
@pineapple__mag	human
@Heckalous	org
@SinouCoffee	unknown
@nesoong	org
@CharleyMatias	human
@carjim16	human
@ROOOARNAIZ	human
@ronnic1031	human
@PamplonasDeli	org
@Telugu_Scope	human
@xaieatsalot	unknown
@IanChatfield	org
@ryaneresen	human
@satnamkhalsa15	human
@morganhughes25	org
@FantasticHasna	human
@Carin_Harris	human
@rachels_nd	human
@caseykeating	human
@DustyKramKram	human
@andyfussel	human
@Gracolo100	human
@cyrananz	human
@AbrahamMcDonald	human
@wangpeng18	human
@Ahhhnai	human
@rider_retweeter	org
@Namphon2U	human
@WhereDC	org
@culinators	org
@CasaLunaUbud	org
@XiAbebsss03	human
@UrbanSuperchefs	human
@dee_and2002	human
@CaroleChvlr	human
@NeuvooRochester	org
@blulafotogenica	human
@jasonmherring	human
@BellaVvonG	human
@Uzumlunargile	human
@Rachelle_WH	human
@theatelierinfo	org
@beckyeh	human
@tspoonbakeshop	unknown
@Mittens57	human
@robynne808	human
@carlosmarquezfm	human
@iGuriya	unknown
@NottsVIP	human
@elisiashoppe	human
@missmusicdiva	human
@chimazo	human
@VeraInesRamos	human
@OriginalCI	org
@SouthHavenCVB	org
@SouthrnSeasnCHS	org
@savethedogslife	human
@aliceinframes	human
@jcma1983	unknown
@nala_me	human
@ParadiseKafri	human
@DonTequilaRoss	human
@Milie_MW	human
@cannmilliken	human
@baiqmalinda	human
@fana_kim	human
@asliecemmm	unknown
@farmans_	human
@aliyahyaeli	human
@deeshoon	human
@EvivaTaverna	human
@oimonana	human
@SuffolkLover	human
@FedericaBVB	human
@Cutkillavince	human
@deyhate_da5ha	unknown
@CharlesRiano	human
@ziilong	human
@mariacaoile	human
@blaisethebaker	human
@Evgenyi_K	human
@zaina1994	human
@pop_RE_tox	human
@CambsBizz	human
@thekimmykimkim	human
@beautyairabelle	human
@nelsonb44	human
@eBay	org
@CazLivesHereNow	human
@IS74	human
@kwangtimo	human
@TheBell4	org
@mr_dy20	unknown
@kankkkk	human
@dezveereva89	human
@TatiotTatanot	human
@dietitiancassie	org
@MeilyVlln	unknown
@Fashion_Rockets	unknown
@EnzoEng	human
@frockadvisor	org
@Mint_Pal	human
@WTFencelan	unknown
@Tarabanana31	human
@superpoohriiii	org
@ElliQuark	human
@chilove94	human
@ChristineVibe	human
@yuriikko	org
@najcrys	unknown
@kanariee	human
@heyybernss	human
@rebeccanatalie	human
@MadieSugerak	org
@manchic	human
@EgmundValks	unknown
@kagan156	human
@eyeSEAbeauty	org
@gtipaldo	human
@TravelwRebecca	human
@zoedwyer00	unknown
@Insil2	human
@PrimeHuntington	org
@Dj_iET	org
@Jasmine725zhao	human
@RamsbottomKitCo	org
@HellemofTroy	human
@johannacruzv	human
@PinkTansy	unknown
@joaomfaria	human
@kimlephoto	human
@dewtsuyu	human
@FancyNancista	human
@Artists4God	human
@bonilyn56	human
@SDjayPEE	human
@veganrawpublic	human
@littlezai	human
@juicyyluce	human
@connectmdrnmdia	human
@Mel0San	human
@ESeldaG	human
@RoyalWilliamYd	human
@shazney110782	human
@Nadvette	human
@BishopAlexander	human
@FefeAyache	org
@NylzGill	human
@KConfessional	human
@clemgait	human
@johncarson	human
@Mysticxv	human
@galianastreet	human
@Edgillwhl	org
@SavoyTruffleMCR	human
@Armygirl3ID	human
@jiezalicious	human
@FashionFrappes	human
@DempseysMedford	org
@yuukilemango	unknown
@HoldensofNewark	org
@reolo	human
@Nomi_Bash	human
@highlynutri	org
@abuabuaburage	human
@ZekesCoffee	human
@Tari_Edwards	unknown
@KimKimpel869	unknown
@cromwells_bar	org
@KianahKaydi	human
@KatrinaAnotado	human
@baby1004h	human
@martinlieberman	human
@sophieaudibert	org
@CervetecaCC	org
@cheddar7889	human
@shihotr32	org
@KarmaKinetics	org
@elma_fabay	human
@rigoleonart	human
@peloquin_uk	human
@theMomiverse	human
@Flip2BFit	human
@themicrobe_	org
@NHAL_	unknown
@MelHales	human
@TheBeachBuddy	human
@ShairaEstobio	human
@TheForagersKitc	org
@YedyLicious	human
@ItsaCafes	org
@SylviaSSoo	human
@theonetruebix	human
@IsItHotInHereMM	human
@CleveClinicCan	org
@sumrteal	org
@Itzmeshawy	unknown
@Shereenhi	human
@azreenaishak	human
@Deryaaceylan_	unknown
@saniday	human
@IonutBG93	org
@adrianaluciamr	human
@zee_lers	human
@FjordBeauty	human
@e4470	human
@MultiplesOfNico	human
@calvin_joe	human
@xoPris	human
@piggyfeather	org
@jimipoi	human
@ProficiencyT123	unknown
@3LittleBirdsJA	org
@lupitaa_Clau	human
@mariofroehlich	human
@boeta007	human
@NaughtyAmateurX	human
@swingbyfood	org
@ChefMike77	human
@KaitlynFitness	human
@JohnPoiarkoff	human
@xCharlotteR_	org
@_dpaj	human
@jenniferfree360	human
@shefreshtadef	human
@Chef_Kafka	org
@bingbingbee	human
@SecondStateDC	unknown
@thehowseproject	human
@ItsYaGirlVee	unknown
@ChicasSP	human
@lilachoco	unknown
@rigo4mwatts	human
@PLM_LDN	org
@aicha14	human
@heiditorralba	human
@Perfectly_Kim	unknown
@KuToga	human
@smwrightt	org
@thisisKristine	human
@SmartSourceCA	human
@smokeys_grill	org
@MWWoodring	human
@SheratonDiana	org
@romi_fransiscus	org
@JillJoAnneLLC	human
@GV_Miao	human
@CFoodster	org
@VinaaEska	org
@yulianasstyle	human
@n_t_k_314	unknown
@sonnybees	unknown
@KAnastasij	unknown
@J_vanwyk	human
@saraHensley3	human
@soupii_chill	human
@MatttyyBoyy	org
@LifeandHope18	human
@josephescol	org
@irenelyn520	human
@sunshineyoco805	human
@jenjen0903	human
@soniadutta1902	human
@xxxAlesiaP	human
@cherry517hk	human
@ChrisMMcDougall	unknown
@MaiteMakeupCo	org
@myteadrop	org
@NoTeFiRsTlOvE	human
@BestBarMix	human
@suintan	human
@edwardjapostol	human
@KnowStyle_USA	human
@milestonesDS	org
@pisuj1210	human
@ZafJam	org
@TheRealBiggieJr	org
@LaCasitaCO	org
@Zaichou	human
@giomissaglia	human
@Applecandra	human
@ysonbueno	human
@Comflite	unknown
@onlypulkit	human
@PauziDamia	human
@NeawCattareen	human
@koganeyasinjuku	human
@LIZOKLOZO	human
@theassetimage	human
@lilou_lagman	human
@GustavoRez3nde	human
@PaoladeMoran	unknown
@HeraldExaminer	human
@Rogen_Zerna	unknown
@FarrahMoose	human
@OhHeyKmo	org
@tyr777	human
@sexyinfectie	unknown
@darasigrid	human
@garconmeansboy	human
@lanasdreamebay	unknown
@theyremyheroes	human
@sincityrockrgrl	human
@tusterza	human
@LadyScarlette69	human
@camillebena	human
@yadiiivi	human
@susieqs2	human
@iria01	unknown
@AuliaPG	human
@witteeme	human
@Youse1958	unknown
@culinary_capers	human
@lefty_com	human
@FrancescaW95	human
@yingz_96	unknown
@samanthaxxdemi	human
@james_g84	unknown
@vabeel	human
@kalungsally	human
@TheLionCOL	human
@ya2_zakaria	human
@Kris_Carr	org
@_MissAlis	human
@PatW21	human
@TheManshipjxn	org
@dhiniadelani	org
@Savvy_Spice	human
@WendyandCharles	human
@eNagayama	human
@DNM_SD_Travel	org
@desdeburca	org
@Vavilenish	human
@zutifomabemi	unknown
@Michi_Santacruz	human
@ajeng_ah	org
@onecrossatatime	human
@mariashkin	human
@RonaldArendse	human
@nitta_sayurii	human
@Kinmibaby	human
@caitlinwilusz	human
@EdixonDev	human
@DublinWineRooms	org
@Farmhousehome	human
@colazionextutti	unknown
@ymomoe625	unknown
@picklesandrye	human
@crystalwmakeup	human
@Koreafornian	human
@umoyafitness	org
@onel0wcubn	human
@WasteOfADrumBum	unknown
@flickris	org
@airmonkey120	human
@dhrace2000	org
@justina0204	human
@hrhta	human
@poppunkisalive	human
@gonzacirulli	human
@ammepoon	human
@HeyAlRuel	human
@tatyanaleonov	human
@johnguilbert	human
@superstardrea	human
@drell_mad	human
@grumblyman	human
@Irwindi16	human
@LifeandStrength	human
@Fancy_Answers	human
@deejblaze	human
@StrawberryFFood	human
@Kissyfit	human
@eatsleeplaugh	human
@RadioFish	human
@sllysa	human
@daniele_solari	human
@tenten757	human
@heyangel	unknown
@Mrgraham007	unknown
@ChristyArsena	human
@daeff	human
@MuhammadPonce	human
@NatStathis	human
@Dorothy_of_Oz	human
@CalderwoodInn	human
@taylergroom	org
@EarlsBostonAR	org
@SonyaSloanMD	org
@FabuliciousHL	human
@pi_tr	human
@WebHed_Mo	human
@Ashfynn	unknown
@wiredprworks	human
@anupaarakkal	human
@queentrust	unknown
@Ranocchini	org
@KMediavilla	org
@becauselunch	org
@natigasparrino	unknown
@BurgerBiteNY	org
@doutlaw311	human
@victor_bravo1	human
@glennbrad	human
@Chique_drea	human
@maniosheenaruiz	unknown
@briellaism	unknown
@chriskairuz	human
@TimetoFit	human
@MiracleDietDrop	org
@sciuri92	human
@ankitminglani	human
@msnataliasilva	human
@TinyFoodDiva	org
@Rim84	org
@XxxBana	org
@JaimeD144	human
@NeuvooLasVegas	org
@Jenn011688	human
@raghebalama	human
@KeshSoomarah	human
@gangstabarbie2	human
@LondonBeachGolf	org
@yhkim9650	human
@pfgun0	human
@SharonRomeo	human
@NasiaGyrlNae	human
@nilo_1	human
@FullMoonBBQ	org
@Patina_Group	org
@sevin420	unknown
@collinsplace	org
@BillyFolchetti	unknown
@itsmysurname	human
@coralkate94	human
@SoCalMFVA	human
@MaggioreW	human
@Pascaldiazduran	human
@h___312_n	human
@QuestHotelKuta	human
@ItsGamaDiaz	org
@16Roby92	human
@Ayefreako	human
@ying050913	human
@thediosanegra	human
@kutcenco	human
@farmlondon	org
@TheKellyfornia	human
@CRAVEamerica	human
@rlyns	human
@mscelfo	human
@imedabong	human
@VerkUs23	human
@Carijmontes	human
@_forevershawn	unknown
@jen_imahustler	unknown
@OriTreasure88	human
@Nandiferdi	org
@Crushinthaone	human
@debikayo	human
@htlacy	human
@spootzzz	human
@MarlosBakeshop	human
@KevieD	human
@FlorAyala20	human
@Lerence	human
@lafuentegorda	human
@martymjm	human
@jerry_f504	human
@GabriellaFrnssk	unknown
@ClaudiaCatalli	human
@AdrienneBurney	human
@AimeeKearsley	human
@meilianakusuma	human
@BMaximus_91	unknown
@ainaarmia	unknown
@xBOB_Ox	human
@QueeredOut	human
@jpauldecker	human
@lopenavarrete	human
@NourishedNutri1	human
@JimmyTaki	human
@leanmean247	org
@murray_chef	human
@thebinderladies	org
@nurul_qyna	human
@ann_asmara	human
@Amo_VacKy	human
@keepitsimple203	unknown
@LukeBloom96	unknown
@crinitis	org
@Gabby727	unknown
@LovelyBirder	human
@duddyjai	human
@vanillaxcupcake	human
@TheSteepingRoom	org
@Cwat888	human
@Scrubsita	human
@vanessarosadias	unknown
@Olivia_Thompso	human
@mhmsk_24	org
@iwantacupcake	org
@elenazanasi	unknown
@nurse_mcdreamy	human
@AmandaAleece	human
@DJ_FX_Official	human
@anchong16	human
@bungeescotland	org
@DESIREEC43	human
@Mizz_Suzanne	human
@B2B_Dundee	human
@migrainekid	human
@beeagoodgirl	unknown
@oSUNNYDOLLISHo	unknown
@LidiyaKravchuk	human
@meals_cnarywhar	org
@rob_ironeaglez	human
@oceanside6	org
@ArcaneTheurgy	unknown
@zeppy_starwars	human
@oridaganjazz	human
@mariadabucon	human
@seydayalvac	human
@kota53534904	human
@bxnzm9e	human
@ChristelleC_V	org
@KouponKat	human
@davidddreyess	human
@grantsmith92	human
@THS813	human
@heartbreak_SJXO	human
@Reytography	human
@jasilasyed	human
@SerafinaHarlem	org
@BLAQaddict	human
@Cibo_C_K	human
@TheReubenReport	org
@Markiemark18	human
@MOEisBAD	human
@dotty4paws	org
@LibbyGleesonAus	human
@sMiiLs	org
@cerrie_jayne	human
@feiticeira	org
@musicayelmar	human
@Rachaelblufairy	human
@jjbutler83	human
@h_pluie	human
@GuiltyBlackJack	unknown
@GabieDamico	human
@yourlocalkids	org
@Newporttweetbot	org
@kor_koi	human
@AussieSunShiner	human
@beedeal	human
@quartierducanal	human
@richardgonato	human
@NoviBeta	org
@yannlepetit	org
@TristinAndTyler	human
@OpenAir_KB	human
@TrueNorthDIY	org
@BullyMiaTJ	org
@MumSonSon	human
@9jigs	human
@nazlikizimiz	unknown
@Luiz_Mag	unknown
@Honest_Coffee	org
@justyhen	human
@Kudu_sa	org
@TheLazySusan	human
@A_AlYousifi	human
@carriemilbank	human
@DannyBoome	human
@rosanna_p	human
@BobbyKristiant0	unknown
@cfailsa	human
@NailahSetepenre	org
@MandCBrookmans	org
@OutofLuckRoyal	org
@EurasianVogue	human
@FARMiCiA	org
@Alexian_Pate	human
@BracChayla	human
@TheVestry1	org
@CharlynKoga	org
@BosTravelNews	human
@g0ldmangirl	human
@TheOwlHighBeach	org
@jilcsrodis	org
@deftadelano	human
@Myfirmfitness	org
@fitfoodiemegha	human
@tealcheese	org
@mmcochon	human
@MexicoBlvd	org
@KnowYourMeal	human
@twogoodw	org
@HamptonsGlow	org
@MikeBreyer	human
@ABSOLUT_pt	human
@Davidteo92	human
@mouserrano	human
@KatrinaCrisp	human
@Ralicha96	human
@MORMO_OFFICIAL	org
@nicoleashleefox	human
@EventDetailsNYC	human
@joannetn	human
@FoodSpace_Media	human
@Shaunsational	human
@onlygirlintheh	human
@MyGingerOrange	human
@hirocbx	human
@iMizo0	human
@globalredproduc	human
@lpgardian	human
@iacner	human
@SantuNicolaBB	human
@nalle_olan	org
@AfiqaaAzmi	human
@TKSVillaMayfair	org
@MsPiggyAngel	org
@professoralawi	unknown
@thatgriffingirl	human
@erick_pidux	unknown
@thesoftblend	human
@Frankenrosie	human
@RUDELUV	human
@nandemoya888	human
@bbbcafe	human
@BearpawLegal	org
@thewaffleaffair	human
@LaNegra_Boca	human
@iremgestalt	human
@justabitofRach	unknown
@AllisonSMalone	human
@crazy_knack	human
@VirginWrites	human
@XXMichellex	human
@AaronBlank	human
@Ias_EinocT	human
@Petworthnewvie	human
@youtube8update	unknown
@insomniacafe	human
@JohnAziano	human
@TheOriginalBite	human
@nuraninoi	org
@TKMississauga	human
@AllOfTheTravel	org
@CristinaCruzE	human
@makepro1fit	human
@zguldent	human
@astridcameliia	unknown
@brownmartin	human
@ongko93	unknown
@sbr_almehairi	human
@Annabella0919	unknown
@sheldamar	human
@divinman	org
@Sunflower_yeon	human
@endangputri	human
@2BirdsEatery	human
@bkken	human
@jayneytravels	human
@knightjustice	human
@MIMI808	human
@gizemmugr	human
@pookiemina	human
@rrrroystonnnn	unknown
@crousselle	human
@TiffanyWyllie	human
@youdonBB	org
@MRNicKMasnada	human
@shannonqualls	human
@EatDrivePlay	human
@ellie_dickins	org
@MissssLauraLou	unknown
@BAustinD	human
@gracel_gracie	human
@DylanthaVillain	human
@jpr_palsforlife	human
@endriawahyuning	human
@Foodie_Laura	human
@LauraGrant777	human
@DJKAME1	human
@4KR44M	human
@AlannahClausenm	human
@jenniferaudrey	human
@ChezLeBoulanger	unknown
@HealthistaTV	human
@CozinhanaReal	org
@GoddessKellie	human
@Casey__Wood	human
@diana0256	unknown
@DD_Gainesville	org
@DulceHalik	unknown
@chicagorequinto	human
@TheKosherKitch	human
@SoniaSagoo	unknown
@doneakebab	human
@Gmabromata	human
@ilianapb	human
@UltGiveawayList	human
@seanrock5	human
@Alta_Warner	human
@FamoUsLia	human
@Barbella79	human
@ChickOnATrip	human
@Not2ShabbyGabby	human
@gordoavila	unknown
@Vinoteque	org
@sarawalterhey	human
@Dhinazulu	human
@ChickenJoice	unknown
@skycharm	human
@mookiehlee	human
@Milanoin	org
@FrancisChaos	unknown
@AmalfiSails	org
@BallyDesoura	human
@HighwayJa	org
@EvaFromTaiwan	human
@SusiPanaderia	org
@VrindaJeeva	unknown
@CieloCielito2	org
@sillylexi	human
@MaszOfficialz	human
@NickandEmilyS	unknown
@_kasia_kay_kay	org
@franium	human
@hisCK	human
@NeryFloresC	human
@noelovessuju	unknown
@FeaztInc	org
@z4teen	human
@LBQblog	human
@daniellabiebe	human
@15pinnacle	human
@Yoyouyi	human
@PosteDC	org
@r_collins55	human
@KandJFoodTruck	org
@BadBoyFromDC2FL	unknown
@ShropsNews4U	org
@RunCrazyKyle	human
@srmoore143	unknown
@DaDaDaShire	human
@eduardogv1999	human
@thekidsinsai	human
@SniperZeroXI	human
@mika_ha_na	human
@leslierahn	human
@MissZukie	human
@thepresscafe1	human
@Dave_Umbach	org
@OlivarezToni	unknown
@fatmawati_utami	unknown
@STY_LIN	human
@Sa400	human
@MargiottaMatteo	human
@scarlettsocial	human
@TheMagicForest1	org
@Cook_Bookers	org
@onthelistmelb	org
@AuraChicBeauty	human
@LNtogo	org
@FixariMora	human
@ValeeMartinez2	human
@NissakiHotel	org
@ConstantinosMkt	org
@VictorSSan1	human
@EBOrganicBeauty	org
@shi0tanuki	unknown
@sallyleung3	human
@jabbarmk	org
@laviesimplemen1	org
@citylifetoronto	org
@Caboome_Ebook	org
@Saje3EA	human
@christarigozzi	human
@patriciabragg	human
@Aero4M	human
@UrBeat_com	org
@HDunki	unknown
@DOCTOR_ABDALLA	human
@bn1magazine	human
@wildbluebug	org
@MillandMainApts	org
@rochiicuello	human
@TheSushiGod	human
@Jedi_Pimp_CRE	human
@Liz_Park	human
@comicsanddakine	org
@cinthiazeta	human
@AgustinaBeemer	org
@iszmikailmansor	org
@BintNizar	unknown
@annapurnell	unknown
@MeisterLinni	human
@iAMminky3	unknown
@classyfitgals	human
@itsmenidia	unknown
@Lady5SpanishFly	human
@REDBONE_CREME	human
@foxy_bean	org
@Oronde215	human
@Moony_Maya	unknown
@bogsmarvin	human
@WendyRandalll	human
@mayahabot	human
@jiayijoey	human
@StrugglinPunzie	human
@jeskerbaby	human
@KnightSanti	human
@khapi	human
@suggablk	human
@BChristieNZ	human
@ivyeatsagain	org
@Ncowley88	org
@francosigno	human
@trepurlorac	unknown
@dewi_setiasari	human
@tr_414	org
@sns3j	human
@ginamariecoach	human
@MelissaBFitness	human
@CenturyPlazaVan	org
@RamonaTiara1	human
@Brandyy91	human
@waynoooooooooo	human
@prettymai01	unknown
@ExDnc24	human
@mioshan4	unknown
@MickeyChung	unknown
@BurgerCoKw	human
@nikkinassif	human
@QuinoBorreda	org
@TRUE2ME_PEACE	human
@AdvantageBizz	human
@JULIO_CRS_	human
@SexiiDreaDre	human
@la_frenchie_	unknown
@b0ister0usp0et	unknown
@SleepyKatee	human
@CallMeBarbie08	human
@howardvee	human
