@SonomaChat	human
@jennifermarisse	human
@LevanaCooks	human
@JoAnnRosenbloom	human
@chunjinenas	unknown
@hungrystylo	human
@WeiserKitchen	org
@lisakartika	human
@localtravelista	human
@RemrkbleCuisine	org
@CYSteak	org
@Choey_zoey	human
@aless326	org
@Amcbeatz75	human
@RickyAppleseed	org
@boomin68	human
@SilkorTweets	unknown
@_MissAnnie_	human
@CarlyJayneLemon	unknown
@AnddyLord	unknown
@suflaka	human
@AhwakCafe	org
@DJcatch1	org
@Laila_e5	unknown
@Saladshots	org
@retrobabe22	human
@devils_disciple	human
@Moonblushbaker	human
@furry_feline	human
@CarloAtYourServ	human
@PIRO_1985	human
@SyazanaMohamad	unknown
@BelaSweetAngel	human
@carlingdoodling	human
@mdrochon	human
@duaybalgos	human
@bbcgoodfood	org
@team178	human
@HollywoodLurve	human
@THEiNFVMXUS	human
@mahmut_kilinc	unknown
@Syaharulhafizi	unknown
@bizfoodtec	human
@paengpp	org
@ClaireSmith25	human
@LowAcidKitchen	org
@QponJunkie	human
@1DZLizzie	human
@sato200912	human
@MomsRising	org
@farmshopBV	org
@FunneeLife	human
@CoalThePig	human
@paulasalazarrey	human
@Hiphopondeckcom	human
@SummitNet	unknown
@QStarSTL	human
@JoShUaVe	human
@SHOTAkeMIRANDA	unknown
@iameds29	human
@KammoSiWong	human
@RDUNK854	human
@StaciFamlyTree	human
@fatheenafiqah	human
@mybeautysleuth	human
@TroopATX	human
@ItsMelissaHopf	human
@Seregi85	human
@MelissaCabrini	human
@XicanoDeKC	human
@DAVIDTAYLORSERR	org
@bbacHouston	human
@birdjung	human
@Suit2Cook	human
@ogahi514	unknown
@fossilizedresin	human
@BenCakilTasi	human
@MrScottEddy	human
@kimlc90	unknown
@MayKaufusi	unknown
@YenYentyc	human
@LeOw_91	human
@NyapNz	human
@training_payne	human
@vicke001	human
@simonprm	org
@IPKKNDRuwizz90	human
@YamaSaghar	org
@einrA_Arns	org
@Miwz_pt	human
@hanahwhitex	human
@Refectory_HH	org
@Curvykarein	org
@Mandy_grahamm	human
@tmasada	human
@sollusfit	unknown
@Chesanek	org
@GhafurEsa	human
@ChefAntRush	human
@BUCKATAYLOR	human
@gosha80	human
@CrystalNGarcia	human
@RosieNewCanaan	human
@GraceEBarron	org
@AlizaRupert	human
@GaryWaynez	human
@maninad	human
@1NAMellionLocs	human
@KBIangel	human
@beyeeutiful	human
@ExceptionalGeek	human
@CanPaleoChick1	human
@caiizhen	unknown
@BaboMarketA2	org
@CorsoImmacolata	human
@Munmunlamba	human
@Ilvolomundial	org
@PeaceLoveLoCarb	human
@Afitnurse	human
@BonjourHouston	human
@KarlBranford	human
@quenniemae	human
@rebeccahartanti	unknown
@ElGatoGrande79	unknown
@pecunk_cherbomb	human
@nicasaitou	human
@ImpressionAnn	unknown
@DD_UrbanCitizen	org
@desy_joly	human
@theladywilson	human
@shihmin2003	human
@MacPhive	human
@ecoBambooStudio	org
@alberts_worsley	human
@cheesesexdeath	org
@WinAHomeForLife	org
@nekowonie	human
@Efendilcw	human
@MsChels	human
@Dominique75567	human
@phokr	human
@TheTWebb	human
@janejanemeow	unknown
@BFigaro	human
@theDanielleBlue	human
@mladdfood	unknown
@alainkun	human
@Twintough	human
@crazy_nathy	human
@mimisbakehouse	org
@Lanchelc	human
@SushiBar_ID	human
@stmng_yk	human
@cindurh	human
@wujae95	unknown
@faithinnyc	unknown
@jgirl_meh	human
@MonWinzz	human
@bbxunorthodox	human
@LexieFDouglas	human
@SC_LincolnHills	human
@CJscoffeecafe	org
@s_karaqui	human
@SensationApartm	org
@IsaWythe	human
@YumeHimeno	human
@BERnicegohzx	human
@the_mmrs	human
@sofipricecom	org
@onecraycupcake	org
@Vava_Kun	human
@thegreenradish1	human
@Fit_4_2014	org
@miliossandwich	org
@linder_binder	human
@MILYNCUMMINGS	human
@District6PBK	org
@kirani12	human
@MicheHair	human
@pburrrd	human
@kennethsurat	human
@caliscenes	unknown
@Airmeli	human
@theskinnypignyc	human
@OhSo_London	human
@CassisGourmand	org
@Emily0w0	human
@ErickNrique	human
@RelentlessMAG	human
@niquesomm	human
@Pav1ov	human
@irilian23	org
@Jacs_Do_It	human
@0n0n0buk0	human
@boneboneee	unknown
@LMayer516	unknown
@Roscoe1679	human
@kazuma_kotani	human
@salari0516	human
@louisashafiany	human
@Recipestable	org
@LugnutKev	human
@AdelaSants	human
@parkefive	human
@Butterandbeats	human
@TheBareMidriff	unknown
@zo_tweet	human
@esd2snap	org
@BearHeidi1011	org
@Samwhiplash	org
@mocchi_tan	human
@mikz20	human
@huinnyoei	human
@SoberJulie	human
@div8	human
@linatjan	human
@TheEdinburgers	org
@Telepescaito	human
@tommortonjarvis	human
@wiidhyaaa	org
@ItsMeNickyRMY	human
@roxrite87	human
@Sophie_Atherton	human
@Zenmaez	human
@Omargunz	human
@north3erndwarf	unknown
@GansoyCastor	human
@ErwinJuventino	org
@Fashion__IMDrug	human
@gdgolly808	human
@surviveanthrive	org
@EricK0H	human
@jasonmeacher	human
@Miss_Kay1007	org
@Kryptomedic	human
@christen_marie	human
@Talin7577	human
@Haydn100	human
@andresmiguelalv	human
@djyurinah	org
@djlos	org
@nirkouris	org
@YaoRD	org
@fishwifeskitch	human
@manyaaapu	human
@djeyes	human
@theelevensblog	human
@Jram1985	human
@NatalieGlazee	human
@juannlo	human
@feifeilemonshi	human
@LaPantorteria	human
@Samarhajjaj	human
@SE7ENTHR3E	human
@DispatchBP	org
@PourHomme80	human
@bamazeera	human
@nippont17	org
@vishalpadhiyar1	human
@CatsofIstanbul	human
@Luisisreborn	org
@chantalireland	human
@Julieknowshow	human
@flukeralwayson	human
@HISTERIA_IPS4	human
@vivihandbag	human
@steflangston	human
@rleonel7	human
@12042525	human
@Daiiprimo	human
@Kellydpa	human
@yuvs0925	human
@JBHtweets	human
@BlacktailVan	unknown
@Nitha_Triany	human
@LethalGlam	human
@krazykat_cfi	human
@BrentfordMarket	human
@seasonsaundh	human
@TrevTheFoodie	human
@KarenFicarelli	org
@Schlotzskys_NJ	org
@CiniAhmed	human
@HearnMel	human
@grachy	human
@AceBlack007	human
@BIGWINEY68	org
@CanyonGFree	org
@mynextoutfit	human
@coachmbarto	human
@379998858	human
@L0nge	human
@YieldFitness	org
@cornerbakerysfl	human
@dedabeleza	human
@ChefAlanamarie	human
@TheBSideDenver	org
@TanenMarquez	unknown
@checkline	human
@theHPH	human
@Mouthgasmic	human
@AlessiaCazimir	human
@KatCassidy	human
@DesMc_Donald	org
@KenzaIntBeauty	human
@My_Waterfront	org
@WillyTalma	human
@LittleLaneBaby	human
@it99ts	human
@eurofoodphilo	human
@Raj_Thamizhan	org
@allenonline247	human
@RonyaMist	human
@jimboweywey	human
@RichardCrandle	human
@1071yamanturk	human
@stevengrullon	human
@Ashvitabistro	human
@GFATool	human
@RyanLovesMegan	human
@HmHealthyliving	human
@TheSalsaGuy	human
@GoldilocksGF	human
@DifferentHotels	org
@coyoteugly74	human
@moxiesdowntown	org
@devycitra	org
@bie_twitt	human
@FollowbackIgloo	unknown
@elizabethc1022	human
@eineliebe1	human
@windstopper1	human
@bxshola	human
@greenplatekate	human
@ayan1610	human
@OBarTrumbull	org
@SerbaFood	org
@baizuraAzme	human
@MaurezMoe	org
@Nicolejean_28	human
@winnie_eveline	human
@wishmedina	unknown
@HappyHourPortla	human
@EleniGoodell	unknown
@KristinaDryza	org
@mayumi_breez	human
@HungryHaus	human
@julietowler1	human
@talonreid	org
@tastykaitis	org
@CodiEOsment	human
@EV_APYBN	org
@TreborSolrak	human
@MartaMila	human
@Autumn_Alysse	human
@JWCulinary	org
@rurexx	human
@Sol_From_Mars	human
@Amnabot	human
@ellewcee	org
@___711mir	human
@SweetLikeMeByCR	human
@FrancesPossieri	human
@JeanRagalieRD	human
@JAriasRocks	human
@phatcat247	unknown
@selincuhaci	human
@QollectorTastes	org
@PamelaMallette	human
@SourXDaft	human
@sandwich_expert	human
@MelanieFrances	human
@subwaywh	org
@DjYamil01	human
@tiepmasheen	human
@tayjohnson1	human
@stellachrisma	human
@Gabysolyluna	unknown
@RoseQuintiliano	human
@ClosetChipsin	human
@kitty_aiai_1209	human
@AlvaroPizarro	org
@LAbles08	human
@venomyuming	human
@Champsarun	human
@Minpo304	unknown
@mohamadmuhaizad	human
@CulinaryPromo	human
@BrookeStrachanX	human
@CookinaCo	org
@andreadevic	unknown
@ActorsNeedWork	human
@kayarejayy	org
@E_Xiong15	org
@NightlifeCabo	human
@harutomo24	human
@Darveen	human
@leighbelanger	human
@BNSmovement	human
@17brightideas	org
@sifybawarchi	org
@77Yumiyuki	human
@ImMiniMum	human
@ObieThePromoter	org
@BleuProvenceUS	org
@Majissh	human
@jillovesyounot	unknown
@ButcherBurger	human
@lennysnyc	unknown
@hashdubai	org
@SandraWidick	human
@babybellykelli	human
@rikkie263	human
@BritneeBLove	human
@patriciachuey	human
@WhatsQuacken	human
@modnutrition12	org
@KutshersTribeca	org
@snjane0210	human
@GastreauxNomica	human
@mcrisever	human
@misotuz	human
@lavingworld	human
@ExpertsInEggs	org
@UrboNYC	human
@yukky92	human
@Marina52682079	human
@oguzyenihayat	human
@los365diasMX	human
@GirlYaLuv	unknown
@GeordieArmani	org
@PowerHousePC	org
@ottfoodiegirlz	org
@SiamSquareNMB	org
@MrJettraining	human
@Siya_Natseva	human
@CFPCOOL	human
@99park_bellevue	human
@kris___ding	human
@mamuroch	org
@TavoloPronto	org
@Yorkshireeating	human
@RapidDiscount	org
@Glucosechef	org
@no_vyalfee	human
@OnePhineGuy	human
@RumourHasItWine	unknown
@ivyprosper	human
@citybuzz	org
@sir_ian_simon	human
@EpatheaLitmer	human
@hudgens_y	human
@MalTamanAnggrek	org
@BettyDiaz_	human
@HONEYANDTART	unknown
@DeeptiSharma1	org
@maricom129	org
@JennsRAQ	human
@nclarkrd	human
@potatopocket	human
@Wellbsolution	human
@AmaziinGrace	human
@iquickfood	org
@NotFromBoston	human
@meghanapetkar	human
@justcallmedwin	human
@I512S328	human
@MartaMang	human
@zach_garcia	human
@FaBRiiiiiiiiii	human
@ThePumpHouseRCY	org
@HamiltonsEdin	org
@jbappp	human
@GothamChick	human
@RosewayRenee	human
@InTheWaySmthing	human
@skclam	human
@merc103	human
@CaneKong	human
@Milkeun	human
@MossAndBerry	human
@angel00708	human
@HeleHwang	human
@CarLvXclusive	human
@CarolinePeipei	human
@katfishandgrits	human
@feedme_imhungry	human
@styleethicscom	human
@FranksKraut	org
@justask4lottie	human
@beefimagebot	human
@ruchisvasudev	human
@CinnabonVzla	unknown
@Pamela_Hope1	human
@brad_montana	human
@mamdouh_ksa	human
@MissBenioni	unknown
@BabySavers	human
@muratbur82	human
@DomenechShauna	org
@t_b_manning	org
@MiNormanRoss	human
@irenelaw	human
@sriwarnihalim	org
@ayn_28	human
@DreamWrite10	human
@tlwhitney1	human
@_LaBrunette	org
@EatMkCelebrate	org
@SoniaRosuaClyne	unknown
@catconnor	human
@Yucari0108	human
@yigitoguzz	human
@VinnieMedugno	org
@Pon426e	human
@ReneeSturme	human
@nancysmith830	human
@MomoYokko	human
@NNNBeso	human
@TheGreenCreator	human
@360nomore	human
@putuprimarani	org
@jmdenouden	human
@Oman_Bot	human
@Tuscany_World	org
@MilesAndMimosas	human
@ElenVelazquez	human
@LauraJHyatt	human
@xuanyy	human
@MrsOliviaBenson	human
@MattHasTheMusic	unknown
@Bata668	human
@agenerouspour	org
@mizusakimami	human
@CrushPizza	org
@EdogawaGie	org
@Samantha_Carrie	human
@Deivid_loreto	human
@rizsunawan	human
@Ryepod	human
@rad_lor	human
@Bella_Vita415	human
@divinetiip	unknown
@gregorynishan	human
@ishiinyc	org
@_cnrchickenshop	human
@JerichoFugaElle	human
@towalters	human
@Lulupetersen	human
@ImitationFoodie	human
@Janisia	unknown
@ProudMomentsTW	org
@trovefoods	org
@FollowbackVault	unknown
@MissDuel	human
@Bernforyou	human
@razzbingo	unknown
@uitetennijmegen	org
@coventgardenuk	human
@MajaGolden	human
@ChatwinAdam	unknown
@katanachan	human
@parkersplate	human
@TimeOutMAD	human
@branbreadmix	human
@JoyRossDavis	human
@mnkpp777	human
@fitsbi	human
@lharvey050	human
@thefoode	human
@Clarks_It	org
@demetry14	human
@StephenThomasM	human
@RevAdamHarris	human
@PensaScope	org
@pixieniks123	human
@siobhanmcwhite	human
@mrGhoney	unknown
@Melanies_Events	org
@NeshCelebrates	org
@OKCSquirtfan	human
@Twinkie_paris	human
@BelliniMm	human
@whollymolly	human
@carolnagnag	human
@heeeechoi	unknown
@TamrynSher	human
@DylanPong	human
@yaginao	human
@saplanet	human
@FollowbackExisT	unknown
@WingnItColeHr	org
@myMaeZii	human
@piiim	human
@RobertGunadi	human
@TestemitTati	human
@SquashBlossom	human
@RicardoGimenez8	human
@FiaAlmA	human
@_ElisaCattaneo_	human
@blascafe	human
@lovely_payton	human
@newiee_s	human
@lucitisima	human
@bentos4girls	human
@fitnutrition24	human
@email2me	human
@JohannaTMC	human
@TobyAtwater	human
@KittsteinerRosa	human
@Simplifytv	human
@mim57	human
@WeightLoseTipsW	human
@TaylorWolframRD	human
@Ce_Dano51	org
@Mars788	human
@flavorsbyIrinaS	org
@NobullWomanApp	org
@shaharzad	human
@paulskitchenhou	human
@tabi_maya	human
@HerenDineren	org
@AliceSartorello	human
@CaradeGata	unknown
@vidomix	org
@renownhealth	org
@sarahjgaines	human
@NaomiSFB	org
@nearifyevents	human
@AprilWattsLive	human
@zootswings	org
@CypriotCimboMan	human
@JJfrens	human
@KetRidley	human
@KitchenetteAnt	unknown
@insiyamustufa	human
@uncommoncafeyvr	org
@chikabebsANYA	human
@feedmytastebuds	org
@JovanJordanXXX	human
@1stLadySazerac	human
@nikitanp86	org
@GRIZZ1987	org
@Rszosofit	human
@ebastentzel	human
@shopannies	human
@health_fuel	org
@nwara_7	human
@Official_Cat	human
@Sarah_Zafar	human
@_Jester960722	unknown
@thefeekingshow	human
@YingChoyYC	human
@Manufacture111	human
@Sultana_malik	human
@bert1185	human
@MamboLegsMolina	human
@OfficialQueenXo	human
@TheSpotToEat	org
@RawEssenceZ	org
@MakeUpEverythin	human
@NewportGrill_KC	org
@elybarCHQ	org
@WeLoveBoth	org
@darkstarjujuz	human
@iDAVISamy	human
@mimoarfa	human
@sweet_tweet42	human
@VenusLovesVirgo	human
@friscaarinanda	org
@vatalocaa	human
@GoldenPalaceTO	human
@Portcreditbia	human
@timessquare64	org
@valeramirez1015	org
@HDPPhotography	human
@LerekoNtshona	human
@EarlsWhitehorse	org
@cynsoto9	unknown
@Agoyo	human
@ElMexicaliCafe2	org
@firebomber_2060	human
@kianfai_rox	org
@Nelsonntia	unknown
@BothSmallEyes	human
@RumAndCheese	human
@NACH0SU	human
@feruiz	unknown
@MikeyMike103	human
@FolkHouseCafe	org
@TheNephildevil	org
@younglookin84	unknown
@moorgen	human
@thefernfindlay	human
@yuko_vegeRD	human
@Tuffyrocks	human
@David_AQ	human
@peanut72	human
@famfriendsfood	human
@RoxanneBautist3	unknown
@Tgizzle904	human
@ChilisQatar	org
@_McNella	human
@recetaslily	human
@pombandit	unknown
@Jeans_Kang	human
@MissAlyss2	human
@AppPicker	org
@IsabelleIles	unknown
@Gemmae_Bakeshop	org
@TheanchorinnSG	org
@tobakiss	human
@theeatingtree	org
@BlackMagazineMx	human
@babydollshoots	unknown
@anuarduayhe	human
@MarcGGonzales	unknown
@crisroba2	human
@iamlastymom	human
@BBQ_Times	human
@belaircancun	org
@ParisOTC	human
@benjamin323	human
@Carmen_CandC	human
@JohnOw89	human
@_R_p_n_	human
@Ange_TIU	human
@cheesezillaway	org
@Tony1234566	org
@SwiftPeakMarket	human
@EmmaAstley2001	human
@alejovalle	human
@mizahadi81	human
@chriswithkicks	human
@_nitasays	human
@LiilyBonilla	human
@RomiKwan	org
@Yopoon719	human
@techdinegirl	org
@prettyisskinnyx	unknown
@aquafm	org
@ThriftStoreUK	org
@Meiping_	human
@A2BRestaurant	human
@josuethebarber	org
@katiikushh	human
@cherrychee	human
@SteelRestaurant	org
@haneefraisani	unknown
@IamNhickz24	unknown
@GoingOutBOS	org
@pangastirahayu	human
@flyinabird2989	org
@DrinkarooApp	org
@ellePSNStores	org
@richardMswanson	human
@bhfreshexpress	org
@kristalynneee	human
@nancyandthewolf	org
@RainforestCafe	org
@JanneSorum	human
@ThriftyDIYDiva	org
@jgibbard	human
@3istro	org
@NonChron	human
@Dianalmadani	human
@ericsczuka	unknown
@xoannmariexo	human
@dhRamirez79	org
@clairewoods32	human
@roelrosal	human
@DreLomax	human
@redd4man73	human
@Fullypaced15	human
@maggiehuang01	human
@MOXXX	human
@exjock10	human
@oliviab1	human
@kl_gutierrez15	human
@MancoraNyc	org
@FreshDiet	org
@GENWWW_NYC	org
@omoshiro_JFYP6	unknown
@ashtonkeefe	human
@dewayne_harrell	human
@judyQtan	human
@gokiro_	unknown
@ajimperial18	unknown
@saajidpuro	human
@EatsyMiami	org
@CronacaRosa	human
@mypanfan	org
@j8612237	human
@CaitlynDawney	human
@amabasketcase	unknown
@HaticeKurukan	human
@liselottetork	unknown
@carlyharper1	human
@SWmagazine	human
@fashionicon1993	unknown
@ellecuisine1	org
@CafeLechePGH	human
@LifeCoachRadio	unknown
@RogueBeauty10	org
@macknade	org
@SaojiTadka	human
@LazyBumGamer	human
@tonymagnetic	human
@AccsryFanatic	unknown
@LorimerKitchen	org
@han_azhahar	unknown
@DFGrilleDC	org
@DjRedBlake	unknown
@Darren_dc	human
@Palomagatica	human
@babykitty91	human
@realsomti	unknown
@DaniLAnderson	human
@jelllydelacruz	human
@Stockfotoart	human
@TeacherStacyH	org
@maomaofur	human
@KENNYCCWONG	human
@FecheI7	unknown
@gherwin	human
@StephanieMB84	org
@IsmaelZeimantz	human
@RubnMaldo	human
@luisvoztokoll	org
@4bistro	human
@RestaurantCatch	org
@Chummy_Who	human
@MERCEtaughtme	org
@DanielePiaz	human
@mfa_direct	org
@sanantoniord	unknown
@glutenfreebagel	org
@hishamad	human
@SwineNYC	human
@elleiraaa	human
@BobenBillSl	org
@ianlabis	human
@cupcakke333	human
@1dir1olmadi2	human
@CM2_VictorHugo	human
@YanithaaSega	human
@Koltsovo_Ekb	human
@JacksonsBham	org
@goroe	org
@deliCONTE	human
@virelya	human
@nurmawaddah09	org
@Vommie_neung	unknown
@notstudying2day	human
@alegambinidt	org
@kasiawolejnio	human
@muddyshoe	human
@LizzyWienie	human
@mtq75	unknown
@mikasuun	human
@iamjapeth	human
@hiimgel	human
@LaTavolaMarche	org
@nishioyuutarou	human
@GaiaAnastasia	human
@ivanitz3rd	human
@garsleat	human
@aiko25	human
@thesweetesthing	human
@cherrymischivus	human
@LeesMyth	human
@cacaelassal	human
@Daniel66290088	unknown
@Win_Fzia	human
@BrooklynViro	human
@RosalindBlight	human
@B4DR0M4NC333	unknown
@dwdove_83	human
@xXc4tCh22Xx	unknown
@GolfInnGullane	org
@heathergirl	human
@ellamarie	human
@staNthaboss	human
@sasimaj	human
@iamjaonine	human
@heystartup	human
@BabyKgirl	human
@sugarluvsbutter	human
@PhilippaBiddle	human
@psylovy	human
@FabulousAndFit1	human
@dafroggie	org
@SalYMortero	org
@ddfernandes	unknown
@itsmekrisborres	human
@armarioYtocador	unknown
@TamarindMayfair	org
@quasi42	human
@superconference	human
@cdnbelle	human
@ChefMcCargo	human
@Jackert86	human
@CamdenExchange	org
@lovegrabwear	human
@jobplacing	unknown
@DerrickLyvers	human
@austinjackbaker	human
@MonicaCrespo18	human
@chefmattedmonds	org
@3week_diet_	org
@DonKanijo	human
@ChicontheStreet	human
@WillPaul2	human
@courtneylynnwoo	human
@frl_coccinella	unknown
@y0eva	human
@LithuaniaStyle	org
@JimLoliarty	human
@review_board	org
@GiuliaRizzi	human
@aikooolynne	human
@SmokeHouseDeli	org
@hollstermaxwell	human
@753gm159jt486wd	human
@CastletonHouse	human
@AnnasVentures	human
@RichxrdOfficial	human
@WWAustralia	human
@SantanaRow	org
@hashtagsonpanel	human
@Felix_Roro	human
@CuriousChef	org
@Najeeb_Khair	human
@JashtelleTetta	human
@_ShayRoZay	human
@tillfare	org
@MorgansBK	org
@ChrisA21580	human
@parisianland	org
@homedecoz	human
@maimusings	human
@Finetodesign	human
@Ciao__Down	human
@Miss_Whisk	org
@BbBorgonuvola	human
@meacute_5	org
@FabDutchness	human
@dlelacru	unknown
@edobrien100	human
@Rharvley	human
@CostaAlegre1	org
@b0obieee	human
@luwee_k	human
@Indymary1	human
@SgtPeppersSubs	org
@YiaVang1	human
@ColumbusCrave	org
@Colahoney1	human
@AndrewFoodie	human
@Journs27	org
@MichelleMovinIt	human
@carolsenaaquino	org
@BigLMK	org
@amlmcloughlin	human
@MyGF_Diary	human
@GourmetGrazing	org
@NeuKuhn	human
@atidecremLP	org
@ChelseaVozzolo	unknown
@Theaandco	human
@Colleena_J	human
@thetomatotart	human
@dedevetronikaa	human
@Veeness1	human
@theRichDC	human
@Rim0308	human
@tata444	human
@MARY_SENF	human
@xJessicaAllenx	human
@fion_li	human
@missnatashagaga	human
@muse_reve	human
@mayiwei	human
@Pasathorn	human
@avinashvictor	human
@emsstur	human
@hidengk	unknown
@12345689mnb	human
@BurgerKing_ID	org
@25DegreesCHI	org
@MsDoll_Face	human
@kezf05	org
@aimee_pluts	human
@cornshaq	human
@DJMoney813	org
@Diego_Fer33	unknown
@ElGauchoSteak	org
@NeuSchiffer	human
@RyNa_MiChIkO	human
@eatfit_ilivefit	org
@saintfranzchen	human
@ThatFurf	org
@huisin25	human
@Columbuswok	org
@moto_kana	human
@ConpaxTP	human
@FilaRachel	org
@bfglardmonster	unknown
@happynina7	unknown
@shopwell	org
@Andrew07734	human
@avillandry	org
@sugarc00kiie	human
@privipi	human
@BlackBeauty676	human
@Spot_jasper	org
@manuazuaga	human
@swearbysarah	human
@ColonelFawcett	org
@Afro__Disiac	human
@okcorizal	human
@ancafe1511lc	human
@shawnmayer	human
@Icyhilltop	human
@TennoMichael	unknown
@West7thFtWorth	human
@foodandflea	org
@MayLynda_B2UTY	unknown
@Banafsajiya	human
@Clarissa_xplain	human
@senzashopping	human
@mich_stnto	unknown
@honeyishrunkthe	human
@brandon110589	human
@NORI1024	human
@littlepri04	human
@chazwinkles	org
@LeBistrotPierre	org
@SpringsAlliance	human
@scottymccaffrey	human
@ecogreenlove	org
@MerlyMerlz	human
@YasPerucchetti	human
@uten_sil	org
@Amanda_LeeJY	human
@NedLuddPDX	org
@EventsR2	human
@_Catarinne	human
@miki_66v	human
@morriscame	human
@Iam_Shivakl	human
@KitchenMechanic	human
@Jus_Oj	unknown
@ZairaAmaterasu	org
@SingitaRavenna	human
@ArtImagz	org
@HonneyMarie	human
@HDerSFO	org
@ashleykiyana	human
@alcantarajojo	human
@Littlestar411	human
@ticklishchicken	human
@DSansonetti	human
@eelaine428	human
@DJAlice_jp	unknown
@dianaion1	human
@HK_Barbie	unknown
@msdarlinghurst	human
@sophiaworld	org
@jessicachaa_	unknown
@sandzcalderon	unknown
@BeckBromFL	org
@Clairemaxim1	human
@AriRiot	human
@HindMansoor	unknown
@CavaHoian	org
@RuthsChrisDubai	org
@AethelweardFabi	human
@himytwi	human
@Johnsonmandh	human
@frshpilot	human
@25hi_hi25	human
@feonpay	unknown
@SaraMesolella	human
@truthorganics	human
@AnastasiaT2	human
@REALMusicFAM	human
@JeepneyNYC	org
@AnthonyKumpen	human
@VIPIMAGEBYCLARA	human
@TribecaGrill	org
@FitIndeed	human
@StreamDean	human
@maeann_moore	human
@ElleSerendi	human
@Queen_Cobra007	human
@_ro_ro_05	unknown
@goddess_gourmet	human
@mamedblake	human
@TasteComms	org
@jerglove	human
@jennrunk	unknown
@lamodaya	human
@paoloigna1	human
@Pulitika2010	human
@MarathonMax2	human
@IvanHalongangan	human
@JackieSiperko	human
@ivanjacyno	human
@amirsamsudin	human
@luxurious_locks	human
@FuckerMCBO	org
@Jassito	human
@Eileenkusse	human
@AfzanNazfa	human
@ImViic	human
@philcolbourne2	human
@carpesunshine	human
@soraRipple	human
@exoticforeignHO	unknown
@OfficialHA_LO	org
@VeggieVariation	human
@tnesse7R	human
@world_kitchenuk	human
@pinkoffee1	org
@KristofVdv	human
@Tsinelas90	human
@Kickin_Kayla	human
@BleeckerKitchen	human
@P_E1	human
@Ratedfood	org
@CianaAspell	human
@jackallens	org
@kevinstabinsky	human
@Fablunch	org
@LifesabeachBlog	org
@Prashant_shaw	human
@wanglosuites	human
@ChiChefLee	org
@AsukaRhodes	human
@sarah4canes	human
@Stories4success	human
@FaizAzizan3	human
@GreensburyMRKT	org
@CraveCute	human
@handsome_yo	human
@foobooz	org
@amandardja	human
@aizbarcelo	human
@thatwan	human
@PacinisPizzeria	org
@feeriaunique	human
@LaPietraE1	human
@craniotes	human
@juhi_h	org
@Marcdunham	human
@ShashersLife	human
@MaddieCamilli	human
@HitEmUpStyle	human
@zeppy_purses	human
@GenuWineTasting	org
@HuggiW	human
@mattcbrad	org
@NelsonWaiChow	org
@ajicoron	unknown
@laurenella_	human
@VirgoDesire	human
@SandyRyanG	human
@Vinaakuunn	human
@Bareburger	org
@stacystowers	human
@lizzyw00	unknown
@Mannenstyle	human
@laurenceamason	human
@IconicTraitor_x	human
@WenyLim	human
@TheWestRoom	org
@julianashahida	human
@PetitsBouchees	human
@shannonj84	human
@HelloFood_CI	human
@thechefsforum	org
@crazygibby	human
@riccardosSR	unknown
@byrdyy	human
@LNN_Fitness	human
@pier7restaurant	org
@ministryculture	human
@ChrisMendes	human
@clevermonki	unknown
@talkradiomama	unknown
@mividaenunbowl	human
@MunirahRohaizan	human
@MercedesEaly	human
@msronnieholland	human
@arash1079	human
@wickedsunny87	human
@samadnj	human
@abdulla_sadiq	human
@Isabel_mie	unknown
@Post4Life_	human
@KudolifeApp	org
@Lil_Ashleigh01	unknown
@sophiademe	unknown
@angiee326	human
@slpy	human
@ZokitCardiff	human
@organicfitmom	human
@inPONTIANAKcity	org
@macaroneer	human
@vhienmiguel	human
@imkiya	human
@JasonTelmo	human
@creatingahero	org
@DMVzHazel	human
@FoodRdl	human
@Alexcedeno	org
@Cheffvlad	human
@Pierogiwagon	unknown
@kerryabdow	org
@engelszungeblog	human
@jirarak31	org
@zoouw	human
@BigIzzysWorld	human
@KeriLeeSereika	human
@MadDogAndBeans	org
@rackynn	unknown
@HtownHomemaker	human
@Starliciousfood	human
@_imzreynolds	unknown
@SybillaBacker	unknown
@cobaltcafe	org
@wannabe1987	human
@AshleyJian	human
@Trancegirl21	human
@fooddailycomau	org
@everardokeeme	human
@itseds_a	human
@LakeShoreCafe	org
@kazuhiro715	human
@hiredBelly	org
@PhilippStraub	human
@Woodysbbq	org
@sarakwan	human
@NeiOliver	human
@CarlyleAvenue	human
@CornerstoneOR	org
@IdiotAtPlay	human
@TigerTigerTav	human
@MS07_B3	unknown
@LifeMadeFull	org
@AKMuskie	human
@belusmedia	human
@SmallVulcan	human
@edamame2003	org
@stephmejia	human
@Sprig	org
@vrncf	org
@LeichterGesund	human
@f12t	human
@kpphai	human
@wunxone	human
@Oh_ItsSandra	human
@esopiak	human
@chlj	human
@FitFunFab	org
@emma_peterson22	human
@HiltonDunkeld	org
@MrEnt92	human
@mz23ex	human
@deassy_kartika	human
@bmorassut	human
@DineAmicGroup	org
@ScarletCoral	human
@ruskie818	human
@BertinetKitchen	human
@ServedTheShow	org
@arianne_marie	human
@cstan1969	human
@JessBernardin	human
@rinonv6	human
@livvy_mae	human
@SeaspiceMIA	org
@TadkaMasala	human
@TiitoBoyy	org
@jamieoliver	human
@PlanetJCG	org
@gregfocker	org
@LopezSD	org
@tanekanashay813	org
@FedericoZappaco	human
@gourmetgrills	org
@jenqp	human
@Benitez0ne	human
@CreateAGorp	human
@crazy8work	org
@burntapples	human
@Carnivale312	org
@nanicanalejo	human
@FoodMeOmaha	human
@DanielleZulueta	human
@jojo41606	unknown
@savortonight	human
@iketani19791116	human
@HilmaTT1	human
@Dalton_Banks	human
@coachsandiebg	unknown
@vinoroma	human
@wilmalamaa	human
@kirankishore21	human
@fancyroutine	human
@cesarmarines	unknown
@983bk	org
@SofitelDubaiJBR	org
@FierlyFox	org
@alittam	org
@PrideLoungeNYC	unknown
@lovekiitos	human
@G4y4tr1	human
@red_bloons	human
@AuntBsKitchen	human
@margerietrishka	human
@MiyuuTakeuchi	unknown
@iejatshahrin	human
@InForLuxe	human
@raigranderson	human
@CheeseTraveller	org
@Preston4567	unknown
@SophiesCosmicCa	org
@MissJonesCdf	org
@besukosan_buyma	human
@REDomination11	org
@MerkinsFarm	org
@UKEatOut	org
@Her_Hotties	human
@theamyjackson	human
@dan560	human
@Partandcompany	human
@dyfin4life	human
@JavierDeJuanas	human
@Sweet_4_him	human
@cestchanelene	human
@jamloafes	human
@MontroseHTX	org
@ChuiSharn	human
@youknowbhoo	human
@Marqeta	org
@gannetmag	org
@InHome_Fitness	unknown
@putragde	human
@nashvillenightz	human
@NotYourName	human
@muratttorhan	human
@encinasmanu	human
@p_koe	human
@JustUsFour1	human
@madebyguinevere	unknown
@iPollmobile	org
@strawberrylocks	human
@nicksecur3	human
@fabfaith1	unknown
@UrbaineCity	human
@scifigal13	human
@CornerstoneMain	org
@RushBowls	org
@IzumiTIP	unknown
@HaleyDuquette	human
@Dirk_Pick	human
@SweetBrigadier	org
@Jul_Marti75	unknown
@PrrrRlcclld	human
@jadiehails	human
@m_lifestyles	human
@EsunGato	unknown
@YungSuave1017	human
@hopingheart	human
@ronniepastry	org
@RobinZlotnick	human
@asiganon	human
@pitreta	human
@innerviena	unknown
@Vegan___Recipes	human
@ShopNTag	unknown
@MilynEmokzzen	human
@NaranjoAnnie	human
@chaiLablab	human
@WerbieLLC	human
@ShaShaBreadCo	org
@EmilyVan304	human
@PizchyMint	human
@herbgab28	human
@randyTHEshiv	human
@CubicLounge	org
@TehLATimes	human
@ParraJoseDaniel	human
@AutolottoscratR	org
@heavytrader	human
@Liyana_MohdZ	unknown
@skew11	org
@Kamelsacibreads	human
@OmaraAmbar2001	human
@chefsaraadams	human
@fucktec	human
@LAOCfoodie	unknown
@booksbyRoger	human
@char3112	human
@Mellappa	human
@KitziaMitre	human
@CerretaCandyCo	org
@xxoob_dooxx	unknown
@zhanRUH	unknown
@yourlastsupper	org
@christian_upay	human
@Piranha_Killer	org
@ThickLittleMiss	human
@sah14	human
@MaryAscension	human
@bluemahoe_jo	human
@AzianShortee	human
@PetraCNR	unknown
@HiltonStrath	org
@fabriziobenzoni	human
@LhadieWynn	unknown
@Niman_Ranch	org
@maker_sandwich	human
@DF_RESTAURANT	human
@CTL0404	human
@1lifecat	human
@haonharas	org
@GODAYca	org
@srutiagarwal123	human
@machiboni	human
@kerryjeanlister	human
@clemmeunier	org
@VaccaNYC	org
@djSIKNESS	human
@Rain_Kasia	human
@roseandcrownyyc	human
@rodrigocollares	human
@KneeDeepWines	org
@BalikG	human
@TangledHeroine	human
@DaltonsBarNYC	org
@dadamo_carlota	human
@WildSeasonsDG	human
@ArubaBmouth	org
@HornyDingo	org
@SesenColageno	org
@patrickvill	human
@YaYa_Zazza	human
@theginaathome	human
@AWLakestreet	org
@GrapeandGander	org
@momof2monkeys	human
@kamalika	human
@graceelicious	human
@lilxceejay	human
@nephropathyIGA	org
@gimmetherecipe	org
@AudreyPuente	human
@BasakSayan	human
@kaa_chika	human
@AgeproofLiving	human
@iamgirlyghee	org
@Radio24K	org
@SimplyHomemade_	org
@niindiujoetia	human
@studiohodson	org
@MeliGradilone	human
@ayepiye	human
@___Lou_	org
@RepublicBurger	org
@KatDeCuisine	human
@tashadoinks	human
@JewlsBarbe	human
@tablespoon	org
@cuppingroomcafe	org
@chef_life_1	human
@TrainerFood	org
@MIAMIPLUSME	unknown
@ChrystinaNoel	human
@menna7o7	human
@OoohDoooonnnaa	human
@SYKitchen1	org
@stephpockets	human
@SteakCorner_ID	human
@AssaggiBistro	org
@BeautiiJ	human
@nutritionnest	org
@OnlyPartytime	human
@maryasburyco	human
@sthelensculture	human
@Dearharts	human
@buyanaa117	human
@MsJillV	human
@LunchingDaily	org
@telesalesking	unknown
@Newingtongreen2	human
@SalmaDinani	human
@mehmetkaramanci	human
@dolcizie	human
@THECUTHCB	human
@bepotato1015	org
@We_Are_Gujarat	org
@sujaykoner	human
@elena_g05	human
@alirezamoradfar	human
@armandopinedob	human
@JoeAlcodray	human
@BatoYesfmManila	human
@AzamaraQuest	org
@JeBortoni	unknown
@jeffgrube	human
@FashionFake	human
@i3fzang	org
@LindsaaayyyG	human
@HolmesII_Fukfuk	org
@bombconsultancy	human
@Taqlamexicana	org
@thelibertiesbar	org
@TheHappyFatKid	org
@EatCrouchEnd	org
@joelrwilliams1	human
@_NoHayQueLlorar	unknown
@S9Kel	org
@LindajarroyoJ	unknown
@BabiAyen	human
@DeeJayZiggy	unknown
@purpleggal	human
@LinahsList	org
@YoAmorLaVerdad	org
@gooj83	human
@DeUceDouble	human
@MariaBonitaDE	org
@RosieRiott	human
@Kpryor23	human
@MissJaejoong	org
@shawnaceee	human
@hopvietnamese	org
@umayoit	human
@koigdasgfd	human
@SHRSunBreakfast	org
@CsQuared_SF	unknown
@raffaelladiano	unknown
@mmsalonga	human
@DragonsKitchen	human
@victorcahv	human
@CooperParadigm	unknown
@Cris_Velasco	org
@chan_shari	human
@Sherika430	human
@StartBundles	human
@Skys_Bait	human
@PurplePwete	human
@changer_vie	unknown
@InHeadingley	human
@Daisuke_M0904	human
@ReeeeynDJ	human
@SamaraCF	human
@barflysms	org
@placerating	human
@astoundesign	human
@_Stephanie88	human
@jeangeorges	human
@nami0525	human
@EmilyClaire_P	human
@catoctincreek	org
@chaebae	human
@seolish88	human
@ChelseaKrost	human
@Enine99	unknown
@Galifornia_Gal	human
@the5magazine	unknown
@sayalice	human
@rouxqueen	human
@Kei_T_Cat	human
@LivePhotography	org
@ellenmay242	human
@himesaffliction	human
@verisimilitude8	human
@Healthy_Hunnie	org
@HOMECHEF_ES	unknown
@Chef_JessRD	human
@chasitym33	human
@KapranosPR	org
@my_contract	org
@bOnTLe_M	human
@farinabakti	human
@HopeGarage	org
@inarubiatul	human
@jaecampos	human
@FunInFairfax	org
@BSLResort	org
@polyklang	human
@leanneknows	human
@kareng23	unknown
@Marmalade_Chest	org
@hAmpzter	human
@AnnabelleAzade	human
@PGEmily	org
@robinsonleiu	unknown
@Scandaliz	human
@jillisyana	human
@HealthOnPhone	org
@PierroBeau	unknown
@THR1VEME	org
@LonghornSD	human
@KirchnerBuddy	unknown
@Pebbles316	unknown
@omg_1_direction	org
@LPatelSmith	org
@paul_fitness	human
@Belleboutique7	human
@allikats	human
@YosseAlexandra	human
@gpadova	human
@thegarvanator	human
@NylahsCatering	org
@BalcaRosie	human
@MaliaKong_	unknown
@alecarloslima	human
@cortstar6	human
@LylaUnicorn	human
@allstrmvp637	unknown
@CHERYL_L_BURKE	human
@mariessum	unknown
@BlimpieSubShop	org
@realhealthyfo0d	human
@angelamarhaba	human
@LTuae	org
@LICMarket	org
@lauren_Curtis1	unknown
@chefchadwhite	human
@ComeTweetThis	human
@JonahColor	human
@BeatMyFood	org
@LadyKLuckxxx	human
@Hostess_Snacks	human
@UrbanBuddy_CHI	human
@hoggitandhoof	org
@TekoaShemia	org
@nugglemama	human
@claudettesells	unknown
@Crystal_tii	human
@figgirl	human
@totsfamily	org
@atlanticyoga	org
@tablesnagCHI	org
@Trainerator	human
@AUNQUNIC	human
@devil_zero	human
@miso712	human
@KountryBoyz601	human
@Miss_Sally_Jane	human
@ludo96_	human
@audrey0985	human
@jcsullivan24	human
@hofeec	human
@itsmehaileyyyy	org
@mostwan_TED	human
@MiszYuna	human
@BCMac7	human
@mrkimperfect	human
@hiya0913	unknown
@BarMarcoPGH	org
@SoFresh_Apparel	human
@ChasingJenni	human
@Hannah_Welch22	unknown
@alex_luu	human
@itsCabatiaN	human
@JulianWasHere	human
@AvantiNatural	human
@TheRCinOKC	org
@ArgyGoTe	human
@MalibuToday	human
@GlamoursGuru	unknown
@Brookemae	human
@Imperfectlyxxx	org
@deanstreetbk	org
@CLFAdventure	org
@jrondolo	org
@5ChurchCHS	org
@themezzapp	org
@vennytweets	human
@ViewBahrain	human
@GP5RA	unknown
@BaldoPellegrini	org
@MissyMaryLou	human
@NightlifeDEN	org
@flutteringazure	human
@PencintakopiID	human
@cmrestaurant	org
@ViE_chibbz	human
@Beau_Chatnoir	unknown
@Sheraton_Bursa	human
@BeaMcNallys	org
@foosharon	human
@DineWellDoGood	org
@juniorjude	human
@mybubbielicious	human
@TheMartiniDiva	org
@Cesckudhy	human
@EthylLove	human
@dewiapril7	org
@HotelCaliBaja	org
@amirah79	org
@MrsStaySeeCleve	human
@jus_Ankitt	human
@kkubota8	human
@VictoriaMeakin	human
@WeezesCafe	human
@FriedrichHendra	human
@marikirari	org
@pandpcornhill	org
@BarbaraGerste	human
@LoveMarkov	human
@ezehiga	human
@Stockwood1	human
@JadeLouisaNunn	human
@steviedsimages	unknown
@coachvalenciaca	human
@Cobonedubai	org
@Bronz28	human
@xDEExLEEx	human
@ThePlanetWatch	human
@coco_7210	human
@MatadorPizza	human
@MockingbirdCH1	org
@ibanez_sun	human
@Baleudang	org
@azura_bajuri	unknown
@TurtleTrend	human
@gongloop	human
@FRESHFARMWhtHse	org
@derealdan	unknown
@NMannas	org
@Siusagi	human
@renai_C0Eei	unknown
@AkiraNighthorse	org
@iraahsile	unknown
@indiiprastika	human
@himynameisJboy	unknown
@TheFancyHippie	human
@Cassie2930	human
@ilovemyveggies	org
@mishramegha	human
@ThatsPopy	unknown
@3FitSis	org
@Instabeer	human
@jade_vergonia	human
@LoveMySalad_es	org
@EvvivaCucina	org
@nyororo	human
@ChefsCountry	org
@Mittkok_se	human
@yuTharie	human
@DragonFruitFoto	org
@joryallen	human
@FrankfurtNeu	human
@Shiokalicious	human
@99pretweets	org
@VivoChicago	human
@EvelynClear	human
@De_La_Sole	human
@NonaMiaRitrovo	org
@webaziendale	human
@NeuvooBournemo	org
@pewbanzon	human
@gbrown86	human
@tsclay17	human
@jessismiling	org
@pinolera27	org
@ILoveCannes1	human
@worrallo	human
@dacohe03	human
@gregorule	human
@MilkfarmLA	org
@ghosty4	human
@lepainparisien	human
@YummyBrunch	human
@getgob	org
@wolfman_j73	org
@takeyama	human
@charliesiegel	unknown
@FromScratch5	org
@_kidauhl	human
@viktoriabk	org
@RunEatPlay	human
@MissEmily_x	unknown
@YeeLing83	human
@OoliteMiami	org
@_hollyholls_	human
@HotNikCeo	human
@foreverursbetty	human
@claire_chang	human
@kinchodanuki2	human
@NodeSystems	human
@klafutiWB	org
@gcafe_sac	human
@LeftBankNYC	org
@ChefGinaKeatley	unknown
@JBlacks_Dallas	org
@libralove36	human
@DanekeS	human
@geeee_arrrr	human
@zulyhendy	org
@revdecubaleeds	human
@cestdelectable	human
@MollyMaguiresPA	org
@3zraj0hns	unknown
@ChicSoiree	org
@lauratermini	human
@IAmYourMaaku	unknown
@kaileighr8	human
@Battle_Mum	human
@JenRenK87	human
@julius_gepe	human
@TheLowryMN	human
@TohITANICeberg	unknown
@laurenovictoria	human
@_littlewing	human
@luigicerv	human
@AlexaPettit	human
@JustBeUAlways	org
@MamasGotItBlog	human
@brendanormance	human
@Munchmaleh	human
@Warburtons	human
@THealthyF	human
@PhoodStation	org
@SchipanoFoods	org
@foodfulmelb	org
@moikusman	human
@Foodlover_eu	human
@RockinDeals	human
@selcamra	org
@CrateandBarrel	org
@lularose_	unknown
@LDGourmet	unknown
@PoweredbyBLING	human
@bot25489115	unknown
@DraftSanDiego	org
@JulesDesjarlais	human
@AnnelAnni	human
@Ssssmmmileeeey	org
@hugegaybrunch	human
@MidnightRose89	human
@bigcokelat	human
@carrelljohannes	human
@howdoyoudo22_	human
@LifeWLisa	human
@errinaleonardi	human
@mjfinefoods	org
@nerinyo_	human
@klahori	human
@stephaniewltn	human
@monicapaclarin	human
@ian_notJLC	human
@AmandaDiaDay	human
@chocolachocola1	org
@fitpin1	org
@Ann_Romano	org
@chky_cel	human
@chantalamadouny	human
@ShmoozSocial	org
@jskystyle	human
@JJBrit30	human
@ButterflyKitten	human
@1healthymentor	human
@Jadinette	human
@TheGFZooKeeper	human
@CrissBKreme	org
@sonia_bee21	human
@Filzflausch	human
@RedAliceRao	human
@blaekle	human
@TheOffalo	human
@MellaLinc	human
@fluffyvla11	human
@dhoodheana	human
@airguitar1982	human
@BakareeBerry	human
@RedZLaShaeQueeN	human
@ChianinaSteak	human
@organic_nation	human
@sassyrants	human
@MrsMandypants	human
@memocorral83	human
@StephaniLauren	human
@alinaermilova	human
@LiveToEatLife	human
@mrsjaymack	human
@bloodyAd	org
@jstahle	human
@heiderstefan	human
@AbdulMoez	human
@scggirl	unknown
@miJeannini	human
@Manuel_balcazar	org
@AmberSBL	human
@_aishasheikh	human
@BedNBreakfasttt	org
@shoryuramen	human
@DailyDietitian_	org
@ejavalon	human
@dawnswick	human
@nishalakshman	human
@PorterAleHouse	org
@AinaSho	human
@HyattEtoile	org
@LainaGoldstein	unknown
@are_nani_mama	unknown
@polytankyossy	human
@BarDemoryParis	human
@Shamalkumal	human
@azdelectables	human
@discovermdv	org
@DYNAMITEFLYY	org
@melairamoso	human
@ThinkTasty	org
@ALYSSAjane03	unknown
@kuba_koki	human
@tomoliciouse	human
@MatiiLaura	human
@Greggarious1	org
@PsalvyParn	human
@NerdNutrition	org
@tsiy	human
@InsightViewNews	human
@qthie	human
@pacsfitness	human
@JenniWilWrapYou	human
@alielbourji	human
@Kelly_Drew	human
@MaZekMoon	human
@ivanforlife	human
@m0m0yann	human
@FilterandThread	human
@MikeKarpenko	human
@GabrieleGabel	human
@losangelesyogis	human
@LetsSmokeLoud	unknown
@OogieBoogieWalt	human
@mkmazer	human
@zeppy_london	human
@cdujardin21	human
@AcademiaCelesti	human
@bwoetdmd	org
@LittleGreenPick	org
@beaterblade	org
@uthemon	org
@DownTheStreetTX	org
@ClickAcabadosMx	human
@VISTAWendyCAN	unknown
@Agua_Restaurant	human
@Bassam_shabibi	human
@IvyThaQueen	human
@MyPrettyBrown	human
@bebek_telorasin	human
@BluTapes	human
@sambalatte	org
@GerardoRocher	human
@theDiegoDelgado	org
@etasflorida	org
@flowerbg	human
@ryanchote	human
@DIYInspired	human
@RadioactiveFox	human
@Kmiles504	human
@DrinkGreenSurge	human
@ShelimUddin	human
@horrorfilmguy	human
@Aioli_Maldives	human
@CertifiedWillow	unknown
@SofitelStrasbrg	org
@ashleyjen	human
@DariyaWright	human
@TooFitToQuit0	human
@HobbsHouse	org
@positiviThy	human
@BertolliIndia	org
@leaannegoods	human
@GingerSnapCraft	human
@HotelSiestaSV	human
@Thomas873022	human
@silvestretg	human
@NehaDhupia	human
@ThatZeeZee	human
@miporin5	human
@Vthevendetta	human
@cheukkin	human
@Addis18	human
@fedelefreaks	human
@sammiefeasting	human
@ReeMerrill	org
@AlanaIsHerName	human
@_ELLEvated	human
@4eyeluvanibble	unknown
@MumbaiFoodiee	human
@uk_girl91	human
@EsraaEHassan	unknown
@GreatAmerRest	human
@julialakaemper	human
@AdriannaGoergen	human
@Dolo_DaPlug	human
@Venus2035	org
@magic_lynx	human
@Rialto02138	org
@CarnivalMarket	org
@isabelponmantel	human
@soundslikeshay	human
@swmbeats	org
@TootAlshehri	human
@HornRebecca	human
@jinrachel	human
@MaurowGomez	human
@robireyes	human
@Pepi_Tello	human
@HardRockinGirl	human
@iamsamgadiane	human
@LordJackTaylor	org
@BestWayOfLivin	unknown
@wifeyoffduty	unknown
@MarySerraiocco	human
@bulently	human
@ninacsop	unknown
@wblack1125	human
@jlou_24	unknown
@MarvsAlipio	human
@TFBJP88	human
@vijiraveendran	human
@CrimsonChakraAd	org
@theELLISeffect	human
@emilyisnobody	human
@Anne_Baxter_C	human
@stephitalica	unknown
@DieAlteLampe	org
@kristenyarker	org
@fashionpastry	human
@Brianly1	human
@AspieSuzee	human
@namihey02	human
@parisparisfr	org
@mag_mei	human
@RelaxInAruba	org
@misscgranata	unknown
@kakia_darling	org
@Yangshq	org
@thelawsondinner	human
@carissaferro	human
@cathryne_chen94	human
@ImSoMa_RTeh	org
@LuvMyAmour	human
@mazgalapagos	human
@harrisjalil	human
@ameliebellemin	human
@kcarpentier77	unknown
@TTYun1	human
@catdy1174	human
@IBITIAN	human
@BahjaTunisia	org
@LifeofLauren2	human
@frattinarome	org
@KappaVelvit	human
@Weekend_Foodies	org
@MrsKelCox	unknown
@Lemur_Lena	human
@jerrycheungs	human
@FRNCPV	human
@Che_Esh	human
@krstfrchn	human
@WCCJunior	human
@RestaurantsCA	org
@TopgolfArizona	org
@katz1019	human
@ZahraMuhammad_5	unknown
@saki0806	human
@RInspectors	org
@thetxpeach	human
@style_icon13	human
@DesyFrandi	org
@mipueblitorgv	human
@FoodieFodder	org
@FitBottomedGirl	org
@clipvain	human
@Chaz10Polley	human
@ClassyCriticATL	org
@claudefoo	human
@__queserasera	org
@JenStewart555	human
@Caritrini	human
@Rizkyafr	human
@RoHNLZL	org
@EatColorfullyRD	org
@MichelleOey	human
@IndyBBear	org
@christi_mariaa	human
@Organics4Free	human
@ShastaHenington	human
@555PortlandME	org
@StupidAnecdote	human
@Dmminako3140	human
@saraferguson4u	human
@monkeybuttchew	human
@YUI_MURUA	human
@olmaka	human
@AmmounAAY	unknown
@sayuri_871	unknown
@oswaldenzz	human
@_MyIdiotHeart	human
@WadeMarriner	human
@ScandicCafe	org
@missmonbon	human
@LudovicEngrand	unknown
@CASQUITO05	human
@VirginiaMateoo	unknown
@lojagger	unknown
@theonlyRandyJ	human
@SelenaCrooms	human
@CheriaPrasetyo	human
@willemharvey	human
@befree_fashion	human
@StellarossaGra1	human
@Selfiepod	human
@Francia0983	org
@MuscleEgg	human
@Lau_AvilaC	human
@GuzmanIron2115	unknown
@MissfitWellness	human
@ipekdem	human
@DDenice5SOS	human
@NoriaYurahima	human
@samdsanchez	human
@jess_selfiegirl	org
@JmeTheBabyMaker	unknown
@yuyunnie	human
@LaVista0720	human
@PantaSon	org
@budiwijaya93	human
@rodolfodelfino	human
@DanielleGinet	human
@deelauliya	unknown
@vegaloverz	human
@Mon_eet_fuk	human
@GiannySummEr	human
@helenasmltr	human
@ted_lelekas	org
@audreybomb	human
@DigitalityMG	unknown
@Chubby_B2uty	human
@MoonGoddesEarth	human
@JhonavierB	human
@monafig	human
@ComputersChap	human
@miku_milk29	human
@Nyfsf	human
@loveu_nicole	human
@AdriannaWulczyn	human
@iLavanyaN	human
@bohsalito	human
@VallaVir	human
@WOWCatering	org
@LadyKirst	human
@lizontheair	human
@CrossStitchCafe	human
@PaintmyOnyx	human
@RokumiH	human
@Anddy_Wae	human
@me_moune	human
@deikericeccbei1	human
@blingblingfel	human
@krquinn1	human
@Tlaloc_SF	org
@whoalansi	human
@natlfoodtrucks	org
@ccturkey84	human
@donstudvent	unknown
@dihanda	human
@guforuvacyn	human
@Pakilyn	human
@NaCherrie	human
@exreimoe	org
@CairoGossip	human
@GSISocial	org
@hannahlee0116	human
@maineveteran	unknown
@JajaAshana	unknown
@MissShafikah	human
@passionistam	human
@ankeeeta	human
@YH2NK	human
@AlexPayton6	human
@GingerMarple	human
@MunchBrighton	org
@fumtandel	human
@smoochagator	human
@jacinto_rdz_m	human
@TheMuddyRudder	org
@Foodealio	org
@dealincity	org
@VernieTT	human
@swaggaboi_25	human
@SoniaMajeedButt	human
@Erousek_Riky	human
@JimmyCohrssen	human
@FollowbackOrion	unknown
@spicykitchn	unknown
@baapoffers	human
@GIBS_SA	org
@triplewincms	human
@RND_build	human
@Poxo26	unknown
@AndrewG009	human
@brekkieosaurus	human
@popchips	org
@omoshiro_pBanV	unknown
@AslinazArslan	human
@ITubeUDecide	human
@PhillyFoodGirl	org
@PavilionDubai	org
@Mister_Burris	human
@Haruyukisama	human
@Pkm89	human
@FreshiiDC	org
@davyBsomebody	org
@Joi_Ride	human
@go_flaglerbeach	human
@pipra3	human
@fatpastard	org
@LITW_Bunny	unknown
@Fitness__Dad	human
@denzyao	human
@Gill0Brien	human
@ArenaDunn	org
@Nawalboolat	human
@joeonhealth	unknown
@kurodai2525	human
@cybermonkey82	human
@lolitapradityaa	human
@vanjoy2014	human
@ReenMatoMato	human
@ayrinend18	human
@sweet_ale	human
@HomeComingKhing	human
@AntonioJiga	human
@antoniofazio	human
@YfLive	human
@dannylinear	human
@FreshnFearless	human
@Claudiake007	human
@sarentos	org
@Yuneealife	human
@mplsmits	human
@HOTTAESCADA	human
@jfyboi	org
@mfirdausdaud	unknown
@_38_special	human
@Anny151284	human
@TheBalcon	org
@Valeriya_Bush	human
@CookedInc	org
@dirrrtyicecrm	org
@malanita7	human
@iitszee	org
@Blueskyangel3	human
@odorna	human
@lipiddoc	human
@ldn_velo	org
@AngieKassabie	human
@dosomehiphop	org
@robotfilozof	human
@PandaBear_86_	human
@OsteriaPanevino	org
@rosyroxy	human
@i3ookii	human
@RAFPL	human
@So_Icy_Shach	human
@Dhivaagar	human
@4YourEnt	human
@anmaine	org
@DalesRawFoods	human
@harloweast	org
@fordy193	human
@Gallirestaurant	org
@dininginbath	org
@XorbiaTickets	org
@walkaheadfarms	human
@JoettaDuskin	human
@TsuyoshiY6	human
@a_healthychick	human
@CiaraShiels	human
@ttianberries	human
@danicialee	human
@Jalen0520	unknown
@FanyLiu	human
@CristhiianOK	unknown
@NomEatNom	org
@theberardo	human
@RufusDeWayne	human
@DiverBatool	human
@Mapleleafdeli	human
@lb20131006	org
@SimonaValiskova	human
@Schnitzel_Bot	human
@Nut_MagdaGzz	human
@Imakeprettyfood	human
@SoranatOonsiam	human
@moumita03	human
@TomJessiman	human
@Miss_Lisha	org
@Predesai	human
@SissiLaBelle	human
@ginita105	human
@missxwei	human
@JessicaRocksIt	human
@FollowMU_	org
@Only1AndyT	human
@charlottesth	human
@gshrivastava4	human
@ThisGirlBeauty	human
@FitmamaJanneke	human
@lanquinseyer	unknown
@urbuncafe	human
@naturefineart	human
@b6aini	human
@amberrhinos	human
@Black_Ieshaa	human
@bart_mex	human
@Laryssima	human
@kottan_19881006	human
@hoteldesalpesto	human
@julietafarcy	human
@gracegurlx	human
@BurritoPic	org
@22MARIO22	human
@idea_rabbit	human
@jmethven	human
@WilliamBunjamin	human
@Leeds80BeersBar	unknown
@otgsf	org
@martinmann_it	human
@Tori_Cautela	human
@easychefirl	human
@TrunkyGeorge	human
@LonnieShupak	human
@Pammygirl	human
@MzsNeng	unknown
@DonCoqui	unknown
@yuninakesa	human
@liverpool_98	human
@yonnie90	human
@BriGeeski	human
@53xYcrys	human
@TwoDoorsDownNW1	org
@meisteredmont	unknown
@yaanlee	human
@maleenhancerx	human
@IamMitchRoss	human
@TheShaheraSam	unknown
@luciennehung	human
@AmourRaq_starzz	human
@AIOLIKITCHENBAR	org
@ojou_	human
@TambayBlog	human
@camismoli	human
@TownFishLondon	org
@PragatiGusmano	org
@Inhabitkitchen	human
@iJon_BaqHang	org
@DreamsnSparkle	human
@Antipodka	human
@Alyssa_Marie08	human
@kyoka1Dballet	human
@tonykitous	org
@ArcadianCafe	org
@saison_bar	org
@gef_hotels	org
@HwangNiGi	human
@derekloveeating	human
@AppelSigne	human
@richardtuffin	human
@lepetitzinc	org
@beasuke88	human
@MeliaBcnSky	org
@GiorgiaMartelli	human
@InLuvWanAngel	org
@gabbianohotel	org
@AlbertWongYK	human
@MarishaGulmann1	org
@n_atika	human
@LexingtonBrass	org
@EridaniaGarcia	human
@marierleslie	human
@GirlsGuide2Grub	unknown
@Robotsixx	human
@Sokaisushibar	human
@CafeLotusBleu	org
@FedaliPortrait	human
@TheFarmDubai	org
@CasaRemi	org
@Foodtrail	human
@Student_Wire	human
@farmavore	unknown
@aprilsalinas	human
@BaRsInPeRtH	human
@FOOOODLovE	human
@Gemini_official	human
@ruchiskitchen	org
@tinajor47	human
@FreshRoasters	human
@feedos	human
@steviegreeks	human
@nanbeth73	human
@Ritchchie	human
@modzatt	unknown
@kooktocook	human
@mrgordon604	human
@RyanAbsin08	human
@GretaMiliani	human
@CASTANEDAPR	unknown
@loveonprint	human
@ChuonThisBlog	org
@jimmy_oh24	human
@KesselandMarch	human
@Al_Braikiya	human
@gintarebeinor	unknown
@Xovita_b	human
@jennawalcott	human
@thornebrand	unknown
@1917_american	org
@stieastie	human
@ZakiArzmi	human
@MdeiPiccoli	unknown
@InstaBratsk	human
@haiIie777	human
@danitee3	human
@BoutinPatricia1	human
@FriedasTearoom	human
@kmichelleortiz	unknown
@Eatonomist	human
@stephanieslanga	human
@Snea	org
@gaypvmx	human
@IncomeTalkRadio	human
@_LindaChong	human
@JWMarriottDelhi	org
@demuths	org
@cestrache	human
@quique7787	human
@Cceesworld	human
@tinesae	human
@googolfgolf	org
@FifiKGreen	human
@BarriYLMAtRiX	unknown
@HQ96884	unknown
@BryanZwan3	human
@CaramelRell	org
@edrinajenette	human
@about_erni	human
@r_natassyah	human
@jheusala	human
@PorkysLondon	org
@JillKBW	human
@thefamilydogatl	org
@russelcuutee	human
@enharyono	human
@vvFAO	human
@JohnnyDownstair	unknown
@Catalyst_101	org
@whatiadore	human
@XONIA	human
@chucksb21	human
@runningera1988	human
@WandaKwok	human
@Rasterify	unknown
@ElCorralUSA	org
@AbbyJayBarton	human
@Webinarts	human
@surfandpeas	human
@HealthyEating	org
@MrSamSinatra	human
@ChisouLondon	org
@SeafoodPubCo	org
@ArlequinCafe	human
@LaVidaHealth	org
@vrokdave	org
@PandorBakery	org
@RedFireTiger7	org
@HKame2	human
@EndySleep	org
@CaviarRusse	org
@KissimmeeBPB	org
@yuknuts	human
@mamoteeen	org
@ErinvaleHotel	human
@Pullman_Jkt_CP	human
@KristinTangel	human
@MiikaaPayne	human
@VickiStapley	org
@snowflake_dee	human
@KINGSEDDI	unknown
@BasilBandwagon	org
@japanfarmbank	human
@Funstatic	human
@BeautyFulLife_	human
@Gsus_Ruiz	unknown
@orodicicognola	human
@GusGusMarquez	human
@brittanieschlos	unknown
@LiuShela	human
@FittataLondon	human
@shimayurika	human
@djjcbahena	human
@Alicemarie94	human
@TipsdeFer	human
@ChuckMeath	org
@richiearells	human
@FERGEFRED	org
@like_gourmet13	org
@DeepDeuceGrill	human
@Conker4buckeye	org
@Kosztirita	human
@vegandthecity	org
@GlassSeller	human
@Monicadrew72	human
@YOSHIKAKON	human
@hangtuahtaiko	org
@ProNutriStore	human
@MonicasBoston	org
@iamhermannk	human
@aireeland	unknown
@hayamanatsumi	unknown
@SkateSessions	org
@vibrantvegan	human
@migmegmagmog	human
@Jezterlyne	human
@SharidatulAmira	human
@chisato_1113	human
@TheTableHunter	human
@DannyChieng	human
@HardRockBogota	unknown
@Mspaoperez	human
@Raddoga	org
@Israel2329	unknown
@thebowtieshoppe	org
@ebayer1993	human
@Jennifer_MS	human
@OmarRoque7	unknown
@medejajevsnik	human
@STARSHlNE	human
@KristineGP	human
@Aroma_Company	org
@DanDoherty_	org
@cotonandunicorn	human
@mannysantiago	human
@TheMarisaBella	human
@tono_tvxq	human
@djblatner	org
@CrioBru	org
@abbeyrogann	human
@Stefanus_Vires	human
@MicheleineLiew	human
@LaVeraLorySmile	human
@ClaudiaZettel	human
@FollowbackHoody	unknown
@ScarlettPRLoves	human
@ByndtheClothing	human
@BeFit_Health	human
@abu1saad	human
@mooiman01	unknown
@Fitness4Her	org
@wesberkeley	human
@Danvigleason	human
@falafelBistro	org
@MisterAngelo10	human
@chinnydes	human
@MaccosBridgman	org
@anthonykingnz	human
@candygirl_toei	human
@PorPlaNS	org
@mmei99	human
@JulieSlavet	human
@Olsen79Olsen	human
@Designartist1	human
@HiDefJetSki305	org
@iliyanaikovska	human
@rachelleea	human
@GVillegas2K	human
@Zaicatmintinth	human
@BigCeej	human
@dianapatriciaao	unknown
@Leesh5353Alecia	human
@eeenteresting	human
@gomezester	human
@EmmaCarderRD	human
@taru_kanako	unknown
@mrfatmac	human
@RCpatissier	human
@ducbieupham	org
@fernandezwells	org
@robyn_gold	unknown
@salloni	human
@pardosmiami	org
@SolanoLuisa	human
@VioletsBuds	org
@1Corben	human
@TeeCee0822	org
@MyMamaKnows	human
@cucinadibarbara	human
@artdivi007	human
@Alexiel81	human
@elmohong	human
@fabricius91	human
@av_glazkov	human
@tehjiashin	human
@shanepaish	human
@helovalverde	human
@LPearce627	human
@Papasito7Angie	human
@The_techblog	unknown
@InGoodFlavor	human
@Funwith_boats	org
@patricia_goh	human
@ParetidZucchero	unknown
@JuanJoseRmrz	org
@Hippo_crit	human
@LaBodegatapas	org
@faranaaz7	human
@HopeTashjian1	human
@JaguarLatam	org
@house_of_jam	human
@lellaVictoria7	human
@Bloomsburysbidd	org
@elferrymadrid	human
@Worldnews_top	human
@smilejenz	human
@Oscmir	org
@AdamLambert_INA	human
@djsaklovsky	unknown
@nicola_procopio	human
@ways_stream	unknown
@UncleTacoMan	org
@TheJetty02020	org
@EdgellAu	human
@timgirton	human
@Naestopaz	human
@FondaMexican	human
@isaaclism	unknown
@HetAirportHotel	human
@lala__valentine	org
@FazzyWazzy	human
@CarolH1978	human
@alin_daa	human
@Izzysan	human
@vennya87	human
@TheLsMum	human
@YMcelane	human
@wees666	human
@JulieMcMahan59	human
@XxxmiicoxxX	human
@Josephine_tipp	human
@DP_Dawg	unknown
@robski107	human
@neabuggs	human
@KSIsooooFLY	unknown
@pbtraveltravels	human
@kayti_ashlyn	human
@47karthik	human
@Milissenta	human
@nyysteak	org
@OscarJMalek	human
@Diamond1Sparkle	org
@suzjdean	human
@bondappetit02	org
@GMbenza	human
@tonk5ey	human
@CADADesign	human
@ashleighsworld1	human
@EmbraceSelfLove	human
@LauriRottmayer	org
@bestlifediet	org
@dan6667	human
@Redteknique	human
@irishcabaldo	human
@josephbrot	human
@Doris1zGuerra	org
@mamawolfen	human
@lilce51286	human
@Thore100	human
@hannahlouise_95	human
@aruha55	human
@ScottsdaleQrtr	human
@eugeniachun	unknown
@bigsolo64	human
@KovcsKevin	human
@ceedamaster	human
@ladyandiron	human
@TheFitChiquita	human
@healtfitness_	unknown
@KristaLawhon	human
@NikSnacks	org
@DistrictLaBrea	org
@Lesli_tmarket	org
@JoLge_LelaGaLza	unknown
@samlifeandstyle	human
@the_truth305	unknown
@LaughingFood	human
@DafyneMeBella	human
@YasminStone	unknown
@SouthwarkWOT	org
@TKCpodcast	human
@eleitaliana	human
@infinitimel	human
@Lamb411	human
@helenjanex	human
@LuxeSunsetHotel	human
@April_A_Smith	human
@thelightleeds	human
@jaizduck	human
@DAA_feed	org
@Marlys359	unknown
@DeMospizzadeli	org
@ganeshpoli	human
@DalArtsDistrict	human
@LilinhaAngel	human
@moxanim	human
@Tina_sWorld	human
@cardiacism	human
@nourishingchloe	human
@mayo_badazz	human
@dr_sho	human
@RapMusicWeekly	human
@yippyyee	human
@straightupstyle	human
@kukiiez	unknown
@valcourtois	org
@TheDesignerGeek	human
@BlancaVee	human
@MikeyHonig	human
@Kelly197730	unknown
@rano1991	human
@esgisoftware	org
@NatalieEmma98	human
@EmyNnamdie	human
@Barons_Market	human
@BMclevedon	human
@Serena_Toh	unknown
@Soundtechdez	human
@simplybeingmom	human
@PhoebeLapine	human
@RobBragagnolo	human
@hibiscusdallas	org
@pedlerpeckham	org
@nobodysaidblog	human
@Vivo_taste	human
@CcPrincess20	org
@SoBeLocalMiami	org
@AhmedMahmoudUSA	human
@Jessie_EatRite	human
@HolisticBC	human
@deborahpenland	human
@KelliCupps	human
@wealthyrichbleu	org
@hottychix	human
@sugeng1101	human
@JuliaShutenko	unknown
@Soloroamer66	human
@halhal69	human
@NatashaShumny	human
@AdamNaim	human
@salgonzales105	human
@BIGGTEMPS	human
@ulyssesDS	human
@lifestylepluspl	human
@colon_robles	human
@yoits212charlie	human
@Tinchuk	human
@elainevrivera	human
@qhybelz	human
@Dietforanewaust	human
@TmoTrains	human
@cookandbooze	human
@marriedwpeeps	human
@JGrillunt	human
@TallywackersTX	org
@1711Jayne	human
@Lozekinz	human
@Kathi5589	human
@shishtawi	human
@pinkheart07	human
@kaaaanae95	human
@CeiliHouseHess	org
@farmerspub	org
@NinetteOseiWil	org
@smorgasapp	unknown
@MatthewWRamos	human
@geoffs_kitchen	human
@CommonwealthOnQ	org
@SteC_o	human
@Mlle_Ruta	human
@sayady11love	human
@ParentingMotion	org
@TheHotSpotYoga	org
@CherryRed82	human
@jankal7	org
@Beautybykaris	human
@Gritpgh	org
@Fit4Martina	human
@jdcrose217	human
@dennyscamp	human
@fouzia_87	unknown
@neanea56	unknown
@REAL__AG	human
@Pakhuisadam	human
@fox_aj	unknown
@l_mustache	org
@apoklipsys	human
@dickeybeans	unknown
@DVJBET	human
@evokedubai	human
@snapkitchen	org
@ernestlfc	human
@EmmaCabochan	human
@BhatiaJii	human
@LaMadameAnena	human
@yo_mimi_yo	human
@glitteratieyes	human
@Lace_MillaA	human
@iamMiuCherie	unknown
@sertacdarcan	human
@Ciindyymac	unknown
@Fearless13Z	human
@daiisies	human
@JakobsLondon	org
@NamedBran	human
@zurry_ir	org
@harrysding	org
@porceelain	human
@sabaw_ng_balot	human
@BelieveBobRoss	human
@sustovan	human
@wu_hin	human
@TeeDGAF_	org
@norris_bess	human
@MusicofDash	human
@4NCambsShire	org
@MariaSparrow2	human
@LeeGregory254	human
@mpopa298	human
@MacoFoto1	unknown
@robert2266	human
@inspire_1life	human
@ChrisCH2011	org
@egoli_girl	human
@gtarrantsr	human
@CafeAmoretti	org
@BareAmbition	human
@_VeroPosada	human
@nikaspirit	human
@TheRoyalHotel_	human
@Wasabassco	org
@NaRiSaBkK	human
@Nicmochii	human
@afiq_ali	human
@Amy0210C	human
@bettayeuh	human
@Elmer_Axume	human
@ToosdeeTMH	human
@pamilya_mentos	human
@_FreeJewel	human
@teainspired	human
@LeicsHour	org
@inktober	org
@jubail1986	human
@ToStrength	human
@defgoal	human
@MartaEskandani	human
@ShareYourCals	org
@Susie525	human
@ftn_tweets	org
@RomainB7	human
@Natalia040692	human
@Bakery4Less	org
@p3iLiNg12	human
@bkbagel	org
@_ImaKing_5	org
@itsmedaiyan	human
@LeRoiHaptalon	human
@GlitzyCoilz	human
@thebeaconhotel	org
@CJsMaui	org
@decorartuk	org
@TheColesbourne	org
@MACARON_BOMB	human
@cosmeticshifter	human
@S2batgirl	org
@tiywie	unknown
@TopgolfChicago	org
@onemoorebite_	org
@cadwaladers	org
@PANSMARINEDA	human
@MerkuriChan	human
@MrsJulie69	human
@Kungi_Voltron	org
@TineWatson	human
@CTinyTreasures	unknown
@emileedupre	unknown
@exercise7minute	human
@christklvin	human
@DjchartsUs	human
@SaraliePooh	unknown
@Giuseppe_Luca	human
@JamesMelvilleJr	human
@Rosy_Acosta14	human
@SatayHut	org
@CashHoarderHuti	org
@chrisspotato	human
@Hertou	human
@RitaMonteiro94	human
@atheirallam	human
@ElleSous	human
@msmaine77	human
@erika_swan	human
@DailyGrill	org
@Prince2117	human
@IlanaTraeger	human
@xpentacle	human
@hamiltonbakery	org
@CatalinaOP	human
@Fishat85	human
@gcfb	org
@obendo	org
@CoyClark10	human
@StevestonCo1997	human
@Acooltime	human
@monijai	human
@eweandlamb1	human
@advertisingdiva	human
@ijinkannoneko	human
@SE16Hour	human
@HollyCooperS	human
@d1rTyd6n	human
@chrismarklein	human
@GateRestaurant	org
@allister_thomas	human
@jcuribep	human
@LadyAngelJung	human
@MacAlwaysOn	human
@DonutBonus	human
@bonafidehun	human
@handikaindra	org
@KatrinatheB	human
@natnut92	human
@dallasmoore	org
@SabriSallehin	human
@Serenasahin	unknown
@500DegreesDerby	org
@MissElaS	org
@blondebenedicte	human
@APlaceToKnow	human
@Mrsbrich26	human
@kellybullrubia	human
@_ChristaSimpson	unknown
@bradengw	human
@tomaskopriva	human
@K_Ncker	org
@EllieComley	human
@stilltheman2010	human
@RusticaLA	unknown
@leSymforian	human
@EdinburghGros	org
@Foxy923	human
@iPrinceMB	human
@lighthorsetav	org
@kageee	human
@dajefe77	human
@vuboq	human
@lanticafornace	org
@thewickedhop	org
@LondonClubLtd	human
@RahiemBrooks	unknown
@810snow1	human
@scandinathan	human
@punproduction	human
@GiveMeYourShoes	human
@jonpincek	human
@Raeubertochterr	human
@Mahendra_Vitara	human
@DialogueAgency	org
@rattycastle	human
@lizii111	human
@simplicitykins	human
@RosalesVALERIA_	unknown
@p0pson	human
@MataBarTO	org
@PepperPlaceMkt	org
@Ashiriru	human
@hereathere	unknown
@andreacomenta	human
@nati727	org
@DashGoPro	human
@HawthorneTO	org
@SG_EGO	human
@scolet24	human
@juanrotorres	unknown
@CapertonFineArt	human
@SumeraSushi	org
@francovaliente	human
@nivek37	human
@preshuzzpenai	human
@BODY360FIT	org
@rep5aj	human
@IluvMissingAndy	human
@Aleciaa_Geerr	human
@Melissa_PLTblog	human
@DodyGeorge2013	unknown
@CMcWilliams88	human
@bus2013456	human
@thetwobiteclub	human
@ohohdann	human
@mademen10	human
@estelle4	human
@daiyafoods	human
@VindyLee	human
@GemmaLondonLife	human
@RSon_HGA	human
@AlexanderPerri	human
@PoBoyQuarter	human
@marysbusykitchn	human
@Lorilee_E	human
@EddyLYC	human
@DebySharma	org
@LuyLeJit	human
@jodieanne27	unknown
@Chefsheadtable	org
@Kitty0505Rika	human
@S_Saigou	unknown
@aliciavideira	human
@etamagn	org
@LESmitty	human
@blackbeautybag	human
@hindamitchell	human
@toutsie717	human
@Buns_In_My_Oven	human
@DuraShineClean	human
@suvictoriam	human
@SJismyNAME	org
@firmannurzaman	org
@ariannecruz07	human
@soapfanfiction	human
@sab168	human
@Chikmai	org
@Madalenantunes	human
@m_esteves94	human
@kennaratyggjo	human
@gardein	org
@PYFitness89	unknown
@punkrawkstar	human
@raquelleesworld	human
@arifute	human
@Fashion101ed	human
@BTPcafes	org
@lucy_waring	human
@Tipstoheal	org
@conniekyom	human
@wtf_angel_brown	human
@jaylu12	human
@asyihShouts	unknown
@cwlord	human
@BlueSkiesCottag	org
@janye7	human
@PeteyPablo623	human
@eatlamb	org
@LeanaShenise	human
@AlenkaArya	human
@vincentlao18	human
@marielistic	human
@HeightsTavernNY	org
@chrisungeun	human
@UncleLeroy7up	unknown
@okotoba_siri	unknown
@transcendancing	human
@RaffaCaterino	unknown
@i83N	human
@McGuireMeredith	org
@daleyandrew07	unknown
@Michaeljamesuk	human
@bot03005476	unknown
@Vnc88	org
@gcalories	org
@lookWM	org
@CharmChawm	org
@StAndrewsBayYC	human
@robynk326	human
@superbintoy	human
@Cucina_wellness	human
@setyukko	unknown
@letiziahu	human
@AAlcocerd	unknown
@KlasyDiva	unknown
@ryn11	human
@talkradiomom	org
@ExpressInquiry	human
@Julia_B_Douglas	human
@TheOnlyLindiLu	human
@pretapregnant	human
@yansitanggang	human
@parkonfremont	org
@tamischweber	org
@StoicMedia	human
@Veggiereviews	org
@randeedaddona	human
@Justapiercer	human
@oyakatane	human
@SandyNMH	human
@cassiezenkert	human
@girlgumption	human
@PrincessHotels	human
@KRAZYB0NEZ	human
@lotusfummy23	human
@irawatysarah	human
@Emilyloke_97	human
@ethos_grkbistro	org
@MissSaraiPio	org
@CastanedaJolly	unknown
@Chan_217D	human
@bengriggs5	human
@nAndytolangako	org
@TopgolfTampa	org
@yomineInes	unknown
@Sam_Shearon	human
@vcreekfood	org
@redpoola	human
@tanom	human
@JohannaWestberg	human
@ArthurRyder	human
@yougrumpyoldman	human
@Kiin9CEO_KDP	human
@FallonBurns	human
@iamPoGay_	org
@ElManzanillo_	human
@ARTPhotoMakeUp	human
@nodenow	human
@FollowMyGut	org
@EatFatRice	org
@MaiyaNevaeh	org
@pryan04	org
@yasmin0687	org
@astitiara	human
@OzLegend14	human
@linusarmel	human
@AhappyNappyAffa	human
@ErinELyall	human
@HankOnFood	org
@MilavaKiseleva	human
@TEFightStands	human
@paleoprincessRD	human
@deoluakinyemi	human
@FunkEyJunk	unknown
@StoneforgeRnham	org
@sacharimilian	human
@KidsHealth	human
@eli_rita	unknown
@WendeezNutz	human
@NatasaBlair	human
@SuziMaynard	org
@h_najua	unknown
@GameTight_4life	org
@find_articles	org
@erhanz	human
@Eva_Johnston	human
@LaurenMote	human
@EuGeniaHarris1	human
@LBcharity	org
@CAPHILLMANSION	org
@Louiesah_Swan	human
@chameleonmagic	human
@RadicalSpazzer	human
@ChaoticJuris	org
@DoveMagazine	org
@ScottsdaleRST	org
@lowcostholidays	org
@Edmarcy	org
@GarveyBecky	human
@bystephanielynn	human
@NatarikuZ	human
@IamKeonte	human
@100189Kenneth	unknown
@bornalmighty	human
@ChocolateBottle	human
@monokae	human
@Cocoaroundtc	human
@ASATravelPR	org
@gemalexander_	org
@XimeTorres8	human
@tanandjosh	human
@AllisonJMontano	human
@VaidosoDeCoura	human
@thefoodjunky	human
@AllServiceUS	org
@iamdustysuarez	human
@UHAVEBINWANTED	human
@paulosamaniego	human
@BM_AYANO	unknown
@regi0709	human
@Lera668	org
@nanc_wang	human
@DjeepTurkey	human
@charlierobinson	human
@izmanzainal	human
@RosKazShiB2ST	human
@reena_onn	human
@ichigolabbit	org
@LishDuchen	human
@corvallistidbit	human
@silvennia	human
@MzgraceTx	human
@eatsmag	human
@SageCafeAdvice	human
@MORadioactt	human
@Jay20_NU_3RA	human
@aristaangelina	human
@frickinGino	human
@polluxc	human
@chitchay	human
@jessica__tay	human
@JessyyJay	human
@Suppa_Jr	human
@ukraines	org
@TheEmbankment	human
@playgroundproof	unknown
@lillo85k	human
@RozieGyems	human
@sl_heavey	human
@FoodHerald	human
@bembok01	human
@t_a_mi	human
@DannyTheMenace	human
@ElectricPressLS	org
@KarandeepWalia	human
@amanowine	org
@JStrongFit	human
@its_salmaa	unknown
@clickthebunny	human
@PrettyWellness	human
@AadhiCuisine	human
@J_r2ro	human
@pantyanimal	human
@5ChurchGroup	org
@jlapanna	human
@Fizzarcher	human
@thethirdofmarch	human
@iamcpaige81	unknown
@kirsten_dart	human
@stamfordlocal	human
@GFEpicurean	human
@StMarysSeafood	human
@malfoysykes	human
@JakeStreetTruck	org
@mon__mon93	human
@monackhavong	human
@BABINEBADABING	human
@TheNationalNYC	org
@pattun_c	human
@DuchessOfFash	human
@BGlamorous	org
@ItsPatMartinez	human
@lunes954	human
@limitlessfit08	org
@FionaSeror	human
@vegtourist	human
@_inSAMnia_	human
@LeilaLuis	human
@Afare2015	org
@BridieMolloys	org
@jesska_lynne	human
@Michelleweeks	human
@BballeyGC	human
@heyitsalyssayu	human
@saowapakch	human
@ElenaALucky	human
@aga_kurczak	human
@CamilaChavs	unknown
@aloha09	org
@MarcelinaMega	unknown
@ribster13	org
@nealrs	human
@RaygunK	human
@kungfusion69	org
@mrymkrc	human
@pratamarico10	human
@88Begui	unknown
@ChefStuart_	human
@paodeguia	unknown
@PUnicornP	human
@teto3man	human
@HangorMango	unknown
@eljayrussia	org
@BFFBurgers	human
@JakadaFashion	org
@liam92payne	org
@silence_suzuka	human
@boyzronaldo	human
@DietitianOnline	human
@BrittaBrat74	human
@hbros	org
@AnthonySmithXXX	unknown
@narstheresse	org
@GavinKelly93	human
@SUCRECREPERIE	human
@Spazzymandy	human
@echawann	human
@beibiibossbheng	human
@akvranish	human
@Allergy_Star	human
@jjqnasty	human
@FrugalFeeding	org
@VarvaraKiss	human
@AromadiRoma	org
@rutaagayire	human
@deals_PA	org
@GloriOutlet	unknown
@febrina_iraa	human
@ArielBGarcia	human
@CheckYourFoods	human
@CandyFlavas	org
@InstaAchinsk	human
@tkoker	org
@radiohai	human
@Maryskate_Vic	human
@BlackMountSmoke	org
@aekay_choky	unknown
@WFMColumbiaSC	org
@MrsErage	org
@mustadventure	org
@wildrosetrippin	human
@RaiaTorn	human
@mazanvistro	human
@NinonCoemi	human
@duttonsMCR	org
@ClaudiasCupcake	org
@GoedkoopJKT	human
@BashfulBlissful	org
@lunchboxdad	human
@DynamicTinting	org
@FoodofLeeds	org
@leamarstonhotel	org
@Mom4everever	unknown
@rosmaninho_r	org
@sjagsocial	human
@malemalemal	human
@MiDulceMagdalen	human
@priscillasisi	human
@Pinkcess_LauraB	human
@pure_coffeebar	human
@ChefdpMIAMI	human
@LyndeyMilan	org
@Just_Geen	human
@FollowbackBogey	unknown
@erika_kristina	human
@mitravanmoleh	human
@ExchangeFlags	human
@SynergyChiros	org
@bekahchica	org
@SeasonalShaheen	org
@roshinixo	human
@survivedmansaf	unknown
@realcaseyy	unknown
@Lumoimage	human
@FSLondon	org
@DCutlerAZ	org
@BrannanJodie	human
@villawedding	org
@onlytabi	human
@PlatinumCamP	human
@FallenzAngel	human
@leblogpaillete	unknown
@teddmabitazan	human
@hustlernature	human
@koikwanklao	human
@RickyKanno	human
@buisandwhistles	human
@Rohit_r7_qtr	human
@Craftyourself	human
@ACMC_Clinics	human
@FrettyAnggeni	human
@Carter_HG	human
@paulmaranto	human
@HannesLatsky	human
@RetnuhMedia	org
@funfitgirlFFG	unknown
@Town102	human
@Nutrition247	human
@andrewjamesltd	human
@PINK_GREENeyes	human
@PamelaSEllis	human
@sanmusone	human
@giakat	unknown
@Appthetable	unknown
@EleLucy	human
@desafio6	human
@John_Primo	human
@EustachyMotyka2	human
@Cheshire47	human
@joysofsarah	human
@TheHarvestBar	human
@NeuvooSavannah	org
@Lewislaw1Max	human
@LL_COOL_TAYE	org
@PrivilegeCard1	org
@BeckaKMason	human
@COYOUSA	human
@botbot201306	human
@brendaalawrence	human
@DAREALDJNICE	org
@CakePartyIT	human
@TheRockenwagner	org
@lizzychaicl	unknown
@pauric19quits	human
@729CapePulpit	human
@WassailNYC	org
@TheEveleigh	org
@ellainers9	human
@TieDKnotWedding	human
@FYeahItsCorey	human
@WSANDJ	org
@RestaurantLAZ	human
@ashour	human
@DougUndone	human
@JohnOdysseus	unknown
@hongnhung105	human
@small_miss	human
@MartinaBohn	human
@jjassociatesYin	human
@Wow_Tables	org
@MinSeven7	human
@foodforaking	human
@Porketeers	human
@PapayaPieces	org
@SliceanddiceME	unknown
@ProperHunt	human
@tocalegacy	human
@_Just_Jade_blog	unknown
@cathymisscathy	human
@icrdi	org
@MaxMLMbuild	human
@TommyT0n3	human
@calafelice	human
@cmunkok	human
@ErikCCooper	human
@fuffyfluffy	human
@ipadzorz	org
@Team_TropHy	human
@anhabelle10	human
@ohsosweetbaker	human
@edno12	human
@riverscorpion	human
@momknowsbest15	human
@AdhaSahaja	human
@cupidpoetry	human
@semraunall	human
@papabilities	org
@MiauCau13	human
@Cykrow	human
@lala_lus	org
@jad3xxx	human
@J_T_9	org
@milliesadler1	human
@ExtremePitaHQ	org
@JsLeigh14	unknown
@fluffypinkfur	human
@realbynicola	human
@asnawimdnor	human
@lukebunker	human
@Musterdogs	org
@augiefantinus	human
@cassandracmpbll	human
@McDonaldsEgypt	org
@Mrs_Martine_	human
@limbeeyan	human
@DanaArtinyan	human
@EdwardsDriveIn	org
@_noviiantielf	human
@AllegroEats	human
@OhSnapVince	human
@TapasYMasUK	org
@fede88avril	human
@ivyk_chibbie	unknown
@elisapavan78	human
@ilovebabyblake	human
@xocheena	human
@Captain_Wingman	unknown
@guoshyang	human
@G_ShaunIzMe	human
@pinkcatclare	human
@KabobKings	human
@leedsliving	org
@marciakhartwig	human
@sodajane	human
@BlueAnchorRH	org
@rmgarciax2012	human
@yukaijiku	human
@Chynahdoll_bby	human
@Richard_ZY	human
@Ln1885	human
@zackeight	human
@CheeseburgerBot	human
@cindylouwho821	human
@NetworkKildare	org
@YEWWlife	org
@chemist_dad	human
@Tonny_Liang	human
@joyofkosher	org
@eco9t	org
@naamahalva	unknown
@divesaustin	human
@franciscotvr	human
@dariopanarotto	human
@iamalexchan	human
@Fazzeleen	org
@thefatveganchef	human
@Raymond_Norman	human
@lawrenceecastro	human
@FcJekko	org
@TheBurntTruck	org
@annamia1113	human
@ssieg	org
@wandavilleda	human
@KaeLeonardo	human
@ale_kowal	human
@StevieLawrence	human
@Ali_Bartmann	org
@atsushi_009	human
@alittlecrunchy	org
@TeacherWu	human
@FryingPanSlim	unknown
@kurtpengchi	org
@JohnLeungYYC	human
@HeeTica	human
@valdovinos	human
@mnn18	human
@Hannimssi	human
@mrsubsnwrapskw	human
@nyan7world	human
@chiswickish	org
@seefuddiet	human
@tinasweep	human
@Beth_TWxx	unknown
@CafeMyHouse	org
@amotherworld	human
@JorgitoLV	human
@MyLilPouch	org
@garybut	human
@KellyFlatEleven	unknown
@manderos	human
@araeruiz	human
@Reinventcarrie	human
@TeeAech	human
@7hoteldiner	org
@wanderlustandra	human
@ciputradavid	org
@vintagerivercrt	human
@edwinlazoco	human
@Piscean_Gershie	human
@xavier0604	human
@Chiechayski	human
@officalnidhi	unknown
@BiggieSin	human
@JovanWilando	human
@Leannakyle	human
@5thSettlement	org
@jerrenn	human
@romy___romy	human
@Spitbank_Fort	unknown
@fitmamaali	org
@ZenshiroJay	unknown
@ji981993	human
@DeniceSundiam	human
@garyaknichols	org
@HaveKidsWillQ	human
@iamcharizeM	human
@shikaruo21	unknown
@Telling_Tales92	human
@emilycleary10	human
@petoandi	human
@Miss_Cakehead	human
@fredbenedicto	human
@TheInfamousIvan	human
@maslinda5330	human
@diegolameiro	human
@kitchenbeard	human
@comp_LEXI_cated	human
@RiccardoPozzoli	human
@heathaamarie93	human
@ayakotaro0327	org
@ROSCOCOFFEE	human
@iheartwanda_ray	human
@kerry_meanwell	org
@Amumin37	human
@ethelhurst57	human
@jugojuice	org
@BateauxNewYork	org
@knk_38	human
@LittleC00kies	unknown
@bot61959723	unknown
@pemikabutimarl	org
@nura_ahmad	human
@22DanielleM	human
@CreativeSpark01	human
@ChellzMB	human
@MonikhDale	human
@CONSTANTSALES	human
@sashabrownfitt	human
@SouthGate_Bath	human
@zenginera	human
@OHCBBQ	org
@ellencnorth	human
@125_ku	human
@i_heart_essex	org
@sa_na_cha_na	human
@yoanajojo	human
@Lock6Cafe	org
@CelebsEatWhat	unknown
@tristupe	unknown
@jenzhouu	human
@donovansirish	org
@djdavidwebster	human
@Simply_ILona	human
@ishmeynana	human
@TheOnlyBigNate	human
@dentoning	human
@msomusica	human
@NOMADPIZZA	human
@Porsha283	human
@MircharMedrano	human
@PoppyetPeach	human
@SupahBars	org
@tweetsfromCAR	human
@GlutenTag	org
@CharlotteLeeTan	human
@christinatthe	human
@EpicureanHotel	human
@Danielzilla	human
@SaraLeeSnacks	human
@jimmyjummblz	human
@DrMelMel	human
@ESClezah	unknown
@jennpartywraps	human
@Cathyt1111	human
@thaomyngn	human
@jjcdeleon	human
@yenechz	human
@DoubleAPhoto	human
@5stonewomen	human
@MyAkronGeneral	human
@HeyItsMeVinVin	human
@ninaabigailtan	human
@CTGunz	unknown
@estanisOchoa	human
@ViralBinge	org
@CafeSiesta	org
@sabachugs	unknown
@NibblesNFeasts	org
@TeamMonchoso	human
@TheBlueEnvelope	org
@HotLm	human
@LiraCarlosE	human
@beaniephoto	human
@Shellys_Wellie	human
@jb_swartz	human
@ProudBhutanese	human
@JohnnyDelTaco	human
@NaydaKunisXO	human
@MrPrettyBoiA1	human
@sigmacal	org
@cindycapo	human
@LoveTheJaxons	human
@swaymyways	human
@davidciani	human
@hipsfish	human
@PHOTOlulu	human
@letshed	org
@DarkreichAZ	human
@Ilvoloverboston	org
@_aikane	unknown
@LaVeuve	human
@SvetlaaLuch	unknown
@marinaastro	human
@Wesaal1	human
@HRH_Group	org
@itsfizaaaah	human
@JohanLange	human
@Seliciouscakes	human
@KarenaMontreal	human
@thecyard	org
@MuzafferAydar	human
@VigilantRobot	human
@minnabrighton	human
@P_Juggernaut	human
@AnotherTweet	human
@Jets00007913	unknown
@therobbyrobster	human
@HibaExpress	org
@india_aleah	human
@HeleneWorldWine	human
@_2Tru_	org
@BerryShortKake	human
@EricTicana	human
@PowerRadioTalk	org
@mhm10	human
@kennygkj	human
@carenwestpr	org
@genes_recoded	human
@NISHAluvzYUUUU2	human
@Sugarloves50	unknown
@lmp423	unknown
@BarcadiaFTW	org
@foodfashion_fun	org
@finogaga	org
@jgomulka	org
@Winnilicious	unknown
@bot14309501	unknown
@FindYourFeet	org
@sasha_alisa	human
@CEOGlam	human
@tinieRazak	org
@Dividebbie	org
@KyleEccleston	unknown
@smooshe	org
@DYPePezy	unknown
@BocaGroveClub	org
@roastd_chestnut	human
@CalistaLeahLiew	human
@IAMSIRCOOPA	human
@Israel_Corral	human
@jonnyashton	human
@hvlint	human
@jaycutomztgod	unknown
@endabinsaleh	human
@OphirPR	org
@LouiseWhittake6	human
@YleniaMaisto	human
@gitlchefs	org
@RedstoneGrill	org
@Fierceover50	unknown
@KataKatharina	human
@LIEBLMAN	human
@ThunderTheodore	human
@Jets0000793	unknown
@tataatm	org
@MuhammadKahfie	org
@babydollwrites	org
@CaffeArtigiano	org
@TheSaintuation	human
@MaMa_Salazar	human
@chesterloke	human
@vicky_chef	unknown
@KyleOverSoul	human
@mizucci0	human
@massimodesantis	org
@StAndrews4You	org
@LizPhoenixED	human
@RikaSoedrajat	human
@jospookytakeshi	human
@blogger_bazaar	org
@RattlesandHeels	human
@PassoHaddad	human
@AlBetzReporting	human
@TheUpsiderNYC	human
@GenesisVera1	human
@coopertreez	org
@DevahastinM	human
@OurKookyLife	human
@JillianElodie	human
@ThePizzaGuysUAE	human
@Mirksumis_Prime	unknown
@weheartastoria	org
@kara_age102	human
@NeuvooMidland	unknown
@greatfallspies	org
@dixieats	human
@MoaFredholm	human
@SRK_PC_MyWorld	human
@abangwan92	human
@GiuliaWutz	unknown
@shiorin2923	unknown
@x_emmylou_95	human
@HappyTalkRadio	human
@lika_lol	human
@techie1978	org
@GrabYourSpoon	org
@dfmatthews32	human
@nickjean	org
@aymileetoco	human
@rhuandsam	org
@RealGallipoli	org
@justevi	human
@hell0imSarah_	unknown
@Brundac	human
@finadenetruck	human
@xxminimousexx	org
@Tecksteroonie	human
@TomohiroMizuno	human
@pradiphira	org
@loveidols	human
@chal_siner	human
@olivertwist123	human
@BarnsleyIs	org
@LondonJamesZH	human
@CalifiaFarms	org
@AMBIENT_SAUSAGE	unknown
@AubreyParkHotel	org
@OnceAgainThink	human
@SmallServing	org
@AJimagePhoto	human
@anipalacios	human
@BlytheFunez	human
@AshAshoneill	human
@PriceSpy	unknown
@cocinalala	org
@shaw_and_co	org
@Asyrafasy	human
@Cheffor5	human
@fundraising_hlp	org
@rairairaika	human
@alohaMMX	org
@shokutsuclub	human
@tyfoguinho	human
@donchang728	human
@FFGeneration	org
@EliseTan91	human
@floydcardoz	org
@hokulani402	human
@KaddizPa	human
@jolienemann	human
@mrkmyword	org
@HuskyGeek	human
@RachelNowland	unknown
@ErikaKapele	unknown
@KaigalwayMurphy	human
@cessellearenas	human
@AthanasiouPty	human
@SilverSuites	human
@tregan28	human
@Tasha_Fierce03	human
@MonicaMPedreira	human
@SomMyTt	human
@JaspersStalker	human
@ohcielos	human
@Emlayyonce	human
@PioHerras	human
@arVINDICTIVE	org
@LucyAlvesYoga	human
@Reshika_Renee	human
@rochellehall63	human
@FateenZacharya	human
@Kushoholic_209	human
@TheRicoLaw	human
@FlawlessHusslin	unknown
@FedeAmbrosini	human
@TheRedStagHFX	org
@HomeToHeather	human
@UNikflowPeace	human
@snorlaxishafiz	org
@bayley_sharp	human
@normaishak	human
@africanholistic	org
@IndieGamerBot	human
@VinePurplicious	human
@perorestaurant	org
@amongthepines	human
@cheftommygunnz	human
@MarleneFood	human
@erixxx2788	human
@BullChinaShopE1	org
@GuslooksVargas	human
@SultanFoodTruck	org
@poonsanova	unknown
@StinkyBabalouie	unknown
@chorichori_0309	unknown
@thalisolis	unknown
@ArisSutjiatma	human
@Fizyazlan	org
@frantarded	human
@imtiagosilva	human
@MercatoMall	org
@LivingFitPT	human
@mcgomez_11	human
@erawd	unknown
@homesickak7	human
@VelaBodyME	human
@tjack2005	human
@ardyes	human
@agenmossad	human
@asliakdg	human
@shmeth	human
@TellersIslip	org
@sdrefnet	org
@charischan	human
@Sarson360	org
@Kos68	human
@DesireeEaglin	human
@emichine3e3	org
@MetrePizza	human
@nami_fl	org
@alexisleray92	unknown
@YougoBreakfast	human
@Miss_Nisha123	human
@moniqdw	org
@GieErgina	human
@southcotabato	human
@nagikoba1979	human
@TDGPhotography	human
@KBinsobeih	human
@Dholderd	human
@Reikoaloha	human
@justgemini_tw	human
@LuciaGreen12	unknown
@LAzeeLuu	unknown
@ChristianHouseW	human
@caro_mad	human
@krios12	unknown
@TheFoodyCall	human
@OldMusicShop	org
@MitoHilton	human
@Clairemj24	human
@Dymestatustv	human
@BestOfEats	org
@BlackBeardRyan	human
@MorbidQueen21	human
@DaC_Style	human
@sixteenbakery	org
@SattarSpeaks	human
@EmpireBarSwords	org
@Dorina_Daniela	human
@InstaTlt	unknown
@thescousewife	human
@Purple_poppadom	org
@boatinbird69	human
@MatisseRestoBar	org
@KariDiazD	unknown
@Kimchinattodon	human
@markyantb	unknown
@Tipsaholic	org
@harriet_grose	human
@michiamocandace	human
@ritu_rajput	human
@stephyhng	human
@Andrea__Hood	human
@mjfordy	human
@Casarina	human
@p_eleph	human
@Clarice_clak	human
@eatmixmingo	org
@DolciPillole	org
@AtHiEsYaEX	human
@ChefCodyStorts	org
@ChuAhMie	human
@memechan27	human
@chl0ebt	unknown
@jasmin030290	human
@budileofan88	human
@MeiFangZhao	human
@BlogWithMom	org
@MenuMBK	unknown
@Darlene38	human
@RATIONAL_AG	org
@cakes_London	org
@animalvoice777	human
@RetreatCafe	org
@sarisaffari	unknown
@Robinson_Julie	human
@RossEdrace	human
@PiccoloDC	org
@KTSKeithThomas	human
@jlaalja	human
@RoyalChinaDubai	org
@MikeN11237	human
@LiliSanchezI	human
@LeavenNH	human
@JASONBARNEOND	human
@vmendez1721	unknown
@SoUniQuePRC	human
@DigItApparel	human
@altstrat	org
@isonlacbay	human
@renai_Yr7OM	unknown
@Burgerbx	human
@zahidnoor2	human
@Buttonlandia	unknown
@SilentLes	unknown
@miliparola	human
@The_KingEddy	org
@AishaZS	unknown
@gramsandoz	org
@traceydavina	human
@NaomiNachman	human
@DanceNatH	human
@0124_yo	human
@KikyRzkM	unknown
@KristynSteinke	human
@Sway_one	human
@Puff1313	human
@Waldyarms	org
@MajesticDivas	human
@gholmes724	unknown
@theone_va74	human
@ScapeSTL	org
@2chicksproducts	org
@IAmEdgarNalugon	human
@Tita_Amazonas	human
@GoodandGuilty	human
@Virgomagazine81	org
@AZPlastic	org
@PunchBowlDenver	org
@ils_learning	org
@eMazingSkokie	human
@KamAhin	human
@elpaisagrill	human
@ljb2689	human
@LoisMarketing	human
@ecstasyfantasy	unknown
@makeupjunkiee27	unknown
@theheinekentom	human
@julianaconci	human
@RadissonBluMi	human
@alina_monique	human
@rosey4exclaim	human
@LJCSC	human
@Tamalaaaa	human
@marcometer	human
@potchybear	human
@deubode	human
@photosbyroger	human
@BudiTW	human
@hayyritchie	unknown
@tracysaywhaat	human
@chynatic	unknown
@Stacey_Bethel	human
@vitkovaS	human
@ComfortDomestic	human
@elixir_kun	human
@venusmay	human
@JacobWellens	human
@DiscreetKat	human
@eZeePicsStudio	org
@VermontWilshire	human
@AbigailAmengual	unknown
@ClaireRDN	human
@julietalucca	human
@colewagoner	human
@kntkfm1213	org
@ArisBeatriz	human
@TaphouseGrille	human
@samuelstuart	human
@Arsimaria	human
@WholeFoodsCRP	org
@TheNewYorkerNYC	human
@CoriSivad	human
@neneni83	human
@rinamama1021	human
@TeasersWinnipeg	human
@E_the_CameraMan	human
@mymantraactive	human
@rahmey13	human
@AlexU1986	human
@GirlFromVzla	org
@jerumi0209	human
@SheBebymonster	human
@saki522126	human
@FedeGiordano7	unknown
@alseraf	human
@Boss_of_2Bosses	org
@BrianHuskey	human
@mattbernradio	human
@dianakelly	human
@takafumiatsuko	human
@DynamicFlurry	human
@thekoffeepot	human
@NeuvooSalEdinb	org
@LaTerrazzaDubai	org
@AlberthFenix	human
@318SCORPION	org
@MyerCentreAde	human
@BarjotSeattle	org
@iAMdianneFIDER	human
@LaKeidaH	human
@tabishch	human
@SteveZayko	human
@CaterstewYou	org
@TacofinoVAN	org
@stacybaby007	org
@BlaisGenevieve	human
@JAmberclout	human
@koby_ansah	human
@ILLupinoHawaii	org
@jojotseng	human
@astonsbread	org
@MelissaClark	human
@Hassan119012	human
@swing_3	unknown
@maggielouie	human
@mollydarcys	human
@DrayInTheCity	human
@birdiechiu	human
@yvonnetanyv	human
@AmyAzmilia	human
@ronvcab	human
@Mastrad	org
@teamskovajsa	unknown
@giannecarlochua	org
@sebastianfogg	org
@fleadaggy	human
@StTolaCheese	org
@marco2482000	human
@lluisgarcia	human
@vavaaaa	human
@Khunooh	human
@Bombay_Sizzlers	org
@SeanSautees	human
@classicfishshop	human
@Mrs_Robyn2U	human
@Madebythechef	org
@JosephWells	human
@dmvfredevents	human
@top_diet_tips	org
@whatsupfagans	human
@thespiffycookie	human
@CareyGLY	human
@AnnaSmithPhoto	human
@JamonJamonTapas	human
@TIME4TRAININGUK	human
@tedhopson	human
@Paola_xyz	human
@_FoOu	human
@WhyteAndBrown	org
@mcgraw_mitch	human
@cavaliereandrea	human
@calvinerico5	human
@elleganze	human
@WesterRossSalmo	org
@durtgeek	unknown
@BumblesofRice	human
@98Greer	human
@BeccaDWard	unknown
@HannaManna	human
@NorthStar_Cafe	org
@kevinbgy	human
@lb20131004bot	org
@anacanicarrera	human
@naat_natato7	human
@litehousefoods	org
@terrylanciotti	human
@thewebergrill	org
@xelisewin	human
@Chefsuman	human
@U_know_u_wannit	human
@Marriott	org
@AletheaYoris	human
@delishknowledge	human
@IonDecoration	human
@fredss33	human
@lb20131002bot	org
@TheVillageBakey	org
@missrucyte	human
@serginho_goti	human
@ClassicFM	human
@NiclieyetXhin	org
@Strong_Food	org
@nikbarkley	human
@meri_rasoi	human
@tuck_joyeux	human
@McKeithCordell	human
@Denis_Madriz	human
@AnejoNYC	org
@hekz_D	human
@1UPCHAMPIONSBAR	unknown
@marikodancelove	unknown
@ZhimingM	unknown
@ivory_elle	org
@GnoccoNY	org
@MissTigresa	human
@ephraimmasanque	human
@jarednoticias	human
@citraspberry	human
@Machupicchu_res	org
@hurricanestdot	org
@foodiesinked	human
@Ms_nDy	human
@bobbit2266	org
@InfoParents	org
@Fanjacker	human
@DukePubs	org
@InstaWhiteHouse	human
@ThysaniaAg	unknown
@CurvyPervy	human
@mccomb	human
@The_Woch_Man	human
@FarynEdelstein	org
@forevermsd	human
@mazzy0108	human
@jcaicedc	human
@MinaTsubone	human
@xvenshax	unknown
@BouludSud	org
@bigvdallas	org
@Fame0bama	human
@Lonna_Roo	human
@Brooke1Boyd	human
@NikoDoughski	human
@HAHearn	org
@SimaMukolera	human
@jcampbell6420	human
@MSEDollyp	human
@Jen_Scoular	human
@EssenseofYi	human
@ggbhabe	human
@alexeyenko	human
@NuHarvestFoods	org
@DanielFanmail	human
@necaxista13	human
@theMICHELLEtoe	human
@AlejoSanchezH	human
@Cookie_Monstish	org
@blvdyvr	org
@lachinatacom	human
@JessDandy	human
@nonacapsa	human
@StephHughes88	human
@like_gourmet3	org
@AngelikaHuber1	human
@jamah888	human
@NHaquee	human
@GQDTuiter	human
@Foodscapevpm	org
@usakitchen03	human
@test88test88	unknown
@andruwtjai	human
@Pureglutton	org
@katiewilson212	human
@AineThePiercer	human
@dfarleyii	human
@sexythkbarbie	unknown
@RodWiens	human
@jtouw	org
@ShahrilTweets	human
@__iamlisa	human
@ElHasouna	human
@f5m_club	unknown
@ComfyTummy	human
@itisSarwan	human
@hookedonhealth1	unknown
@Healthy_Habiits	human
@jasonlimwt87	human
@iLoveHD_	org
@capitanlist	org
@thyoffer	org
@KathleenHijmans	human
@djayderamos	human
@mannat88	human
@Pattyquin	human
@missy1307	human
@PattiXiahh	human
@FortMarkFitness	human
@BrendaKookt	human
@shefinds	org
@Veggie2Bella	human
@keepitrich	human
@fantasiacaffe	org
@rjeusebio	human
@chancchanc1236	human
@MelanieDFuller	unknown
@EstherPeyron	human
@MoriAlberto	human
@AND_smoooch	human
@henyergr	human
@GenerationSofie	human
@kristinerudolph	human
@Rinanto	human
@aka_L_G	human
@adamisatlantic	human
@MommyPowers	org
@iammichiewill	human
@drbobmoss	org
@BrunchWick	human
@Dis_Col	human
@Lanie642	unknown
@98CMaria	unknown
@profesortbaker	human
@candiceking1984	human
@UWiesendanger	org
@ThatcuteguyMarc	human
@jun_pure_bsb	human
@pudding_purin1	unknown
@JGPR	human
@NataChudinova	human
@OldCityDistrict	human
@angelgeniusjail	unknown
@chefalexmoreno	human
@_danyeele	org
@ayupichi1206	human
@_bozman	human
@JiNnuDoll	unknown
@LucaGiii	human
@TentazioniWorld	org
@AnnaCanDoItBlog	human
@JarretTT1	human
@JustJosieLow	unknown
@LeitteKarinna	org
@corneh	org
@PaolinaBulle	unknown
@pigpigscorner	human
@chantay_	human
@uniiquequeeniie	human
@CoscienzaSp	human
@EndlessDreamers	human
@vivaluxury	human
@aksc0724	human
@EatLoveLou	org
@FratelliRo	human
@BodegaWorc	org
@CoutureGoesCorp	human
@realMandarjoshi	human
@Cupcakes_Amore	org
@GonvilleHotel	org
@ThaliaBurtdance	human
@DaniaEdibleHI	org
@NelliePomPoms	human
@Christina_Loei	human
@prynsas	unknown
@dejeuneratyourd	org
@ilkka_siren	human
@andelkita	unknown
@GosH3lp	human
@GreatQ4U	human
@PrinceDonny	unknown
@thesophislife	human
@woodlepops	human
@RedRiverStkHous	org
@SusieNeuner	human
@rdizzle707	human
@Lai_LingB	human
@jay_jhai	human
@AmberApproved	org
@cohococo	human
@TerryComedyClub	org
@AnthonyBPT	human
@z_teca	org
@somaruyoo	org
@MarindaSoU	human
@sweep91	human
@YelpLV	human
@Yuup_iSaidIt	human
@nutnormaangeles	human
@lydiamcm	unknown
@KurtzKreations	human
@villanophoto	human
@Maioush	human
@NishdeLuxe	human
@MadeleidysDelTo	human
@dancer2712	human
@Sharp_Edge	human
@_IshakPasha_	unknown
@Agirlhastoeat	human
@marymarygr	human
@FashSkint	org
@GranoVitaUK	org
@p_i_pp_i_n	human
@tfandthemachine	human
@annamadamm	unknown
@annglisset	unknown
@PolsK1_1987	human
@jeff_wise	org
@ohohginn	human
@zhengning	human
@TajEnterprises	human
@funkselekta	human
@rio_1218	human
@MarialeBedoya10	human
@ThePunchBowlLDN	org
@REALMRGOODLUCK	human
@BigGulsDoItBest	human
@FlavorBoner	org
@SanchoRMuje	human
@TValvano	human
@BambangPramono_	human
@alekslovesmusic	human
@KingsHeadBev	org
@aaronasuncion	human
@Jets0000794	unknown
@tuneadd	human
@jonfarrington	human
@ScottN10	human
@fooreveryoouung	human
@kirbydingwall	human
@MatheusPrieto64	human
@thesoofster	human
@amindunstable	human
@SilTiraboschi	human
@KRLNG5	org
@meeya18	human
@GTFishandChips	org
@hasnida	human
@MrsPsKitchen_1	human
@chefs_About	human
@FrankCoQ	human
@Independenttrac	human
@tsuka_JAPAN	unknown
@LascoMarco	human
@danandesther	human
@angxous	human
@natsking84	human
@EDELWEISS_DELP	human
@AdelinaTMonroe	human
@JayaSWadhwa	human
@OrlandoDugi	human
@MadeItLoveIt	human
@kiki_king	human
@mydogwontbite	human
@balkesh	human
@inimoe	human
@I_am_Italy	org
@jpsmokin	human
@TextureLondon	org
@NOIZU_SAMA	human
@4HBPAGGStack	human
@srslylou	human
@ean0227	human
@umichfan21	human
@aryo_wibi	human
@SuperVixxxens	human
@DNM_Chi_Travel	human
@elizfinch	human
@ThePakiNextDoor	human
@Chefhaick	unknown
@CavsLisa	human
@CelisProduce	human
@strangerinbree	human
@BossMargie	org
@slumdunk0820	org
@AnaliFirst	org
@HesTiee_Shine	human
@MENAVARRO86	human
@TheStuffedOliv	org
@Henry_Beck	human
@madbazz2	human
@PatelDevansh	human
@mykgeronimo	unknown
@dearkani	unknown
@PaperGirlTE	org
@mong_alice	human
@bostonc	human
@OGfromohio	human
@belangacafe	human
@movidabaku	org
@SonyaEstillia	human
@GoDutchDiet	org
@MsAddikted2Fame	unknown
@HenryJermaine	human
@dontMJEW	unknown
@CulinaryMuse1	human
@ayu_ayunni	unknown
@de_diego	human
@azureLemonc	human
@x_chapa	human
@GraffitiJ7	unknown
@bakeorbreak	human
@EefenLien	org
@KristinaLaRueRD	human
@IdeaCatalyst1	human
@genussgeeks	org
@FiveLittleChefs	org
@Need_Einafets	unknown
@Jutta_jung	human
@Superbarkx	human
@mami_19870617	human
@ahasansansan	human
@NeuvooNiagaraFa	unknown
@priapradana	human
@AimsterSkitz0rz	human
@BrkfstClubBos	org
@Homervillehound	org
@TatinhaTodaBoa	human
@FrkenFager	human
@SmoqueNBones	human
@letitflair	human
@TisforTable	human
@CarolGarnier	unknown
@TravelerSuggest	org
@elisasunshine13	human
@landyk	human
@HOTPrinceJP	org
@VVN_B	human
@Lannexbeach	human
@reality666Check	unknown
@vezzycoops	org
@BestofMelbourne	org
@YOSHIKIbot2	unknown
@Lena_Kil	human
@WealthTalkRadio	human
@jen_fontaine	human
@filicoritr	human
@ilmaffio	human
@cookinghat	human
@adelwtest	human
@thepapurazzi	human
@schubbube	human
@temporubato_yh	human
@TheLoveBite	human
@bridgetteleeson	unknown
@ishirleyun	human
@ai_0124	human
@DarkHorseMosele	org
@vansventures	human
@DJStephanM	human
@tattoo5455	unknown
@____hakim	human
@janinaurelio	unknown
@erencarrizalez	unknown
@foodbyjill	org
@umchester	human
@hargawow	human
@Strippers4UUK	org
@ellengcb	human
@ainuraffni	unknown
@crownandsandys	org
@DixieCrystals	org
@nizariadh	human
@AIKO_esNAIL	human
@littlelove25	human
@xCoolBreeze93x	human
@TayTayleo_foods	org
@lvhchocoholic	human
@DilavsKitchen	unknown
@bigdc76	human
@mhark4184	human
@natalie_pav	human
@cel_lab_slim	human
@FOIR_Official	human
@Budi_S27	human
@alicepolack	human
@sarahdarling1	human
@momnrock	human
@BodaciousJewels	human
@milliebird	human
@adouglasjr	human
@pvgreen	human
@jm_0424	human
@J1nxedd	org
@TH_Sharky	human
@SOBTruck	human
@hinya_	human
@lizmoll	org
@GustoLappsQuay	org
@hafizkutep	human
@loving_italy	human
@beatrizc0311	unknown
@BushsBeans	org
@evil_chichang	unknown
@rania_marketing	org
@eyingyow	human
@SurfCityFamily	human
@amandawongsoo	human
@burcinozercolak	human
@BurgerBeast	human
@MLRPromoBiz2Biz	org
@wapple_13	org
@QualityLBV	org
@TeaPufff	org
@Aimeehx3	human
@VocelliPizzaa	org
@ardelle60	human
@gelleesh	human
@AgatheGatha	human
@LaMelaVerdeVE	human
@rodrigopp04	unknown
@ChefDarrylf	human
@bruttiandboni	org
@FoodEpix	human
@Angeline_Cheong	human
@RedCoatStudio	unknown
@rachel_shines	unknown
@ranveerbrar	org
@didith_melody	human
@lidiva78	human
@MizzLee_88	org
@paolanoe	human
@annisa_idiot	human
@myBrideBod	org
@TheMadPK	human
@DomesticDivaBN	human
@Snapbak_Lady	human
@katrinabishop93	human
@ayuagus_salam	org
@FichFahmi	human
@theSINGING_CHEF	human
@DanaRob55	human
@Jsouldragon	human
@cy_vipass	human
@elinda_joen	human
@KeyboardistTomo	org
@faraz_ahmed92	human
@straymoon	human
@Jets0000791	unknown
@wrki	human
@monstroze	human
@Parelshaarlem	org
@matchbox3	human
@FoxMarlowe	org
@emmalou150	unknown
@jj_tt	human
@Sarahlil16	human
@marcmenor	human
@viajesaludable	org
@JustbeingStella	human
@kitchen_academy	org
@HollaayyyyRose	human
@iLOVeBAP07	human
@blackgirlsketo	human
@RoBeau78	human
@m_y_acts	human
@iChhann	human
@juanasom	human
@Marccc09	human
@ShannonLGilstad	human
@Yoanitawati	human
@MariaPretelt	human
@thefittutor	human
@TheStarInn1744	org
@LucyJohnnyLove	human
@kekkaolivetti	human
@CosyClubBath	org
@Imdlprs	unknown
@workercharlie	human
@LoPurnell	human
@Wanny_Mustahfah	human
@FarmgirlsDabble	human
@berryjia	unknown
@jorgybirds	human
@HealthPerch	org
@pranalip	human
@SRMarketingRach	unknown
@JamesCSherry1	human
@patrick_shieh	unknown
@Andrea_Farro	human
@StationTaproom	human
@RubenGom3z	human
@EpicTalkRadio	org
@JustAngeloCz	human
@yelpGTA	org
@ApproachNottm	org
@marleymar2wavy	unknown
@moleatron	org
@minyong23	human
@AbiNubliSafeei	human
@josemonkey	human
@SimplyOrgFoods	org
@LaPetiteAuberge	org
@butterfryme	human
@Lux_Cartel	human
@EssGOfficial	human
@wholefoodsnyc	org
@theMEESH	human
@JWStarrPass	org
@BostonPicks	org
@BelleBellely	human
@jmd10686	unknown
@DolcevitaMmm	human
@GideonOh	human
@mattyadams84	human
@blackmarlinhhi	org
@slimt1213	human
@misterbatch	human
@zfrkyrk	human
@ChelsJong	human
@EstersDoilies	human
@JusPooh88	human
@UncleJimmysBBQ	human
@teahivetweets	org
@SubcultureRebel	org
@princessleloz	human
@sheratonsub	org
@SirHeisler	human
@platingpixels	org
@AngieKurosakixx	unknown
@deliathomeuk	org
@itsmesexyxayn	human
@PizzaBolis	org
@PPnori	human
@tentoes71	human
@xflixx	human
@ElmerCarbajal	human
@2Spaghi	org
@mvadera	human
@pastrychefmike	human
@hopsharvestLV	unknown
@LauraLorto	unknown
@QueensHeadChis	org
@GuadalupeBlaise	human
@EmmAisha	unknown
@lookssoyummy	human
@lablab1086	unknown
@iam_emmie	human
@giftinggal	human
@yuannavales	human
@ferdzdecena	human
@get2theroot	human
@martinamayer95	human
@girlwhowaited	human
@p2malatai	human
@MissReeDimples	org
@AlphaOmegaBot	unknown
@McD160BwayDJ	org
@Andrewboii4	human
@rusticdublin	org
@MydelisJourney	human
@SandmanHotels	human
@SophiaGorgeous	human
@FormerlyCrows	org
@bandetv	human
@Littlelambtales	org
@MixedBeauty090	unknown
@DiannaChoe	human
@tantiligent	unknown
@veggieash	human
@surlyspice	human
@TheFemGeek	human
@sandosando	human
@r2thebrouphy	human
@Ravin_Dave	org
@dokushinno	unknown
@_NeonLife	org
@603MMY	org
@l_1ght339	human
@audygonz	human
@TanOnTheStreet	human
@boynagirlnaboy	human
@foodnflavors	org
@naem_zubaidah	human
@RashandaF87	unknown
@anlesc	human
@noblondgirl	unknown
@sedairy	org
@JessicaLSuss	human
@Feryal_alateeqi	human
@jlanzmo	human
@frankschicago	org
@shinchiki1974	human
@KizMySeLf	human
@e18ht33n	human
@MiaandMiloPaleo	human
@GoldClubSF	org
@quintavis3	human
@freckleheadlh	human
@grayzeeG	human
@BerlinUp	org
@wavesss	unknown
@pegilola	human
@CalDelicious	org
@yapchernchee	human
@Bell_Dakao	human
@tastypursuits	human
@latekitchen	org
@takemehomesoon	human
@blonde_rabbit	human
@miracle_waves	human
@urbanhealth_ie	org
@mafaldasbaf	human
@prettee_teena	org
@HolidayInnMV	org
@annafelizatweet	human
@Eatsoho	org
@MikeAdamOnAir	human
@kfkelvin	human
@SleepyPeaHead	human
@PrincessPanya	human
@KBoyler12	human
@Prescilla_L	unknown
@Fischbachz	human
@Pastitsiopgh	org
@mahamahu	org
@FerFDL	human
@eemy195	human
@AngieWatWat	human
@jets00007915	unknown
@MarioCsttill	unknown
@PerfectoMiami	org
@topmeatball	org
@hommey3505	human
@Anoellas	human
@LAmandierHotel	org
@mthum76	human
@LKPH	human
@JaneticsInk	human
@dj_abhishekm	human
@MelissaSChapman	human
@Supersonex	human
@arivilalta	human
@ErikaLundgren	human
@nikklit	unknown
@mrs_conceded	human
@Veeah_	human
@artfulgourmet	org
@Dre1allianceEnt	unknown
@BOT06325438	unknown
@yodokozu93	unknown
@MadamePapin	human
@aikopots24	human
@HolidayGreece	human
@jaypsyd	human
@MaycollCalderon	human
@LondonCw	org
@priyabangaram1	human
@dnice183	human
@CREPYS1	human
@ChadiZeitouni	human
@SouthernRailAZ	org
@Jets00007911	unknown
@NinoEmoon	human
@Civilocity	human
@CarlaABruns	unknown
@pickandeat	org
@zacks1981	human
@EmeraldCSisters	org
@angelafred5	human
@IvanIva95424730	human
@danfarrow9	human
@freakfrompluto	human
@PetChristensen	human
@GlutiesGirl	human
@VGMeats	human
@MeekGoneWild	org
@seattlefoodtrk	org
@goodgirlgonered	human
@Bucket909	human
@Mikel_Arevalo87	human
@Jozikids	human
@henz_zhen	human
@StephenShute	human
@g33f	human
@ggwilliamsburg	org
@ericisaac	human
@rishatan	human
@AndrewZogby	human
@jcjeleazar	human
@imQueenChinita	human
@kznkids	human
@MAYA_CHANDRA90	org
@c_olufson	org
@AppetiteToronto	org
@0910_miho	human
@MachinaEspresso	org
@KrocCenterSD	org
@megabitecanada	human
@WhiteHart_Hgt	human
@SparkleJenM	human
@__a_w__	unknown
@Sophie_McLean	org
@SetsunaCastro	human
@harleytales	org
@SherleyT1	human
@cyrilprumper	human
@yuka94vip	human
@FatManTheChamp	unknown
@paradarioaro	human
@iamzahir	human
@LaSheidakeh	human
@wela_iAV2	org
@jun_aloha	human
@Maeva__Davis	human
@NutriTilty	human
@BethRosen	human
@segnalidi_laura	human
@fatefoolfolks	unknown
@HendyMusa	org
@CharlesMiddle14	human
@AlchemyTree	human
@rhestyputri	human
@LaGrace82	human
@m_oliverbr	human
@trinitygou37	human
@igersvalladolid	human
@_Dakotastorm	human
@SwettSyalalala	human
@WanderingMak	human
@ImViola_	human
@ChefRoccoTO	human
@EmanuelaGolemme	human
@liladollie	unknown
@MaxBlacker	human
@PrivilegeAluxes	org
@decoforhouse	human
@theyhotel	org
@LenaliSC	human
@LSchag	human
@DeidraLicata	org
@ericaJr_success	human
@Ms_Hamdana	org
@Lighthouse704	human
@zetanun	human
@SamiraSummer	human
@_ShadesOfJay	unknown
@MarioIzurietaH	human
@LungaGaxa	human
@yu_tr1	unknown
@Tacece	human
@emecatedral	human
@OxfordLovers	human
@dyayaIR	org
@thegriddleboca	org
@Zippy_dude	human
@PhotographyJLS	org
@TaylorLouiseNot	human
@Bea_Falomir	human
@BestYaEvaHad	human
@berenabozzi	human
@SnapDeli	org
@VerdeIrlanda	human
@Liztennis	human
@WeLovePlaytime	human
@FTPointLoma	human
@SouleyVegan	org
@haperbaper	human
@MO_PARIS	org
@asiascafe	org
@vinylremix	human
@AubreyMikah87	human
@darwin__paul	human
@kadomasakazu	human
@LaylaAdler	unknown
@PauliinaMuller	unknown
@Sisujuice	org
@MadMonkIndie	human
@OrganizeMadeFun	human
@chuesli	org
@writerrhiannon	human
@ElementsDWC	org
@eveilane	human
@zaryanne	human
@standrewslarder	human
@jOw_nie	human
@MaryamRahimi25	human
@ZetaJhanji	human
@alex94125	human
@TsuyokuFeng	human
@keithflaherty	human
@twitreseller	human
@anumjaffery	human
@nominomz	human
@iamyannakarizze	human
@Sleekster	human
@GumbootGlam	human
@deviechangmin	unknown
@chichay17	human
@LeSexDansLaCite	org
@ValeriArribas	human
@alishasappetite	human
@a16ya	human
@agnesolivia	human
@MrsOtisHuff	org
@greenshopperuk	org
@mztress_isis	human
@elmwrites	unknown
@ThaiBana	human
@BaronWoodmead	org
@Sirynah	human
@StaciRyans	human
@Renerestaurant	org
@NeekaGoodman	unknown
@theworldofcraig	human
@DowntownSantana	human
@DamesDietz	human
@akosierickgo	human
@BackstageGabe	unknown
@Katenok13	human
@FollowbackGhost	unknown
@ChinaMemo	human
@SerinaGuerrero	human
@TipayTio	human
@JBPLLC	org
@kirakiramekuyo	human
@Slates_x	human
@PrancingQueen	human
@MsFtGtJH	human
@Rain__Yee	human
@SarcasticPunk26	human
@leicruz	human
@Jandrosaayman	human
@leeniezxcs	unknown
@EllingtonHotel	org
@mariacascone7	human
@DavidJohnPreece	human
@PirateBee	org
@ChiPhotos	org
@v1nc3nt91	org
@f3ndy15	human
@supremaic	human
@28am_j	human
@carissalynn	human
@90IP6	human
@SweetChickLife	human
@Agnes_oo_OO_oo	unknown
@bawyse687	human
@chenmooo	human
@NastyNickMusiQ	human
@kesserwenorg	human
@primalkitchen	human
@EnonPoh	human
@GossipG23321662	human
@natacouk	human
@MarkAnthony83	human
@HKristianus	human
@jesshleen	human
@jhayne16	human
@Valeria_Lubrano	human
@jorgelbt84	human
@damianjproject	human
@mariagiesa	human
@alexxjaeandmilk	human
@iamsuperarn	human
@megonza	unknown
@daee37	human
@sarah_kira_kira	unknown
@HealsUK6	unknown
@EyeCandyPopper	org
@alandavesalazar	human
@goo_jae	human
@3TopInc	human
@Bebengisms	unknown
@RosannaBuckland	human
@iM_jamesWONG	human
@Pizzeria28	org
@titussonya	human
@thaz	human
@mikajimboxxx	human
@seeannsave	org
@QueenHazeSplash	human
@ShameerDShah	org
@Chellebobaggins	human
@CTSweeper	human
@JennyNg	human
@aldosvinoteca	human
@pbo_t	unknown
@craftycat1968	human
@jeremygoodrich	human
@arthurhay	human
@chadcreasey	human
@ShangrilaNewDel	human
@iVillageAus	unknown
@ai_JBxxx	human
@Prochet1861	human
@2ser	human
@SemperFiGurrl	human
@zac_lemieux	human
@Purehealth_nh	org
@Queenlyanggun	human
@DayFeda	unknown
@JoeyManalang	human
@ABC14367355	unknown
@aytenesendemir	unknown
@tynjarlos	org
@CalinisanF	human
@MediaScanl	org
@raulradio	human
@ParkerHouseVT	org
@amiillusive	human
@QueenBlkInDutch	human
@JambaJuice	human
@lzam23	human
@reneekohley	human
@blarneystone17	human
@parisi_official	unknown
@JoyBeyondDrugs	human
@www_SuperRookie	human
@htmur	human
@pilotshubuk	org
@EatDrinkEatBlog	unknown
@SiameseBasil	org
@MinecraftLuvFLL	unknown
@SnuggBrixton	unknown
@MenumateID	org
@classyladyrev	human
@Savingsure	org
@insunyang	human
@NoNameBarDublin	org
@JoyBansil	human
@PastramiBcn	human
@weeepaula	human
@LaVitaBriggs	org
@mouthfoods	org
@EventsByRay	human
@chefspike	org
@NSHDeli	human
@bergamo_ebisu	human
@Danieltcw1	human
@todoadriano	unknown
@Lupe_mao	human
@ethosworldcare	human
@theresa_jose	human
@risitano	human
@BlueMarlinUAE	human
@tsang121	human
@WarehouseCafe1	org
@Chef_Ronaldo	human
@cinerestaurant	human
@davenseebarran	human
@Sha_DreamMiss	human
@gorille	human
@bigredbooty	unknown
@LautaaFrancucci	human
@GraciaPatriciaH	human
@Fedecentrica	human
@inconnu_info	human
@ManonLoubaki	human
@RestinaD	unknown
@CS_UNCG	org
@rookiephenom	unknown
@TheDCLadies	org
@arisic9	human
@111111Rhonda	human
@zzhilinggg	human
@GoyaFoods	org
@Uandyourskin	human
@vannelei	human
@celeinaann	human
@ToniJim13	org
@an3Ferreira	org
@TerriLMowat31	human
@Jonesy2001	human
@tireland	human
@flavavicious	human
@manongdinmak	unknown
@AmanitaCastanea	human
@DolceCafeBolton	human
@skinnywrapslisa	human
@msalilla	human
@HouseDublin2	human
@SlatternHouse5	human
@TheWitchingPen	human
@PastaProntoWA	human
@ArturoEder	human
@CoffeeBeanBar	org
@DJYATUSABES	human
@hyobabyy	unknown
@FunFitAisa	org
@CorpoNatura	org
@JennyBurnley1	human
@SoulcialiteNeka	human
@Eb_the_Celeb	org
@DAPs_Magic	org
@Sports_Insider	human
@HenriOftana	human
@CLEstephanie	human
@daiten5	human
@ScoopsofJoy	human
@lolo_tamimi96	human
@pspix	human
@BlackBauhinia	human
@WiseGuyBigSwoll	human
@AOndar	org
@dreamlivenjoy	human
@lmcasiano	org
@boienxtdoor	human
@IslandPicnic	human
@spencer096	human
@CostanzosBakery	org
@Culinary_King1	org
@gfreefun	human
@zafranOK	org
@msqiqi_blessed	org
@HoggingUp	human
@akmal_m	human
@foodeclaration	human
@hervinahua	unknown
@abbeyragsdale	org
@kids_josette	human
@Nanaharaslife	org
@SpokeAndBird	org
@kizzycod1D	human
@LeMeridienND	human
@CarolineCalcote	human
@SaucyTrini1	human
@shaahid_96	human
@TomDion	unknown
@PINGGJatim	human
@Biancas_Blog	human
@thestomlin	human
@SoulZahraWahid	human
@Camilleaparis	human
@aussieflame	human
@gadiusagi0805	human
@TomFaklerPhoto	human
@patriciowise	human
@EloisaTT	human
@eateateat_	human
@hui_for_un	human
@brisketbel	org
@abc15828299	unknown
@1ed06e2568ac4d8	human
@thebikinichef	org
@mynameisyui104	human
@SwagGirl1313	human
@StopLaceFrontin	human
@GavinGreene1	human
@abbiscarlet	human
@jessiefester	human
@PacificKosherG	org
@luca_sessa	org
@Shopper_Liz	unknown
@HeyitsgraceLee	human
@FoodiQueenLDN	unknown
@mellamo_laura	human
@AtlantaRD	human
@drummwill	human
@RhetLife	human
@PasonActress	org
@TwistFroYoPdx	human
@pandadorra	human
@lindaPePpaz	human
@jollyblue_05	human
@Anuthegoddess	human
@Jekyll_n_Hyde	org
@namastefree1425	human
@GriffenBakery	human
@Justine_Huang	human
@lilnita07	human
@moose_hefner	human
@corinnevail	human
@HeyMissFats	human
@MaicchoY	human
@WFMRoaringFork	org
@NicaApa	human
@hcmc_ts	human
@JAMES_LEWIS124	human
@KDAHMumbai	org
@Kamakura_Local	human
@MarciaBcreative	human
@yogisdotme	org
@mr_adbrooks	human
@ElkenCafe	org
@NatalyaKills	unknown
@DietingTricks	org
@umahapsari	human
@Avatarsg	org
@kburdtweets	human
@randomblitzr	human
@Dokusaisha_M	human
@AlgoPrestadowp	org
@littlechunga	human
@Heykissez	unknown
@EliaGuardiola	human
@Tedrepou	human
@MalarkysNB	human
@TheBankGlasgow	org
@mybelly_eu	org
@AskChefDennis	human
@Milica_Opacic	org
@MsMelTaylor	human
@SapphireFlavors	org
@earlofsandwich	org
@LaFortezzaDC	human
@Prisca_Mi	human
@BeeIRL	org
@DaRealYoungKaos	human
@bourbonandblack	org
@hammettz	org
@PinkieFanClub	human
@DaleHerbst	human
@kitty_white_0_0	human
@_l_e_a_h_	unknown
@tarailm	human
@Elizabeth_Chen	human
@UnionSocial	org
@superdanUUu	unknown
@Marnieg33	org
@ady_sut	human
@alici_cr	human
@amydfy	human
@patonproduction	human
@Will_Hicks	human
@klevacooper	org
@KTCevents	human
@rhoda_navarro	human
@tntpchrist	unknown
@ceciliadeline	human
@RambosKitchen	org
@EmilyARoach	human
@zhayns2000	unknown
@DramamamaX5	human
@KellyHTandT	human
@nancybaggett	human
@pereira_nana	human
@DeGaulleBistro	org
@AB_Restaurant	org
@DeilaBoni	human
@BondAppetit	human
@Dr_Ago	human
@reypokemond	org
@_sarah_smile	human
@KentuckyLovers	human
@CelineMahou	org
@nhughes1986	unknown
@Staybridge	human
@MrBriHam	human
@liberatedlibra	human
@Il_Fornova	human
@WeasylCritique	org
@alexb281	human
@KaraCopenace	human
@MzHeidee	human
@kannibearr	unknown
@TooSpoiledForU	human
@jgscontreras	unknown
@OnlyInMyOwnMind	org
@maria_wheat	human
@Silvia__BB	human
@EmilysFrugalTps	human
@Elana434	unknown
@pinkwinkgirly	human
@acupcakeleeder	human
@fabtasticeats	unknown
@BeccaLudlum	human
@itbholdings	human
@_iLaiLa_	human
@JFRGirls	human
@larabesqueworld	human
@wafaa985	human
@em_orchard	org
@representasian	human
@_sartoris	human
@10sfitmom	unknown
@Sunset_Inn	org
@rena092	human
@Yukon164	human
@SybariteAdv	org
@tinastullracing	human
@ZuliRamos	human
@akosijson	human
@OfficialLilJ	human
@AndazSanDiego	org
@ShellMalham	human
@shengyikoh	human
@ThebrasserieMK	human
@Erick_Tan	human
@miinerr	unknown
@thebluehorseinn	unknown
@coconutmerchant	org
@aishahroslan92	human
@GFtravelers	org
@dominolarose	unknown
@XLDubaidxb	org
@hayleylouiseR	human
@GlotonMex	human
@culinarytravel	human
@CChissima	human
@pennypolaroids	unknown
@FitnessinQatar	human
@ilmitoEAST	org
@VanessaLanham	human
@mesle_ana	human
@zeryzamry	human
@Adh_V	human
@patrickleedavid	unknown
@ZDBoutique	org
@CafeTiramisuSF	org
@YiaourtiNYC	org
@mbrandond	human
@JolieFitness	org
@FoodPornGod	unknown
@EnnHelen	human
@ELLESPORTUK	org
@kerchoo7571	human
@DJone01	human
@Ph_Aith	unknown
@DuskyDharsh	human
@SLUGGA2GS2PS	human
@renai_14zmd	unknown
@GiorgiaTombesi	unknown
@Vkdotkr	human
@RLLoverJoe	human
@picataste	human
@verbst	human
@phuminkosy	human
@arloulou	human
@freesamplefeed	org
@ldh_mode	human
@NPillman	human
@RabbitArmitage	human
@DanTT5	human
@IndahRaniOslo	unknown
@ogjessica	human
@MarianneMaher3	human
@ItsMeShop	human
@RayandMikesDeli	human
@imanitalibah	human
@Diamante3Sq	human
@lingjingatlj	human
@chanchinee	human
@89LaToya	org
@ZaccAnson	human
@SuSuryhern	unknown
@Lawyer_A_Ho	human
@Laurabernardi94	human
@rabihrania	human
@sheknowsnofear	human
@malyovi	human
@lilianafoto	human
@sezzyevilmuffin	human
@jvillanopow	human
@DebbieDavidov	human
@AndreiaFlor_	human
@islingtonlloyd	human
@cbeachclub	org
@beechdalegc	human
@InstaPetrozavod	human
@roseragai	human
@AccessoryExpert	human
@HerringboneEats	org
@LovageSeattle	org
@VigorVirgoVegan	human
@empowerfitchick	human
@SunshineALFA	human
@eatburritoz	org
@textualism	human
@grynwasabi	human
@SpizeNoida	human
@mackoylouis	unknown
@MoveAUS	unknown
@tancredfarmshop	org
@zeito_0110	human
@TheCurryBible	org
@mustachio2011	human
@LT_MonaLisa	human
@SbonnerABV	human
@GBOTCANADA	human
@EireTrea	org
@kathyxunyc	human
@RONNIERON89	unknown
@Aranxitalt	human
@BarbaraBakes	org
@CozyAtoZ	human
@JayFingers	org
@diannefajardo30	human
@ConradAu	human
@SCP_London	org
@The5Kitchen	org
@AVvFTCFoDMxrqkW	human
@_Soul_Alchemist	human
@EatBeMary	human
@mamavotes	org
@MassonAssoc	org
@FitFocused_les	human
@VChizi	human
@Alpro_BE	org
@JuYogi_Blog	human
@McClureBarbecue	org
@bossymissi	unknown
@chari0782	human
@sergio_andres77	human
@22avelondon	human
@Arinags	org
@annie_nyc	human
@janinek77	human
@NWREottawa	org
@five_london	human
@MariaKacanda	human
@TomdelaParra	human
@InterHealthNI	org
@Mar_Fane	org
@j_juandy	human
@AhyenSese	human
@BlakIzBeautyful	human
@Jannalmedia	human
@Piwikids	human
@chloelovesbooze	org
@gertii_94	human
@a_sandulescu	unknown
@StylerMx	human
@__mabo	human
@fitnessgwstuff	human
@02lee05	human
@Trindad_Marley	human
@ConcSue	human
@karenschrav	human
@youpeoplereview	org
@Bete11	human
@OdaRukiRuki	human
@BelgradeVIP	human
@LucarellisCater	org
@ForkNPlate	org
@EizaFWinchester	human
@CulinaSophia	org
@dimsumanyone	human
@guson16	org
@stepupphysio	org
@mufasa37	org
@BarBouludBOS	org
@erikarasmus	human
@sophiafakhry	human
@BaderKarl	org
@LifeNtheSandpit	human
@carlosnunes11	human
@KoOlinaResort	org
@fashionmoodsba	human
@AnthonysCFPizza	human
@3DC_CAFE	human
@PhotoByLeal	human
@jessicaf0ster	human
@AyUtami05	human
@MalbonBrosBBQ	human
@cafelovemilly	human
@MsEbayingFlynn	human
@paulbehave	human
@ohanatamayo	org
@DAMONMUSSO	human
@lavinaflack7751	human
@Eaglecrazgifts	human
@MJ_melendez	human
@trinh_q	human
@heybetty55	human
@rondavid83	human
@RSCKCLOTHING	human
@mikiiying	unknown
@DenverHousewife	human
@EternallyRa	unknown
@_a422u	human
@Lynnx_n	human
@SilvanoSanges	human
@DowntownMuse	org
@myupbeetlife	human
@pierreporeotix	human
@ICCamisas	human
@hhav_social	human
@Bot_Banyuwangi	unknown
@aaa03615902	unknown
@HiltonAustin	org
@CurreyCo	org
@Jjiddy	human
@jesterxen	human
@LivCollAcademy	org
@Omeezy812	human
@AMPisthyname	org
@Jesse_Horne	org
@Rumithecat	human
@oohbarista	org
@CravingCoffeeUK	human
@ZhaoYuan3	org
@afoodk	human
@Eddie_reyes11	human
@jul4hair	human
@TweetingOn_E	human
@theknotstory	org
@tnoree1	human
@SmotheredSF	human
@GotSoulEvents	org
@BrittanyA_Xo	human
@shchen	org
@kuttinup23	human
@lukaswilliam_	human
@PhilippaLivijn	human
@inge_ilse	human
@DonGerardoPaez	human
@Buford5912	human
@Realmiss_krysss	human
@sandmanhighpowa	human
@joecimperman	human
@MTCXII	unknown
@mezsteps	unknown
@PrincipeSavoia	org
@shellkitchntips	human
@Jazz221	human
@TacoTsunami	org
@coachjeff24	org
@lovebodyandmind	human
@thebruffin	org
@bot37999964	unknown
@Diep_LeShaker	org
@female_pirate	human
@jaraymusic	org
@sonofsamhunter	human
@maryanne132005	human
@jewlibron	human
@StreetFoodSaga	org
@hanadiazara	human
@toastgurgaon	org
@ROAMIEsRTs	org
@jonybarete	human
@jcoleproject360	human
@thatgirltorie	human
@sign1001	human
@paupaumg	human
@Deondriea	human
@Giardino_Salads	org
@taipiyo0924	human
@hopscotchbake	human
@idao77	human
@XBen3000	org
@Dcali_2k12	unknown
@NESNick1	human
@al_arbison	human
@TekiTejam	human
@Les_Duponts	org
@aPrettyBully	human
@Sandra_Downey	human
@ayachelly	human
@TheProteinWorks	org
@McdreamyYyYy	unknown
@RvrtnHousewives	org
@SuPeRBiBLioS	human
@ikristy91	human
@risr	human
@NatalieBTSC	human
@TeamSBN	org
@animaginatic	human
@T_Bookalicious	unknown
@hendralie	human
@michelletawas	human
@VKO_airport	human
@_iAmRashad	human
@PlainTasty	org
@DavidLewetag	human
@BodegaKL	unknown
@VegasWayne	human
@monde_vin	human
@alawatik	human
@pablozelaya0613	human
@gezelligdining	org
@feastonthemove	org
@pOmares_mark	human
@NurulLaluna	human
@diana_han	human
@yizhen1104	org
@wigRahman	org
@FirstAndSouth	org
@Jookette	human
@AT24sportsPT	human
@ESgoingout	org
@dp_cahya	human
@xciteplus	human
@abaqro	human
@afzaal	human
@ChristaH14	human
@bergermuzik	human
@GyroonPita	org
@somethingnewnow	human
@TommysIAG	org
@kimchisomething	org
@hamdool	org
@streetfoodshow	human
@traininthearena	unknown
@Myke_restaurant	human
@sfairuza	human
@thehubmk	org
@wiewilliam	human
@ImMavisB	human
@fatima_kaj	human
@judy_lb	human
@TuneTownTroll	human
@Londonfarmers	org
@Hannapat40	unknown
@dinocah	human
@JMac1715	human
@statsosphere	human
@erdaldogandoors	human
@IndikaUSA	org
@ChlobertG	human
@ServePingPong	org
@IltuoHomeStager	human
@alina21luglio	human
@MarieMCMx	human
@imarshut	unknown
@billofflair	org
@fmgunited	human
@seapointfarms	org
@yantinawawi	human
@MrsFrantic	unknown
@DewickEka	human
@raduenachephoto	human
@Ayushitarum	human
@melisscharlotte	human
@IAMSILLIEWILLIE	human
@chefgeoffs	human
@wimps_0113	human
@CosgroveSw	human
@inspyral	org
@AP_Fuchs	org
@vandaevents	human
@brrzaar	org
@mr_angonzalez	human
@marthasofiaa	human
@N21Ri	human
@ferhatbehzat	human
@onna_no_urawaza	unknown
@FATBOIRIDINHIGH	human
@PannaECacaoBlog	human
@dana_annez	human
@StarkCountyOH	human
@mitoyskee	human
@Sawyeratx	org
@CatherineCiceri	human
@rienaz02	human
@OdetteJimenez	human
@beloved_atmo	human
@Karien_d	human
@kouturekuisine	human
@Kim_areung	human
@Steph23059	human
@dcammy1977	human
@jonesbabie	org
@ameninabonitaa	human
@NikSpeller	human
@Asia_Lam	human
@Ozzilady	human
@eatpretzelman	org
@andreakmecza	human
@HastingsVoice	org
@BierMarktQueens	human
@SarabethTribeca	org
@EDITIONHotels	org
@diandrra	human
@ProphitIzaya	human
@rustanthony	human
@WKBMiami	org
@Sarah_M_Linda	human
@RomaninaExpress	human
@SandosLosCabos	org
@orangetablebar	unknown
@ALLINPR	org
@chenenenen	human
@fiddlesticks83	human
@ElizaFailure	human
@barelovebeauty	human
@GoodeandWright1	org
@PhotoUpApp	human
@SenorKobayashi	human
@purplegyrl31	human
@vggiannakis	human
@RachelETranter	human
@shewolfffffff	human
@QTJanbrown29	org
@SBSussex	org
@NoshGourmet	human
@LamyBoo	human
@jellology	human
@AlternativeFam	human
@MichelleCHope	human
@MolosNJ	org
@alexsiregar	human
@Invest_Donate	unknown
@bethyharrisx	human
@laurelas	human
@munta623	human
@RAFAHE	human
@DblTreePhxTempe	org
@TamrahMarie	human
@yangsingmcr	org
@sarmadalikhan	human
@MuyEnano	human
@Rave353	human
@mtnhighapp	org
@FeliciaSanity	human
@bobstroup	human
@15onthecorner	org
@mosaicdistrict	org
@itsmeEdward	human
@LightUpAllNight	human
@constantspring	org
@lisacavaleri	human
@Cat_Wicks	human
@jrumali	human
@SimpleFood365	org
@noreu2003	unknown
@Jessfrances	human
@GlasgowGros	org
@yzhifa	human
@chrisota	human
@OTSURINA	human
@hkmun94	org
@Daneli	human
@jbcheer21	human
@HeyRatty	human
@stijnverlinden	human
@JohnsonvilleCA	human
@dadekian	org
@margie_pocket	human
@girlinamsterdam	org
@sweethings4life	org
@GladysHsu	human
@mayjordan23	human
@LarryCarey67	org
@donhornsby	human
@cafe_ceres	org
@pinkstar2418	human
@Tom__Coleman	human
@SundayTreamprom	human
@herry_Jamil	unknown
@CHOMPBKKCAFE	org
@Chavez77AJ	human
@BamboozlesAW	org
@brandonchan76	human
@heidy_amin	human
@SalaViewHotel	human
@_AndTylerToo	human
@Marimel_75	unknown
@Bobman64	human
@Queen_Kween	human
@GlamityJane1	human
@ComptoirLibanai	org
@CROOKsoHARDBODY	org
@itsmekandi	human
@elynn_jay	human
@lovewithbrunch	human
@Cinqueterreh	human
@kalumjohnson	human
@FridayBlgrO	human
@diipsiii	org
@rinaendo	human
@CynGoogle	human
@JoyofVegan	human
@assiral93	human
@Hazmyzulkifly	human
@lebontemps21	human
@PORTAXE	human
@cikpetir	human
@clarizsales	human
@rinnyhafid	human
@steweeggs	org
@EmmaJMYardley	unknown
@SetSipServe	unknown
@Libby_J_Kennedy	human
@ZX_Photography	human
@Secoh2000	human
@SusiesBreakfast	org
@asobinikitao	human
@chinamandan_	human
@jennanicholls	human
@ilianna82	human
@EmirHotels	human
@like_gourmet15	org
@noetorres88	unknown
@Miscellanista	human
@Doughnutdoll	human
@EmilyAnnTowner	human
@TomasKnut	human
@trevnyc	unknown
@_FredFerry	human
@carolyndavis	human
@peppersoriano	human
@roopssy	human
@mattchoo16	human
@iamSGB	org
@YTDistilling	org
@DLADHIBI	human
@TykischaJacobs	unknown
@CONESTILOMYRIAM	org
@theingredientsp	org
@QSBoilerhouse	org
@MrNikky	human
@WaveHouseSD	org
@DellT2	human
@CatMason	human
@Trudeestweets	human
@Gastronomisti	human
@LoveandLim	human
@DishcrawlSEA	org
@california_bee	human
@paultart	human
@3p4sfmarket6	human
@fefezaza	unknown
@manfromwales12	human
@visitpinas	human
@LukmanOthman	org
@nidyaglory	unknown
@cerisiersakura	human
@MacKidNatomas	org
@kareemgouda	human
@Bottlebareast	org
@Kathleencarla	human
@MusselBar	org
@EatMyCame	human
@gamesyouloved	org
@cookstr	org
@BessBlanco	human
@Ratchayoot	human
@CharliineMoreau	org
@queenkv	org
@Pizzaputney	org
@francis_africa	human
@ivanastrawberri	human
@mrmenco	human
@yukiNa316	human
@foiegras44	human
@DURANGIE	human
@Drink_boss	human
@yhMathew	org
@mayicortez	org
@Chris31___Tupas	human
@IciarJCarrasco	human
@eckacabrera	human
@LaurieAEakes	human
@Thaliia_mottola	human
@StatenEats	org
@TwoDrunkMonkies	human
@aycadizdaroglu	human
@JacquesCafeLV	org
@BethMjimenez	human
@Tomimito	human
@yamatocurry	human
@veggielivinmom	human
@raidahamrouni	unknown
@RoseIsla	human
@jeSUISchrisanne	human
@krispy_mnmz	human
@zee_far	human
@tanakanji	human
@asukasukisu	org
@PIMSILENCER	human
@tokinoha_hotoki	org
@markjoelcelera	human
@nory983	human
@Mamzie2	human
@CiaraLooove	human
@MaevaZbn	human
@KatieCernak	org
@bott_co	org
@iamMrAGCastro	human
@LynnNisha	human
@1829peach	human
@msflwr	org
@rafi081	human
@rujal29	org
@usa_mayu07	human
@christinewayne	human
@LynSire	human
@superjannex	unknown
@Chillabongs	org
@sammyswellbeing	human
@FarahSyaqireen	human
@InFamouS_eSport	human
@babylopez95	human
@cdbaring	human
@dina_tropika	human
@USFoods	org
@SuusjeQ	human
@StellaBarraSM	org
@Chef_AA	org
@Jessonick	unknown
@Ziggy1956	human
@LoweAlicia1	human
@NeuvooBak	org
@SherSista	human
@tweetniGAIL	human
@recetaspremium	human
@zoltanszabo	org
@sweeetsouthernn	unknown
@shan___ny	human
@KathiaTiburcio	human
@Reserve_LA	org
@ocean_wise	org
@DavidRu83	human
@HEALSUK2	unknown
@HeyItsLeila	org
@adamcarypt	human
@bot22327076	unknown
@DewDropEnt	human
@MissSteff89	org
@HindiRecipe	human
@RadioPrimeTalk	org
@Outofbox2011	unknown
@PeterWHaagensen	human
@themuur	org
@theboss1500	org
@MadysinHatter	human
@bayeraUS	human
@itshonestlygood	org
@bbla90	human
@RoxFoxx	human
@miiraK	org
@MEAMayflowerJKT	org
@StephenPetro411	org
@TheBreakfastNk	human
@FrenzyCondoma	human
@WeAteThat	org
@Madeleinee_	org
@PursesandI	human
@EntrecoteMelb	org
@Natsumi082777	human
@shionmiyabi	human
@BrigiiteV	human
@RunEatRelax	org
@thebluelemonin1	unknown
@kOikOi00	unknown
@ttzimmermann	human
@lucascardullo	human
@DesmondMokky	human
@CazCooksToo	human
@liza_tf	human
@papabasto	human
@BBC66	human
@SprucenewsBlog	human
@Jo51jjp	org
@caralipio_lindz	human
@Camaradas115	org
@Purpl3Lover23	human
@swamplaybarge	unknown
@TomNuara	human
@Trans4mLife	org
@CheeseboardMag	human
@alloycious	org
@MissJodieJones	human
@peterneal1	human
@beSocialBham	org
@BoyGiuly	org
@TaylerFogggal	human
@EgleStandtaite	human
@keyshan23	human
@MissWDavidson	unknown
@monicazyoung	human
@Cindy__Gomez	human
@Fallamocaer	human
@TheBrixtonDC	human
@fitsagee	human
@tourism_europe	org
@TheZeitweets	org
@paddytan	human
@PristineGalaxy	human
@christeenwlj	human
@DairyMax	human
@anildwarapudi	human
@bellayalta	human
@EventsonCentral	human
@JoelHarrisonAU	human
@harepusverden	org
@GabrielRSRocha	human
@JigsAbad	human
@TheBishopAE	unknown
@nathwithnall	human
@AcestayGChick	human
@Shakirarodrigo	human
@JeSalvador	human
@AngoraFerret	human
@ette87	human
@PriszcillaEPint	human
@kennethrtan	human
@hatim_qaizar	human
@PiliRamirezOk	org
@CrownePlazaAdel	org
@fitmooney	human
@Por_panawat	human
@ugotGod	human
@bot92151675	unknown
@ThreeSmarties	human
@LRX350	org
@TheLeRoiLeonRUS	unknown
@Fannypincanon	human
@BOT18365239	unknown
@LifemadeSweeter	org
@TryCaviarEB	org
@5FashionUk	human
@ekolka	human
@DTDunblaneHydro	human
@jacquestorres	org
@samvalladar3s	human
@OrlandEspluga	org
@Lishientan	unknown
@BoBClubsLHR	human
@madokakumagai	human
@Kikynelwan	unknown
@Motiv8YourLife	human
@AJ1996_	human
@OinKChaN	unknown
@jmbpatterson	org
@chikiriya1854	human
@DelaneysRant	human
@acedapogi	human
@Shanafoods	org
@kathleenpapp	human
@25michelle25	human
@LauraPye	human
@Citywealth	org
@wellmeing	human
@soni_palma	human
@krisa_clothing	org
@iSonzaBoy	human
@diner_deluxe	org
@JuJusCafe1	org
@webnovias	human
@zackbobot	human
@Jamms_LV	org
@IAmRudeElf	human
@snowillard	human
@BeatricFranzi	human
@LizEvansTX21	unknown
@houseofjuicebk	org
@Sebastian_MMA	human
@SpainThymTravel	org
@PolkaTruck	org
@IAM_JTK	org
@airdiogo	human
@Cre8tivat	human
@UltiGordon17	human
@WineCentersNJ	human
@AnamiBlog	human
@YselaCraig	human
@itssonisse	unknown
@TangerineHearts	human
@nuriqa67	human
@booksNyarn	human
@AdamsHomesTweet	human
@Heartless_Hark	human
@ekebom	human
@smccudubai	org
@GuuIzakaya	org
@CraveMate	org
@beeball33	human
@miwanakabayashi	human
@TTNevada	unknown
@Peck_Milano	org
@AranjuezSocial	human
@ThePuddingStop	human
@iaCneR	human
@Erndiddy_RN	org
@fgshop	org
@trnunes	human
@setapartimmy	human
@FoodieArmyWife	unknown
@RTIreland	unknown
@barboncinopizza	org
@JayRootz	human
@HK_Fans_AC	human
@briberybakery	org
@_TijaR_	unknown
@jdmehaffey	human
@dabblemag	org
@2Brookelynn2	human
@murray_pura	human
@PreetsD	human
@shopgirl1001	human
@kelsbels59	human
@Jokungza	human
@RedCarpetRoxy	human
@StephenALee	human
@MikiChiappinell	unknown
@LBLTHP	org
@EnzasBargains	human
@jennawessinger	org
@myglowforever	human
@MFAH	human
@Arctickfox	human
@choclattjared	human
@smoothie_luv	unknown
@andradaprd	human
@Flavour105	org
@ONeillsKingston	org
@_Ary_	unknown
@StacyLynnLondon	human
@thepickledfork	org
@DStepel	org
@inner_moppet	human
@jraymac31	human
@carlsl	human
@WorriedNoodle	human
@eugenebelbis	human
@poly_89	human
@Fancienanc	human
@SwissNews2015	unknown
@insanebabydeer	human
@Beekeeperstorie	human
@jessiecarvalho	human
@RachelShimArce	unknown
@Johanna_Styles_	human
@IBelizeit	human
@asslikegrass	human
@TheOldShipE8	human
@ChristepherWee	org
@TheRawRockChick	unknown
@elPauloloco	human
@rema_bukit	human
@TahoeEats	org
@charleygrady	human
@LucindaKatherin	human
@damien_chengxi	human
@MadeWithLoveJB	human
@hrbal15	org
@maryism_	human
@MrTonitas	human
@Nimmiijo	org
@lyddish	human
@KCPrincess	org
@OrlaConway	human
@wayan_prathama	human
@Celinda_Kyles	unknown
@Thesweetswirl	human
@BossXposure	human
@Gamer_Snack	human
@padialover	human
@tutus_eat	org
@joecanez	human
@TheonlywayisBen	human
@CityCenterDC	org
@daversa_g	human
@thealexoneil	human
@AgodaMV	unknown
@jefte1979	human
@SampsonHall	human
@livingfoodalf	human
@stuli1989	org
@LIVELIFEHUMBLE	human
@FreckledWolf	unknown
@PaulCrisBert	human
@twilhelmsen	human
@KimAdamsMorgan	human
@HangoutBeirut	org
@yunieminami	org
@academictroll	human
@Mirabdulrahman	human
@Haii_Ily	human
@sutcolhour	org
@realejenniferb	human
@lostouroboros	human
@hayreelville	unknown
@nutri_corretta	human
@LaCocinaDeVero	human
@ClodaghsKitchen	org
@natfitfoodie	org
@Mensweardesigne	human
@ForwardLadies	org
@sjobergjohanna	org
@FilipaMoedas	unknown
@SerpentineBK	org
@113_cake	human
@musiceoso	unknown
@anniescranton	human
@Patrick_D_Ng	human
@_Flameless	human
@twicksnz	human
@Shalizaaziz	human
@bmcgrew	human
@yyaannaaa	unknown
@650Cafe	org
@snakedoctor30	human
@FriendsOfJodi	human
@HarrisonsPD	org
@Aiamhasvirus	human
@iamlisaaa	unknown
@gemmabutton	human
@pololucasenr	unknown
@Tweetinggoddess	human
@JulietteKitsch	human
@Keralino9	human
@delphisantiques	human
@MiszB	human
@modanastrychu	human
@susietroub	unknown
@missnathaliaa	unknown
@JeickAvelar	human
@GiuliaPossanzin	unknown
@WildNdAmazin	human
@beautifullybway	unknown
@actorsarahjean	human
@CharmingChantel	org
@LuJaynMar	human
@cts1hypeman	human
@Mandy10058	human
@krisyoung75	human
@friedafrei77	human
@AstorBakeShop	org
@BoonyBoonBoon	human
@mambosprouts	human
@Mindyscatering	org
@stylingediting	human
@kamisimiao	org
@alialassiri	human
@chrisnewby_83	human
@sunnylicious	human
@Fabicolors	human
@Krevette	human
@Label1401	org
@KmenBA	human
@TeejGrant	human
@k_van_liao	unknown
@CIAwesome	human
@Itsfatboyradio	human
@MeredithStreet	human
@Sam_u_Well	human
@extremejohn	human
@iamcarlosantos	human
@PaulaLorenzoni5	human
@sHiReLLiE	org
@marissaAmendoza	human
@freshtodeath	human
@ReyEslaTeo	human
@tiensaw	human
@SpanD_Enuffsaid	human
@eien_pop	unknown
@WinesofSerbia	human
@DayBsofly	human
@MsIvyJade	human
@HenryDogTweets	unknown
@WoodysFoodTruck	org
@Remus_Isis	human
@GarretBonnick3	human
@1gajasemnick	human
@OldTownSocial	org
@DeterminedAdams	human
@princessyrh	human
@blackmerz101	human
@SkyfireFX	human
@MariaTheAuthor	human
@unnowwn	human
@shawnsalehi	human
@doublemacbex	org
@zumbaclairea	human
@ohMYkennie	human
@HerbsnSpices1	human
@UniteYoga	human
@DubStarAwesome	unknown
@JohnnyJ978	human
@CynDavCzarnecki	human
@Unicorn_HI	unknown
@JamesJshu	human
@ParkHyattSaigon	org
@shellandjeff	human
@dantifaramita	human
@aapantazi	human
@Iamtomchris	human
@PaulaRoumanous	human
@ayakocy	human
@KeriEvelyn	human
@Matt5verse6	human
@steakrua	human
@iSaloni2015	unknown
@nyanyanyaxxx	human
@bklyngyal09	human
@MakeItAllWork	human
@Lazycx	unknown
@theoldtriangle	human
@markusfromfi	human
@Healthy_Eating_	human
@HendritaHoran	human
@maykadivia	human
@annabmac4	human
@geoffmobile	org
@Josecio	human
@Evilspout	human
@JadeAsianGreens	human
@MeridianFM	human
@megsmealplan	human
@ravenandboar	org
@bunnykissd	human
@Maisci	human
@EvertonAlecrim	human
@Food_crazyTO	org
@CPistoneCN	human
@CrepesBonaparte	org
@alexipappa	human
@plajung33	human
@RealRated_R	human
@MusselWoman	human
@starlightoniros	unknown
@JuvalTongco	unknown
@WodkeHawkinson	org
@BrownsSheffield	org
@Missy_B83	human
@FerryLoeve	human
@urr_beautifulll	org
@nikkibankert34	human
@DinoTeppara	human
@Maria_Michael	human
@MarkSBaigent	human
@emily_wellness	unknown
@katen21	human
@HarlemsYOTM	org
@AngieATFblog	human
@TheLaundry1997	org
@EmHerbert_	human
@THE305ISH	human
@Renee922M	human
@ShakkhaEsprit	human
@Ainakamura77	human
@FarmerOwnedFood	org
@strongsam042	unknown
@Fehmz	human
@FroBunni	human
@FrugalFamTree	org
@Twittepher	human
@Maryeeellen	human
@azimask	human
@EatRightMama	human
@NYRnick	human
@_williamb1	human
@A_N_Tiller90	human
@cherokeeman09	human
@OPIUMRest	org
@Gaby_0rtiz	human
@Lennysdeli1	human
@RadlettDotBiz	org
@Th3Funk	human
@AlessandraL77	human
@noihotels	human
@PowellBettyJ	org
@ahmadriaz994	human
@LiGillis	org
@stephenmasi	human
@TwinkleSyera	human
@ElSarache	human
@MYMY_YOU	human
@AmandaStas	human
@linkedmeup	human
@WrapandSlimYou	unknown
@yukarhythmic	human
@ChristianPFerna	human
@plantCT	org
@LolalololoLola	unknown
@janghyemin	unknown
@SamsTavern	org
@romeoyoscar	human
@Noun81	org
@LaKisha_Kenney	human
@chithrapunni	human
@LvinW	human
@RattleWest	org
@GabrielSMurphy	human
@jraabs	human
@720Naachan	human
@anktangle	human
@MKKstudio	human
@amathysssoul	human
@lucybrownhill	human
@lil_ms_marie	human
@prairiedogs	human
@Se240ng5	unknown
@solpaks	human
@applecrest21	human
@cookwithmarica	human
@LIRIUSKA	human
@YordyTube	org
@JeniferMoka	human
@coldplay1222	human
@NateGiro	human
@EcoOutfittersOL	org
@MuzzaAndrea	human
@standrewbrewhse	human
@germankiwi	human
@lionaqr	human
@OfficialSlowD	human
@snataliemora	human
@mintlolly	org
@adrielleann	unknown
@Manorys	org
@errysyaffri	unknown
@Fabiolabarinas	human
@VintagePickles	unknown
@LittleIvyMay	unknown
@Earthdog56	human
@omoshiro_LgFNd	unknown
@veggiesage	human
@sebastiaenz	human
@RobertFoster772	human
@BobbiesBlogs	human
@kezkez_211	org
@Nick_Chuu	human
@serennsnmz	unknown
@psymic	human
@JaysYi	human
@yllanal0u	human
@Phillip_Oakley	human
@uhqayshuhdy	unknown
@cikHaroro	human
@SueParmet	human
@wlstcom	org
@RedPeppersGrill	org
@farizoverdriven	human
@domzchubs	human
@mgph0t0graphy	org
@GWMarket	org
@RestPieterman	human
@PoetessBella	human
@patsantos03	human
@boopshis	human
@GardenofEdenMkt	org
@TenStrawberrySt	human
@SuperNeena1	human
@SHARON_A_PEARCE	human
@seika_nakajima	unknown
@laradunston	org
@Dance4life80	unknown
@drkracker	org
@DavidIsraelSy	human
@DeeKee_G	org
@AmyMPolk	unknown
@The_Garan	human
@vitalityclinic	org
@MobyJara	org
@toastgal	org
@RibWich_NUE	human
@fingerboardfan1	human
@FSFlorence	org
@sparky_town	human
@JustFruitBars	org
@LaScala_Risto	org
@sweetcakesbakes	org
@Embarque	human
@TheCitrusLife	unknown
@toneeanney	unknown
@Micheal87Mr	human
@vanessajhoy	human
@DOYSQ	org
@diginn	org
@princesskarly11	org
@NoviWang	human
@laura9890	human
@danmancio84	human
@umakemehungry	human
@ZaatarWzeitKSA	org
@H3bK11	human
@ariesrockstar	human
@ElinyZafran	human
@YisneyLagrange	human
@shino_dela	unknown
@ChowChic	human
@BeingMeCsy85	human
@UllaUnten	human
@jaypaypresents	human
@FruityRooty1	human
@koFitness90	human
@contentmentnow	human
@CocinadeVilla	human
@JCAutious	human
@ihotelschool	org
@djfocus007	unknown
@iSpeak_Stowe	human
@Kaotik_Nonsense	human
@LiiFelii	human
@arieiVanairaM	human
@WarbsNewburnBH	org
@Bertrand_Duh	human
@toastdelhi	org
@funachukentaro	unknown
@RedRoses4	human
@BFan81	human
@SingerJan1111	human
@SporkOrlando	human
@HOODFILMS	human
@foodilic	org
@peaceloveandowl	unknown
@TommyWee	org
@sheilaflaherty2	org
@fishpool86	human
@1Tcakes808	human
@ONTHELAM_NYC	org
@mickyates	human
@88_Health	org
@thefluffathens	org
@seharish	org
@aeigliane	unknown
@BarryhuiHui	human
@enigmaticKR	human
@VancouverAnd	human
@Carl_T84	human
@Tai_Thomas	human
@UnSpoken_Me	human
@aniebonanie	human
@NoemiSifBono	human
@FiorellaEats	human
@Koko_farmasi	unknown
@lauralang90	human
@MariaJoyAbdul	human
@TipplingHall	unknown
@Ent_Calgary	org
@AMEDEONYC	human
@stedubes	human
@VickieSHardy	human
@pizzarium_us	human
@xennydesu	human
@JorgdlCruz	human
@RevolutionNOLA	org
@AEThatsMe	human
@EVTavernBowl	org
@Crispbond009	human
@Prita_912304	human
@PandicornJason	human
@savormania	human
@RosieMira	human
@fitt46	human
@Roochster	human
@CavatinaLA	org
@allaboutthekale	org
@TownsendHotel	org
@muis_alamin	human
@BellevuePhilly	org
@Khamui	human
@TheFoodieTeach	human
@yottan827	human
@puri812	human
@Fruits_Veggies	org
@resumakeovers	human
@ninaismailsabri	human
@mywellnessland	human
@That_dude_Xito	org
@mrsbluedsp	human
@hudaMF2	human
@stacyyeng	human
@CoachTalkRadio	human
@jankarlroelhsen	human
@MeganVegaTV	human
@Bunnbite	org
@iamT_TWYNE	human
@edrasem13	org
@MyLovAble1	human
@SoStyLIN	human
@Oracledalphin	human
@RobertAdamson90	human
@karen_dawkins	human
@InstaKrskCenter	human
@TheWhiteCompany	org
@MurphysLawTO	org
@platosdepizarra	org
@SmlBizNetGroup	unknown
@AdvantagCoupons	human
@cliff_89	human
@LunchClub1238	human
@Azanie_M	human
@chibialexa	org
@WohlSteven	human
@FiveMenandALady	human
@isan_rivkin	human
@ElicitC	human
@lpnewspapergirl	human
@LaBocaHouse	org
@LisaN46	human
@xJoelle_xD	human
@tuerkiscastle	human
@RachelOchocolat	human
@LabellaQB	human
@McDonalds_Utah	org
@HappyVelice	human
@cedie_boy	human
@sweet_n_spicy_	org
@LilMissBritt_	human
@For_Cooks	org
@geminieast7745	human
@anime_Mmubs	unknown
@kitdes	unknown
@RosaRBlackburn	human
@SSponheimer	human
@GetOffYourAsana	org
@monalanomnom	human
@munchesters	unknown
@TAGA29	human
@Bigio27	human
@jempg	human
@YunnyYong	human
@BurcuBaki	human
@keepitsimple48	human
@LoveCamberley	human
@SaltYardLdn	org
@KylieSabraArt	human
@PandaPantry	human
@FollowThaikhun	org
@iam_tumz	human
@Ning4u	human
@jennieyuen	org
@tuesmatoutmonde	human
@cookthemhealthy	org
@Tero_Montero	human
@kahawa_cafe	human
@mikkelbaekgaard	human
@hamspamtymaam	human
@georgeanag	human
@Smoothie_App	human
@andrealves655	human
@AMill1994	human
@LevantineHill	human
@MurphysDeliATX	org
@NickiGirlStar	org
@kazal1401	human
@orcunkurum	org
@AminAznizan	human
@shananonigans	human
@my1styears	human
@weisterlouise	human
@a8410252012	human
@EmmaPhoon	human
@gunturyu	human
@Lillyg21	human
@trizziaearl	human
@radiojustin23	human
@_siscamariani79	human
@chefjoejohnson	human
@DVanLierEsq	human
@ALEXANDRA_BARBA	human
@HudsonDelray	human
@ahtihsin	human
@0725anna	human
@egberaranguren	org
@onlightspeed	human
@DadsPeppers	org
@superchris46	human
@DNurcan	human
@Karenthe1adams	human
@RiinaReinikaine	human
@CaravaneDoree	org
@minimalistbaker	human
@ShariAlligood	human
@Pure_Pita	org
@Suedtirol_com	unknown
@CMehltretter	human
@JerkyGoldMarind	org
@PinchOfGinger13	human
@jack27004142	human
@maru_plaza	org
@XOKatReid	org
@edmarnipal011	unknown
@brodimiles	human
@JuliettaLuna24	human
@dillingersbk	org
@KENSIEaphrodite	unknown
@rahfoundation	org
@Haleymariehales	human
@FullertonChambe	unknown
@DrePigglesworth	unknown
@jessaskinmarin	unknown
@carolinardc	human
@CHORDDEEN	human
@shiphrahsignora	human
@MemoriesofIndia	human
@CFakaruddin	human
@Passtherouge	org
@QueensKickshaw	org
@slicknickricky	human
@BlueDiamond	org
@MargotCafe	org
@darrin_reid	human
@sdiego1717	human
@mistybzamora	human
@irevx	human
@rohit_dasgupta	human
@frompdxwithlove	human
@AMWATERS	org
@HopsScotchBeans	human
@TEculinary	unknown
@eunike_jacklyn	human
@salumitriglia	human
@tysiagotuje	human
@markdiwan	human
@CitygateCentre	human
@FrugalGenius411	unknown
@PaulaWordsmith1	human
@jewels_nails	human
@YenyenLiau	unknown
@ninorestaurant	org
@methhamfetabean	human
@AQufat	unknown
@DisneyMaingate	org
@adoresh121	human
@davidhenkes	human
@richardbarr2424	human
@SPIKEDEEJAY	human
@Yenkazu	human
@Pumi_Poom	unknown
@aliterson	org
@eyecandyphotog	org
@MsHighSpirit810	human
@tenty	org
@HIENiagaraFalls	org
@Nommery	org
@StewieB	org
@Virginia_Roj	human
@humanbrainfood	org
@krisztian_berki	human
@Sparklyroses	human
@NewTweetTopics	unknown
@MissVie2	human
@JessEst1990	human
@dwightmoss2015	human
@singletonscene	human
@museumbar	org
@wholifebalance	human
@PapasRawBar	org
@LolitasLumpia	org
@maja_zor	human
@brasseriebread	org
@SmileyfaceLaura	unknown
@LoveandPrimal	org
@ayuanggrainiptr	unknown
@PhilosophyMinor	human
@NonaAyiek	human
@RegentSingapore	org
@alfemminile_com	human
@TasteWestSussex	org
@janelvisoner	human
@StephanieMcGloh	org
@LEMcClelland	human
@TammePha	org
@rinachaaan_05	human
@ruggedghost	human
@AleFrisk	human
@MariongwalshG	unknown
@MadLulablog	unknown
@TheDevil1899	unknown
@applebaula	unknown
@ralphrcalvo	human
@S_Vaibhavie	unknown
@MO_ybe	human
@gennydago	human
@fifiliciousify	human
@SoftyGrillo	human
@TheClarence	human
@Gabr_Salas	org
@CorinthiaHotels	human
@Dee_Uee	org
@Vena_dartO	human
@DepressionMgmt	org
@MockingbirdHOU	org
@BITW_SYFH	human
@CoffeeVanilla	human
@ayed441113	human
@indowncitypvd	human
@BionicPrince370	human
@mooknoi2540	human
@hamtothespam	human
@wh_lymington	org
@CoffeeRetweet	org
@sfoti28	human
@WeDOScotland	org
@marcel_sevigny	unknown
@clebagelco	human
@FeedMePrimal	org
@LeslieKLovesDC	human
@BonfireLana	org
@JaceEatsDonuts	human
@elmo_ballou	human
@PowerofMeals	unknown
@ollybongo	human
@fplusb	human
@jnydawson	human
@whitneyjweiss	human
@nunilu	human
@FahDaBarber1	human
@onkappysplate	human
@joyceorena	human
@RebeMontoyaBeko	human
@saekookuya	human
@zifafalicious	human
@JaniceMarit	human
@princessvivien	org
@Eatsalsa	org
@RonnieA16	human
@shopsatlegacy	org
@ainsara168	human
@yuuuuri07_ig	unknown
@BEAutyMeetsCoco	unknown
@ginaj23	human
@LoicBisquit	unknown
@nataliebondx	human
@AAAYAcama	human
@valeria_fiore	human
@ms_hanie	human
@FatFoodCrazy	org
@shaluna	human
@cmelakigor	human
@AnusmritiSarkar	human
@MariahHasamdin	human
@DashaLibin	human
@YourMildura	org
@rtumasonyte	human
@AsuliaFoods	org
@BostonPhilly	org
@iblogfood	human
@BegoHudgens	unknown
@cikmasz_	human
@fitlifeofsandra	human
@chefgeddes	human
@ishtutee	org
@estreitta	org
@anndunawayteh	human
@DeBenSter	human
@Juliekinzzz	human
@LupeGomez1_	human
@vodKAbrandyWine	org
@rameshmenaka	human
@misterpretender	org
@mukai0811	human
@MyrticeT1	human
@trendsnutrition	human
@donnazflores	human
@LGW08	org
@SalvoEmilio	org
@Stern_Z	human
@Konnigans	org
@FUEL10K	org
@pornarazzi	org
@Conservatoriumh	org
@luqesya	human
@andrea_kirsch	human
@TwinLeaf_Store	human
@fba7	human
@KBEARSMUSIK	human
@Michelle_kawaii	human
@fakhrudinrest	human
@Chickenowme	org
@ElectedLadi	human
@HollyIndoFan_	human
@andytightpants	human
@KatieHayKnight	human
@EatCraftSow	human
@reyzamarx	human
@cafeREDdragon	human
@Kunstreiz	human
@cecia25_2	human
@Kemyst4Lyfe	human
@neelsmcgee	human
@TreaDavenport	human
@PiiPii100	human
@YoukaaaSays	org
@JustAmyConway	unknown
@djpoojab	org
@zeAnya92	human
@JanisThiessen	human
@EllieAbel	org
@saifulbuble93	human
@Just_Hong	unknown
@re_finance4u	org
@gohvernice	unknown
@TurmericSaffron	org
@sy_sez	human
@MursideTJ	human
@ella_1977	human
@DIP_Bullring	unknown
@i_isaFha	unknown
@RandellisRED	human
@UniqueKandy1	human
@Nicola_Piano	human
@Ya__Bitch	human
@mansillajaime	human
@janchsport	human
@YeeDarosa	human
@Castellis255	org
@x_decemberlove	unknown
@GiadaBenassi	human
@med_blick	human
@KittyStoner	human
@gorgermz	human
@pestanaca	unknown
@BeaBaptistaa	unknown
@NightOwl_NYC	org
@piroccha	human
@pureformulas	org
@ThomasGuinee	human
@lelo_acosta	human
@Lauri_OrozcoRod	human
@FareezaNazim	human
@TicerAishah	org
@Hillbillxo	human
@CodeAndCommand	human
@mlyakira2	unknown
@Outcastotter	human
@sugar_spicexo	unknown
@e_pah	human
@shonshaE	unknown
@ilovemacoh	human
@wndalynn	unknown
@TeamHMB	human
@YosefCrazy	org
@mollie_stones	org
@NightOwl_DC	org
@bigdataoz	org
@DusitThaniDubai	org
@haxdlavyceroz	unknown
@denlovesyouu	human
@vargasmi	human
@whitney_justine	human
@pdub395	human
@djjustcrazy	human
@SLGridiron	human
@honeyhong	human
@healthy_heidi	human
@inrichmint	human
@O2sTapHouse	org
@masbashice	org
@TROYceratops	unknown
@eveintheQC	unknown
@reichdeguzman	human
@PinnacleMiami	org
@jatifallat	human
@TheChiaCompany	org
@deaniew	human
@PetterMikhael	unknown
@ToyCh3st	human
@alwaysophie	org
@euclidg	human
@mayang_joanne	human
@tRexzor	human
@NeuvooHosCA	unknown
@carlo_spinelli	human
@KarenCovey	human
@lieeeta_s2	unknown
@snsdjessi418	human
@YESLIAM	human
@YOHfg	human
@dunesverdun	org
@cosocomo	human
@deliciousliving	human
@maru_domo	human
@soniahunt	human
@MauNjer	human
@michaelaloremia	human
@TaylorMadeVegas	human
@eatnmesscakes	org
@AiliaReal	human
@elvirapongawa	human
@JacquiMiholos	human
@BreweryTheBeast	org
@MarlenSchenker	human
@PercyFounders	org
@toxiccity	org
@maruya0808	human
@brilliantmello	human
@shellyhiddleson	human
@ElyLondoner	human
@epicfuentebella	human
@AmySowder	org
@fancyfly83	human
@ENZOPOLLIO	human
@pescatarian	org
@sampuzzo	org
@flowerrrkids	unknown
@ginosaylon	unknown
@PFAviles	human
@godinezlyn	human
@cocaros	human
@wishtheworld	human
@HapaNom	org
@SSY_JP	human
@linhheoooo	human
@WritingOnACloud	org
@ArzoomanIrani	human
@xxoGossipGirlxo	human
@DonSebaztian	human
@ultratapww	human
@roomsandmeals	human
@naseemstowell	human
@krazekatlady	human
@gyp5ielady	human
@GDJasL	human
@hasifthejugg	human
@zdcoaching	human
@hlkeene862	unknown
@Frumleys	org
@MazaganResort	org
@Doctorfoodlove	org
@SarahAlpha_	human
@enengeyi	human
@BeerRunVA	org
@ansha_	human
@MissLPeeters	human
@2befab	human
@juandelmuerte	human
@happyg0lucky7	human
@nuccissi	org
@BusyCookMomma	human
@blanca_mar2004	human
@Moe_the_Monster	org
@aiiswpoch	human
@Carib_Gourmet	unknown
@whowantsdinner	human
@CamilleDg	human
@janeschwan	human
@sherlymotz	human
@dmarie824	human
@kylejnorton	human
@BenSNewton	human
@WooleryKitchen	org
@VictoriaEHill	human
@bon_manhkong	org
@RedMagDaily	human
@suzycatindig	human
@MenuSpring	org
@mvperera	human
@irvankeritings	unknown
@PieceOCakeDJ	human
@ChakaDmusPlyers	human
@ArwandyazZ	human
@TherOundThing	human
@iLoveMatet	human
@slowcalledlife	org
@Jecksie	unknown
@kateemarieshop	human
@KibokoTHotel	org
@ModernMom4Life	human
@FaaRzz	org
@Sammario1912	human
@ivoire_life	org
@jazzTWEETING	unknown
@I_Rock97	org
@KathrinChavez3	human
@Bearded0ne	human
@2econdome	org
@jeffzaret	human
@rasperrypi	human
@HayleySlims	human
@atoa76	human
@fairyfactoryza	human
@NunoFumoLinks	unknown
@anok_one	human
@Marwagotpmday	human
@BrookeLong4	unknown
@BananaIslandDOH	human
@Sniffapalooza	human
@Rhonda_Drews	human
@imccp	human
@A01F3C	human
@clari_mendez	org
@irash2020	human
@pepecaldelas	human
@Nabila_Sharani	human
@irenegm8	human
@FEMI_FATALE	org
@planetpuCi8	human
@sorandomsofun	human
@ChopShopLondon	human
@SavvyLets	org
@ayana416	human
@johannaox	human
@RakishEats	org
@BernardesSandra	human
@kevinthejover	human
@hofubuto	human
@bcfamilyca	org
@NewtownCafeBK	org
@kiraeji	human
@LuellasBBQ	human
@lisa_eatsworld	human
@FortunesLounge	unknown
@fadzoners	human
@MarquisBiasNYC	human
@ilovebtv	org
@TheLouiseNYC	human
@jacob00mx	human
@Thian_Lee	human
@klcbbz	human
@Baker_The_Brand	human
@StaceyMorris11	org
@HampshireTalk	org
@crystalhaha	org
@stephrawnsley	human
@Donanci_G	human
@wilsenism	unknown
@LAubergeBR	org
@planesyocio	unknown
@how2lovehealthy	human
@alberts_shed	human
@jaminmicah	unknown
@kurtoglumelike	unknown
@Tristanbogaard	human
@MrTonyE	human
@wcuebas	human
@FollowbackYacht	unknown
@75TEG	unknown
@chris_bowler166	org
@Martinique757	human
@YURIPEM_	unknown
@EtobicokeMoms	unknown
@GasheadAu	org
@MarikaMarku	human
@healyourWHOLE	human
@JudyGEvans	human
@Brittni_615	human
@iamlee1059	unknown
@Seaun	human
@newyorkeventsco	human
@eatNusli	human
@casaagape3	human
@Dominika_Imr	human
@BrabanteCerveza	org
@solphoto	human
@TheCellar	human
@Rincossella	unknown
@floripalondon	org
@angryrc_29	human
@Cynthia_Koh	human
@garrardhayes	human
@Ciaffo88	human
@manjoozz	org
@norzaid	human
@83rdandWestern	human
@monicamarolo	human
@123ViolinTuner	human
@Rizaldi_Syko	human
@humbaraba	human
@AmorShandell	human
@speybaysoul	human
@nympha_dora_	human
@MPSF	human
@sheilafsalgado	human
@GeoMktFan	human
@cmaetaylor	unknown
@QCOliveMill	org
@h_ohigashi	unknown
@mmmpanadas	org
@OnnaBcn	unknown
@TheCheekySkunk	human
@Superestacion	human
@Miss_HardJane	human
@LovelyLacole89	human
@DelaineHilbun	unknown
@MizzBlaqueBalla	human
@shathakalh	org
@Niki_Chow	human
@MRZHAY3Z	human
@HishamMan	human
@ViaItaliaStreet	org
@designGerr	human
@a_estrera	human
@kevinaguilar	human
@sotsnutrition	org
@CADoodleMoo	human
@EastonTownCtr	human
@RiennaMazlan	human
@ValoCastillo	human
@fzlorenzoni	human
@chris_1108chen	org
@lulugirard	human
@jeremysaisai	human
@livias_dish	org
@HerryYF_BoY	human
@dragonaireoven	human
@Lvpinkprincessa	org
@GODFATHER_WC	human
@SamSummerscales	human
@RachelLuFoods	human
@alathiamg	human
@PeoplesPharmacy	org
@sarah_radwa421	human
@BellaMilanoEd	org
@jrsebiert	human
@SprngGdnProduce	org
@_extraordiMARY	human
@naoco_mode	unknown
@losgalpones	human
@AntonsDumplings	human
@la_ime	org
@TheMommyMix	human
@DORestaurant	org
@mentarioqtavia	human
@EmelTejada	human
@anitaliantheory	human
@ginsanagara	unknown
@SonsNotbijs	human
@pthitima	human
@PledgeSHRED	human
@remi0727	human
@Ganglamb7748	unknown
@ATOimports	human
@GlamRockMomish	human
@petatranquille	org
@DaFuturMrKc	human
@selimcelen	human
@LIVELOVEMANJA	org
@RosenkranzMaria	human
@May92_	human
@Darren_iddon	unknown
@niaazmy	unknown
@magfoxx	unknown
@QSMarket	org
@ognenmitev	human
@eveelibra	human
@bookmiamiashley	unknown
@AwapuhiAquino	human
@those2girls	org
@lennykool	org
@LauryHaytayan	human
@toto__xoxo	human
@jamcafejp	human
@Arashi_affandi	human
@shopthethings	human
@PexelsPhotos	human
@TaniaArpa	org
@FoundersInn	human
@eatdrinkmag	org
@BooHawaii	human
@Adolphint	human
@Mercato4141	org
@robordignon	org
@Heliosresto	org
@PauGiulioni	human
@MomsDadsDocs	org
@ChiBangBodies	human
@STREATfwplace	unknown
@MollybeeToys	human
@AnnelieMalmsten	human
@coffeebooksme	human
@karinakristine	human
@lovelylicious	human
@nithinlives	human
@diamondcanopy	org
@xpressingit	human
@MorningStarFood	org
@TVMoody	human
@Anjana_2010	human
@johansonbong	human
@90sBaby_4Ever	human
@SammieSakran	human
@BeaconHill09	human
@steveGOgreen	human
@BastosBello	human
@GoGreenMustache	org
@m4ina	human
@aqsa_summa	unknown
@Nashschico	org
@weekendscount	org
@myn4m315R174	human
@travelbreakfast	human
@meerkossman	org
@GansevoortTC	human
@Armandina8234	human
@GreenGablesCafe	org
@spiceitupfood	human
@SeasonsEatings2	org
@Ibtissaam_	unknown
@ValentineGirl76	human
@KuwaitFoodiez	unknown
@Clean_Cheater	human
@Atomic812	org
@Chitowndawg	unknown
@SamarElazhary	human
@canudoitlikeme	human
@Athanasius5	human
@Michaelasblog	human
@ThrivePacificNW	org
@MarketTablenyc	org
@HedonisticHabit	human
@EliteLifeWell	human
@cookingwcaitlin	org
@wineanddineblog	human
@AkoAtaSiLEMUEL	human
@nadiazGee	human
@Carmalisious	human
@CathieSantos	human
@Dynza	human
@BCAE	org
@TylerMuster	human
@thebxbrunch	org
@S_Angelique	human
@GennaW	human
@GoudaCheese007	human
@HiltonEdinAirpt	human
@CalisthenicJay	human
@Jony_sharp	human
@__rossella__	human
@KidsMenu	org
@FaDeAwAyINDIGO	unknown
@GoldhillOrganic	org
@robzie_	human
@belangelyn	human
@JEAN_2MORAL	human
@_yuriiinaaaa	human
@linjaaho	human
@digentre	org
@gehlebelly	human
@DjTayaKruZz	human
@preppack	human
@TAPSCorona	org
@backroomone57	org
@arnisvanur	org
@trotys	human
@CaboFlatsStuart	org
@6363ema	human
@lazygirldinners	human
@tasiaadams18	unknown
@mrzn31	unknown
@Alyousifi	human
@bladimir_yanez	human
@laguirihabla	human
@500degreesCT	human
@OrnellaBonomini	human
@putra87	human
@kelvin88lau	unknown
@NonhleNdala	unknown
@saradubrasiu	org
@BoundaryRestE2	unknown
@ingersmona	human
@Javish	human
@kala_cw	human
@TKathaleen	human
@HazMat64343517	unknown
@JulieTennert	human
@JudeCisse	human
@ImPrEpPy_DaKoTa	human
@tiffanieRUArt	human
@Jonathan_1Cano	human
@ChaayeKhana	org
@LoseWeightEasyy	org
@leoZANI	human
@collien_jana	human
@bellacarmella86	human
@gstoremiami	org
@GlutenFreedomTO	unknown
@ParkHyattTO	org
@katleehl	human
@CayeISVermouce	human
@mervet98	human
@vinho_dosanjos	human
@superheroDJ	human
@SongForAnimals	org
@jeffreyDamnit	human
@WindsorCastleW8	org
@foofiefoo	human
@CozinhaFantasia	org
@noelieululanib	unknown
@RiiichRaw	human
@TheHappyHourBus	org
@SJS1983	org
@Parisian_Wanabe	human
@ReillyDaria	human
@CherylJClark1	unknown
@loujeanp	human
@Buta_Usagi_Ooka	human
@140cranleigh	org
@FatmaMutz	human
@TXWomenBloggers	org
@LilMissTNM	org
@T3GROUP_it	human
@ReginaDowntown	org
@dannijohnb	human
@stopguacnroll	org
@BKBeso	human
@Kringerkitty	human
@ohsnaplizzie	human
@BrandonRek	human
@Data_Dreamer	human
@AddieLuke	human
@XKaren_DX	human
@MaryANappi	human
@GabriellaDesgn	human
@chefmarc_TAOgrp	unknown
@natnatles	org
@djmarkguedes	human
@mommieagain	human
@108volando	human
@danielle_kupsky	human
@laValeWorld	org
@Jmarjet	human
@WrapWithJohanna	human
@MinsokYou	human
@Donnabrazier	human
@Princess__Mo	human
@CourtneysSweets	human
@Joa91	unknown
@FocacciaVE	human
@schimiggy	human
@bigsursabry	human
@Nora_Makia	human
@gigithenggith	human
@lexilou26	human
@dannyboygohard	org
@LaimaKr	human
@cestlaviv	org
@KitTyy_KT	human
@LMenTeen	org
@micoeniza	human
@MicheleMLee1	unknown
@OzoEspresso	human
@KerriAnn37	human
@FitMomsforLife	org
@iamYuno	human
@Marylynn349	human
@madisonwine	human
@visitorcity	org
@Gokigen11	human
@gmac77060	human
@HowAboutJuiceOZ	org
@sally831h	unknown
@billiegribben	org
@LucyClarvis	human
@lifewith2boys	unknown
@nu_eng	human
@MommyMerch	org
@zoefolkard	human
@AishaNaomi	human
@AlcampoLounge	org
@SaucySpatula	human
@Di_Kumarasinghe	human
@brian_wood_	human
@stepaheadme	org
@BorgoSantaCecil	human
@slsdiva	human
@paaaupaaau89	human
@TamOShanterLA	org
@BarEstilobham	org
@amey_walawalkar	org
@myinsanity	human
@NitaAhmad	human
@mhayes1984	human
@RiverCafeYYC	org
@sunsun2404	human
@JeremyyLow	human
@OnTheRocksEdm	org
@AsliKarabacak	human
@GyhaTheLast	human
@PeeHunas	unknown
@republiqueLA	human
@mamama2901	unknown
@Willowtown7	human
@charlietheyogi	human
@Alexstine	human
@thedionshow	human
@wenny_natalia	unknown
@Pentusi	human
@highlanderbar	org
@amukamukamuk	human
@VFoxxy	human
@Kirito60924	human
@Melodi755	unknown
@RhymesWithLost	human
@HasboundPerla	unknown
@vonliesse	human
@krem09	human
@samhgardner	human
@goodnessghealth	unknown
@RizkiKharisma	human
@310marine	human
@BenoitNY	human
@madolab4	human
@Taneishhh	human
@Simonna	org
@sarahteass	human
@epcotexpert	org
@iamkhalmambuay	unknown
@theskinnydoll	human
@DelCampoEventos	org
@PremoDaMover	org
@lo_calkitchen	org
@organicssense	org
@PlaceLipsHere	org
@ryanm0294	human
@LannaGreens	org
@__riotan	human
@The_CrepeEscape	human
@rvelnoweth	human
@Medb_B	human
@Perkierfoods	human
@ChefTZac	org
@ecurie12	human
@modeleatsalot	human
@fortunedyforboy	unknown
@Pierre_Ann	human
@SarriaSambrook	human
@AikaaAI48	unknown
@simitchikuchi	human
@djalexpty	org
@tracysteer1	human
@8888_aido	unknown
@djflacoflash	human
@LifeLJstyle	human
@johnny_caldera	human
@zuma_miami	human
@Carollinelee	human
@SaborConna	human
@garant02	human
@dcrispinacks	human
@imagine8music	human
@Xanderated	human
@BiscuitBunBanks	org
@Bea_Inspired	human
@stezodo86	human
@smurftopman	unknown
@OfficialXinaLim	human
@FrancescasFlops	human
@gizmopromotions	human
@Linda_LMExpose	human
@LoveFitGirlsXO	human
@InHollysKitchen	human
@fentonlawless	human
@AloftKLS	org
@PRBUSA	human
@Nidocamen	human
@sarahlovethese	human
@Uttist	human
@gattuwei	human
@vargas_alberto	human
@hatanaka_naomi	human
@YumRestaurant	org
@clutteredforest	unknown
@blakeich	human
@Austin_Grill	org
@JamieMagazine	org
@kasian94	human
@khunlung_s	human
@celinesachii	unknown
@arijimenez	unknown
@JuanmaPineda1	human
@duppANDswat	human
@METROMKE411	org
@MushroomChannel	human
@missharri91	org
@beautifulszewan	human
@itsmitchuy	human
@Tomobabyka	org
@NIKKIERIOZZI	human
@UrbanContest	human
@HakanOzcolak	org
@Non022non	org
@joannehlam	human
@CarolineWatts9	human
@mac12399	unknown
@TheCertified10	org
@Chicago_ToyShop	human
@Olesja_Gudovska	org
@Sara_MarieH	human
@cgoss805	human
@RingPRgirl	human
@EmilKazaz	org
@oMg_iTs_bRii	unknown
@yeschefdubai	org
@aleirahs_mommy	human
@Happy_E_After	human
@SerafinaDubai	org
@claudiawarni	human
@hidayahsalleh	human
@brianjchong	human
@LtMhpBeaz79	human
@airgmichelle	human
@Lenaaaguiar	human
@caluanmo	unknown
@FollowbackXrays	unknown
@fuckevie	human
@moes_kitchen	human
@PJGolfPro	human
@alovingspoon	human
@eenergyn78	unknown
@TribeHummus	human
@gwynnaa	human
@OxfordsKitchen	human
@melizapicazo	human
@GrainBerry	human
@ladypammie	unknown
@leroyjaputra	human
@RollingPhilly	unknown
@lancejj	human
@justsillyemily	human
@Ryan_W_Hester	human
@LawLorcan	human
@sarahllancare	human
@Chica_La_Fresa	human
@juliej0	human
@jdsrocka	human
@chiiyoonoo	unknown
@baron_boon	unknown
@SvenLinnquist	human
@mADtivity	org
@eLLy2k	org
@ibmskrissy	unknown
@FourPointsLagos	org
@RyNSF	human
@DIAMONDSTATEDVA	human
@Lucuyii	org
@fabforam	human
@MrCream_O_Wheat	org
@natuhealth	org
@MindyLorrie	human
@kuruvata	human
@mariconmansilla	human
@ShipShapeBF	org
@cottoncandii_	human
@ym22oy07	human
@OniDj	human
@claudia_palmira	human
@Mojo_Barbados	human
@smallbussiness1	unknown
@kehau	human
@davide300mila	human
@c121266	unknown
@Slish_John	human
@luibalbuena	human
@maestrocanada	human
@CantarellaAngel	human
@DTLondonEaling	org
@AStrongerU	org
@MarLaMitcheLL_	unknown
@UglysMKE	org
@heidilynn_7	human
@CribdeRib	human
@Mamatoga	human
@TatumLetard	unknown
@mitchael75	human
@LadiesInNavy	unknown
@socialsoupco	org
@Tiffhoney85	human
@edwin_khy	human
@AngelaYvonne	human
@vega_conflict	unknown
@CStoreNews_	human
@continspiration	human
@lizadixon	human
@CloudsRaleigh	org
@ksantoso77	org
@CharmingCuisine	human
@loveshoesblog	org
@ladybug10573	human
@AveriaSuzette	human
@telva	org
@EimansBellaVita	unknown
@llDJKATZll	human
@adrian_wallis	human
@PetitePrincessJ	org
@PokemonMMORPG_2	unknown
@HouseOFpinheiro	org
@LarraineFultz	human
@GOTZA6	human
@ne3ko3ta	org
@SI_TraceyDavis	human
@MichkimMich	human
@yuriel0208	human
@busybeauty	human
@ways_of_seeing	human
@SweetTableVE	human
@mygorgeousboys	human
@Bloodylock_AIE	human
@mistereastlife	human
@TomatoPies	human
@andalusianablog	human
@Tastybuteasycom	org
@jamila0412	human
@lovetheworm	unknown
@ClairesDietFile	human
@FoodPortland	human
@RJovelle	human
@aquashard	org
@laserenita	human
@decafe_lombok	org
@Lawrence2493	org
@LeenaKim	human
@joserabascovale	human
@mirandam4	human
@pachampcrp	org
@kunimp	human
@CarlosLynch	human
@ARHallab1881	human
@LondonBirdLucy	human
@sophianovita	human
@artigianogirl	human
@MonadnockHumane	org
@angelfanardy	human
@smilebrianx	human
@LuciaAlarcon	human
@ahadaamir	human
@reina_ist	human
@ribenaberi	human
@Celestesleep	org
@MightyMayoFilms	human
@pondicheri	org
@MadameDickinson	human
@QueenBee_Mktg	human
@bfairbanks22	human
@joyofnutrition	human
@cfernandezok	human
@MCQUEENISMYPAPI	human
@neharajpalmusic	human
@MusicalCroc	org
@vdawwgs	human
@mshouston	human
@T_Tate3	human
@clara_pinq	human
@lenbiscocho	human
@SaraRZielinski	human
@Saralaise	human
@Bere_Agu	human
@TriniPriceless	unknown
@jc_abe	human
@misnomer3	org
@MexicanTuesday	human
@WFLBC	org
@LCofChs	unknown
@agnes18onlyme	human
@Yuchaldy	human
@yuriL0729	org
@Sumali106	unknown
@knitpurlmama	human
@z_is4zombi	human
@SaltedBrick	org
@instaSunsets	human
@Marcus_RQ	human
@insta228	unknown
@ACLeats	human
@irhaff24	human
@nicoleamandaa	human
@ShubhamLovelove	human
@Pod_Papugami	human
@BelleBoulevard	human
@jfreshgreens	human
@IMozheyko	human
@WeBuyTXHomes	human
@joey_yeoj20	unknown
@tastesocial	org
@murselsezen	org
@BelmodoBie	org
@HungryCaramella	org
@CircoloLettori	org
@epicuriousbrit	human
@bestillandeat	human
@GabiGnez	human
@Mayousef	org
@helloBos	org
@LauraRunning	human
@ExperienceShiro	org
@gtmckay	human
@808NoriT	org
@EmLeyMoreSon	human
@KDHamptons	human
@BryJaimea	human
@the_wharf	org
@Bleary_	org
@ayeshacookery	human
@theloveegoist	org
@tanjaelse	human
@MiMithaBAP	human
@SnaresBleu	human
@cathmenk	human
@hitstoni	human
@Metro_Garden	org
@ChristinaRoseL	human
@ritrdko	org
@allspicenutmeg	unknown
@Amanda_Gajdosik	human
@vonjeffers	human
@OrlandoShow	human
@DannyPDolan	human
@minazaruchan	human
@eli_barbie5	human
@mstmst47	human
@masteractor	human
@MaktalCFBar	human
@SamsonTam	unknown
@Corn722	human
@CaffeDiFioreTX	human
@N58Albatross	unknown
@imasyzreenna	org
@WhiteHorseSW6	org
@CardiffDrmTeam	org
@doubletreeleeds	org
@HabiAnnaToure	human
@kamanomariko	human
@farhanismail10	org
@pinixnaix	human
@ron_ron10	human
@catherineruehle	human
@MikyJarvis	human
@Teenlovesupport	org
@TomCenci	human
@Must_Cricinfo	org
@arlando_b	human
@VJ_ingridVM	human
@downtownpaul	human
@LeTigreTruck	human
@micaribemaya	human
@SpyranRetail	human
@MaxMuscle2014	human
@manishapatel	human
@Yui522	org
@imKhmer619	org
@Leeds_List	human
@miGLAMbition	org
@jminter	human
@onton_a	human
@JacquiDuran1313	human
@BCLBakery	unknown
@HarvardGardens	org
@DorothyBJack	unknown
@dirtybeautyskin	human
@Belindaj75James	human
@JOE_nicolella	human
@sahooook	human
@SaraGlancy2	human
@DesiatoDo	human
@catarinabento99	unknown
@Rjoffroy	human
@delishogram	human
@YCYSonline	human
@SuperFoodieUK	human
@jolynnchoong	human
@lindseystuart81	unknown
@discomonki	human
@Monsalwafoods	org
@abvee_	human
@cruzsains	human
@JyinxWong	human
@NoCoastFoodie	human
@canagusto	human
@YunLynnBruce	human
@JillianAnnS	human
@__VivaLaTwitch	human
@Locomelon	human
@chefanzel	human
@Peter_McHenry	human
@eischiia	org
@sasulaukkonen	org
@MakhosiFuze	human
@HeritageWXW	human
@WELLYTEE	human
@qzb	unknown
@arieerose	human
@tinajbowen	human
@princessyukapi	human
@J_J_S_S_Smooth	unknown
@PattraNew	human
@IAMPOLAN	human
@ANYs_herbs	human
@JennyBoccara	human
@BIGDaddyPR1	human
@verandahyogya	human
@ISaBellaSanchez	human
@rubiatassie	unknown
@Daphfinitely	human
@kazuya0321	unknown
@Flylife07	human
@Marcos_Tre_vino	human
@BlueMoonFishco	org
@GRANMELIA_JKT	org
@pilar_ayuso	human
@CuisinenCouleur	human
@Yashima_Udon	human
@kieym	human
@jenwilsonTO	unknown
@sonacroi	human
@arctic_berries	org
@sugarbistro	org
@iamirawood	unknown
@212CafeBar	org
@GabFiorucci	human
@kristinagill	human
@schulzandrew	human
@katzz44	human
@JASPERJOYNER	human
@benginahmad	human
@TasteClubHQ	human
@SilferSilvia	human
@MW_Soest	human
@Gado1996	org
@mommykatandkids	human
@Sarah_redfern	human
@ATX_Swingers	unknown
@tashamack704	human
@PaoGelo21	unknown
@a_savvy1	human
@blkgizibe	human
@FoodFanNYC	human
@nimbus9vape	human
@buendiaenmadrid	human
@CartonSmart	org
@lasgorditasus	human
@Echa_Winnie	human
@taurius1	human
@HunnieBun603	human
@Annaalles1	human
@sea_jen	org
@RalphieTupaz	org
@DelBayBliss	human
@VaginaHook	human
@cafeABPdmc	org
@ChadMontealegre	unknown
@cdekultura	human
@ptanguilig	human
@AvrgAwkwrdAsian	human
@thebigsalenow4	human
@nenaaa30	unknown
@thezombieshow	human
@anitmat	human
@3bluestore	human
@Lucz_Hyuk	org
@LaColoraX	org
@JudithDuval	human
@LiliPichardo	human
@HellieSage	human
@TantaliseMT	org
@TitovaKatia	human
@nellz_atc	unknown
@CkEatDelicious	human
@melissajaneFRS	human
@samfrobar	human
@MarcellaPoincai	human
@frugalis	human
@X_AnneMarie_	human
@lisa_sammie	human
@martamanhattan	org
@msfashionmyworl	human
@Chris_Shh	human
@ChooseReuse	org
@guyanajazzfest	human
@ridhiUtamiNu	human
@howattoizudisu	human
@Jorgegancia	human
@VanessaJoySing	unknown
@FairwayMarket	org
@ryandanielward	human
@michelle223	human
@Vieille_Europe	human
@coredanddiced	human
@pedrocastelan	human
@the_joshjohnson	human
@PhilipiakMilano	org
@0nisuka	human
@sjrhoades24	human
@SalwaAnwarali	human
@sammieappleton1	human
@fabualice	unknown
@martinkeelagher	human
@FoodNService	human
@zip0109	human
@NenahOliveira	human
@SafiyyaKahan	human
@CafeBlueMini	org
@sudan_raghav	human
@hydrophantom	human
@Logic562	human
@ikearstin	human
@gourmetcoffeeSA	org
@JadeyWalsh	human
@Alison_McLean	human
@TheFeastingFox	org
@vincrinaldi	human
@ringthemerchant	human
@harrywatts	unknown
@GobiernoCiudad	human
@guricgg	human
@leonardoverse	human
@ShopaholicPH	org
@Pjlovell	human
@onoriadealvarad	human
@Abdy_Junior	human
@ChinoLoco148	human
@phrilesnippets	unknown
@Eleonoracarisi	human
@red_hrk	human
@kevdev83	human
@talitazahrah	human
@subranu	org
@Akankshajain22	human
@DonnaLampkin	human
@KochblogRadiode	human
@SacGaby	unknown
@DancingMarlin	org
@HoneyBSavin	human
@RagaekRuthless	human
@InnaMurugova	unknown
@laura_scfc	human
@NarisTue	human
@matbakh101	human
@InglewoodNative	unknown
@Leony_CC	human
@djfuzion15	human
@C_Campbell_1	human
@veegirrrl	human
@leahvelazquez	human
@AhilaanSleepy	human
@MN_Fine_Art	human
@NathaliaMrqz	human
@cowboyjoe_40	human
@AirDeLineAde	unknown
@jeiology	human
@imbetsycracker	human
@MissFunmike	unknown
@salloom89	human
@estebanGLZ	human
@irishplum	human
@ohgopo	human
@AALDARWISHI	unknown
@angelph__	unknown
@petitlouislake	org
@iheartblr	human
@zellxak	human
@AdamMcCollum	human
@thewhiteou	human
@shintalestari94	human
@TedithMytrendy	human
@MUSHROOMCLOUD3	unknown
@heartpringles	unknown
@hhernandez1230	human
@tom08	human
@J_Remy_kwj	human
@fgBegiak	human
@MissLeMaika	human
@weseetogether	human
@TheConster	human
@BTBouillon	org
@ONEJTC	unknown
@pattiers	human
@danijeljames	human
@TimeandPlaceSK4	org
@PrimroseHerd	human
@ManeNMin	human
@HebaVsReason	org
@The_FigandOlive	org
@iFAMiLYi	org
@AloeAloeMaire	org
@carissmisss	human
@msangie8807	human
@Lexo214	human
@KDLIG	human
@Bearnaiseboy	human
@neosiren	human
@kesiahvisioli	human
@Chefs_Diet	unknown
@abuelita_esther	human
@Sam2Drews	human
@Mariko_only	human
@Delicatesseny	human
@LiChnon	human
@AngelsOfSteel	human
@no1DMIARVKS_fan	human
@celineledez	human
@ymtn0615	org
@abc93812747	unknown
@luluAris	human
@DelaniesCoffee	org
@MyFarmerMarket	org
@feemariee	org
@ThreeYoungMugs	unknown
@Mo211MMM	human
@isolated_killer	unknown
@JakeJDasilva	human
@DavidVmusic	human
@AmericanaBrand	human
@csabadallazorza	org
@albacore151	human
@Empress_Li27	human
@beth_titus	human
@EthelAJewell	unknown
@Boogie__1969	unknown
@bulenk_boo	unknown
@SarahTook	human
@rosiedolly314	human
@unik_smith	human
@miztooshort13	human
@LesLdElsa	human
@malcdz	human
@Petty_Pookie	unknown
@waisartgallery	human
@kapoors_s	org
@erikmoody	human
@annieshomegrown	org
@FANTASYBODY1	human
@JOSEPH2marcucci	human
@osteria_firenze	org
@pinkelephantu4u	human
@HeathTT1	human
@iBrianMiguel	human
@Make_Bake_Share	human
@sparklesandglue	unknown
@vernee98	unknown
@DebraBros	human
@Rifai_Frabizio	human
@StepneyCityFarm	org
@bonbonbaik	unknown
@SweetNonaGirl	unknown
@junkkDNA	human
@SamanthasSays	human
@novscor74	human
@stevedavis	human
@Deqnoor	unknown
@littleGuySimon	human
@MultifoodsRD	human
@wailing_02	unknown
@VictusCatering	human
@eileenmaud2	human
@DOZESalamanca	human
@iMattzkie	human
@DinnerDelicious	org
@AMLILexonOrange	human
@iHealthMeals	org
@TheILVOLOversMx	human
@Simply_Chavonne	human
@Firefly_SC	org
@montsonicaa	human
@thescullerycafe	org
@Sneexate	human
@MymieAsmyda	org
@mjcusap	org
@fidyarondonuwu	human
@Nyonyintono	human
@SophieBoyce_	human
@shunichitakano	human
@madelmartin	human
@nhocsumin	human
@yuuuuumi_	unknown
@animalkingdom27	human
@mcrfoodfan	org
@reveletoi	human
@UHElle	human
@SofiaPNW	human
@SYantorno	org
@FishSmartMN	human
@kgodsigfdsd	human
@Breadandwithit	human
@to_on1008	human
@LondonTeaTime	human
@Jessamynleesha	human
@relishcornwall	org
@janebplain	human
@summerpampo	human
@heyitschal	human
@goodcleanchow	human
@KaitlinCassidy	human
@2FunatEtsy	human
@KOFoodTruck	org
@polengloveless	unknown
@_joecephus	human
@YvonneYoga77	human
@WasabiSushiLkwd	human
@AshworthPR	org
@sonikhadilkar	human
@TommyAwadi	unknown
@karstvdw	org
@jeffmshaffer	human
@SoldonShawnee	human
@aandar2014	org
@AmeliaWMurray	human
@gabriellaR87	human
@MintMovie	human
@fuadiifx	human
@aysheewawa	human
@jessinfully	unknown
@saracom	human
@_0630yes	human
@thehubpr	org
@rocotilloscafe	org
@babyfinger2010	org
@syamim_aizat	human
@thanhbuutran	unknown
@FishforThought1	org
@KJSkib	unknown
@new__HIROKI	unknown
@EffieMissy	unknown
@saberculinario	human
@TheStudiocity	human
@TrainerPaige	human
@M3LLYBABY	human
@bitzeemamas	human
@DASURIIII	org
@SHAREENA__	org
@AkaneD417	human
@prezzi_rapas	unknown
@FiveTwelveGB	human
@WoongFoodTruck	human
@DrRichardRotten	human
@LjhOc	human
@iamjorgexolalpa	human
@vegbarbrixton	org
@estongestyy	human
@gshm69	org
@Gizemizmirli	human
@emakNdaru	human
@gauchogroup	org
@SCUCoffsVillage	human
@OneCost	org
@blogger_bp	human
@LeishaMatty	org
@AlHamraTower	human
@salttapasbali	unknown
@roadsterdiner	org
@AmandaRushforth	human
@JOELTANJH	human
@t_anarchitect	org
@LindsR3	unknown
@UNSWVillage	human
@Data88Geek	human
@Charles62305157	human
@Teacher_Tracy_	human
@omichaan	human
@andrea_Vaz1	unknown
@iloveadaline	unknown
@ItsAneworYocniv	unknown
@NicoleMDizzle	human
@STNnutrition	org
@Maraniak	human
@DanHirst92	human
@valentinatozza	human
@amy_grech	human
@lilawdii	human
@tobynwabu	human
@kozcng	human
@santisapag	human
@misshkfoodlover	org
@SeattlePictures	human
@PaulertB	human
@VeronicaEmmaGar	human
@Noodle_Cat	human
@MarsAng91	human
@Aliciapunchyou	unknown
@Akenatorr	human
@MFaridaatje	unknown
@JASON_RAY_CLIM	human
@iambewitching	human
@mho62	human
@rachtate	human
@StripBarLDN	org
@scrollock	human
@Mollieofficialx	unknown
@BransenSands	human
@YatesBmth	org
@SwanZhang	human
@shreyashilpa	human
@Pebbles143x	human
@_Chris_Wallace	unknown
@nangningNUNK	unknown
@RenParisStCloud	human
@PhotosByGarbot	human
@PCTravels	org
@RayKliewer	org
@TopTravel43	unknown
@mssheyfles	human
@mojopo	human
@Harzich	human
@LurttCyl834	unknown
@CyprusAeropolis	org
@mollykom	human
@CookingUpAdvice	org
@inthewindrider	human
@ivaaaaann	human
@Belieber_ever	unknown
@BoudyShak	human
@AmberMcAnally2	org
@Jbcooking	human
@momo_sweeta	human
@superallantot	human
@kitkit9414	unknown
@RevaeNorvell	human
@shirleybudiyani	org
@asiangirleats	human
@Free2bMe7821	human
@LJJoyCe	human
@Aj_roslen	human
@Kelledstyle	org
@KhiriThailand	org
@alingzhang	human
@pauloshea19	human
@chefprive77	human
@BENICIOuy	human
@ArkBunyi	human
@kiki_kate	human
@RochdaleTown	org
@SarixRocks	human
@kelvingani	human
@CocoaBrownTan	org
@beerman007	unknown
@SouthsideJQBred	human
@TheNOSHChicago	human
@jusylfruit	human
@AmyIp_	human
@funzool	human
@kristinlang426	human
@PeacockMediaGrp	unknown
@dwiii_	unknown
@Ciphoy	human
@mkeen8	human
@melaverdelime	human
@dailycookbooks	org
@mydeliciousyear	human
@kimberlytheriot	unknown
@GalvinatWindows	org
@mahiblog	org
@THELOUDERMOUTH	unknown
@Trenchermen	human
@lurchaj	org
@auspicious_gift	human
@MattiaAllegro	unknown
@LingerDenver	org
@PinnacleVodka	org
@Jesus_Repairs	org
@xxxKANAaaa	human
@MorseGinger1	human
@Alessio_22	human
@JohnnaT1	human
@sheannec	human
@lessonsourlife	org
@blomo_chika	human
@jennykordell	human
@babyhuskie11	human
@LawrenceLately	human
@Cirque1993	human
@1china_black	human
@PRAZHM	human
@brkn_ertrgn	human
@Natali_Lavruk	human
@OfferOlivia	human
@roarsphobia	unknown
@chefbrokenloud	unknown
@SusanWong0902	unknown
@CherLoyy_	human
@MakaMasande	human
@Trendingpix	human
@RollinGreens1	org
@lifeisahandful	human
@nishchaymehta17	unknown
@NikkiLewis37	human
@JuiCelynShos	human
@baveshmoorthy	human
@bizmark1217	human
@tiamotisposo	human
@CrabbLashawn	org
@WinnieDeshea	human
@SweetSassyPalet	unknown
@TheViewHouse	org
@Horeca_Mobiel	org
@h_aldarwish	human
@HovePlace	org
@eatstyledallas	human
@MauriceHoff	human
@memes605	org
@juvenverzosa	org
@AloversResmiMDN	human
@MarianaCPortela	human
@TheMiraHongKong	org
@dancenowblog	human
@elementshollis	org
@i_st03ry	human
@kareny123	org
@KavDee	human
@tspcurry	human
@MalelErkin	unknown
@VoteRecipe	org
@llandmakeup	human
@CamiAlbrrn	human
@Good4thePalate	org
@2foodiesinlove	org
@cuoriforchetta	org
@FitnessFoodGirl	human
@ItsKamBam	unknown
@jellojanett	human
@trueflip25	human
@ashmmmac	human
@VIVECKVASWANI	org
@ditses	human
@malathip	human
@26Carmela	org
@VivinWang	human
@healthmancer	org
@AyeshaFaisal	org
@laurenswoolf	human
@SebastianBer	human
@KiriBear13	human
@Dominicana0317	human
@KellyHewitt2	human
@jodavinky	human
@TatumMuller	human
@AnujaNYC	unknown
@KaterinaBeth	human
@glowing_kitchen	human
@AlbertSt1	human
@TheSloaney	human
@Donahues101	org
@pipilihibo	human
@PheasantUk	org
@LaVitaminaT	human
@yuya_killer	human
@Azuani_wanie	human
@eerievar	human
@SyafXandra	unknown
@JoeyDueck	human
@joakimdahlswe	human
@FinnAndPorter	org
@ExploreJuice	human
@IAMV_DUB	human
@ChristabelNovea	human
@NekyRomero	human
@TwitTesty	human
@europeyoga	org
@Toosleepy73	human
@milagrosa2618	unknown
@misssandyp	human
@soigneechic	org
@mikereidchef	human
@nickdayah	unknown
@YoungBillyGrand	human
@AirullZafrull	human
@DaveM83	human
@Nelliegoodfood	human
@NightOwl_Philly	org
@RandallBaez	human
@IamnotEliza	unknown
@kitty_cheung	human
@sommelierdecafe	human
@ilaismail	human
@shuckedcoffee	org
@EdouardBorie	org
@imperialzodo1	unknown
@PhilippW83	human
@A_Malallah84	human
@JoztyAcevedo	human
@GiuliaBenini92	human
@MolinoFrances2	human
@BelindaCCothren	human
@BiancaDarmanin	human
@realcrazychow	org
@apoltrias	human
@Mr_M_Dawson	human
@KELiCHiA	org
@WithNatalieIWG	human
@avodwich	human
@kawaii_lha	human
@vance289	human
@JustinFrames	human
@CYNStudio	human
@getshacky	org
@miralsl	human
@b_boomm	human
@DaphPunkDlp	human
@LennoxDaniels	human
@KwanzaMvelase	unknown
@askthepixel	human
@imeldaguanzonya	human
@riezforester	human
@FromOutskirts	org
@Casa_Fortuna	human
@LatoyaWalker3F	org
@saranouva_	human
@ongkurt	human
@John_JoniE	human
@naturalysl	human
@3rd_Law	human
@MercolaMexico	human
@ton_zitcho	human
@PAULONTOY	human
@gabriel_josefa	human
@MadeFoods	org
@RichardMerrill	human
@GinaLASFmag	human
@PrisObermeier	unknown
@mdshohagmia16	human
@JustSayinNL	human
@silveetiplicova	human
@JGarz86	human
@HavanaRicksCafe	org
@MarcoMa88	human
@CCSOttawa	human
@swinediningldn	org
@fabrecipegirl	human
@kim_erim	human
@IEVCM	human
@JosephsKoeln	human
@GlobalSouls	human
@MasterPlan216	human
@Earlzy	human
@ElCaneloNC	org
@jannieville	human
@BenJamminAsh	human
@JinjerCoach	unknown
@MRMiamiMarvin	human
@Vera_Mills_45	human
@Thisis_Opie	unknown
@3d_lounge	unknown
@alexsandra8888	human
@dvarma813	human
@BethAnnFarmer	human
@CiNcO_DeUcE	human
@Stevengfonhoe	human
@RoxyEyes22	human
@BizouTampa	org
@WeLoveItalyCdf	org
@ronnkelly3	human
@foodboxmumbai	org
@la_ste83	human
@groovygreenlivi	human
@NatchezEvents	human
@AskMateo	human
@bosocial	human
@itsJadeyVDW	human
@soc_medexpert	human
@GregLumpkin	org
@bigxkaliber	org
@TheJoshRidgway	human
@Max_TheGreatest	human
@avstar25	human
@nutriliciousss	human
@happyblogplaza	org
@JMontezMusic	human
@Keitasato1975	human
@PollyTG	human
@JaleoPanama	org
@AmbreMauritius	org
@andinskeey2	human
@EuroActivist	unknown
@TazUlhaq	human
@HHydration	unknown
@savvysassymoms	human
@MapleLeafFarms	org
@SyzwniA	unknown
@SusanPazera	human
@Janicebg	human
@Stralisemiai	human
@LMAG1981	human
@Ansku01JB	human
@ufaafaa	human
@Cassandra_Raj	human
@sherron5hayes	human
@stardustfallout	human
@msk_enterprises	human
@Su_Naka	human
@chehabmike	human
@SophiaA12305161	human
@ssbeautiful33	human
@__F_U_M_I__	org
@BakeaholicMama	human
@claireford007	human
@Ryuichi_Aizawa	human
@RanggaVP	human
@justkenedi	human
@AikasLoveCloset	org
@EddieBarron	human
@ReebonzMY	org
@ShapingYourself	human
@crellim	human
@joieandthevivre	human
@LeoDalmagro	human
@DomenicTT	human
@Health_Alliance	org
@JRCX	human
@friesystacey	human
@anthonycrice	human
@NatPrintMuseum	human
@dogzillahotdogs	unknown
@audreyleighton	human
@moremakesmerry	org
@capewinereview	human
@i_toitoito_i	human
@mackdrama1017	human
@CrazyHousePR	org
@dhinakaranjbraj	unknown
@gemmalouise_may	human
@muskilash	human
@ataratov	human
@BlackAngusResta	org
@des_hyukjaeELF	human
@Felipe7975	unknown
@clementina_cafe	human
@JustAHippo	org
@Naqa2_	human
@tolmachevo_nsk	human
@jasjassyjasmine	unknown
@rainborn8228	human
@danceismyall00	human
@CoachMichaelaL	human
@leapinaygypsy	human
@GRMUYB4VXQZTP2V	unknown
@VintageBakeryMI	org
@mattcheesman	human
@syk_gyda_spr	human
@Jessmleff	human
@SkankingMumma	human
@HippieMp	human
@okiezhip	unknown
@ChocoletteCooks	human
@MulaysSausage	org
@ThePierreNY	org
@mimzyf50	human
@eatsleepOKC	human
@armieloves	human
@RisakoTanigawa	org
@Gentiane_	human
@Emmasara0908	human
@LuxeMode	human
@r0sa3105	human
@cosmicais	human
@Danithepoet	human
@LovinMyKnights	org
@magconftjanos	human
@RoseleeDressler	human
@COOLHAUS	org
@JCMelbourneBoy	human
@Williwolle77	human
@Iggyscatering	human
@hazelgoquilla	human
@DianMira	human
@FeministDialog	org
@hutch_kl	human
@Ismail_Alkhouri	human
@Joshua_R_	human
@PeoplesMarkets	human
@catchup_isme	human
@lelai_	human
@HisPrincessLove	human
@chanrinasan	human
@mimbles	human
@Natalie_Ivey	human
@sandyweichen	human
@EventsInPrague	human
@SmarandaLinaSam	human
@glennismynem	human
@KanaLovlov	human
@TheWestmoorClub	human
@aysha05	human
@PetraKim13	org
@AvilaTeiMiami	human
@mom2teebee	human
@Crummbs_uk	human
@amycrofts	human
@bl_ct	human
@alperabakay	unknown
@kiichan333	human
@TheChief_xx	human
@Anisewineroom	human
@Cristina_1Ma	human
@court163	human
@GoiAviles	human
@Kimi_Kudo	human
@Dane9690	unknown
@martinalove987	human
@lokkomotion	human
@ellie348ellie	unknown
@Pretzel_C	org
@AggieTomic	org
@askPLiz	human
@PETITEOLGA	human
@funnyvideoscat	human
@tweetallthefood	org
@Nelleybly	human
@reymasUKNOW	unknown
@Lozziee_xxx	unknown
@stargalla	human
@Natrl_Pur_Simpl	org
@KPritchettRD	human
@fspike	human
@FarihaOsmani	human
@KORN2532	human
@hanschumacer	human
@blogthatfood	org
@nellie_wu0408	unknown
@ChrisBTow	human
@IG_Gourmet	org
@Michael415Mike	human
@Apple_Bottom4L	human
@BodmerH	human
@chiaanr	human
@ChicPeaceLife	human
@Jskittles23	human
@rujunxrawks	human
@Knitterfee	human
@vyta_pratiwi	human
@tweetmet	unknown
@BeokaSz	human
@NikkiHayes1969	human
@LasClementinasB	human
@redponcho	human
@SusannahMakram	human
@DimatiqueWines	org
@_MIGOT_	human
@yuyunyuditya	human
@LuxuryPRGal	human
@LexoExo	unknown
@MosesTaura	human
@vega_eat	unknown
@the_happy_oak	org
@VABding	unknown
@SkinTips_Health	human
@StupendaStar	human
@ReflexNutrition	human
@ziggymoonblues	unknown
@sherrygo	human
@enaguaviva	unknown
@tallant90	human
@steviey	org
@jennifer_toal	human
@RaggedeyAnn	unknown
@akb48_archives	unknown
@PointHealth	human
@Courtneykabot	human
@niantukin	human
@_xxyukiiiixx_	org
@IssaWi	human
@kyoukun_zinnsei	unknown
@Fleurdelis318	human
@dafnepatruno	human
@HookPerkins	org
@nonifatunisa	human
@genemosca	human
@ortodibalu	human
@shihorin24	human
@Spies_J	human
@rumichiki	human
@HuertasNYC	human
@crazyfool54	human
@hobbs_samantha	human
@somewineplease1	human
@PetchRachasak	human
@anna__bo	human
@CatBirdKidMom	human
@enFlip	human
@LapaYuliya	human
@McCoyMcCoy	human
@ChefKas	human
@myrthevdhoeven	human
@zerine_wen	unknown
@FitFoodie_Lee	unknown
@insanemingo	human
@djchefrocks	org
@nahum_pedraza	human
@Eldabiebs	unknown
@punchromano	human
@Dubsane	human
@rshamr	human
@steffieliciouz	human
@zwee24	org
@toushi1000	human
@dinaedana	human
@_Jesteva	unknown
@Siya_Maloka	human
@tawanon	human
@RJFlamingo	human
@nino_laziale29	human
@Ricetteracconti	org
@modernveganista	unknown
@millyrosej	human
@lindacooganB	human
@guia_lugarzinho	org
@BungaBungaLondn	unknown
@spekeresort	org
@jejejepoy	human
@AndysDinerPA	human
@overrunz	human
@GraceGoodEats	human
@ambientetapas	org
@rafiq1811	human
@IrenePreite	human
@MTLaTABLE	org
@chefdispensa	org
@HeyBitchChile	human
@discoverhalifax	org
@TheYufar	human
@VCarruyo	human
@RoyalGorden	human
@frogsnbooks	human
@JohnFindleyAuth	human
@aldentegourmet	human
@cherry_lien	human
@HamptonsPenarth	org
@DaveQuinn247	org
@PoloGrillTulsa	org
@voltaireisagra	human
@sweetumamiuk	org
@kitchenstadium	unknown
@AlannGoulart	human
@EmciaPichci	human
@anaafilipaa98	human
@CatchTheMelody	human
@warmflowuk	human
@calvin_khoo	human
@EnteliaBristol	org
@ecarlos1	human
@karmanae23	org
@IrusVirus	human
@tacosmqt	human
@TdublB	human
@LynseySWConwy	human
@Shar316	human
@_FerCabral_	human
@justicefergie	human
@TEEZ_WORLD	unknown
@CinDyi_Ah	human
@christopherF818	human
@ropuchaP	human
@atlanticcityluv	human
@Phoebe_tj	human
@FreegoFood	human
@smileygiraffe	human
@bagelworldcafe	org
@midtown_okc	human
@EmilyJanesFoods	human
@NatureValley	org
@KakPahVirgin	human
@HobbitZoe	unknown
@GrindTim3	human
@_lu0511	human
@Melissa1_Tru	human
@DaryaSudirdjo	human
@Charlaface	human
@MercedesCSpradl	unknown
@Qamaoi	human
@kensingtonpub	org
@ryukyu25	unknown
@simoneskitchen	human
@food_blueprint	unknown
@37_ka	human
@maryeeo	unknown
@TheMowWay	human
@thejoiofsummer	human
@Lucy_Parkes	unknown
@Shifu_Sam	human
@2weenty8ight	org
@spencernjoya	human
@gustifam	human
@kathsiri	human
@rohitbokariya	human
@DeeperthanmyK	org
@PalermosCafe	org
@VettaPasta	org
@WhitBitsKitchen	human
@GlamAntonnette	human
@freebiequeen15	human
@JSMfitnessUK	human
@GARAMKIMHONG	human
@NALMom2010	unknown
@MarketGrillLDN	human
@iSugarCoatIt	human
@anothersocalgal	human
@monkatrosel	human
@KvnT	human
@ronald_mccallum	human
@whoishashimoto	human
@alliewho	unknown
@AndreaFarmerArt	human
@kidskrfsrds	human
@DinaNatasya5	unknown
@msh3al	human
@francmgarcia	human
@nurulainn86	human
@FabiMuse	human
@Gfreemomtobe	human
@rukaruka1001	human
@MillersGuild	human
@Sofik29	human
@gendi_	human
@daisu_keeee	unknown
@sophielaamb	human
@EKSYBBY	unknown
@FiveLeavesNY	human
@im4ginaryFri3nd	human
@rofidahynt	unknown
@Genusszeit_Blog	human
@claudiadaponte	human
@Kii_Mo	unknown
@cohyou04270604	human
@lenipaperboats	human
@utsukushikokoro	unknown
@michaco1007	human
@alineapproves	human
@0626_asami	unknown
@aaron_1001	human
@BenNacca	human
@datayoung	human
@ChefAnahita	human
@iam_tonirose	human
@TheDeltaKing	org
@1DTicketHelp	human
@WhiteRockBIA1	unknown
@bandedesquatres	org
@BaileyTheChef	org
@Health_nutTO	human
@OrlandoTM_Homes	org
@Chef_Turok	human
@Keilin246	human
@CuliNice	human
@ReasonableBloke	human
@COOKSHOPTR	org
@nashikensazali	unknown
@tonygmpt	org
@misswowwa	human
@Didi_88	human
@MJW1906	human
@afalsaleh_al	human
@nanase_ellevie	human
@YSJLA	human
@larr_helms	human
@ChitranCh	human
@shwa5y_1989	unknown
@GleeNYC	human
@amgiammarino	org
@katiesueg	org
@GodsGift30	human
@InokumaT	human
@qudo18	org
@PNG_PZ	unknown
@grouchiemarks	human
@Surrahbubbles	human
@tdyrod	org
@VorobiovMax	unknown
@mystylediaries	org
@chrisbycz	human
@PaigeTurna	human
@casadelacargill	unknown
@TheMichiganMom	unknown
@thehackneypearl	org
@RestaurantZari	org
@itsmsjen15	human
@KarynNobleLP	unknown
@947planet	human
@jaydejeido	org
@JennysTong	human
@sachafarber	human
@jovyentac	org
@SoSWDC	org
@christineyeohan	human
@imMichelleChong	human
@miakesch	human
@mk_inwa	human
@Justin2407	human
@Happy_Boho	human
@stephane_mk	human
@Lamasbella1218	human
@bot73891421	unknown
@CoCoDevi	org
@ManrinaR	human
@Marjorie_BT	human
@soranaindonesia	human
@sulung88	org
@JJPikachu	human
@ritikabetala	unknown
@StyleWorthwhile	unknown
@CurtCanada	human
@BabyDoiHeed	human
@tskloves	human
@katrin_rain	human
@AnastasiaLiena	org
@LeGrainne	org
@CourtneySCurran	human
@SueHudsonBBF	org
@jennybeaumont	human
@arktrux	human
@shbooty	human
@shabrinacha	human
@shapo_nataliE	unknown
@maoroserabbit	human
@NorhanSs	human
@5TILT	human
@LoveBiteTTDI	org
@GraffitiJunk5	unknown
@mixnmunch	org
@SchwarzAngel	unknown
@tracy06192708	unknown
@samanthadowdell	human
@CharlieChanCamb	org
@elaineyousay	human
@social_pantry	org
@cafesoif	human
@Derestaurantesy	human
@parmindervirdi	human
@alemjusic	human
@fruitive	org
@charlenetingzon	human
@AgencyRulesPK	human
@chiucchiu81	human
@NYC_Cornerstone	human
@FabulousFarheen	human
@Sangalli_Pippo	human
@Hexagonbot	org
@LoyaltyMgmtEU	human
@PesanSNACK	human
@_Lady_WeWe_	human
@BaoDownTN	human
@EighthDayVeg	org
@FareezJamali	human
@its_carriedee	unknown
@Daphunnone	human
@Glamorousglutto	org
@milano_to	org
@ITYDarling	human
@Princezz2nv	human
@thiagomarinelli	human
@paris_b	human
@trisnawirra	human
@Koltureshoq	human
@NiSor_NiFer	human
@Cult_Events	human
@VIPS	human
@Gmoney757	human
@IlaLaras	human
@MOrozcoSecurity	human
@ANewGIG	human
@NisyaRifiani	human
@amendolaart	human
@VictoryaBee	human
@sirquelate	org
@BOT88724557	unknown
@MOLM2011	unknown
@SheriMcShane	human
@Minon_nl	org
@Umm_Meh_Duhh	human
@jorellrendon	unknown
@IndieQtrBfd	org
@MaccReTweet	org
@zattonia	human
@MsSarahFontenot	human
@SaveALot	org
@TheDessertSpoon	human
@EnjoyPorn_net	org
@RebeccaMonique	human
@FabriziaMartano	unknown
@theconsmommy	human
@Jhayceelovesyou	human
@Mannygsi	human
@pecelmasjedit	human
@reluxed	human
@JosephWerder	human
@Mr_Work_A_Holic	human
@AmyEvangeline	human
@tinigoobar	human
@Abdul_klf	human
@Jabbasnaggle	human
@EllaIllustrator	human
@alsouks	org
@MansonFTW	human
@Shamisgourmet	org
@Lynn_0305	human
@Katrina_Lexxa	human
@JoseRamirezGaga	human
@DocPo	human
@est90s_hashboyz	unknown
@DiellzaDobroshi	human
@maldonadojrr	human
@jemmagorring	human
@ginger_michele	human
@En_Rouge	human
@PatGGamboa	human
@Hana9JJANG	human
@AndreaCoventry	human
@BartWeel	org
@GossipPirate	org
@AsiaBurgos	unknown
@themorganhotel	org
@Choc_Goddess	human
@just_me_just_em	human
@bfahad	human
@SwissChoiceEG	human
@WindaMedikasari	human
@MrMaine1988	unknown
@mama_lous	org
@wineTchallenge	human
@downtownLDN	human
@fsenada	human
@ziavu	human
@4lilangelitos	human
@BritniDWrites	human
@GothamDublin	org
@wertolocal	org
@aienbranzuela	human
@clipit_app	org
@ivorization	org
@zuckmaeada	human
@myplacefonthill	human
@VolupteAnytime	org
@bLovedqink	human
@Cafe_bicyclette	org
@chiakkyo	human
@loveaugustblog	human
@ireneclng	org
@HippModernBuild	human
@HkKenhui	human
@debbieeparks	human
@energiefee	human
@travel_thelife	org
@Oantoinette	unknown
@diptea	org
@PaulaSheets24	human
@Bangbangblond	human
@LinkSheridan	human
@azuBK	human
@WaterLaneBS	org
@putisafira	human
@NikIntanRashid	human
@gorestreetcafe	org
@PurmalaShrestha	human
@MaBlerh	org
@Arty_V	human
@qt_michelle	human
@Cloei_13	human
@allsetUS	human
@OljaDakich	human
@Wheredrobe	org
@hsbhachu	unknown
@gelmina	human
@brunchpants	org
@tinasMD	human
@mariagiorgiavit	human
@Ronan	human
@AsphodelDW	human
@glassofwin	unknown
@yumenoosuke	human
@TetRadandei	human
@DavidPied	human
@atlanticwharf	org
@GaiaMolettieri	human
@nestpercee88	unknown
@DrMarcusHester	human
@superbearvin	human
@ItaliannisPH	human
@TanzTatjana	human
@tat_mama_21	human
@harryobakery	human
@Ferdypaindepice	org
@MatiChaied	org
@TheTacoteca	org
@thelittleloaf	human
@BELLYwinebar	org
@HomeAtCK	org
@ZelosMonaco	org
@uoksas	org
@NoufAttar27	human
@hashtagbrunch	org
@loveworkrepeat	org
@anbencheeck	unknown
@Chicago_History	org
@lopezloni	human
@Fxckedupbastard	human
@alberto_borrega	unknown
@arumsukapto	human
@vixennika	human
@littlemisslocal	human
@wwong17	human
@souleland	human
@redne2013	human
@mandymachado	human
@kitintoi	human
@OwenKwong	human
@pkballr	human
@happykidz	human
@berttakesworld	human
@Riahzatanish	human
@SparkPeople	org
@CeciliaMatilda	human
@m3lissao	human
@Jomasito	human
@beavertonmom	human
@lercylee	human
@RobotFilly	human
@FightChixTrev	unknown
@MsLadyJolie	human
@blcromer	human
@DonnaSiggy	human
@sanntimartinez	human
@Free_PSN_Codes_	human
@rihannaRIHNA	unknown
@howyee28	human
@BrandaT1	human
@natnat_ester92	human
@_n0rthernlight	org
@viewvyjung	human
@livelysiren	human
@mbughnaim	human
@Goddess_Asha	human
@T_as_Tasty	human
@insideMrRH3	org
@HerryXuJr	human
@colsonbklyn	org
@galeriinfounik	human
@ifyouseeVAL	human
@kojIooooooo	unknown
@MellonRhonda	org
@pinkgirl_xxxxx	human
@FreeLikeBirdie	unknown
@1alexcam	human
@icenimagazine	org
@gabgabomnomnom	org
@ALLEYEZONMAY	org
@asboediono	org
@dMaS_9194	human
@jennyj1122	human
@AsktracyCa	human
@FineDiningVanBC	human
@talipanda	human
@mnathalie	org
@c0mp4r101	unknown
@andrewdominick	human
@jerebles	human
@Groupon_UAE	org
@skinkwallis	human
@JuanPilyo2	unknown
@NicoNovillo	human
@pizzaporta	human
@SPKitchen	org
@duttasanjib	human
@BeatriceLawale	human
@PattysFood	human
@JunkBanter	human
@myThaiMassage	org
@tapdawg8	human
@knysnatourism	org
@SharronCalvin	human
@thevalleyledger	org
@tilltewtew	human
@lemesayEVEN	human
@orobakerybar	unknown
@Randy__Randall	human
@milkmaker73	org
@Courtneyz0rz	human
@Franck_Capone94	human
@abdoshawky18	unknown
@gracedelanybell	human
@yr_0201	human
@iAmKRenee	human
@minshukuoyaji	human
@papipupeseijin8	human
@lendzera	human
@cheer_fe	human
@BetzMyboyblue11	human
@Jennajj88	human
@AFRESSHx0ox	human
@MariaInesGms	human
@rachcollings	human
@SnookerBunnies	org
@Jane_jici	human
@Steve_Starfist	human
@a155391	human
@ChungWampole	unknown
@jijiomilky	human
@F00dca	org
@MarionJMiller1	unknown
@Gucciolli	org
@IamBig_D	human
@GreenOnionUK	human
@ebarrera	human
@farmfreshmiami	org
@claudiabiondini	org
@sonnycole	human
@SamanthaSwiftx3	human
@justinejoi	unknown
@jaminafrias	human
@deelearn	human
@deannecaballes	human
@Jeff____Adams	human
@FatinAzrin	human
@epochrestauran1	org
@3000ri	human
@amypeat	human
@GValentina94	unknown
@GourdoughsPub	human
@SydneyUV	human
@ReneOmega	unknown
@MICHAEL2MARCUCC	human
@marcicelloo	human
@StreetMeetsStyl	org
@Yushoisnacks	human
@SchreinerPritch	unknown
@ZADF_ORG	human
@mksand27	human
@MayraQ1998	human
@LittleIndiaCO	human
@Mr_RyanWilson	human
@BlogHedonista	org
@SyracuseFirst	org
@UKSOPRO	org
@gallimaufrey777	human
@poundthelbs	human
@HayySmith22	unknown
@lynn_sheridan	human
@Brezilya	human
@TheToastedHTX	org
@becky_dods	human
@CloraSkiver	org
@onehated1	human
@zoojourneys	human
@DanielJanetos	human
@hiran_das	org
@C1145628896	human
@bryncynonstrat	org
@AnthKate	unknown
@koryaversa	org
@YaiCookie	human
@shawcookie1	human
@PetiteTable	org
@xZeroCool30x	org
@TrybeApp	org
@Amythepiggy	human
@jennycosep	human
@imperiallamian	human
@tamae_131	human
@Leo_Aguirre_Jr	human
@megan_daughtry	human
@weefizzy	human
@LeFashionCamp	unknown
@Tapped1007	human
@ALIVEMONSTER96	human
@Edward_Mah	human
@yayaruzaiman	org
@LMDreamerOnly	org
@KaewBlanker	human
@mimitulip	human
@TegaTea	org
@JeztarzCourt	human
@ColorfulCanary	human
@Kefi86	human
@thebunchybaker	human
@annascanlon	human
@ArdisBardach	unknown
@FearKu0319	human
@candyvreyes	org
@Wishingwell66	human
@alisontel	unknown
@Chau_Rose88	human
@Aizamiaa	human
@SANAE0408	human
@Lush_Liah	human
@Globe_Croqueuse	org
@britghouse	org
@srita_mar	unknown
@iamthemaven	human
@idibus2001	human
@erikadk85	human
@Chapteronetml	human
@LandSMumbai	unknown
@29ParkPlace	org
@PaoloPanDeejay	org
@SleepersGourmet	human
@LOVVIT_	human
@emjneves	human
@AndreasAldo_	unknown
@jamelybg	human
@momokun0128	human
@Binge_Magazine	human
@ackyogafest	org
@frankleow	human
@aurorabaron	human
@stupidity_gal	org
@hauteturntable	human
@TruthDrivenLife	human
@addictedadhiet	human
@Aris_restaurant	human
@chanipati	human
@thatgirlscrazy	human
@bhabyjoanne	human
@banuh	human
@RhodesiaTalluri	human
@MatthewTwihard	human
@CahyaSuria	human
@lunatoona	human
@peachiestarr	human
@BCRealEstatePro	human
@Dideias	unknown
@gabriel_ferry	human
@The_new_paul	unknown
@LindaJHerrera1	unknown
@Riquezaensalud	human
@luisitho_cabre	human
@VenuSpeak	human
@tbyrdi	org
@sngwriterSha	human
@omgunreal	human
@notketchup	org
@junhaophang	human
@Esthebandres	org
@bevznocete	unknown
@eatfreshfirst	org
@63TayStreet	org
@KentsCajunKitch	unknown
@ClifKoplin	human
@ayheehihihi	human
@enchantedpink07	human
@cafecottoncafe	org
@ayudurotul	org
@simplykharl	human
@the_taaaaae	unknown
@bshawcross	human
@SafwanAmaludin	unknown
@KelleysCreation	human
@OscarDeli31	human
@BullseyeEnt813	unknown
@ziporacindy	human
@KMitch1120	human
@s_nsm495	human
@LesMuise	org
@Lexxemilie	human
@NaomiCotterill	human
@DJKUTZ313	org
@Reyna5star	human
@PinkMama68	human
@ls_2030	unknown
@a_mikoda	unknown
@KiaraEve1	human
@yumi_ando	unknown
@trickhster	human
@smurfinwitty	org
@tonmj	human
@herbal_flgirl	human
@NilCavalcanti	human
@maharani_mok	human
@Tanti_Meliana	human
@wperezlopez	human
@benyuan5	unknown
@JuliaBezbakh	human
@LillysTable	org
@mjbohl07	human
@vinash_lynn	human
@VeronikaVogt	human
@LindsayAnnBakes	human
@DennyCoates	human
@VioletVermilion	human
@DessyRahmadan10	human
@PupShiny	human
@nin_chibainu	human
@PerezGermino	human
@namedlikegrace	human
@DiMOv95	human
@underthemoonv	human
@melly_s57	human
@PondHouseGrill	human
@Pigg15	human
@manatannnn	unknown
@YellowBrickLead	human
@SawayaChristina	human
@DebraPonzek	org
@MvelAcuaR	unknown
@BingeBaby	human
@physicianpulse	human
@rivierafit	org
@BimBirdy	unknown
@R0ula_	human
@DesignLover6	human
@IAmDaniel0	human
@pure_dubstep	human
@jhvu	human
@LilyxJean	human
@bobbydotson2062	human
@VegInspirations	org
@deadman7	human
@journeyasadaddy	unknown
@SonoraGrill_MSP	human
@ayuman_jap	unknown
@fierytalent	human
@arielptenorio	org
@mario_bakrie	org
@_md_syazwan_	human
@DolceDellaVita	human
@BloodyMimary	human
@Ayaann9	human
@FollowbackNorth	unknown
@TheKenSchwartz	org
@_Manu23	human
@picklepants	human
@ccduniv	human
@deliaalley	human
@mitchdudani	org
@KeilaBonjour	org
@LTVibes	org
@missymiimo	human
@jusosevero	human
@khun_nhoo	human
@TheRefurbishedH	org
@Global_Britain	unknown
@Cocolito23	human
@sexybrahmabull2	human
@ashleykoff	org
@EmilyGussin	human
@angelababy2007	human
@jazzymofo	human
@deniztokgoz	human
@bibinparker	human
@zoya_altaf	org
@eninaj_nosila09	human
@kerusi_putih	human
@NicholeNo1	org
@DepotLiquors	org
@brondhys	human
@susanannstyles	human
@lalalakoehle	human
@happyhourcom	org
@arudyqol	human
@gd2btk	human
@cloverstars	human
@deryameselik	human
@Kettlevalleypub	human
@kjneil77	human
@koneko2213	human
@hubleicester	human
@bella616	human
@fashemployed	human
@astrakhanphoto1	human
@ChefMichaelMina	human
@nicolassasson	human
@TravelNewsNow1	human
@FashionistaBook	unknown
@Lightofday1228	org
@SimmiSweet	human
@BitcoinAgile	human
@iamGilbertLopez	human
@Alberto__510	unknown
@DkRochelle	human
@MasAppetit	human
@bimmerswife	org
@fionadrizka	human
@boi_bakal	human
@KarooCandL	org
@carlamandine	org
@Yerijuice	human
@InnaKova	human
@eri_n0qa9xx	human
@mattertaste	human
@_MsCeasar	human
@GoodiegoodieGF	human
@laurawise1983	human
@MissyMischiefPR	human
@itfashionj	human
@R0DA	org
@explosioncries	human
@TNGWB	org
@MinusTheSims	human
@Mariette_Jansen	human
@ChicagoParent	human
@lostNFoundbali	human
@NWWOLFSTRONG	human
@GuenBt	unknown
@MarkusUeberjahn	human
@eatcuriousgoods	human
@NocheAlpha	human
@CostanzaRyM	unknown
@Ykaner89	human
@simonoxleee	org
@BaguioMyrtle	human
@hballantyne88	human
@ChefAramReed	org
@castlecarls	human
@minifreaker	human
@FriscoShotta	human
@ManuelPasquali_	human
@creativeswag	human
@HoBoTrails	human
@Miss_Pudding	unknown
@jhez4you	human
@Tivz_S	human
@calvinskeleton	human
@chikinensis	human
@TODHMNOLA	unknown
@ehog	human
@illestleslie22	human
@Wikilicias	org
@ChelseaMSMW	human
@321hans	human
@ImALhynG	human
@Gucho_87	human
@ionedinburgh	org
@pfroio	unknown
@86arumacissej	org
@kalidasforever	human
@tmzo	human
@iNutritionDaily	org
@SaladandGo	org
@Julasbabe	human
@NightOwl_BOS	org
@HealthDayEditor	org
@SirMiestro	human
@MJMakeupStyle	human
@runningpfuhl	human
@thegeeksoffice	human
@StephGatz	unknown
@Skinade	org
@DamienAlvie	human
@sao5124	human
@x0x0alisha	unknown
@dticloud	human
@RainbowCoOp	org
@MCSpiedo	human
@OllyMagazine	org
@cgarcia049	human
@Linh_Winn	human
@MissSyoV	human
@energyshots	org
@eat_fit_slavvi	human
@dopecafearte	org
@ROBERTA_CUSHEY	human
@ccceciliawong	unknown
@Jess_squats	org
@PhillyKhalis	org
@YousufAhli	human
@djmorie99	human
@Popkiss6	human
@_BethShorey	human
@Jamjamsjam1	human
@dream___boys	human
@HoadsFarmEggs	org
@Raiineyb00	human
@taramonfils	human
@faradilaaa	human
@BellasMommi13	unknown
@PatsEatery	org
@jiajiachen59	unknown
@SaintScorpius	human
@ThrifteeQueenB2	human
@jodiekay	human
@PHiLLy_WaNka	unknown
@louieats	org
@Greenbitter	unknown
@sandwich_foryou	human
@HenrysMajestic	org
@Prettyqirl_Baby	human
@myraamer	human
@luvsarahelsayed	human
@duranbrindis	human
@thisisge	human
@UffordParkHotel	human
@No8ThorpeRoad	human
@ProjMotherhood	human
@westdorsetfoodi	human
@normanestilo	human
@AmandaBlake9	human
@eilikelossov	human
@GisellaTaranto	human
@BabblingHook	org
@mako_loves	org
@ReubLim	unknown
@jeongmany529	human
@clurlie	org
@SCULismoreCLV	human
@anygivenfood	human
@paolys	human
@ashleyschwenkel	human
@nanoobaby	human
@KareemNaaman	human
@DowntownRideau	org
@ryandasissoto	human
@kayeaug04	human
@TechBreakfast	human
@cocoism	human
@eugeneetcook	org
@beechwoodbandb	human
@trangdangle	human
@lakshansen	unknown
@KTheStylistB	human
@rosELLEmnop	unknown
@JoojiMaikeru	human
@LuthVanD	org
@colotime	human
@Austinpublisher	human
@teewern11	unknown
@Cheektint31Dg	human
@darekultura	unknown
@JimTT11	human
@Iris_Teoh	human
@misa_ie	org
@FadhliSafar	human
@UnbornOrochi	human
@sycamore_hyvee	human
@tonno90	human
@aobertop	human
@AktionDemograph	human
@duggansbrewery	org
@SaucyRecipes	org
@yuuka_xxx6	human
@EMewe	human
@Muse_Writer	human
@Michae11O	human
@rosellegqf49	human
@HisfancyGal	human
@Stheels	human
@kimnawa	human
@rmcajucom	human
@caoluhuzii	human
@gilbertsbakery	human
@isadoralucrecia	human
@Clarabella590	human
@yumippe15	human
@RamadaPortrush	org
@lyndac1234	human
@SassPulpaki	human
@StianMT	human
@steph87usa	human
@Sheri_Myles	human
@etcblogmag	human
@hotelplazanice	org
@BNoble4Life	human
@ayid_funky	unknown
@_renboi	human
@DadaTortona	human
@LorenaGuGa	human
@PalmePamela	human
@janebarredo	human
@ProductTestUSA	org
@AwieAwan	org
@77117	unknown
@sheridonmcgrew	human
@tehbuster	human
@_PineappleCake	human
@itsmelady	human
@DoNotDieYoung	org
@halholdenbache	human
@joana_id	human
@maalpedro	human
@AndreaEAntal	unknown
@team_slug	human
@mustardbeanie	org
@CarissaAnneB	human
@conmuchorollo	unknown
@409restaurant	org
@GemmaGWoww	unknown
@nefertitidubai	org
@Pamalot28	human
@SlevyCzech	human
@cerdallanosycia	human
@SuperRawKitchen	unknown
@riii_na137	human
@SoleiSoSmooth	human
@T_Andi	human
@ChefChristaM	human
@ero_tuito_	unknown
@BroadcastingBea	human
@NayiMeowMeow	human
@TrafficNgayon	org
@1DENNISDESANTIS	human
@KelloggsAKN	human
@Gaby_Diaz95	unknown
@banazir	human
@brutweets_uk	org
@MyLittleRecette	human
@TheFoodCo	org
@Trinity_Fitness	human
@BBHstl	unknown
@FastFoodLondon	human
@ChrisMartinezPA	unknown
@melfurnari	human
@abroad_me	org
@IamCody45	unknown
@JC_Rosals	human
@rsamlopez	human
@nurullrizal	org
@just_jenine	human
@TheGlenfarg	org
@HardRockMed	org
@PrincessGDust	unknown
@FamilesFamily	human
@NutribienInfo	human
@ohitsfergy	human
@SimonPaulClose	human
@s3cu7ar	human
@mamazanobia	human
@athinavalyraki	human
@CharlotteBell3	unknown
@ktnobmzk	human
@LeJim21	human
@sterlingsauce	human
@elainechiew	human
@RajSanthana	org
@iamdeedra143	human
@eProFitFoodie	human
@123banjotuner	org
@WittlesDeli	org
@HashtagSD	human
@MistahMez	human
@paigeye	human
@turningblog	human
@colega1989	human
@bfastxgreens	human
@MissOLee	human
@dadelaidelm	org
@MYWHIMSICLE	human
@otu67	human
@fica2209	unknown
@daijiraamen	human
@elin_eduardo	human
@mikes41720	human
@andamanpavan	human
@cathbrillouet	human
@SofitelLondonSJ	org
@BJ_ParkerJones	human
@BiennaleTC	org
@justcallmeDLY	human
@drewd_abides	human
@sweetlikez	human
@TaylorPrecison	org
@syidakarunia	human
@citypig88	org
@kelsangdongsar	human
@BrookeMontes	unknown
@RealJherzEm	human
@j_s_shannon	human
@MrsPatsos	org
@TrastiendaTapas	human
@iLoveJounieh	org
@AbbieLeighPowel	human
@louisalim95	human
@MrcssDvlaa	unknown
@nina_barberis	human
@sumtxkid	human
@rudeey_hbb	human
@kanondhee	human
@AgraColombo	human
@moonlightmornin	unknown
@sjgrlinbkfld63	unknown
@VanessaNewkirk	human
@kristineslate	human
@academyfmthanet	org
@InterConNairobi	org
@jerrickoi	human
@denisepala	human
@myfitnesschoice	human
@Paperfiguae	human
@FloridaLoverUSA	human
@chell_chellz	human
@FSToronto	org
@sevenoakszumba	org
@YesaPrisci	org
@serialindulge	org
@icliniq	org
@VinoLasVegas	org
@mo_azim	human
@harprawbargrill	org
@osixmg	human
@glutenburg	human
@mangoclothing	human
@Jaco_Baez	human
@mhauherrera	human
@ReeseBeauty719	org
@atheneze_jan	unknown
@justjoda	human
@Caterinadiiorgi	human
@osteriagiogo	human
@ncmamabird	unknown
@VioletRoseapple	human
@ratedPGV	human
@AlmaAlessandra	human
@jolenzBE09	human
@KelloggsUS	human
@fr0zen	human
@_gugap_	human
@BaruBrezi	human
@sanderson95	human
@Gabriel_llano	human
@LizziE_cho	human
@maki_hirose	human
@joannamma	human
@thewarriorlady	unknown
@DIYActive	org
@VeganCallie	human
@clairsentient5	unknown
@ThingDoerdotcom	org
@IamJoanneHeart	unknown
@gracunningham	human
@LucasParkGrille	org
@Reentot17	human
@PollyGredley	human
@allaboutdann	human
@loseittea	human
@informationkumi	human
@dynamatoles	org
@w7nG5	org
@MonitaOropeza	human
@carabaccia	unknown
@enyceexdanny	human
@chrisandjuelz	unknown
@answersos	org
@Redstripe89	human
@rahulkshetry	human
@solagraciafm	human
@yuuuri37	human
@VincentDynamo	human
@FabulousArizona	org
@ShannaMSimon	human
@reluctantp	human
@TheRopesMaine	human
@justcranky	unknown
@febryloh	human
@JashuMistry	human
@beelhana	human
@bluehominy	org
@mey_is2	org
@UrbanMeadowCafe	unknown
@Paramountperson	org
@MeiRebagliati	human
@MasQMenosUK	org
@29Vogue	unknown
@Yu_koara	human
@ET_xbeings	unknown
@nanacoco_	human
@CocktailDeeva	human
@acicomb	human
@tinabotot	human
@munknlala	human
@mommadhouse	human
@eshturns_u_on	human
@hossy_style	human
@JCRamos55	human
@Randirobics	human
@fitclubvegas	org
@SicaYama	human
@MrJRDrain	human
@OG_Goonster021	org
@torinomama	human
@rich_kids_4eva	unknown
@NanaLingwei1906	human
@natashankpr	human
@Lantipasto	org
@sesquius	human
@EastBessie1	unknown
@AlamtiniAhebAl	human
@MentariRirin1	human
@cosme_Ulap07	unknown
@samtingwong09	human
@pronokaluk	org
@TheTroyReport	unknown
@VeronicaOtta	human
@TOWER4HIRE	human
@GDVIVI_EN	unknown
@Starhotels	org
@ameleithe	human
@SofyaBenzakour	human
@eatfreshtrash	human
@shui510	human
@love_yuyu1212	org
@MzBrittney85	human
@snailong	org
@MilestonesKam	human
@homeinFLX	org
@RaEyes1	human
@nuvolarossa18	human
@Frootishus	unknown
@StephMarieC99	unknown
@AuthorCHKelly	org
@Manoletebcn	human
@mstitisari	org
@Airgmichelle	human
@lloydwhiskey	org
@NowByu	human
@RCCantina	human
@thechiclab	org
@enchantedremedy	human
@ExpatMUAddict	human
@kaistinamonggu	human
@VolleLotteBlog	human
@bongConcep	human
@madhvibd	human
@therrrrachell	unknown
@MarcysCom	human
@younus257	human
@marusatsu24	human
@usnamom2014	human
@Tavmacdougall	org
@HellaCrayy	human
@ThatguyTaii	human
@peterboroughsxp	org
@Iamjiggielina	unknown
@voicebbfu	human
@imurdev	human
@angelynz95	unknown
@cher_iver	human
@AlfiesDublin	org
@jennygreensings	human
@TamarLpz	human
@samperry07	human
@esthermeiqi88	human
@SpringCassidy	unknown
@hunysueaida	human
@Fashiontweeter1	human
@chichaaang	human
@veganliferae	human
@strumpet101	human
@TheFI3RCEMrs	unknown
@padilla624	human
@Armando_Rafael_	human
@Mykonos_Greek	org
@lilbusgirl	human
@LifeAsLloyd	human
@TheSpicyDiva	human
@PlantBasedPaige	human
@TerraMaeBistro	org
@Tamarah_Go	unknown
@BDixonPhoto	human
@mel_issab	human
@jean_niemeier	org
@Jayson_B24	org
@KnownStarz	unknown
@terinrin	human
@afro_63	human
@robetz_han	unknown
@kumausagirope	human
@malebumbeauty	unknown
@QSRmagazine	org
@EbonyNJGordon	human
@penandpencilnq	human
@AlanWilliamHard	human
@DuggGraves	human
@ResidentKonte	human
@UncreativeMommy	human
@kinobajka	human
@narisells	org
@adzramel	org
@jesminejonas	human
@burstono	org
@Claraklaara	human
@TikiTender	human
@TastyTripod	unknown
@ConsciousCrvngs	org
@jkfranchesca	human
@blu3_a11_r1s3	human
@RemodelWorksBK	org
@risachan627	human
@milanbirmingham	human
@Sparklyrainbows	human
@ChloeGa62305195	human
@paolettabolo	human
@sarahohm	human
@BedivereLB	unknown
@marsailors	unknown
@BENGRABS	human
@QuenchGlassware	org
@mikedeancomic	human
@PaulLudlow	human
@radioxtiv3	human
@dwellersfilm	human
@Smoakworkz	human
@gtk77	human
@mrmatthewhoward	unknown
@esthererwt	human
@johen_mee	human
@KTara4444	human
@kikiwongkiswork	human
@vbrown1221	human
