@jillianhailey	OW*
@jas2995	NO
@PoukaBabbi	NO
@peaches8790	NO*
@Zachylilly	NO
@MaritzaMarinax3	NO*
@iMsCandie	NO
@Hannah_Barnett0	OW
@divaindi	OW
@FrancescaHolt	NO
@petalisbless	OW*
@ENVYblognovel	OW
@LaToyaSCooper	OW*
@kclarkcfc	NO
@_ForeverQueenD	NO
@nicolereitz92	OW
@JasonKing1979	OW*
@BRITTANY_SHEARz	OW
@Kaylla_Llyn	OW*
@fresheima	OW
@fatgrrrls	OW*
@ButStuffNThings	OW*
@g_kohls	NO
@msteaupax	NO*
@ikiwn	OW*
@AimeeLouFlynn	NO
@KanyaSalinas	OW*
@wil_stryder	NO
@radfatfeminist	OW
@MeghanPemberton	NO
@KMGVictoria	NO
@kltorres82	OW
@blueskies_	OW*
@happy2xjoy2x	NO
@OliviaCroom	NO
@ChloeInCurve	OW*
@paigeruland	NO
@WriterAllieR	NO
@marcy718	OW*
@jee_AHN_ah	NO
@thesundiamond	NO
@katieeitak297	NO
@SangeetaRannee	NO
@UCLAKerim	NO
@jillblair	NO
@BraveMermaid	OW*
@TheyCallMeBing	OW
@inaziyaqureshi	NO
@JamieRLyons1	NO
@TaneshaAwasthi	OW*
@addisonj29	NO
@Kelsey_Koz	OW
@ckrusch	NO
@ChelseaToyah	NO*
@kingehdee	NO
@EmilyAnne95	NO*
@TheyCallMeBur	OW
@MorganSkylar13	NO
@abbistannard	NO
@dmhaggerty2	NO
@cazkins1	NO
@missypkg	NO
@BethVaughnRTV6	NO
@LeahShafik	OW*
@IvethSa35104618	NO*
@vquinness	NO
@tyegreeneyes	OW
@EmilyMeusel	NO
@hayleyalexandra	NO
@mshpiper	NO
@SquirrelBalls2	NO*
@Twirl4meK	NO
@Cuauhtemoc_CH	NO
@lique_12	NO
@charlatimer	NO
@BrayBray27	NO
@JChaneice	NO
@MSweetTreasure	NO*
@Shannon1405	NO
@AshleyWesttt	OW
@Jaded_one_ftw	OW
@lari_lynn	NO
@cocoforever141	NO
@MeganZombiee	OW*
@JNelly43	OW
@MaureenAimee	NO*
@EarthWindFire82	NO
@joolzplus	OW*
@holly_philomena	NO
@TheGingerPear	OW*
@ashmancex3	OW
@jodie90seabrook	OW
@X2o__	NO
@Lexspacio	NO
@itsMtotheG	NO
@SaraChernoff	NO*
@DivineMrsDiva	OW
@sarahlamrich	NO
@abbmorganxx	NO
@FThic	OW*
@BrotherEzra	OW
@Piddcast	NO
@vaichin	NO
@YoungQueenAysha	NO
@_alexiskeyona	NO*
@KirstFaulks1	NO
@sarahleggexo	NO
@durkniggler1	NO
@yannie_73	OW*
@Gia831	NO
@mrsjacko85	NO
@youhaveadriiixo	NO
@Scarlett_Curves	OW
@abby__salmon	NO
@LindagreenMrsGx	OW
@Shhreenny	OW*
@SydneyLeliiAnn	NO
@Juicybstorm	OW*
@AngieSandoval33	NO*
@Byagi	OW
@Itslizblanc	OW
@boberella_alice	OW
@iamcorb	NO
@callherfancy	NO
@litblossom	OW
@kocky_fat_bitch	OW*
@kiddotrue	OW
@kst2456	NO
@_hanjayy22	NO
@dawnjeanine_	OW
@GoonerKJP	NO*
@Jula1	NO*
@ItsJazzie_ToYou	NO
@laurpX	NO
@freudianfoodie	NO*
@fatgrrrlforlife	OW*
@SugarDarling	OW
@lizziieeepie	NO
@emmarose768	OW
@courtcobalnn	NO
@TedLangill	NO
@mariposa_renae	OW*
@BuffaloGirl23	NO
@wet_pterodactyl	NO
@Rosejen83	NO
@josearod	OW*
@BerniChalmers	OW
@Webby1808	NO
@kepryce	OW
@nicolac90	NO
@She_iz_NeMa	OW*
@misstytoyou	OW
@apriljane96	NO
@_jillianmary	OW
@IHopeDavis	NO
@LyseeNicole	OW
@gothamlover23	OW
@xokhaleesi	NO
@_sugarWALLS	OW
@michealaalexis	OW
@Cfarr__	NO
@MarthaWatsonxx	NO
@Sarah_Pinkston	OW
@garza_puerto	NO
@pbfhpunk	OW
@cathryndawson	OW
@S_Alisma_x3	OW*
@MelaniePaigee	NO
@KCrupper	NO
@Chloe_Dawson_	OW*
@angryblonde_	NO
@cariadontoast	NO
@WhereLeanneAt	NO
@Natie_Dominguez	OW
@ldoherty3	OW*
@DollyMendez	OW
@HBfromKC	OW
@bakergem	NO
@D9MSX	NO
@WinkeeKrick	NO
@ashleyreed__	NO
@annejparris	OW
@mdooher	OW
@RahenaTB	NO*
@keiseveila	OW
@ChioCho	OW
@mandygriggs	OW
@CindyTjensvold	OW*
@leanne_berry90	OW
@emilyfaith35	OW
@O_sO_Jazzy90	OW
@heres_maggie	OW
@J_Lynne_	NO
@fxk	NO
@MalindaONeill	NO
@Ian_W_Kelly	OW
@moneymaknme	NO
@SunnySMurthy	NO
@lebowskigurl	NO
@mavensupdate	OW
@FeiFei_Hana	NO*
@boat999	NO*
@marypoppings	NO
@linalacy_	NO
@Rebeca_Guzman_	NO*
@RetroLoveBeauty	OW*
@craftybeeress	OW
@phankablam	NO
@voodoo_luv101	NO
@Annabellender	NO
@soapboxteacher	OW
@SheIsTammyD	OW
@CarlSutton9	NO
@sandrasathome	OW
@raremuah	OW
@KikkiPlanet	NO*
@SprinkleMeGlamB	NO*
@dicksmith110	NO*
@FourN7	OW
@LaurenHensonx	NO
@lizethhpa_	NO
@vanessafinessa	NO
@MissMinaMina	NO*
@PlainMrsJane	NO
@KayeRavyn	NO
@Jewel_Nicole	OW
@EmLaEmLa	NO
@boykatie_	NO
@MyBellaMoxie	OW*
@samantha2113	NO
@GeauxKris	OW
@MissInformed11	OW
@tamluvstowrite	OW
@Sassyannn	NO
@Katykicker	OW
@dogstagemom	OW
@FatManWriting	OW
@mandiebruce85	OW
@msbudgetbeauty	OW
@ALYSSAmaSKEET	NO
@9starz	NO*
@bushthompson	OW
@novelty_na	OW
@rumblespur	OW
@PalomaSharma	NO*
@risapulver	OW
@IrmaSantamaria5	OW
@kirsty__gx	NO
@Nicola_LilyUK	OW
@Vernanda_J	NO
@LuckycharmMw	OW
@Ftbcom135	NO
@anthony54250262	OW
@Rosiee4L	OW
@hopebeav	NO
@Dotellmawii	NO
@jaccquuelinee	NO
@JusttSteph	OW
@tayylorjaye	NO
@BarbieDollBoss	OW
@uscchick81	OW
@kalikleo98	OW
@Apr1L1	OW
@hnicole_00	NO
@ooginboogin	OW
@mycoffeegoddess	NO
@Lottie_Lamour	OW
@MindySuuuprise	NO
@RosieVanM	NO
@kgirlz44444	NO
@LaurenaVentura	OW*
@AnthonyTuala	NO
@erin4573	NO
@Claira_bell	NO
@bittyboo85	OW
@jessfect	NO
@MLahage	OW*
@_deldefelice	NO
@qlina03	OW
@MichelleMazuros	OW
@oirae	OW
@dayaknee	OW
@DestineeElaine	NO
@queenazsa	OW
@pretty_kb	NO
@machomeg	NO
@gabifresh	OW
@ChloeGower	OW
@nellienel3	NO
@Alonso7349	NO
@brave_star92	OW
@nickanderts	NO
@lebgotskillz	NO*
@_WeAreAllNegan_	OW
@_sApPhIrE_06_	OW
@phat_cupcake	NO
@daithiorourke	NO
@Syl198	NO
@JohnGermaine	NO
@hilarygrant112	NO
@factgammon	NO
@IEatSleepTravel	OW
@LynnetteTOG	NO
@GirlGeekInDress	OW
@KahulaLui	OW
@Stuart_Briggs	OW
@samantha_chang	NO
@jessybooramirez	NO
@MissSlinkySW	NO
@ellaburrows	NO
@LauraKings	NO
@rachelmurray__	NO
@_eignAzodneM_	NO
@Athenamo	NO
@jennylamb	OW
@Zazaa	OW
@c_reed61	NO
@SBTCDCharli	NO
@FulleeFabulous	OW
@look4thewoman	NO
@KayyMadison	NO
@zTaylorRyan	OW
@DrHudson05	NO
@VitaaLunaa	NO
@HenryHate	NO
@wee_frumpy	OW
@elo1617	OW
@beckpoppins	OW
@Whit_Tobei	NO
@mrs_yamz	OW
@IllustriousLady	NO
@Lindseychef	NO
@Brightnystar	OW
@blondecurlyhead	NO
@LaughterandCarb	OW
@Love_My_Unicorn	OW
@KrizZtyLE	OW
@smocksapologies	OW
@blakekimball	NO
@LaraElectra	NO
@plussizeproud	OW
@Teal_Mystique	NO
@bl3berry	OW
@Anny_Poppins	NO
@aleprahl	NO
@muki7x7	OW
@kerrie_thorn	NO
@emilykrust91	NO
@ArchedEyebrowBR	OW
@NameAndAFace	NO
@jaymo__	OW
@oh_mandy93	OW
@paul_curry97	NO
@Kimmeejack	OW
@Amrita_x_	NO
@kiranmartis9	NO
@DinoSolankii	NO
@KittenCrit	NO
@Powderpuff_Room	OW
@lenabeanna	OW
@authemmie	OW*
@cussattasays_	OW
@TheLezbo	OW
@TylerCronan1	NO
@_bellanina	NO
@ObvzItsAndrew	NO
@StarfishGawdess	OW
@runaroundraq	OW
@DaMotherOfLiam	OW
@paisleyplus	OW
@Adam_Ringland	NO
@ChiProducer	NO
@superkakkoii	OW
@Maribabaz	OW
@NikkiCurliGirl	OW
@SuziSimi	OW
@jamieefoster	OW
@Love_itx0	NO
@Aamanaa	NO
@Andibelle1221	OW
@thatgroovysoul	OW
@OOsal	OW
@bee_on_cuh06	NO
@lungowe	OW
@JesseVCoffey	OW
@TheExhaustedMom	NO
@MrsSammyB13	OW
@nvbellefeuille	NO
@Ktelfx3	NO
@pegsterwan	NO
@sensi_socialite	NO
@hayhay_swims	NO
@melissaleyva4	NO
@cheryls1mx3	NO
@forevrjwills	NO
@haylz_03	NO
@CupCake8805	OW
@FabulousFatGurl	OW
@toner426	NO
@electroskippy	OW
@SaraaSaunders	NO
@ill_Luminati	NO
@MissFrances86	OW
@katierose44	NO
@Carla_Paige	OW
@Frau_Griesgram	OW
@kodakfeelings	OW
@TinaMcGuff	NO
@yomanaja	NO
@Angelac59518625	OW
@MichelleSwoons	OW
@PaulaDeanne13	OW
@JabberjawBTLS	NO
@PrincessVenom81	OW
@CharlotteBoosey	NO
@sophiternal	OW
@akichoklat	OW
@guiyah	NO
@Lizonastage	NO
@_msjxm	NO
@jovannayious	NO
@SuzyFHomemaker	OW
@GweNdzalo	OW
@Hemingweed	OW
@lizziejoy1023	OW
@_Joham_	NO
@DisChixBadd	NO
@GarnerStyle	OW
@TheGorgeousNerd	NO
@heather_heywood	OW
@boomitsace	OW
@AsianFusionGirl	NO
@CraftyChica	OW
@littlekateface	OW
@HeyBabyItsCaty	OW
@elenaprosser	NO
@SteffyAnne	OW
@TwylaDMV	OW
@CupCakeMyHeart	OW
@SarahLCutts	OW
@RubyWanders	OW
@SteffyFullStyle	OW
@zombicurious	OW
@DylanJDavis_	OW
@SHAlilbear	OW
@ShowingElegance	OW
@aplussizedgirl	OW
@mrJohnnieR	NO
@strellabjj	NO
@weblossomwedie	OW*
@JenesisJW	OW
@JustaRebel89	OW
@CirocObama	OW
@aniecemarie69	NO
@Captaincuuuunt	NO
@_PrincessV93	NO*
@thecreativegeek	NO
@MsAliciaMack	OW
@aliamariee	NO
@Amywestwood01	OW
@damnitness	OW
@LauraML84	OW
@cakequeen11	OW
@missleighcarter	NO
@ASouthrnPrincs	OW
@hleethal	OW
@Nellabbeauty	NO
@MissyMalii	NO
@desee7	OW
@Angie_Found	OW
@t8ortot9312	OW
@SteelersGurlie	OW
@JoannaLogan1733	NO
@jackiehagland	OW
@FletcherSasha	NO
@julay_le	NO
@thisbeyayaa	NO
@SaaraLynn_	OW
@shernasium	OW
@NormaMaree13	NO
@EMBuddy	NO
@justthatlilly	OW
@mryjhnsn	OW
@BigHipsRedLips	OW
@milliemongo	NO
@jaquonna_vinson	NO
@_sashacavender	OW
@tbarbree	NO
@SoNotTogether	OW
@thefatandskinny	OW
@seductive_riah	NO
@EmmaPerna	OW
@barbarita	NO
@TheRealLexis	NO
@KurvyShe	OW
@jessbyrd13_byrd	OW
@darealstacey	OW
@piggybear_carol	OW*
@Siany_Poo	NO
@emmamaid	OW
@emorse19	NO
@KenHodges10	OW
@xoNatashaLouise	NO
@elissacnicolas	OW
@FFrenda	OW
@kristinekirby	NO
@__missdemi	NO
@aoliver94	OW
@JasonKing1979	OW
@stmcgraw	OW
@JBlanchardlive	OW
@holtcomedy	OW
@JNelly43	OW
@k4s7	OW
@RyanDookie	OW
@mdooher	OW
@FunnyFatGuy3	OW
@DouglasJPump	OW
@GluttonEire	OW
@thefatdrake	OW
@alex14blue	OW
@MILLERMAN41	OW
@d3vind4vis	OW
@suckaducka707	OW
@piannello04	OW
@Bearded_Coach_W	OW
@Jmart316	OW
@TheBuffOne	OW
@cfowlerwvu	OW
@jwilkes81	OW
@jburj	OW
@jwoods2112	OW
@DeusExRequiem	OW
@TheRedGlasses	OW
@ScotPThomas	OW
@SuperJT	OW
@victorcruzfilms	OW
@pdaveb	OW
@rebornboy7	OW
@omnichang	OW
@DavidTurner180	OW
@Torch14	OW
@movieguypaul	OW
@srodrigueziii	OW
@ThaMadZak	OW
@Trei_Gamer	OW
@Polby	OW
@Gabe_Bacine	OW
@__j_0_s_h__	OW
@Walker_009	OW
@Walshy1542	OW
@rtesch70	OW
@BustinJustin951	OW
@gbok71	OW
@Hammie62	OW
@JASON_JARVIS	OW
@sallydatgirrl	OW
@stephemccoy	OW
@Stormnlinks	OW
@tonichelleak	OW
@_LizzKessler	OW
@dayaknee	OW
@jessybooramirez	OW
@PeachieMcGee	OW
@klzipp	OW
@tattdkiki	OW
@qlina03	OW
@20smthingmuddle	OW
@soapsa	OW
@GrahamsGirl	OW
@ashleyAF_fo	OW
@KShort8	OW
@cupcakenasshole	OW
@Kelsey_Koz	OW
@genny_swift	OW
@fhayefg	OW
@teresadf	OW
@HeatherOsborn	OW
@MsMoneyMagnet09	OW
@sarlynclements	OW
@abbmorganxx	OW
@vickyagui22	OW
@savannahfaitthh	OW
@klskingle	OW
@JorDonnieGirl1	OW