 AL	Alabama	AL
 AK	Alaska	AK
 AZ	Arizona	AZ	Phoenix
 AR	Arkansas	AR
 CA	California	CA	Los Angeles	San Francisco	San Diego	Cali	Hollywood	Bay Area	City of Angeles	San Jose
 CO	Colorado	CO
 CT	Connecticut	CT
 DE	Delaware	DE
 FL	Florida	FL	Miami	Orlando	Jacksonville
 GA	Georgia	GA	Atlanta
 HI	Hawaii	HI	Honolulu
 ID	Idaho	ID
 IL	Illinois	IL	Chicago
 IN	Indiana	IN	Indianapolis
 IA	Iowa	IA
 KS	Kansas	KS	Kansas City
 KY	Kentucky	KY
 LA	Louisiana	New Orleans	Baton Rouge
 ME	Maine	ME
 MD	Maryland	MD	Baltimore
 MA	Massachusetts	MA	Boston
 MI	Michigan	MI	Detroit
 MN	Minnesota	MN
 MS	Mississippi	MS
 MO	Missouri	MO
 MT	Montana	MT
 NE	Nebraska	NE
 NV	Nevada	NV	Las Vegas
 NH	New Hampshire	NH
 NJ	New Jersey	NJ
 NM	New Mexico	NM
 NY	New York	NY	New York City	NYC	Brooklyn
 NC	North Carolina	NC	Charlotte
 ND	North Dakota	ND
 OH	Ohio	OH	Columbus
 OK	Oklahoma	OK	Oklahoma City
 OR	Oregon	OR
 PA	Pennsylvania	PA	Philadelphia
 RI	Rhode Island	RI
 SC	South Carolina	SC
 SD	South Dakota	SD
 TN	Tennessee	TN	Nashville	Memphis
 TX	Texas	TX	Austin	Houston	Dallas	San Antonio	Fort Worth	El Paso
 UT	Utah	UT	Salt Lake City
 VT	Vermont	VT
 VA	Virginia	VA
 WA	Washington	WA	Seattle
 WV	West Virginia	WV
 WI	Wisconsin	WI
 WY	Wyoming	WY	Cheyenne
 DC	DC	D\.C\.	District of Columbia	Washington, D\.C\.	Washington, DC
