@takitokitchen	org
@Nutriphys	org
@HighlandParkMkt	org
@EmporiumThai	org
@traykitchen	org
@SunsetSmoothie	org
@alimentum1	org
@Rialto02138	org
@JimsCountryEats	org
@HogandRocks	org
@Reds_Place	org
@DickeysBBQMN	org
@Project_Raw	org
@eatatblueroom	org
@DrinkYour_Juice	org
@LifeatFFN	org
@krystalskorner	org
@TGIFNewportNews	org
@calpastachico	org
@PreNatalPilates	org
@EnduranceZone	org
@BodyShopNA	org
@heart_and_belly	org
@ModCloth	org
@midwaypizza	org
@EdgeMiami	org
@ColdHollowCider	org
@FreshandFabCafe	org
@yogajoy11	org
@CoonamessettInn	org
@DanielasNYC	org
@WhiskeyKitchen	org
@Schillecis	org
@JaaliBean	org
@Doma_Restaurant	org
@GranvilleCafe	org
@DonckersOnline	org
@ScottsdaleRST	org
@BrooklynWBagel	org
@appPicker	org
@TheViewUST	org
@OomaTesoros	org
@SixSistersStuff	org
@YatCuisine	org
@SoleHealth	org
@M5International	org
@CorkandCuisine	org
@TheBite_KC	org
@EatAtVeneto	org
@EventsByMomo	org
@blackoakomaha	org
@baconandbutters	org
@GSISocial	org
@EggAndCheeseYo	org
@SonomaFarm	org
@vivianafoods	org
@bklynbrewshop	org
@TGIFNewark	org
@JAMRestaurant	org
@FSPhiladelphia	org
@LowellsMendon	org
@PinkSumoCT	org
@ACDMedia	org
@HendersonCox	org
@StFoodieDiaries	org
@HappyTomatoFood	org
@MapleAve147	org
@MainStrGrill	org
@CookieDept	org
@CaracolHou	org
@HaliHannigans	org
@AmishMarketTrib	org
@SeedNourishment	org
@BLDBeverly	org
@astoriacafewine	org
@JellyUcafe	org
@RevolutionBloom	org
@IronHillMS	org
@AmericanEatery	org
@LIVESTRONG_COM	org
@ETLCblog	org
@BeautiqueInNYC	org
@JaguarCeviche	org
@MoxieFL	org
@TableHost	org
@SofiaVoloWine	org
@LilMsSophia	org
@exchangenb	org
@QueenBeanCoffee	org
@SchoolhousPaoli	org
@3FitSis	org
@PuritanCo	org
@Foodseum	org
@TriciasList	org
@ArtisticELA	org
@riceNnoodles	org
@PritikinCenter	org
@UbonsBBQ	org
@GetChopbox	org
@BringYourDate	org
@cgeclectics	org
@autochlorsystem	org
@WrightBBQCo	org
@AFCSoyFoods	org
@AmerigoTN	org
@manisnacks	org
@NaturesHabit	org
@PressCoffeeBar	org
@narberthcafe	org
@OpiaRestaurant	org
@sightseethecity	org
@LuxorLV	org
@MeliCafeChicago	org
@UnitedConcordia	org
@CouponCabin	org
@OTCRestaurant	org
@FerventLoveMedi	org
@Nextdoorganics	org
@PigoGozzi	org
@HmtwnHrvst	org
@JohnnyBrownBag	org
@DietitianSherry	org
@RanchOne	org
@cityQuickerNYC	org
@AKOutdoorSports	org
@CraveLocal	org
@NuValTexas	org
@mommacuisine	org
@StarbucksGelman	org
@CaninesCouture	org
@IdeaFS	org
@AlsCabin	org
@ThreeSanMateo	org
@GloriaOConnell	org
@ToulouseCafe	org
@HunniesCupcake	org
@RudysTenampaKC	org
@loveyourpark	org
@JohannaMHaack	org
@SeattleVacation	org
@EquinoxDC	org
@BeeHiveOven	org
@ColombianFusion	org
@BalansUSA	org
@SwineSouthern	org
@ShoreBirdGrill	org
@AlohaKitchenLV	org
@EatDrinkThePark	org
@FarmersRdDrThru	org
@PoogansPorch	org
@CnR_Pub	org
@chewsylovers	org
@UNIONKitchenTap	org
@App_iTize	org
@NikosBarTaylor	org
@javaearthcafe	org
@SunsetHouston	org
@MiamiLunch	org
@BonfireMankato	org
@RandyFuhrman	org
@DigitalLA	org
@CyberCFOUSA	org
@ElisCheesecake	org
@Denver4Lunch	org
@grogreek	org
@fishtown	org
@SmokingGoose	org
@Granite_CentInn	org
@TicoRestaurant	org
@Extreme_Pizza	org
@VerdeFoodTruck	org
@LeawoodPC	org
@BuffaloBrunch	org
@MunchistLA	org
@KiwianaNYC	org
@Norton_Health	org
@IKEA_Tempe	org
@ChristysChomp	human
@Cloudchaser921	human
@chompiesaz	org
@JennCharlotte	human
@johnforbis	org
@TheGladly	org
@yafreaka	human
@itsIRISS	human
@50mmart	human
@TheModerik	human
@1000goodbyes	human
@abby_thefablife	human
@8x10proofs	human
@PeterKunka	human
@IvannaExposya	human
@tracyofcourse	human
@thewperry	human
@4GirlGina	human
@Seanslongtrip	human
@EclipseSTL	org
@actoraldo	human
@wizbang2093	human
@LidiaPoet	human
@4theloveofcurls	human
@JeannieMyrick	human
@coxxy666	human
@realjoe	human
@Nigella_Lawson	org
@Chriscstrick	human
@Jewels_Cupcakes	org
@meleyna	org
@tedgrafx	human
@Nidocamen	human
@NutriNancy	org
@1Xinfin	org
@GramAndDun	org
@CabooseSpices	org
@topshelfaz	org
@Melt_Shop	org
@Chelsandson	human
@cindynorth1	human
@tatehemlock	human
@juanlara1993	human
@PaleoByParris	human
@issmagicmixes	org
@RayleeHatch	human
@transform2	human
@ForagersNYC	org
@Volksdragn	human
@traina	human
@noGuruDiet	human
@JustinEats	org
@PompanoCC	org
@sanctuaryaz	org
@2homegirl2	human
@pouchpies	org
@JamesTMercer	human
@CCtoMB	org
@MeganNJohnson	human
@chanel_nel	human
@77Moms	org
@mi55g33k	human
@iTzDEViOUSBitch	human
@cindyrhernandez	org
@ManyTastyMiles	org
@RokaAkorAZ	org
@actionjacquelyn	human
@MyFamilyTable	org
@sheryl_lbc	org
@SavingSense	human
@AnticaPosta	org
@MrBangChang	human
@monzanitas	human
@MandaMentality	human
@postandbeamLA	org
@MrKenyattaBanks	human
@ccampbell2009	human
@SangKyanaMarie	human
@KavitaBhuyan	org
@MAHAMOSA	org
@ThorpeWD	human
@lills72	human
@KristinaDaniele	human
@Q_theChef	human
@JamieLBGC	org
@6Percenter	human
@aaronhasspoken	human
@VaughnWessel	human
@33rdxLucian	human
@tylerlagunas	human
@NiccoleaPoetry	human
@joswifey	human
@TonyGist	human
@valdovino	human
@PorkUniversity	org
@mjulieta_	human
@aanastasia	human
@AchiDeb	human
@100eats100days	org
@MeeshOneLove	human
@parsonstraining	human
@BatdorfATL	org
@YNotshops	org
@CaJaPopcorn	org
@MorganDelight	human
@tamikathomp18	human
@PAZCantina	org
@MaloriMayor	human
@MYSSNIKKI053	human
@zanewalling	human
@robtimusprime	human
@KissKrissers	human
@icecreamchef	org
@mollyluise	human
@iheartnaptime	org
@TasmacNCheese	human
@NativeMensMag	org
@Vebinista	org
@1DZLizzie	human
@susan_az	human
@1019thewolf	org
@ScrumpAngel	human
@maccamcmanus	human
@LB_AZ	human
@starheartly	human
@megfit	org
@NubianGlamRock	human
@IamAlexSiordian	human
@charshaff	human
@Bottlefork	org
@MrsMandypants	human
@inherpeace	human
@Car__Dude	org
@KimMillerStyle	human
@ourthreepeas	human
@thepresscafe1	org
@vincentsoncback	org
@NadiaThinks	human
@805BarandGrill	org
@skinyfitlicious	org
@teinte	human
@CHEF_BLAX112	human
@coleyritz	human
@Shades_Of_U	human
@sosathemexican	human
@KMM1130	human
@notcode4	human
@112_al	human
@NateWorthington	human
@StephNLieb	human
@rosatistucson	org
@Bourdain	org
@cooknindablubox	org
@actionteamgv	human
@1000_Cats	human
@OrderPodcast	org
@OysterHotels	org
@ProudEchelon	human
@Pichuberry	org
@IndianGrillNYC	org
@feelfoodny	org
@topdealretweets	org
@CattLovins	human
@VerradoGolfClub	org
@Miraval	org
@Jeanie_Ann	human
@junebahe	human
@so_very_blessed	org
@AnziPizzeria	org
@chandlergilbert	org
@JAYdotSIMS	human
@LHudson	human
@PeaCee01	human
@1chefdiva	human
@InsideCoup	org
@AltadenaFM	org
@AlexisMathewsHM	org
@AliciaAConrad	human
@alexdevera	human
@AthletaFashnSq	org
@awayfaringchef	org
@blendid	org
@bradshaw1984	human
@amandascooking	human
@briel79	human
@blickieblick	human
@brandon110589	human
@BriSeeley	human
@benibonnietta	human
@Amandotrucker	human
@BobSnz	human
@BloomRoomSF	org
@BridalHotlist	org
@BigPoint7	human
@afterdarc	human
@bouncestyle1	human
@BABEL_ROCK	human
@BOLLYWOOD_BITES	org
@Briebrieyup	human
@Atari303	human
@alldonemonkey	human
@BestFatBurnDiet	org
@aimeepanmusic	human
@alexiaanastasio	human
@AustinDavison	human
@Banana_Chuck	human
@BlckPrlEnt	org
@BBEncino	org
@bearstatecoffee	org
@brettdurrant	human
@AHizz	human
@boatelsegundo	org
@aericdk	human
@alexbullon	human
@AliceShort3	human
@blancetrougesf	org
@Axegrind00	human
@BelindaCCothren	human
@AlyssaMorganLA	human
@BerkeleyBrett	human
@BolthouseFarms	org
@aerhta	human
@boudinbakery	org
@bolanos_a	human
@BBWGeneration	human
@AYCMegatron	human
@Adaptamed	org
@BidwellPerk	org
@BrettMalec	human
@actressmbonilla	human
@AMarie_Reyes	human
@AkashaRichmond	human
@backyardbite	human
@AlannaTT	org
@BrightVibes	org
@baovo	human
@Amanda_Allison	human
@alicetaywong	human
@BabysBBsOC	org
@BethMjimenez	human
@BattrUpPancakes	org
@BiiBiiBeauty	human
@bigolgreek	human
@AdAstra24	human
@barneysbeanery	org
@babybondgirl	human
@bink1002	human
@adam_orth	human
@bassbiz	human
@akaroderick	human
@BiggJaay	human
@ayeetuween	human
@adam_drexlerLA	human
@blueplatesamo	org
@BabsiS	human
@a_pisceslife	human
@AllAbtFashStuff	human
@beretweet	human
@amart125	human
@BriGeeski	human
@boomsygals	human
@Brewbom	human
@bookjanelle	human
@BBCoachAutumn	human
@awells_wellness	human
@bluepromocode	org
@Bookwormaddict1	human
@afoggycitylife	human
@barbrix	org
@BrcelonaOntheGo	org
@BackCafeDuMonde	org
@belkissme78	human
@AErikson13	human
@adamparson	human
@AdamWhittington	human
@BarrioStarSD	org
@BlakkHoodie_562	human
@bellalucia	human
@baby2foodie	human
@BayAreaMommyCom	human
@BrandiHong	human
@BestTalkRadio	human
@aznswtgirl87	human
@AllyLoprete	human
@BarneyButter	org
@alongcameaspydr	human
@bbcmichelle	human
@bossedupshawtyy	human
@BreeAea	human
@BlackHalo39	human
@BreadandCocoaSF	org
@BigOzAfg	human
@A_SweetBoutique	org
@BitchsLoveFood	human
@BakingwColette	org
@beamjack	human
@AllyCakes4	human
@AlbertPostel	human
@adudle00	human
@BassHitter	human
@alyneddie	human
@AJimagePhoto	human
@AyleenGaspar	human
@beatapevny	human
@BloodyMaryTour	human
@Bottegamericano	org
@BaySportsMom	human
@BrigiiteV	human
@bikinicountdown	human
@BleedingBlue132	human
@azumioinc	org
@alergic2vanilla	human
@AliciaSilv	org
@bigtymer32	human
@bikramglow	org
@bcaudill	human
@BreadArtisan	org
@bay_food	org
@blackgirlseatla	org
@BiciGirl	human
@AishaBelaPR	human
@allaboutangeli	human
@BrassPickleDeli	org
@beastmodejavs23	human
@AgentBaz	human
@benomix	human
@bennysoo	human
@aghease	human
@ahappyfooddance	org
@Boardners	org
@akaMaddHatter	human
@Bossiibiitch	human
@Barbarellaf	human
@astroross	human
@ayaredee	human
@billewoodruff	human
@aduenas619	human
@akop_medvedev	human
@ameer1013	human
@B0nb0n920	human
@belmontparksd	org
@alyroux	human
@90h7	human
@AKCuisine	org
@AKPTRSVC	org
@AlaskanaKitchen	org
@Alaskan_Heather	human
@aurelientt	human
@brandonia33	human
@BrownJugAlaska	org
@cinthiaritchie1	human
@CopperRiverWild	org
@DandyManderz	human
@FernandaConrad	human
@hillarygamboa	human
@Josiejanzde	human
@Kate_Dutton	human
@LauraOinAK	human
@MapleysMorsels	human
@martha_florence	human
@mbif	human
@melissahisman	human
@msuson08	human
@pineapple_bride	human
@Pinoy_is_cool	human
@ProduceOnParade	human
@Sades11	human
@sfs52002	human
@ShantayJ907	human
@Sharvab	human
@simonseaforts	org
@stoki8082907	human
@SuperArmyWifey	human
@80sCovergirl	human
@318SWEETSHOP	org
@AlexisBorne	human
@Ali_Sweeney	human
@alisia_E	human
@AllisonFontenot	human
@AlonShaya	human
@AmandaSoprano	human
@AngieWorldOrder	human
@AnneCanCook	human
@April_du2	human
@averysweetblog	human
@Baddie3Shoes	human
@BAnneCox	human
@BeaTheStylist	human
@MaddyBeckham1	human
@jeejennifer	human
@marleneb75009	human
@ThatsVicki	human
@LonJandis	human
@TWHToni	human
@Artlettakid	human
@MrtDiana	human
@BlueNile1957	human
@StephenHelin	human
@pooh05bear	human
@reymondkix	human
@GaryDacanay	human
@JulieAnneR15	human
@PizzaOfVenice	org
@Rose_Zanne	human
@MichaelHJordan	human
@freddysfoodcrt	org
@Boblack98	human
@1917AmericanBis	org
@sushisavedme	human
@KatieJBeales	human
@YouCanFixIt_	human
@Harvestland	org
@DhananiGautam	human
@MatthewBanks3	human
@BurrsBerryFarm	org
@Essexsteve78	human
@SofitelMunich	org
@impossiblerainn	human
@StripDistrict	org
@TasteArkansas	org
@CottonBeachClub	org
@badgertopspin	human
@TasteInThePark	org
@BlockYYC	org
@unionDining	org
@Foxkitchen	org
@johnofficial15	human
@justinecedwards	human
@DigitalCyclops	org
@thepiazza	org
@GaslightBoston	org
@JPSLuxurySafari	org
@funsavingmoney	human
@eatingexeter	org
@Caveman_Foods	org
@CourtyardChakan	org
@Streetfood_SGN	org
@CookinMattersPA	org
@Emily0_oStrange	human
@whipuntilfluffy	human
@LeeBrowski	human
@knightdaniji	human
@megwalds	human
@AnneJoconnor	human
@incurablepicure	human
@thesavingqueen	human
@MsMurderMonroe	human
@RowdyRez69	human
@sakshi7920	human
@Atlanta4Lunch	org
@Boston4Lunch	org
@FeelingItaly	org
@breakfastmag	org
@BelloRestaurant	org
@BillericayNews	org
@Mrs_Rach_M	human
@callmemochelle	human
@PrasannaBidkar	human
@frugalfoodiemom	human
@mandarinfox	human
@GabrucciJoseph	human
@MissKateWi	human
@maydouglas490	human