@VinnimcHIJACK	M
@ernieborts	M
@nicoo_var	M
@madhavdwivedi	M
@FFredFredBerger	M
@pickleshenry	M
@andjazuly	M
@Isaac_West	M
@BaronWestoe	M
@rohannon	M
@DarraghZaidan	M
@AdyBoy65	M
@ryan_conran	M
@kylejnorton	M
@BishopGi	M
@zulz_zizou	M
@jordanblake0	M
@bigdc76	M
@mrcupcakes2014	M
@chefsharwin	M
@matthewwdavies	M
@paulwreynolds	M
@vCenterNerd	M
@ljoe187gp	M
@Joclair301	M
@AndyMarcolin	M
@engeniero_ako	M
@herbivoretri	M
@AverageJIM65	M
@musiccritic11	M
@PeteC1981	M
@ssujitdube	M
@samurysam	M
@ImaginaryNora	M
@headturnerdj	M
@mikilito23	M
@rbatkins	M
@BlackBeardRyan	M
@RichardCrandle	M
@DenRosen	M
@DavidGarayDAG	M
@breezyIman	M
@TheSushiGod	M
@halholdenbache	M
@darrellfishbeck	M
@Docpip0	M
@donnydoit	M
@Keizer_Aquino	M
@VictorAmaro69	M
@BigCuzLive	M
@AskChefDennis	M
@hoeadrian	M
@AllanPerkins	M
@LeeMccleskey	M
@itzbblac	M
@Briamoga	M
@iTravelandDine	M
@AlbertoLondres	M
@PYRO83	M
@LuyLeJit	M
@richiesartwork	M
@220boy	M
@luisfsanchezjr	M
@RobDellaPietra	M
@GheeEnriquez	M
@AZTommyTaylor	M
@willexploreph	M
@BigDaddysMix	M
@DisasterReborn	M
@Colindarbyshir3	M
@markeith86	M
@mike_nugesi	M
@MSiry	M
@FOESAD5150	M
@wsnizam	M
@danishkhan_iam	M
@whowantsdinner	M
@Such_A_Narcist	M
@Macdonald_Watt	M
@RumSoakedChap	M
@antjustcoolin	M
@JustinbArnault	M
@BOBBYBALBOA75	M
@DjayyCharliee	M
@THEMartiniMike	M
@LuiLui06	M
@timgirton	M
@tomcassas7	M
@bertchai89	M
@1_Proud_Dad	M
@akfagan	F
@GiddyPrincess	F
@nitaalnora	F
@SopranoKatie	F
@AmyO_Indy	F
@royciepoisie	F
@mommysnippets	F
@FlurriesofFlour	F
@marygllrd	F
@BrianaLayfield	F
@HammerEmma	F
@uedoahlex	F
@hollyarchibald1	F
@My_Mwikali	F
@BabySavers	F
@julessulls	F
@mscleverKJ	F
@whatjanesays	F
@natashainozblog	F
@bagatyou	F
@Jessica_Remmers	F
@Kalynn_W	F
@mikuniwildpea	F
@EvaCVincent	F
@singerinkitchen	F
@tinathefinn	F
@elsielam	F
@frecklequeen45	F
@judithphillips	F
@giulygi	F
@AtlantaRD	F
@KashmiriBeesham	F
@JulieC13	F
@lazybeautiful	F
@GayleCraik	F
@rona_alan	F
@AProverbs31Wife	F
@cherielianne	F
@emmaeustace	F
@BrokenMeatball	F
@MarinaKatura	F
@musclebabe91	F
@LarkinYogaTV	F
@bcwyngaard	F
@janebled	F
@Healthy_life4u	F
@MrsCashMommy	F
@Naomi_Griffiths	F
@sprinkles418	F
@amber_lee_rose	F
@daIbyang	F
@ItsYAmM	F
@Seraphimslair	F
@TheStyleMartini	F
@StormyWhisper	F
@malvarezds	F
@nicola_marie	F
@katgurl72	F
@HitchcockDarlin	F
@NutritionLeslie	F
@SamanthaSpice	F
@mbthingsiknow	F
@Eat_Car	F
@mtan14	F
@TheSpiceScribe	F
@runawaykiwi	F
@carrieste	F
@AnaRRocha	F
@TE2Perform	F
@365ishPins	F
@4evamamii	F
@DVL_85	F
@JennaSSumner	F
@missusjoy	F
@IOKEYYOUOK	F
@globaldish	F
@100PCT	F
@zebraprintsky	F
@ofie23	F
@emilybratkovich	F
@auranmichi	F
@alma2004satea	F
@moe_lan	F
@misssaether21	F
@candice_mcnish	F
@thunchanok_aor	F
@tcchronicles	F
@evelynblogger	F
@pamelaoctaviany	F
@KendrasTreats	F
@katelynnpedrie	F
@rkmangus	F
@Afitnurse	F
@MelissaRapoport	F
@Lorisjourney8	F
@FitMittenKitch	F
@Lovely_Boiser	F
@zamlos	F
@NadiahJaapar	F
@KimParkAan	F
@Yajaira_Vanessa	F
@Cowthran1	F
@JoshiBieber6	F
@ashasuparna	F
@IngeMuchan	F
@Caypay	F
@cik_coki	F
@niki4nu	F
@swaych	F
@PeculiarForest	F
