@TboneTalbot	M
@WarLordwrites	M
@BurgessMoon	M
@admartinezjr	M
@mrrm_1994	M
@KerryCanCook	M
@NutriBeautiful	M
@FaizalOrtho	M
@bongloaded	M
@STX488	M
@Fischbachz	M
@Catchster	M
@iamAdrianGale	M
@lightboltjoe	M
@planktone	M
@AshworthPR	M
@carpcrusader188	M
@itsmeayan0911	M
@TwoDrunkMonkies	M
@muscleworldnow	M
@iam_robot	M
@ZayyOrtiz	M
@biakaz	M
@SwissLybee	M
@angelinebailey	M
@leroydlf	M
@SergioArjona	M
@TomHall	M
@1Corben	M
@chefvan_dyk	M
@rctwilkinson	M
@sasopapp	M
@Barstoolliving	M
@tajexperience	M
@didsburygav	M
@jonnealeman	M
@RichardDeVita	M
@JeremyWu	M
@johnleesandiego	M
@charlesallen15	M
@AshleyDlite	M
@tbowman88	M
@JaiManny	M
@harrycalat	M
@slantedk	M
@CoachGFit	M
@atty_natzki	M
@Big_Herbster	M
@antoniodivine	M
@Blakhopela	M
@SteveHaweeli	M
@speight_mark	M
@thinkmolecule	M
@abokadomark	M
@IvorRomeo	M
@robertbarry13	M
@ridhuanmohamad	M
@damionhamilton	M
@jordanwillcox	M
@ReverendSkulls	M
@carrelljohannes	M
@mike_m_50	M
@bradmck65	M
@baritonekeith	M
@hmjavio	M
@HadyElHady93	M
@BryanCejas	M
@Navarrarest	M
@itsCabatiaN	M
@emilycardiff	M
@King118	M
@theDickTater	M
@bacspin	M
@akosiJepoii	M
@KingTraylon	M
@BrandonG__	M
@goestiwijoyo	M
@DJREDRUM	M
@DianeCapri	M
@AndrewHeslop	M
@hnwen	M
@markparton	M
@sd4david	M
@theheinekentom	M
@MaycollCalderon	M
@KevinArrow	M
@IamSeanDustin	M
@danrundan	M
@Wreckk	M
@a7mdo0h	M
@sniperwong	M
@johnnyday76	M
@ccodyharrison	M
@Ra77maN	M
@BeingBoycie	M
@jalalspages	M
@beoliu	M
@_AlexDizon	M
@robblee	M
@ldeguzmanpintor	M
@BenFenlon	M
@murray_pura	M
@libbylangdon	M
@johnnykrtz	M
@SunjayJK	M
@heyhodaddyojoe	M
@TWF_Ewer	M
@salman_albanna	M
@jrecarro	M
@heythatsjack	M
@BooVay7	M
@NielGermishuys	M
@princeyuanito	M
@uthemon	M
@pinakadalisay	M
@TheJasonHodge	M
@comet5o4	M
@RussDeGuzman	M
@MohamedSheta	M
@TheIronChuck	M
@vidthekid82	M
@c1int0n	M
@eRiC_Bz1	M
@TsardChua	M
@StormiNormanEnt	M
@benjiebels	M
@going_dad	M
@DAVECASTILL0	M
@DixonTam	M
@ChChChianti	M
@RabbyRich	M
@khansohaibuddin	M
@lilxceejay	M
@Larybs	M
@isurunix	M
@honeyandfizz	M
@rowiro	M
@headphonaught	M
@pichetong	M
@UncleLouie	M
@mattIttam	M
@ecurie12	M
@nadirkeval	M
@derek_madlutk	M
@Nasara_Gargonnu	M
@OzziesPOV	M
@chanpaco	M
@knowledgelaw	M
@KoMoDoZide	M
@AdamPT_	M
@MeynStay	M
@Anthony_Assaker	M
@Workplaysoul	M
@rizal_ninodeale	M
@iamtonico	M
@gevone	M
@URaUseful_idiot	M
@dciplochrist	M
@rpa	M
@Umerlathiya	M
@manifested1	M
@FizzleDollas	M
@pspix	M
@3ndys	M
@Boris80678	M
@Triplesei	M
@rorytothemax	M
@PreachersKid_PK	M
@nigelfoong	M
@moutiz9	M
@putra87	M
@_superb0i	M
@elfabuloso	M
@adl_hsn	M
@jarsiny	M
@Emil3134	M
@PhoenixxMD	M
@WayneStinnett_	M
@_HOANGIIE_	M
@Renat_Sky	M
@ERodenhaus	M
@WLC47	M
@funtime7777	M
@BagBoyDad	M
@lemilcollazo	M
@samlee561	M
@LuigiDiotaiuti	M
@CharbelGhsoub	M
@MikePaineShow	M
@EliaMssawir	M
@gdmFitness	M
@stefanogrande	M
@StevieT2588	M
@skullver1735	M
@MrJonBurk	M
@maxcalbucci	M
@inisidika	M
@matt_hew_boyd	M
@jackwatson05	M
@indradha	M
@mlwoodward	M
@COALITIONBOY_K	M
@DanDanTheArtMan	M
@deanskinner	M
@StevenGalindo	M
@bmcgrew	M
@DJEFFECTLMP	M
@dfmatthews32	M
@sushavan	M
@AidensCuisine	M
@paul_cude	M
@RisBrian	M
@CriminalSingh	M
@sandytoe	M
@earl_johnm	M
@alzy25	M
@philipmilton	M
@quinnCeNation	M
@DiYelSy	M
@JeremyMallin	M
@KvasirYYC	M
@ryanjonesphoto	M
@TheMontyShow	M
@mattbernradio	M
@superheroDJ	M
@FrankieG421	M
@IamShawnNeo	M
@noj	M
@johnoneil1978	M
@ActorDavidChen	M
@jstjaved	M
@Stallonation	M
@nicholascfuller	M
@RamonNavarro	M
@wilumm777	M
@ManoharMankani	M
@rdhillphx	M
@mmm_nachos	M
@EricNRamos	M
@paulj85	M
@urbartender1	M
@IamJesusSanchez	M
@sgtjbourne	M
@zubi89	M
@lesterplatt	M
@Xaviersalinas1	M
@dprihodko	M
@killeveryth1ng	M
@FlawLessKid	M
@im_emouse	M
@Michael_Vasanth	M
@davidgray13	M
@CoalCityEnt	M
@LpeaceChris	M
@ahsamkor	M
@CTSeth	M
@McKeithCordell	M
@joejacksmith	M
@SixerIverson04	M
@PaulKindersley	M
@chavamendez	M
@zriha	M
@JapsDioknoFull	M
@dscaturchio	M
@HectorRochas	M
@arifbil	M
@schooldinners	F
@lunatoona	F
@MsZeineb	F
@J0dieKay	F
@AmandaFaymous	F
@misz_nadya23	F
@kayLEEEsha	F
@fitgirlposse	F
@maemperez	F
@natashajwarren	F
@my3tartlets	F
@sweetpea297	F
@andre_karren	F
@TaraQuigley1	F
@BocaFrau	F
@sunshinesam83	F
@omfgitsMEL	F
@wendyswayhealth	F
@Blogmebeautiful	F
@Fish_Brain07	F
@rebeccanatalie	F
@tweet_ingHAPPY	F
@bredanielle0602	F
@Breezie_24	F
@siriuslyheather	F
@theTinaFan	F
@kristinagill	F
@maddie_mart	F
@MissDivaUntil	F
@ValerieMCathell	F
@SoberJulie	F
@Racheljennielee	F
@italydreamer15	F
@meg_leonard_	F
@theargelhouse	F
@AshleyNevis	F
@culive2ride	F
@ChanellAvent	F
@teawithleigh	F
@thetxpeach	F
@intanjuliet	F
@joyceroxanne	F
@MeJadeBianca	F
@SteakExpert	F
@sunchyne79	F
@holisticvanity	F
@Culinaryqueen6	F
@SuzysNest	F
@NiftyMom	F
@cookiesnsandals	F
@experien_CEZ	F
@frmscratchbecca	F
@wedgail	F
@josato719	F
@angejim0531	F
@DutchLady	F
@moviesweetie	F
@adrianachavira	F
@mskidest	F
@gidgetsafreaq	F
@funmiloves	F
@Michelle_M_74	F
@YPJ2013	F
@Francesc_ahhh	F
@Sherridacherry	F
@MrsBruchie	F
@styleisland	F
@eatspinrunrpt	F
@LeighIngham	F
@ChristineBoegh	F
@Cesckudhy	F
@HerbsnSpices1	F
@GermanCityGirl	F
@vsdresscode	F
@wyrdup	F
@IeshiaE	F
@TheFitSkool	F
@1nOnlyBmounger	F
@fabulousmissmsm	F
@kittymayo7101	F
@MsShanBo	F
@HotMamaNtheCity	F
@CraigBarachiel	F
@_byKiki	F
@dessertnowblog	F
@KPritchettRD	F
@PrinsesaHailie	F
@HeartAddictYup	F
@Missuptan	F
@HuntingDragons	F
@sabinekadyss	F
@JoscelynRC	F
@elizfinch	F
@pediRD	F
@HerJunkMiles	F
@ishisevilla	F
@trinaellen727	F
@lisa74	F
@LittleBitsofLov	F
@LauraWard23	F
@lizjns	F
@MarizonRicheson	F
@dheena13	F
@liakurtz	F
@girlcalledgemma	F
@karentokaren	F
@LucyFarrugia85	F
@SarahAlpha_	F
@AdUmbraLumen	F
@psychofan1	F
@TRussell1120	F
@reenie_rocks	F
@shoelaccey	F
@Jessi_lou_87	F
@EmilyGussin	F
@SaraGalipeauRHN	F
@Susanpuno	F
@basicndelicious	F
@Jackiekovacs	F
@jessicapair	F
@JaniceMarit	F
@mommykatandkids	F
@TrampLeeDesigns	F
@AlicePotenza	F
@happyandharried	F
@lenluvdea	F
@AineCarlin	F
@KomalMirza	F
@jendrakefeltner	F
@TheFlipFlopWife	F
@queen_frugal	F
@Alexx_AndraM	F
@uberbutch	F
@LemorW	F
@Kiaraho	F
@monikabaechler	F
@ShiningWs1	F
@kylasmuse	F
@missharri91	F
@REALHONEST	F
@mrs_jacksparrow	F
@babswool	F
@KeepinUpWithCDJ	F
@HopePeoples	F
@SoulofHealth	F
@Reese22	F
@MissSherell	F
@TeriGentes	F
@VeryToriKaye	F
@Rmfrye	F
@savvysassymoms	F
@thisisAerishxx	F
@musicandhippies	F
@shadeofcat	F
@SimchaFisher	F
@LeeAnn915	F
@yellowcumbrian	F
@tiramisu8	F
@meichanTJ	F
@deejaybarte	F
@soniakruas	F
@ShanaHuff001	F
@ByJoBeach	F
@deanne2622	F
@ChristineTopley	F
@MeredithStreet	F
@spunky_ginger	F
@sbeezyxo	F
@Rae_RaeLanay	F
@CallaLilRapture	F
@KelaWalker	F
@marcelaCFit	F
@StephHasJobs	F
@m3_creative	F
@mrgordon604	F
@wellashopaholic	F
@metalita	F
@YesiSao	F
@Vicious_Veee	F
@rachieannek	F
@denisemwoodward	F
@juanadotcom	F
@casseykoid	F
@LidNath	F
@Radhikamisra1	F
@MzTotaLPackage_	F
@emmyburns	F
@MelamudSashka	F
@ArushanaS	F
@dEcLee	F
@Nellathebest777	F
@runningpfuhl	F
@veggielivinmom	F
@legendapcy93	F
@Litefooted	F
@CelebrateSweets	F
@srutihari	F
@Iamthobeka	F
@annafelizatweet	F
@sandralbutler	F
@Melbling16	F
@stormie_sikb	F
@SistahInTheRaw	F
@naomi_jane	F
@AskMissE	F
@RockStarMommy	F
@JoGati	F
@girlwithapuck	F
@keke_everyday	F
@kittylover1313	F
@Likalottakeyz	F
@minierika	F
@MsAprilFish	F
@AlenaKobzarenko	F
@beautybymissl	F
@NigamPrerna	F
@ManjCarthigaser	F
@CLEstephanie	F
@FabAtAnyAge	F
@skeekies	F
@amazel_chef	F
@wullybully76	F
@Kellybrarian	F
@IM_BECK_JONES	F
@Melissa_Meyers	F
@Writer_Foodie	F
@cameraCHEYTV	F
@Tygemstones	F
@adidooms	F
@mynnisme	F
@Kendy13	F
@FitFantastic1	F
@visithra	F
@ShelbyAnnG9	F
@jawanalfadel	F
@bananables	F
@GrayceBeverly	F
@futurehopecom	F
@Susie525	F
@jenstyle	F
@voodooangelrah	F
@lucirebecca	F
@solariz	F
@hadehoplah	F
@SushGirl	F
@pentanthera	F
@YouCanCallMeLB	F
@melissatumoka	F
@laurasmessperth	F
@StephKall	F
@adLzXiaoFei	F
@snataliemora	F
@LisaOHaraLoomis	F
@IHaveLanded	F
@AGreathouse_AK	F
@Carla_Goycochea	F
@L0G0F0SH0	F
@duckie323	F
@Leighs_Stars	F
@syawaerisya19	F
@itsmedaiyan	F
@BronxPepe	F
@Tidbitsofexperi	F
@SarahOlson22	F
@littleflower6	F
@diviacity	F
@ElyseBrittany	F
@QsQueenFe	F
@priyabangaram1	F
@WalterJennyfer	F
@lmariephoto	F
@FunNFiber	F
@SuziG	F
@MtnMoxieGirl	F
@MissAlexV	F
@elainevrivera	F
@ItsNikkiBelle	F
@Hen_kumaseop	F
@ModernMom4Life	F
@rucsIncharge	F
@Pinkyinthesky13	F
@KatMonDieu	F
@Jojomololo	F
@CarolineIlima	F
@Tanyawarren	F
@SusieQMix1051	F
@CANDY_DBSK_SJ	F
@athenalucina	F
@thepotterbryant	F
@PaigeBARGA	F
@siesiechampion	F
@GiantBabyYoo	F
@WanderFit	F
@Stylewka	F
@Sharon_Grose	F
@fayecortes	F
@IntentionalAB	F
@JJelly_Swag	F
@BriGarcia07	F
@renZafarina	F
@WrapSkinnyTeam	F
@TrueToMind	F
@Taydolashes	F
@itzMzLORi	F
@marais_marion	F
@babycakesmel3	F
@Singing_Kat	F
@TipAM	F
@shelleyb99	F
@MissAlyss2	F
@Janelledakid	F
@angelannr	F
@TonyaTko	F
@merotCenaWade	F
@SisterShareefah	F
@febywiria	F
@Krista_Ra3	F
@OrganicSunshine	F
@JenniferSzaflik	F
@KarmenTahmasian	F
@despblogwife	F
@SherryAWright	F
@hamhamgirl	F
@MissMarieCox	F
@Setsuko136	F
@RaeRayRay	F
@theaprilnoelle	F
@doingsplendid	F
@GreySword	F
@DaniLAnderson	F
@thedanielcowan	M
@GRIFFERS	M
@HectorBaellerin	M
@WesleyMoore08	M
